time,open,high,low,close,Volume,Volume MA,RSI,RSI-based MA,Upper Bollinger Band,Lower Bollinger Band,CCI,Smoothing Line,Histogram,MACD,Signal,OnBalanceVolume,Smoothing Line,RSI,RSI-based MA,Upper Bollinger Band,Lower Bollinger Band,True Strength Index,Signal
1993-01-29T09:30:00-05:00,43.9688,43.96899,43.75,43.938,1003200,NaN,NaN,NaN,NaN,NaN,NaN,NaN,NaN,NaN,NaN,NaN,NaN,NaN,NaN,NaN,NaN,NaN,NaN
1993-02-01T09:30:00-05:00,43.96875,44.25,43.96875,44.25,480500,NaN,NaN,NaN,NaN,NaN,NaN,NaN,NaN,NaN,NaN,480500,NaN,NaN,NaN,NaN,NaN,NaN,NaN
1993-02-02T09:30:00-05:00,44.21875,44.375,44.125,44.34375,201300,NaN,NaN,NaN,NaN,NaN,NaN,NaN,NaN,NaN,NaN,681800,NaN,NaN,NaN,NaN,NaN,NaN,NaN
1993-02-03T09:30:00-05:00,44.40625,44.84375,44.375,44.8125,529400,NaN,NaN,NaN,NaN,NaN,NaN,NaN,NaN,NaN,NaN,1211200,NaN,NaN,NaN,NaN,NaN,NaN,NaN
1993-02-04T09:30:00-05:00,44.96875,45.09375,44.875,45,531500,NaN,NaN,NaN,NaN,NaN,NaN,NaN,NaN,NaN,NaN,1742700,NaN,NaN,NaN,NaN,NaN,NaN,NaN
1993-02-05T09:30:00-05:00,44.96875,45.0625,44.71875,44.96875,492100,NaN,NaN,NaN,NaN,NaN,NaN,NaN,NaN,NaN,NaN,1250600,1073360,NaN,NaN,NaN,NaN,NaN,NaN
1993-02-08T09:30:00-05:00,44.96875,45.125,44.90625,44.96875,596100,NaN,NaN,NaN,NaN,NaN,NaN,NaN,NaN,NaN,NaN,1250600,1227380,NaN,NaN,NaN,NaN,NaN,NaN
1993-02-09T09:30:00-05:00,44.8125,44.8125,44.5625,44.65625,122100,NaN,NaN,NaN,NaN,NaN,NaN,NaN,NaN,NaN,NaN,1128500,1316720,NaN,NaN,NaN,NaN,NaN,NaN
1993-02-10T09:30:00-05:00,44.65625,44.75,44.53125,44.71875,379600,NaN,NaN,NaN,NaN,NaN,NaN,NaN,NaN,NaN,NaN,1508100,1376100,NaN,NaN,NaN,NaN,NaN,NaN
1993-02-11T09:30:00-05:00,44.78125,45.125,44.78125,44.9375,19500,NaN,NaN,NaN,NaN,NaN,NaN,NaN,NaN,NaN,NaN,1527600,1333080,NaN,NaN,NaN,NaN,NaN,NaN
1993-02-12T09:30:00-05:00,44.875,44.875,44.59375,44.59375,42500,NaN,NaN,NaN,NaN,NaN,NaN,NaN,NaN,NaN,NaN,1485100,1379980,NaN,NaN,NaN,NaN,NaN,NaN
1993-02-16T09:30:00-05:00,44.46875,44.46875,43.40625,43.46875,374800,NaN,NaN,NaN,NaN,NaN,NaN,NaN,NaN,NaN,NaN,1110300,1351920,NaN,NaN,NaN,NaN,NaN,NaN
1993-02-17T09:30:00-05:00,43.46875,43.53125,43.28125,43.4375,210900,NaN,NaN,NaN,NaN,NaN,NaN,NaN,NaN,NaN,NaN,899400,1306100,NaN,NaN,NaN,NaN,NaN,NaN
1993-02-18T09:30:00-05:00,43.9375,43.9375,42.8125,43.40625,378100,NaN,NaN,NaN,NaN,NaN,NaN,NaN,NaN,NaN,NaN,521300,1108740,NaN,NaN,NaN,NaN,NaN,NaN
1993-02-19T09:30:00-05:00,43.40625,43.5625,43.34375,43.5625,34900,NaN,44.43621277226252,NaN,NaN,NaN,NaN,NaN,NaN,NaN,NaN,556200,914460,NaN,NaN,NaN,NaN,NaN,NaN
1993-02-22T09:30:00-05:00,43.6875,43.78125,43.5625,43.71875,513600,NaN,47.07529963522664,NaN,NaN,NaN,NaN,NaN,NaN,NaN,NaN,1069800,831400,NaN,NaN,NaN,NaN,NaN,NaN
1993-02-23T09:30:00-05:00,43.84375,43.875,43.46875,43.6875,373700,NaN,46.598595030528045,NaN,NaN,NaN,NaN,NaN,NaN,NaN,NaN,696100,748560,NaN,NaN,NaN,NaN,NaN,NaN
1993-02-24T09:30:00-05:00,43.71875,44.25,43.71875,44.25,26300,NaN,55.361077219383105,NaN,NaN,NaN,NaN,NaN,NaN,NaN,NaN,722400,713160,NaN,NaN,NaN,NaN,NaN,NaN
1993-02-25T09:30:00-05:00,44.21875,44.375,44.125,44.34375,44500,NaN,56.6381501490259,NaN,NaN,NaN,NaN,NaN,NaN,NaN,NaN,766900,762280,NaN,NaN,NaN,NaN,NaN,NaN
1993-02-26T09:30:00-05:00,44.4375,44.4375,44.1875,44.40625,66200,321040,57.51086685307007,NaN,NaN,NaN,13.128380137249692,NaN,NaN,NaN,NaN,833100,817660,39.01613429784017,NaN,NaN,NaN,NaN,NaN
1993-03-01T09:30:00-05:00,44.5625,44.5625,44.21875,44.28125,66500,274205,55.121403187911675,NaN,NaN,NaN,11.729530818767035,NaN,NaN,NaN,NaN,766600,757020,36.94343802211418,NaN,NaN,NaN,NaN,NaN
1993-03-02T09:30:00-05:00,44.3125,44.9375,44.25,44.9375,182400,259300,63.658295398737685,NaN,NaN,NaN,58.29596412556149,NaN,NaN,NaN,NaN,949000,807600,39.81541538704964,NaN,NaN,NaN,NaN,NaN
1993-03-03T09:30:00-05:00,45,45.15625,44.9375,45.125,280100,263240,65.6677553973071,NaN,NaN,NaN,98.65092748735194,NaN,NaN,NaN,NaN,1229100,908940,45.20074327802833,NaN,NaN,NaN,NaN,NaN
1993-03-04T09:30:00-05:00,45.1875,45.1875,44.875,44.875,89500,241245,60.83751281687735,NaN,NaN,NaN,81.70940170940202,52.70284085566643,NaN,NaN,NaN,1139600,983480,48.827798413108745,NaN,NaN,NaN,NaN,NaN
1993-03-05T09:30:00-05:00,44.9375,45.125,44.71875,44.75,40000,216670,58.51972469808197,NaN,NaN,NaN,68.27850990972318,63.732866810161134,NaN,NaN,NaN,1099600,1036780,51.30948189065825,NaN,NaN,NaN,NaN,NaN
1993-03-08T09:30:00-05:00,44.84375,45.75,44.84375,45.75,50800,194605,68.77023822887872,NaN,NaN,NaN,135.17422748191976,88.42180614279167,NaN,0.2817531754335363,NaN,1150400,1113540,54.71555362488663,NaN,NaN,NaN,NaN,NaN
1993-03-09T09:30:00-05:00,45.65625,45.6875,45.5,45.59375,169300,173265,66.02477499386558,NaN,NaN,NaN,141.86118892001252,105.13485110168187,NaN,0.33121674563858505,NaN,981100,1119960,54.99909431641725,NaN,NaN,NaN,NaN,NaN
1993-03-10T09:30:00-05:00,45.59375,45.6875,45.40625,45.6875,194400,176880,66.8791576254194,58.07850457189827,NaN,NaN,126.02818521714197,110.61030264763988,NaN,0.37367433772929104,NaN,1175500,1109240,54.38673858300458,NaN,NaN,NaN,NaN,NaN
1993-03-11T09:30:00-05:00,45.71875,45.84375,45.5,45.5625,70900,161445,64.54839037913911,59.51508868667516,NaN,NaN,115.97444089456856,117.46331048467319,NaN,0.39270892597437523,NaN,1104600,1102240,53.96422359287147,NaN,NaN,NaN,NaN,NaN
1993-03-12T09:30:00-05:00,45.1875,45.21875,44.8125,45.09375,643600,192650,56.58455992093022,60.194321564225426,NaN,NaN,54.40126883425883,114.68786226958032,NaN,0.36575358712394745,NaN,461000,974520,46.817558645682276,NaN,NaN,NaN,NaN,NaN
1993-03-15T09:30:00-05:00,45.0625,45.3125,45.0625,45.3125,310800,206065,59.11937114234976,61.08866271506984,NaN,NaN,67.88525006346782,101.23006678588995,NaN,0.35791674230240034,NaN,771800,898800,43.16757034084687,NaN,NaN,NaN,NaN,NaN
1993-03-16T09:30:00-05:00,45.3125,45.4375,45.3125,45.3125,30800,188865,59.11937114234976,61.35711228099603,NaN,NaN,72.8703561755838,87.4319002370042,NaN,0.34769794089176287,NaN,771800,856940,41.252830541139275,NaN,NaN,NaN,NaN,NaN
1993-03-17T09:30:00-05:00,45.25,45.25,44.96875,45.03125,21800,179410,54.384678263665045,61.196150003470244,NaN,NaN,41.33421985815626,70.49310716520706,NaN,0.3132934903177045,NaN,750000,771840,37.601337540772136,46.28699417674427,NaN,NaN,NaN,NaN
1993-03-18T09:30:00-05:00,45.21875,45.5,45.21875,45.3125,59300,163470,58.006512997584224,61.23155329950698,NaN,NaN,64.14453740754253,60.12712646780185,-0.035820293757658495,0.30520403769908455,0.34102433145674305,809300,712780,35.26815848468749,46.019281618661935,NaN,NaN,NaN,NaN
1993-03-19T09:30:00-05:00,45.28125,45.28125,45.03125,45.03125,66900,165070,53.43724501112028,61.11125628687902,NaN,NaN,32.06997084548129,55.660866870046355,-0.05445775209083703,0.2729521413431968,0.3274098934340338,742400,769060,39.14339174586871,46.176421170358694,NaN,NaN,NaN,NaN
1993-03-22T09:30:00-05:00,44.59375,44.875,44.5625,44.78125,183400,148560,49.69032943447083,60.11354443228853,NaN,NaN,-28.519224658404994,36.37997192567179,-0.0822239340105484,0.22462997592084832,0.3068539099313967,559000,726500,37.32370413245995,45.99844179503085,NaN,NaN,NaN,NaN
1993-03-23T09:30:00-05:00,44.90625,44.9375,44.8125,44.875,55200,132635,51.07571384707228,59.0712557501289,NaN,NaN,-20.305531834139536,17.744794323727128,-0.09213154696872616,0.19168947622048904,0.2838210231892152,614200,694980,35.98931872764564,45.340482898574955,NaN,NaN,NaN,NaN
1993-03-24T09:30:00-05:00,44.8125,45.0625,44.59375,44.875,37200,133180,51.07571384707228,58.37398439514283,NaN,NaN,-37.34707018673511,2.008536314748851,-0.09609930098804653,0.163696896954157,0.25979619794220354,614200,667820,34.83367470574319,44.34090263376312,NaN,NaN,7.354536544294706,NaN
1993-03-25T09:30:00-05:00,44.90625,45.25,44.84375,45.15625,110100,136460,55.35330039355918,58.14781123053405,NaN,NaN,4.2852770125508535,-9.963315764249483,-0.07796832258201994,0.16233579471467863,0.24030411729669857,724300,650820,34.095679333523194,43.111345308253476,NaN,NaN,6.934300804813469,NaN
1993-03-26T09:30:00-05:00,45.125,45.15625,44.875,44.90625,101500,138225,51.078238742056904,56.88409698147536,NaN,NaN,-30.92501368363436,-22.562312670072615,-0.08066217098804879,0.1394764035616376,0.22013857454968638,622800,626900,33.03513844974671,41.56274422431492,NaN,NaN,5.346573849011564,NaN
1993-03-29T09:30:00-05:00,44.9375,45.3125,44.9375,45.09375,87100,139255,53.95078505364795,56.021669128602674,NaN,NaN,-6.0087820660933335,-18.06022415161028,-0.06816332808691636,0.13493441444104093,0.2030977425279573,709900,657080,35.75057737990042,40.18785015742085,NaN,NaN,4.900564597594849,NaN
1993-03-30T09:30:00-05:00,45.15625,45.21875,45.09375,45.21875,56000,132935,55.813506514215035,55.23126547780236,NaN,NaN,5.928853754942087,-12.813347033793956,-0.05063045657991433,0.13980967180306436,0.1904401283829787,765900,687420,38.45256912798698,39.04969519634817,NaN,NaN,5.107164426443343,NaN
1993-03-31T09:30:00-05:00,45.34375,45.46875,45.1875,45.1875,111600,124510,55.21221434927015,54.564395761383146,NaN,NaN,35.08771929824714,1.6736108632024773,-0.04071756848365812,0.13954316777840603,0.18026073626206415,654300,695440,39.18068382462712,37.993728070044995,NaN,NaN,5.11607252462365,NaN
1993-04-01T09:30:00-05:00,45.25,45.25,44.9375,45.03125,129500,126510,52.184977343666766,54.25013986300719,NaN,NaN,-31.982765763524668,-5.579997692012627,-0.043984792742248285,0.1252797453342538,0.16926453807650207,524800,655540,36.84531563679915,37.281424997981915,NaN,NaN,4.306092430931076,NaN
1993-04-02T09:30:00-05:00,44.65625,44.65625,44.09375,44.09375,59400,127480,38.53336080053536,52.77971055287759,NaN,NaN,-244.01737721817122,-48.19847039892,-0.10509908240684743,0.0378906850679428,0.14298976747479022,465400,624060,35.069260407322915,36.7029742884445,NaN,NaN,-1.107102431235317,NaN
1993-04-05T09:30:00-04:00,44.4375,44.4375,44.1875,44.3125,172200,133550,42.32467764931084,51.58008958908909,NaN,NaN,-201.6260162601604,-87.32191723773342,-0.12523836407592254,-0.01355818762011296,0.11168017645580958,637600,609600,34.252518302087935,36.20295198565511,NaN,NaN,-4.181871109893839,NaN
1993-04-06T09:30:00-04:00,44.40625,44.40625,44.0625,44.1875,129700,131570,40.7768901015041,50.608104720363315,NaN,NaN,-185.10484454085204,-125.52865689689224,-0.14029144850001943,-0.0636841341692147,0.07660731433080473,507900,558000,31.43874186687738,35.76276658037692,NaN,NaN,-7.134827289353004,NaN
1993-04-07T09:30:00-04:00,44.25,44.34375,44.15625,44.34375,28000,123250,43.55553925426715,49.57589231012638,NaN,NaN,-143.57262103505354,-161.26072496355238,-0.13309902492953588,-0.08976646683111511,0.04333255809842076,535900,534320,30.212162722502896,35.401624025935156,NaN,NaN,-8.653544148867548,NaN
1993-04-08T09:30:00-04:00,44.53125,44.53125,44.09375,44.28125,180800,128745,42.69267876089121,48.80842329225287,NaN,NaN,-120.334620334617,-178.93109587777084,-0.12599734100276727,-0.11416411815503835,0.011833222847728933,355100,500380,28.49610927895337,34.64110384972692,NaN,NaN,-10.135106668471538,NaN
1993-04-12T09:30:00-04:00,44.71875,44.9375,44.65625,44.90625,348500,113990,52.769134036775114,49.02833790670318,NaN,NaN,-8.90626697078091,-131.90887382829277,-0.07516299563174728,-0.08212052169195516,-0.006957526060207886,703600,548020,34.15002351433108,34.41441237700343,NaN,NaN,-8.04015692505892,-0.014407953474423798
1993-04-13T09:30:00-04:00,44.875,45.15625,44.84375,45,146100,105755,54.07360954469501,49.24247331367622,NaN,NaN,29.082774049219335,-85.76711576641682,-0.0333145079262215,-0.048600660967984766,-0.015286153041763261,849700,590440,38.79108993313603,34.61453889168131,NaN,NaN,-5.934259688610723,-0.8601010584938951
1993-04-14T09:30:00-04:00,45.03125,45.0625,44.90625,44.9375,119600,110195,53.02222546253415,49.38150985763779,NaN,NaN,27.895480225990468,-43.16705081304833,-0.009187528066411696,-0.02677056312477788,-0.017583035058366184,730100,634880,43.29963181076168,35.21925011346835,NaN,NaN,-4.545542028352926,-1.386592625616614
1993-04-15T09:30:00-04:00,44.90625,45.03125,44.75,44.9375,148600,116535,53.02222546253415,49.21500450542171,NaN,NaN,16.119331168053197,-11.228660372426967,0.006576722069673534,-0.009362132471274265,-0.0159388545409478,730100,673720,46.97572138257407,36.13925311697198,NaN,NaN,-3.4249590676058594,-1.6777878316150776
1993-04-16T09:30:00-04:00,44.96875,45.03125,44.875,44.9375,47900,115965,53.02222546253415,49.35386069974152,NaN,NaN,31.650339110779132,19.168331516652266,0.01625799750667004,0.004383642342389749,-0.01187435516428029,730100,748720,53.27532496082228,37.58498072490595,NaN,NaN,-2.503997712610246,-1.7958178146143873
1993-04-19T09:30:00-04:00,44.9375,45.0625,44.71875,44.75,157000,120470,49.42167577248834,49.0303528939444,NaN,NaN,10.093167701868001,22.96821845118206,0.009616206562349853,0.0001459030386570248,-0.009470303523692828,573100,722620,51.00436376190629,38.67453689504923,NaN,NaN,-2.661060794336935,-1.9194239545747511
1993-04-20T09:30:00-04:00,44.6875,44.75,44.25,44.53125,279500,125275,45.53657166974976,48.29628611933975,NaN,NaN,-65.93406593406104,3.9648504545259513,-0.008924611777307852,-0.020626068245327644,-0.011701456468019792,293600,611400,42.659384553520454,38.97502371115876,NaN,NaN,-3.877326643090908,-2.1991243386484878
1993-04-21T09:30:00-04:00,44.625,44.625,44.375,44.5,67900,125910,44.99243086508984,47.566301584755436,NaN,NaN,-60.564031437813945,-13.727051878234931,-0.021965416669972267,-0.03915822730548513,-0.01719281063551286,225700,510520,36.7811128522695,38.80362578456179,NaN,NaN,-5.035173559672557,-2.604274227366212
1993-04-22T09:30:00-04:00,44.3125,44.6875,43.9375,43.9375,97700,128935,36.53059023391249,46.44813107691585,NaN,NaN,-110.72844917553412,-39.096607946952396,-0.06472836942103953,-0.09810327241181227,-0.03337490299077274,128000,390100,31.246202988965337,38.40368916685937,NaN,NaN,-8.762629648682307,-3.4840392875542254
1993-04-23T09:30:00-04:00,43.84375,43.96875,43.6875,43.75,106000,128730,34.22026968891166,46.1400531403713,NaN,NaN,-157.95914525086795,-77.01850481928182,-0.09979973101168821,-0.158124566755383,-0.05832483574369479,22000,248480,26.244338043483197,37.77333756944224,NaN,NaN,-12.60921403657376,-4.787635680271302
1993-04-26T09:30:00-04:00,43.78125,43.9375,43.28125,43.40625,62600,126785,30.421660733572693,45.289837646390005,NaN,NaN,-172.58883248730845,-113.5549048571171,-0.1379556997437381,-0.23076946042336743,-0.09281376067962932,-40600,125740,22.832869178104914,36.95764834630061,NaN,NaN,-17.198780344327208,-6.560656346565003
1993-04-27T09:30:00-04:00,43.34375,43.875,43.34375,43.875,156800,130270,40.17410779004019,45.246781766999725,NaN,NaN,-131.62645658952817,-126.69338298821053,-0.12387856074542167,-0.2476619616114064,-0.12378340086598474,116200,90260,21.944853466490912,36.27951346055871,NaN,NaN,-17.939177536606667,-8.186159373713812
1993-04-28T09:30:00-04:00,43.8125,43.90625,43.71875,43.78125,85900,131765,38.99681795855249,44.921158817305816,NaN,NaN,-104.69135802468944,-135.51884830558564,-0.11341576023226921,-0.26555310115632125,-0.15213734092405204,30300,51180,20.977107451809616,35.61986665550919,NaN,NaN,-18.89960987867697,-9.716652302994262
1993-04-29T09:30:00-04:00,43.875,43.96875,43.625,43.96875,85000,130435,42.61860518165225,44.91586784736018,NaN,NaN,-88.86027044430044,-131.1452125593389,-0.08755961894416181,-0.2615868646042543,-0.17402724566009248,115300,48640,20.912556940356822,35.07818434560944,NaN,NaN,-18.526249367845438,-10.975166169401573
1993-04-30T09:30:00-04:00,44.125,44.28125,44.03125,44.03125,88500,128385,43.81602470861403,44.276360038205816,NaN,NaN,-41.04131925143426,-107.76164735945216,-0.061188293422599876,-0.25051261243834233,-0.18932431901574245,203800,85000,24.494412094972503,34.388497815655256,NaN,NaN,-17.85607924049229,-11.95815375098596
1993-05-03T09:30:00-04:00,44.09375,44.3125,43.90625,44.3125,80500,129440,48.97599258046857,43.91224454076107,NaN,NaN,-28.678761224112527,-78.97963310681297,-0.0217769144067321,-0.2165454620241576,-0.19476854761742549,284300,149980,30.548165448344577,33.799717495313004,NaN,NaN,-15.645902450707148,-12.484974993803274
1993-05-04T09:30:00-04:00,44.40625,44.625,44.34375,44.46875,149100,128285,51.63359795276737,43.81305686149201,NaN,NaN,22.61566878407157,-48.13120803209302,0.015814133915066392,-0.1750008802235925,-0.1908150141386589,433400,213420,35.94761038429915,33.27457310770854,NaN,NaN,-12.974289860571384,-12.554877117627289
1993-05-05T09:30:00-04:00,44.46875,44.75,44.46875,44.59375,109000,127250,53.710761235498985,43.86223798813235,NaN,NaN,40.248226950356774,-19.143291037083788,0.048263303749827485,-0.13048588445137455,-0.17874918820120203,542400,315840,43.57449428214958,33.03162831482108,NaN,NaN,-10.11663977909889,-12.206557497837517
1993-05-06T09:30:00-04:00,44.53125,44.5625,44.40625,44.4375,54700,128585,50.7753146945026,43.701744361844376,NaN,NaN,15.611140677668127,1.750991187309923,0.05772988488058106,-0.1065868321004757,-0.16431671698105677,487700,390320,48.387397583305166,32.682490644998424,NaN,NaN,-8.544016456242954,-11.683337349038293
1993-05-07T09:30:00-04:00,44.46875,44.46875,44.28125,44.34375,68000,122945,49.04338892458942,43.67472387270874,NaN,NaN,-2.68456375838559,9.422342285919662,0.0561521967361398,-0.09412647106088201,-0.15027866779702181,419700,433500,50.99704365581711,32.681967780277766,NaN,NaN,-7.720380133809562,-11.117200604005617
1993-05-10T09:30:00-04:00,44.40625,44.6875,44.40625,44.4375,113900,111215,50.848877619491745,44.05417429769032,NaN,NaN,26.120096672247737,20.38211386519171,0.059572709343629876,-0.07581278111748446,-0.13538549046111434,533600,483360,53.89585621336765,33.48457289883829,NaN,NaN,-6.512272584215706,-10.45935374403563
1993-05-11T09:30:00-04:00,44.4375,44.625,44.3125,44.625,42600,106040,54.333879626215825,44.72142063777074,NaN,NaN,33.999608073685685,22.658901723114532,0.07179381615617017,-0.04564322026590162,-0.11743703642207179,576200,511920,55.519021682789216,34.822994958161125,NaN,NaN,-4.449359570241211,-9.600783147779284
1993-05-12T09:30:00-04:00,44.4375,44.59375,44.4375,44.5625,31000,101610,52.98526419164441,45.89675449189445,NaN,NaN,42.15625644197414,23.040507621438007,0.07277226572321956,-0.026471704268047347,-0.0992439699912669,545200,512480,55.55206540225103,36.55912798768153,NaN,NaN,-3.089373018669649,-8.670581700763622
1993-05-13T09:30:00-04:00,44.375,44.375,44,44.03125,129100,100635,43.17550319557861,46.53641402808495,NaN,NaN,-30.012460046585943,13.915787476587195,0.036572350963726005,-0.05352853128660939,-0.0901008822503354,416100,498160,54.43838770010534,38.57298867744026,NaN,NaN,-4.817614279195876,-8.1201577833968
1993-05-14T09:30:00-04:00,44.03125,44.15625,43.96875,44,63500,101415,42.67499343949531,47.41165207850799,NaN,NaN,-42.9732868757217,5.858042853119973,0.01079289318132827,-0.07660976577367506,-0.08740265895500333,352600,484740,53.35879604968506,40.75341202541027,NaN,NaN,-6.355173187218131,-7.868017126799848
1993-05-17T09:30:00-04:00,44.125,44.15625,43.9375,44.15625,34000,95265,46.043034259321736,47.8308611120281,NaN,NaN,-27.67680632612138,-4.9013377465538515,0.004837390508939082,-0.08135592081882947,-0.08619331132776856,386600,455340,50.973836159924076,42.82691078922692,NaN,NaN,-6.665405022069454,-7.696215397552649
1993-05-18T09:30:00-04:00,44.1875,44.21875,43.96875,44.125,105200,86550,45.46765988585676,48.29306410683555,NaN,NaN,-18.54838709676831,-15.410936780644652,-0.0003574812205159317,-0.08664016285341347,-0.08628268163289754,281400,396380,46.486423396962216,44.64900478530925,NaN,NaN,-7.081682424321651,-7.608424972805364
1993-05-19T09:30:00-04:00,44.125,45.03125,43.84375,45.03125,50200,85665,60.77582348159519,49.59000827111719,NaN,NaN,113.57250212377524,-1.1276876442844297,0.05502659415042439,-0.017499438944867052,-0.07252603309529145,331600,353660,43.498422909499695,46.262280925962315,NaN,NaN,-2.068367156564542,-6.816988141913818
1993-05-20T09:30:00-04:00,45.03125,45.15625,44.9375,45.15625,98200,85690,62.345924606479635,50.91357254953616,NaN,NaN,181.1366517832618,41.10213472168512,0.09549408860952277,0.04684157766661201,-0.04865251094291075,429800,356400,43.748166994759295,47.637549133089934,NaN,NaN,2.4161650268469623,-5.497966260662278
1993-05-21T09:30:00-04:00,45.1875,45.25,44.71875,44.75,221400,91460,54.684553416793094,51.321326894987905,NaN,NaN,126.86804451510936,75.07040099985133,0.09037000195882211,0.06430999150561689,-0.02606001045320522,208400,327560,41.66083290330959,48.431311094158865,NaN,NaN,3.6246127524502536,-4.194740687360488
1993-05-24T09:30:00-04:00,44.84375,45.09375,44.84375,44.9375,30500,89855,57.293046037554305,51.7255731867584,NaN,NaN,127.07273025776173,106.02030831662796,0.09462437499088705,0.0922204582854036,-0.002403916705483459,238900,298020,39.57785676083125,48.690614406768304,NaN,NaN,5.479236693357359,-2.81274391868651
1993-05-25T09:30:00-04:00,45.125,45.125,45.03125,45.03125,191800,91605,58.57697170575796,52.07315964891976,NaN,NaN,136.89482470785134,137.1089506775519,0.0983353895227376,0.12051532019793854,0.02217993067520094,430700,327880,42.696743790489215,48.62791794307828,NaN,NaN,7.366345852392363,-1.358588237103814
1993-05-26T09:30:00-04:00,45.15625,45.625,45.125,45.59375,102400,92430,65.31481925266732,53.111695688788664,NaN,NaN,195.46925566343512,153.48830138548385,0.1312017036299376,0.18618206021262296,0.05498035658268535,533100,368180,46.695863090795704,48.50709405075617,NaN,NaN,11.433286336287248,0.4688224162377663
1993-05-27T09:30:00-04:00,45.65625,45.65625,45.375,45.4375,53800,90870,62.28414656352285,54.05746409156962,NaN,NaN,172.12301587302662,151.68557420343683,0.1344511070935513,0.22304424044962445,0.08859313335607318,479300,378080,47.662171132089036,48.26888887048989,NaN,NaN,13.66589811737413,2.3541189449715323
1993-05-28T09:30:00-04:00,45.40625,45.40625,45,45.21875,79100,90400,58.21174458141686,54.58338316027856,NaN,NaN,103.07328605201913,146.92662251081876,0.11467182038339632,0.23193290883531859,0.11726108845192226,400200,416440,51.342861856210575,48.08653213069295,NaN,NaN,14.168405901524055,4.041874224479035
1993-06-01T09:30:00-04:00,45.375,45.8125,45.3125,45.65625,28300,87790,63.370227768287194,55.228836598997944,NaN,NaN,144.93497604381213,150.49907166802885,0.12311444131121621,0.2711541400909425,0.1480396987797263,428500,454360,54.731927930431745,48.030311148381706,NaN,NaN,16.35596229993938,5.801029663830514
1993-06-02T09:30:00-04:00,45.53125,45.75,45.34375,45.59375,20300,81350,62.18917522470101,55.886258815644844,NaN,NaN,120.14134275618987,147.14837527769654,0.11661399643343204,0.29380719432151636,0.17719319788808433,408200,449860,54.24903112851004,47.93723727168592,NaN,NaN,17.69460456912691,7.50011179315857
1993-06-03T09:30:00-04:00,45.5,45.5,45.34375,45.4375,21600,76980,59.2177777564779,57.03213556999479,NaN,NaN,88.51727982163217,125.75798010933595,0.09483959859660104,0.29574269613383564,0.2009030975372346,386600,420560,51.08838724399731,47.69795152482106,NaN,NaN,17.869510377887572,8.981454448119855
1993-06-04T09:30:00-04:00,45.3125,45.3125,45.09375,45.28125,32000,75845,56.319820996901676,58.006766109809526,NaN,NaN,54.80062374694039,102.29350168411871,0.06441707423648563,0.28142444033284164,0.217007366096356,354600,395620,48.49824783176714,47.35076950925549,NaN,NaN,17.13063512072288,10.145623115634573
1993-06-07T09:30:00-04:00,45.375,45.375,45.125,45.125,121400,78515,53.50026692597122,58.53942558599878,NaN,NaN,47.257965686277934,91.13043761097047,0.030022051169008218,0.2545349300576163,0.22451287888860808,233200,362220,45.19368933480848,46.937901878890095,NaN,NaN,15.665898215237256,10.934233844149242
1993-06-08T09:30:00-04:00,45,45,44.71875,44.71875,104500,78045,46.92276759236016,58.643361850749024,NaN,NaN,-13.722674325828647,59.39890753704234,-0.021082655465748112,0.19815955955642295,0.21924221502217106,128700,302260,39.93325131780113,46.46981815895002,NaN,NaN,12.2669788468664,11.12462598739455
1993-06-09T09:30:00-04:00,44.875,45.0625,44.8125,44.875,43300,78080,49.494663956081276,57.83756474178374,NaN,NaN,-0.8406893652753162,35.20250111274929,-0.044036187337963606,0.16419698084971657,0.20823316818768017,172000,255020,36.34395550673759,45.95878477303844,NaN,NaN,10.242968861489127,10.99867496940806
1993-06-10T09:30:00-04:00,44.84375,44.9375,44.75,44.90625,17900,77425,50.01632458617507,56.956879026047694,NaN,NaN,-12.492302278520079,15.000584692718826,-0.05601868677690444,0.13820980971654961,0.19422849649345406,189900,215680,33.632844327220624,45.2362617253571,NaN,NaN,8.761106103854981,10.67902227432905
1993-06-11T09:30:00-04:00,45.0625,45.15625,44.90625,45.09375,647400,103340,53.14352924590989,56.84680587098461,NaN,NaN,12.763868433978521,6.593233630126446,-0.05039742532007013,0.13123171484336638,0.1816291401634365,837300,312220,44.561867569787736,45.4434784872484,NaN,NaN,8.397024673206506,10.353022617025829
1993-06-14T09:30:00-04:00,45.15625,45.1875,45.03125,45.03125,64200,103375,51.97619289129311,56.467030646251665,NaN,NaN,10.380622837377862,-0.7822349396535746,-0.04987669341730841,0.119283273391801,0.1691599668091094,773100,420200,53.73823957843062,46.45493440279121,NaN,NaN,7.7672346478847105,9.983624335719956
1993-06-15T09:30:00-04:00,45.09375,45.125,44.9375,44.9375,142400,108795,50.19511459634074,55.86832656700757,NaN,NaN,-21.853388658359314,-2.408377806159708,-0.05446079517315472,0.10108397284266601,0.15554476801582073,630700,520600,60.31567367276166,47.71342939438211,NaN,NaN,6.743102778440678,9.520692684680059
1993-06-16T09:30:00-04:00,44.9375,45.03125,44.8125,45.03125,330900,120080,51.96765844667056,54.91495793800781,NaN,NaN,-51.28205128204321,-12.496650189513284,-0.049914262445950985,0.093151939958382,0.143066202404333,961600,678520,68.0180880487745,49.236445462809165,NaN,NaN,6.3484713130963195,9.067518203025239
1993-06-17T09:30:00-04:00,45.125,45.1875,45.03125,45.1875,37400,119440,54.851689790695886,54.38406816852017,NaN,NaN,-4.9435028248496,-10.986890298779189,-0.03578079298356904,0.09834021117487168,0.13412100415844072,999000,840340,73.65975475900598,51.09341572187467,NaN,NaN,6.7905982392625575,8.742243922487713
1993-06-18T09:30:00-04:00,44.84375,44.84375,44.5,44.5,58500,117455,42.702291754914675,53.276250109484295,NaN,NaN,-157.79757604943478,-45.0991791954618,-0.07014391931030814,0.04644110502055554,0.11658502433086368,940500,860980,74.28289704853584,52.731989664183615,NaN,NaN,3.3250819009338337,7.968363633694302
1993-06-21T09:30:00-04:00,44.625,44.625,44.53125,44.59375,29300,107850,44.507318808033425,51.92889946946617,NaN,NaN,-152.22623345366344,-77.62055045367006,-0.08308497843974327,0.012728801281184587,0.09581377972092786,969800,900320,75.47388016102568,54.2135576806546,NaN,NaN,1.0796696726969086,6.98426449640896
1993-06-22T09:30:00-04:00,44.65625,44.65625,44.5625,44.625,137500,113200,45.12784753102146,50.71023320563192,NaN,NaN,-129.55522661590956,-99.16091804518013,-0.08571994567703908,-0.011336152375371,0.07438379330166808,1107300,995640,78.11812928545757,55.91849326329371,NaN,NaN,-0.549400713950247,5.9080266092147875
1993-06-23T09:30:00-04:00,44.625,44.625,44.21875,44.21875,227600,114990,39.01935190196646,49.26748850173824,NaN,NaN,-167.0995670995604,-122.32442120868355,-0.10948197966653558,-0.062468681281501404,0.04701329838503418,879700,979260,76.58999985799981,57.74003702143675,NaN,NaN,-3.9578478796597936,4.49861596794699
1993-06-24T09:30:00-04:00,44.34375,44.8125,44.34375,44.8125,243700,122055,49.72954693465516,48.79675464014921,NaN,NaN,-85.96165739022315,-138.52805212175826,-0.08117320931513239,-0.054453213258881306,0.026719996056251083,1123400,1004140,77.31585811502782,59.79843775595537,NaN,NaN,-3.4307113594014726,3.3658549211829243
1993-06-25T09:30:00-04:00,44.78125,44.90625,44.75,44.78125,44800,121605,49.23937442305329,48.492405175655065,NaN,NaN,-43.13725490195365,-115.59598789226204,-0.061412489824170094,-0.05004561622396153,0.01136687360020856,1078600,1031760,78.12667573543429,62.150793927428644,NaN,NaN,-3.179191288049679,2.4308483198639808
1993-06-28T09:30:00-04:00,45,45.28125,44.9375,45.28125,439900,139645,56.60890356483834,49.18427203083208,NaN,NaN,46.64031620553975,-75.8226779604214,-0.014002307188115067,-0.006136010384935275,0.007866296803179792,1518500,1141500,81.02825284224973,65.08615117917498,NaN,NaN,-0.4227082435808564,2.023197382229004
1993-06-29T09:30:00-04:00,45.21875,45.21875,45,45.0625,207500,148605,52.98459524017849,49.433552836839034,NaN,NaN,38.12018041612767,-42.287596554013966,0.002415671394288268,0.010885886046040127,0.00847021465175186,1311000,1182240,81.9837397145195,68.34613576544511,NaN,NaN,0.6151672200628937,1.822050216205274
1993-06-30T09:30:00-04:00,45.125,45.21875,45,45.0625,437600,169470,52.98459524017849,49.645572169267844,NaN,NaN,48.99848376028165,0.9320136179544519,0.012502287484283807,0.024098074007106618,0.011595786522822811,1311000,1268500,83.83958979250792,71.93233187010848,NaN,NaN,1.422288432655975,1.7649413899839457
1993-07-01T09:30:00-04:00,45.125,45.125,44.875,44.9375,605700,198675,50.8279709881338,49.48017515085526,NaN,NaN,22.80701754386708,22.685748604772506,0.01008606792079465,0.024203371423816122,0.014117303503021473,705300,1184880,75.69903543838419,74.15641528929395,NaN,NaN,1.440962526839407,1.7186586952490115
1993-07-02T09:30:00-04:00,44.78125,44.8125,44.53125,44.6875,285400,211345,46.73115846801854,49.10552983490708,NaN,NaN,-70.14753953528566,17.283691678106095,-0.008040220754191498,0.004067027560282099,0.012107248314473597,419900,1053140,64.99226084515982,74.96027395120316,NaN,NaN,0.21063223414973872,1.503226343663401
1993-07-06T09:30:00-04:00,44.625,44.75,44.15625,44.21875,246400,217595,40.190095754128336,48.39088563189192,NaN,NaN,-149.7620836463736,-21.996788292276577,-0.049004855059679886,-0.049148820510126257,-0.00014396545044637402,173500,784140,49.57383232471961,74.19299956920017,NaN,NaN,-3.0362551789077186,0.8547289832960984
1993-07-07T09:30:00-04:00,44.1875,44.40625,44.1875,44.34375,343700,229555,42.50137613092283,47.714722609338494,NaN,NaN,-142.88874142887883,-58.19857266127788,-0.06413325826386104,-0.08031053828027268,-0.016177280016411638,517200,625380,43.07835499430794,72.4115900653097,NaN,NaN,-4.945833772288253,0.026077161069762433
1993-07-08T09:30:00-04:00,44.375,44.9375,44.3125,44.84375,248200,239800,50.706965080962334,47.41867084435753,NaN,NaN,-30.46280023432323,-74.09082946019885,-0.03819715985022405,-0.0639237298291917,-0.02572656997896765,765400,516260,39.269760134962155,69.955161877878,NaN,NaN,-3.9272665971937597,-0.5386862329678835
1993-07-09T09:30:00-04:00,44.84375,44.96875,44.75,44.96875,378200,257815,52.53081369017637,48.120708125447656,NaN,NaN,24.605081167656593,-73.73121673544094,-0.011726805388181612,-0.04038507671419467,-0.028658271326013056,1143600,603920,43.584788723151966,67.7624398546363,NaN,NaN,-2.525240418944848,-0.8224796881074499
1993-07-12T09:30:00-04:00,44.90625,44.96875,44.84375,44.9375,373700,244130,52.0126855281746,48.65680574831488,NaN,NaN,33.16898251905403,-53.067912324573015,0.003746008483714109,-0.02397576072137042,-0.02772176920508453,769900,673920,46.83340760328563,65.71669181479771,NaN,NaN,-1.564592393666274,-0.9284957889015676
1993-07-13T09:30:00-04:00,44.96875,45.09375,44.65625,44.90625,389600,260400,51.466011718191886,49.1095317616842,NaN,NaN,28.120873145348966,-17.491320966228496,0.011506128589619916,-0.013339108468059635,-0.02484523705767955,380300,715280,48.712638214284794,63.61629959542823,NaN,NaN,-0.9399647976049141,-0.9301342187163314
1993-07-14T09:30:00-04:00,44.9375,45.1875,44.90625,45.0625,617300,284145,54.065640536465835,50.18426666414844,NaN,NaN,76.26076260763362,26.338579841073994,0.025964870515079723,0.007610851086170101,-0.018354019428909622,997600,811360,52.879316604326895,61.92267936302302,NaN,NaN,0.33601657096147325,-0.7492555344766451
1993-07-15T09:30:00-04:00,45.03125,45.03125,44.78125,44.875,443800,289790,50.56549913459523,50.24397753557274,NaN,NaN,31.449478436876785,38.72103557531399,0.02186772655011073,0.008980638758728787,-0.012887087791381941,553800,769040,50.91712748405847,60.03705574652521,NaN,NaN,0.4437890736329186,-0.5788205904609931
1993-07-16T09:30:00-04:00,44.90625,44.9375,44.6875,44.75,216400,298740,48.319645739397004,50.178282629597284,NaN,NaN,5.85529067336673,34.97107747645602,0.010293654869529437,-0.00002001920447014527,-0.010313674073999583,337400,607800,44.189177403657574,57.61294872282688,NaN,NaN,-0.0977246418904398,-0.5100925978080569
1993-07-19T09:30:00-04:00,44.75,44.75,44.59375,44.71875,188200,305225,47.748675950144914,49.54540922854776,NaN,NaN,-29.341521664952392,22.46897663965474,0.0005993663729734894,-0.009564466107782721,-0.01016383248075621,149200,483660,39.82594278702064,54.6699265760248,NaN,NaN,-0.7020791174378802,-0.5375192434694602
1993-07-20T09:30:00-04:00,44.6875,44.84375,44.46875,44.84375,68500,307185,50.27954212965071,49.35219114922434,NaN,NaN,-22.1336874723246,12.418064516120028,0.0025616240750646942,-0.006961802386925342,-0.009523426461990036,217700,451140,38.74662337124895,51.58156112293404,NaN,NaN,-0.5426068152670174,-0.5382460394405398
1993-07-21T09:30:00-04:00,44.78125,44.8125,44.65625,44.8125,142700,307445,49.63230853642926,49.11274209895653,NaN,NaN,-10.892642850539167,-5.012616575514531,0.0017497658874853252,-0.007336219102633379,-0.009085984990118704,75000,266620,33.24177107338366,47.96743121442516,NaN,NaN,-0.5772720717177023,-0.543821186908706
1993-07-22T09:30:00-04:00,44.75,44.8125,44.5,44.5,632400,327685,43.58953088144189,48.595710662764255,NaN,NaN,-75.76656775468868,-26.45582581382762,-0.01871100146758797,-0.03247473682460367,-0.013763735357015697,-557400,44380,28.069211630429464,44.565300942428394,NaN,NaN,-2.305461471197097,-0.7954840846641904
1993-07-23T09:30:00-04:00,44.59375,44.71875,44.5625,44.71875,286200,329810,48.3317199685854,48.71003648423332,NaN,NaN,-52.38095238094254,-38.103074424689474,-0.016468957131321457,-0.03434993177116752,-0.017880974639846062,-271200,-77340,25.70959738100568,41.75939640927453,NaN,NaN,-2.4731821036008723,-1.0351552302265734
1993-07-26T09:30:00-04:00,44.84375,45.0625,44.84375,44.96875,121300,333635,53.17635438289854,49.63762638628833,NaN,NaN,53.714285714296494,-21.491912948839694,0.001917076156554745,-0.015484629444152631,-0.017401705600707376,-149900,-137160,24.614456009598413,39.9765838153373,NaN,NaN,-1.1802834128150308,-1.05588782773921
1993-07-27T09:30:00-04:00,45,45.03125,44.78125,44.9375,92800,316280,52.513523310612754,50.35277975626618,NaN,NaN,46.21676891616627,-7.821821671141521,0.011504935358757396,-0.003020536402260632,-0.014525471761018028,-242700,-229240,22.99101455369552,38.54177378386498,NaN,NaN,-0.30972073711702053,-0.9492925290788973
1993-07-28T09:30:00-04:00,44.84375,44.9375,44.78125,44.84375,30800,307445,50.480628125062516,50.33661283084477,NaN,NaN,28.298782494254073,0.01646339781712669,0.011060832006961166,-0.0006994317523165705,-0.011760263759277736,-273500,-298940,21.81797416945264,37.295217643471446,NaN,NaN,-0.1364094662346931,-0.833166377244011
1993-07-29T09:30:00-04:00,44.9375,45.21875,44.875,45.09375,331000,302115,55.43502622780336,50.54405658353242,NaN,NaN,117.75121735282217,38.72002041931929,0.026264281573071094,0.021070088207061133,-0.005194193366009962,57500,-175960,28.727717114434157,36.23399824284875,NaN,NaN,1.4616743358487156,-0.5053319896593358
1993-07-30T09:30:00-04:00,45.09375,45.09375,44.78125,44.84375,75300,275595,50.04309192866799,50.4033713264248,NaN,NaN,54.029614558621724,60.00213380723214,0.018509630696633785,0.01794284500478227,-0.0005667856918515147,-17800,-125280,31.41772563596126,35.13287810232557,NaN,NaN,1.262414792892791,-0.252796735009032
1993-08-02T09:30:00-04:00,44.90625,45.125,44.90625,44.96875,41300,263390,52.52931733044606,50.479321727300096,NaN,NaN,85.992907801429,66.45785822465865,0.02066123558718072,0.025259758792124387,0.0045985232049436655,23500,-90600,33.27363855830316,34.0300924126126,NaN,NaN,1.8302110565775545,0.04477580664619463
1993-08-03T09:30:00-04:00,45.0625,45.1875,44.84375,45,81600,255150,53.1569632104438,50.4144162040128,NaN,NaN,86.18976651764702,74.45245774495478,0.022879101874528573,0.03319740054810438,0.01031829867357581,105100,-21040,36.95863031465533,32.89290053477892,NaN,NaN,2.4735153822238574,0.39173860315728926
1993-08-04T09:30:00-04:00,45,45.09375,44.875,45,434000,259665,53.1569632104438,50.59952078085913,NaN,NaN,74.55329636477553,83.70336051905909,0.022975787210628075,0.0390380326868609,0.016062245476232827,105100,54680,40.791788441946444,32.16966203177092,NaN,NaN,3.0026567773211124,0.7647269137521211
1993-08-05T09:30:00-04:00,45,45,44.84375,44.90625,36800,249095,50.81916330354547,50.77805774972688,NaN,NaN,27.09483191170901,65.57208343083646,0.015702616566018505,0.03569051618375596,0.019987899617737455,68300,56840,40.90217861020886,31.934876403667438,NaN,NaN,2.83555724167313,1.0605598177408366
1993-08-06T09:30:00-04:00,45.03125,45.0625,44.90625,44.96875,402300,250300,52.324507414545984,51.10490285432695,NaN,NaN,62.79485928096578,67.32513237530527,0.014127155126113906,0.037646843525379836,0.02351968839926593,470600,154520,45.82157077436474,32.36313554562059,NaN,NaN,3.0880707551437894,1.35020423736983
1993-08-09T09:30:00-04:00,45.09375,45.34375,45,45.21875,828200,273025,57.87830885755773,51.64767190632032,NaN,NaN,168.449197860972,83.81639038721387,0.02813910904640902,0.05869357470727721,0.030554465660868186,1298800,409580,56.09806579662994,33.60252429029066,NaN,NaN,4.885538380777934,1.8552519721424163
1993-08-10T09:30:00-04:00,45.1875,45.21875,45.125,45.1875,604900,283790,56.984698667371276,52.17284262995902,NaN,NaN,141.28215598205196,94.83486828009487,0.03317357048770927,0.07202142877050477,0.0388478582827955,693900,527340,59.88163719040749,35.50537187007808,NaN,NaN,6.144487119619385,2.467999850353412
1993-08-11T09:30:00-04:00,45.15625,45.3125,45.15625,45.1875,542200,280035,56.98469866737127,53.12964032895398,NaN,NaN,149.8907314565017,109.90235529844009,0.03423589149513552,0.0816427226517149,0.047406831156579385,693900,645100,63.28886214380232,38.02106119246186,NaN,NaN,7.193523542636276,3.1430746635366784
1993-08-12T09:30:00-04:00,45.3125,45.3125,44.90625,45.0625,303700,273030,53.17599435793221,53.475659928193046,NaN,NaN,78.83211678834189,120.24981227376665,0.024697624710017338,0.07827886204410106,0.05358123733408372,390200,709480,65.03710917312341,40.83016917761313,NaN,NaN,7.121002507594235,3.711350069830615
1993-08-13T09:30:00-04:00,45.09375,45.15625,45.09375,45.125,103500,267385,54.802617596125195,53.59182158628066,NaN,NaN,84.65608465610289,124.62205734879407,0.020924647653432236,0.07973704690087402,0.058812399247441784,493700,714100,65.16531051869977,43.72665878540608,NaN,NaN,7.483688271550239,4.2502555272191325
1993-08-16T09:30:00-04:00,45.15625,45.5,45.15625,45.375,241800,270065,60.68580250709654,54.17555581460093,NaN,NaN,167.67175121202692,124.46656801900505,0.032881148659522866,0.09991383507184537,0.0670326864123225,735500,601440,59.44147336003896,46.330262985859186,NaN,NaN,9.495908212810104,4.999634482303557
1993-08-17T09:30:00-04:00,45.34375,45.53125,45.34375,45.53125,369300,285105,63.85273870726606,55.13070657047261,NaN,NaN,192.57795344754382,134.72572751210345,0.048011953472868116,0.12704762825340765,0.07903567478053954,1104800,683620,62.05939208405847,49.2046499797596,NaN,NaN,12.191111922878557,6.026988402385699
1993-08-18T09:30:00-04:00,45.6875,45.875,45.65625,45.78125,414300,298685,68.25850934069715,56.04666964996503,NaN,NaN,250.46040515655824,154.83966225211475,0.0702126456544552,0.16680148184860855,0.09658883619415334,1519100,848660,66.70704881876338,51.91745938721168,NaN,NaN,15.999393986916369,7.451617771604366
1993-08-19T09:30:00-04:00,45.8125,45.8125,45.71875,45.78125,28500,268490,68.25850934069715,57.34777089368139,NaN,NaN,206.7594433399802,180.4251275624424,0.07956636452649753,0.19604679185227525,0.11648042732577772,1519100,1074440,71.79692441574022,54.801687871481604,NaN,NaN,19.05478943948156,9.10921372415825
1993-08-20T09:30:00-04:00,45.6875,45.8125,45.65625,45.8125,80700,258215,68.80962962654857,58.51065034340299,NaN,NaN,169.99697244930442,197.49330512108273,0.08219046617071357,0.2192185100391697,0.13702804386845613,1599800,1295660,75.71456323957146,57.833182491572195,NaN,NaN,21.743954567671373,10.914176701802981
1993-08-23T09:30:00-04:00,45.625,45.75,45.625,45.71875,15600,252930,65.15476576730671,59.36763624032177,NaN,NaN,127.21812721814166,189.40258032230565,0.07229447769153002,0.22739614098286864,0.15510166329133862,1584200,1465400,78.21507285372986,60.780071244363235,NaN,NaN,23.052594012227292,12.648236317577883
1993-08-24T09:30:00-04:00,45.71875,46.21875,45.71875,46.21875,273400,261960,73.30018796098845,60.806438008217825,NaN,NaN,175.14420555848466,185.9158307444938,0.09279686749928956,0.2710977476654506,0.17830088016616102,1857600,1615960,80.16584442232164,63.592503814390035,NaN,NaN,27.087330218564134,14.710964017718776
1993-08-25T09:30:00-04:00,46.21875,46.4375,46.15625,46.25,242300,272535,73.7137714491306,62.44176716147391,NaN,NaN,183.31303288673757,172.4863562905297,0.10115157000410124,0.3047403426712876,0.20358877266718634,2099900,1732120,81.53934572355308,66.49515860820034,NaN,NaN,30.408102188141612,16.95341232777918
1993-08-26T09:30:00-04:00,46.28125,46.53125,46.09375,46.28125,120000,261985,74.14507492156295,64.00037912626082,NaN,NaN,154.41702432046972,162.0178724866276,0.10122382524754325,0.3301185542266154,0.22889472897907215,2219900,1872280,83.06337851080471,69.15528773223177,NaN,NaN,33.219062431162946,19.277076628262574
1993-08-27T09:30:00-04:00,46.15625,46.25,46.15625,46.25,25700,259505,72.85767153892027,65.07033360350103,NaN,NaN,121.77293277560271,152.37306455188724,0.09188170170414695,0.3437468561092558,0.25186515440510887,2194200,1991160,84.25097850782566,71.16621006874574,NaN,NaN,35.16071588492782,21.546167950643323
1993-08-30T09:30:00-04:00,46.28125,46.5,46.28125,46.4375,183500,266615,75.5956811135249,66.399689492512,NaN,NaN,131.067579262064,153.14295496067172,0.09087925445343842,0.3654642224719069,0.2745849680184685,2377700,2149860,85.69322040124223,73.00989458380538,NaN,NaN,37.70245352914709,23.854208747572432
1993-08-31T09:30:00-04:00,46.40625,46.5625,46.34375,46.5625,66500,265860,77.24377342817206,67.84676626114062,NaN,NaN,126.4264264264322,143.39939913426122,0.09096076848546591,0.38828592862530087,0.29732516013983495,2444200,2267180,86.66539547518309,74.67964696461829,NaN,NaN,40.369577718173495,26.21354717194401
1993-09-01T09:30:00-04:00,46.40625,46.59375,46.40625,46.5,136500,250985,74.5334521929975,69.37229896364528,NaN,NaN,115.62279823488463,129.86135220389065,0.07954428539277358,0.3967555168808019,0.3172112314880283,2307700,2308740,87.00233813328904,76.2485918903444,NaN,NaN,41.80496190372934,28.440892133627628
1993-09-02T09:30:00-04:00,46.53125,46.59375,46.3125,46.34375,472400,272765,68.10020285355306,70.32212648203298,NaN,NaN,95.18392112249201,118.0147315642951,0.05535534786462426,0.38640541631880865,0.3310500684541844,1835300,2231820,82.83061787215519,77.51039955844836,NaN,NaN,41.144808212062536,30.255737287689758
1993-09-03T09:30:00-04:00,46.3125,46.4375,46.25,46.375,630500,284175,68.68241609129953,70.89331316661891,NaN,NaN,76.79644730294235,109.01943446976304,0.036268553346233634,0.37638576013697644,0.3401172067907428,2465800,2286140,83.43469025972276,79.22420076556863,NaN,NaN,40.76396799419758,31.756913102905163
1993-09-07T09:30:00-04:00,46.375,46.4375,46,46.0625,196400,252585,57.400247117959374,70.43242091023987,NaN,NaN,43.519619500600385,91.50984251747032,-0.0006397407772615882,0.3393175308191658,0.3399572715964274,2269400,2264480,82.19288944536083,80.66230771994735,NaN,NaN,36.81066934968564,32.47887828101666
1993-09-08T09:30:00-04:00,46.0625,46.0625,45.59375,45.90625,269900,235835,52.735730056327476,69.32365096135632,NaN,NaN,-9.965635738826064,64.23143008441866,-0.03681044375724857,0.2939442168998667,0.3307546606571153,1999500,2175540,77.11736613444243,81.40590181392443,NaN,NaN,31.943495404119776,32.40239501288853
1993-09-09T09:30:00-04:00,45.71875,46.03125,45.71875,46,239200,220685,55.09368899162054,68.383306650708,NaN,NaN,-5.923836389274003,39.92210315958694,-0.054584396476810904,0.26252416506110166,0.31710856153791256,2238700,2161740,76.32976353600306,81.72967603680036,NaN,NaN,28.638877219138482,31.864749613781385
1993-09-10T09:30:00-04:00,46.125,46.4375,46.0625,46.40625,106500,210825,63.574154712262946,68.00934415683045,NaN,NaN,57.61824064089581,32.408967063267696,-0.03982845374191457,0.2673229943605193,0.3071514481024339,2345200,2263720,78.10902836800298,81.90070926025975,NaN,NaN,28.422613918516547,31.373015943029266
1993-09-13T09:30:00-04:00,46.5625,46.5625,46.4375,46.4375,66900,208995,64.13523071670976,67.93652022464495,NaN,NaN,87.40010202347285,34.529698007373796,-0.02929778047524917,0.2705292225083724,0.2998270029836216,2412100,2252980,77.44875105679183,81.84597198904989,NaN,NaN,28.435656736265187,30.953393199205827
1993-09-14T09:30:00-04:00,46.3125,46.3125,46.09375,46.25,184500,206130,58.32975098602386,66.86720329786176,NaN,NaN,24.235355106281755,30.672845128510072,-0.035860797940025224,0.25500100555859007,0.2908618034986153,2227600,2244620,76.9037973600398,81.61296862745833,NaN,NaN,26.542300618198965,30.323237116204847
1993-09-15T09:30:00-04:00,46.0625,46.40625,45.90625,46.375,101000,192715,60.87257411762846,65.9499749170402,NaN,NaN,20.293805845837117,36.72473344544271,-0.03276901141965183,0.24990053922405053,0.28266955064370236,2328600,2310440,78.204133427727,81.37473917775647,NaN,NaN,25.792467928296965,29.67598437507515
1993-09-16T09:30:00-04:00,46.3125,46.34375,46.15625,46.28125,54300,174715,58.01325117255754,64.79770179211123,NaN,NaN,24.678922185857886,42.84528516046909,-0.03767328411895993,0.23557794549500244,0.27325122961396237,2274300,2317560,78.34615582328837,81.03779470007672,NaN,NaN,24.28231621521798,28.90546035223841
1993-09-17T09:30:00-04:00,45.875,45.90625,45.75,45.8125,200900,183335,46.30215743377038,62.90087935602909,NaN,NaN,-119.13295784261484,7.495045463766957,-0.07117800064552332,0.1842787288070582,0.2554567294525815,2073400,2263200,74.36216041091657,80.3314505502975,NaN,NaN,18.686034121636126,27.445542319295228
1993-09-20T09:30:00-04:00,45.875,45.96875,45.4375,45.4375,57800,182190,39.44240676985424,60.31850261719548,NaN,NaN,-176.77756033917962,-45.34048700876353,-0.11470741363188419,0.11207246241272628,0.22677987604461047,2015600,2183900,68.86101669612505,79.12915028564628,NaN,NaN,11.275444027907907,25.13552827766847
1993-09-21T09:30:00-04:00,45.5,45.5625,44.8125,45.28125,318200,197320,36.983784056598665,57.44278909065453,NaN,NaN,-254.60209572356266,-101.10797717473243,-0.14801667303222016,0.04175903475433529,0.18977570778655545,1697400,2077860,62.23135366030807,77.38386158458377,NaN,NaN,4.558298892974145,22.195924079854997
1993-09-22T09:30:00-04:00,45.4375,45.71875,45.375,45.65625,439700,205635,45.72764207940368,55.385231225397824,NaN,NaN,-131.50992881227094,-131.46872410635405,-0.13893351790172503,0.016108810409399155,0.1550423283111242,2137100,2039560,59.98501847413035,75.45405303750101,NaN,NaN,2.0432036531275424,19.316964018893934
1993-09-23T09:30:00-04:00,45.78125,45.9375,45.71875,45.90625,88500,197945,50.644418641192935,54.138389495943535,NaN,NaN,-58.739255014314594,-148.1523595463885,-0.11141632300854543,0.015771924550442407,0.12718824755898783,2225600,2029820,59.3978256688446,73.78028216583596,NaN,NaN,1.813509581872314,16.816470527890846
1993-09-24T09:30:00-04:00,45.84375,45.875,45.71875,45.78125,53500,194620,48.28881085736055,52.68170340780504,NaN,NaN,-64.66804502640626,-137.2593769831468,-0.09746520953940845,0.005356735634727272,0.10282194517413572,2172100,2049560,60.24716054587533,72.12403004341829,NaN,NaN,0.8204712586503596,14.531327775142206
1993-09-27T09:30:00-04:00,46.125,46.28125,46.125,46.28125,274600,207065,56.920349787771464,52.647425027077325,NaN,NaN,31.658637302141425,-95.57213745488261,-0.0526402106955976,0.03702168180463872,0.08966189250023632,2446700,2135780,63.80826433567509,70.81084253558357,NaN,NaN,3.161395648882532,12.90705175710511
1993-09-28T09:30:00-04:00,46.3125,46.3125,46.15625,46.1875,158300,205805,55.0644233441947,52.81376026192498,NaN,NaN,32.227711126802035,-38.20617608480966,-0.0285856193382283,0.05392986832745095,0.08251548766567925,2288400,2253980,68.03568976347118,70.16215136622849,NaN,NaN,4.3123158975073625,11.679232348591146
1993-09-29T09:30:00-04:00,46.1875,46.3125,45.96875,46.03125,221000,213530,52.020053397053886,52.59421486231308,NaN,NaN,11.293124844884362,-9.645565353378615,-0.02273395001084136,0.05409805015212754,0.0768320001629689,2067400,2240040,67.04111428200106,69.49867641951406,NaN,NaN,4.21548865830475,10.612983249978804
1993-09-30T09:30:00-04:00,46.03125,46.125,45.84375,45.9375,99300,211670,50.22577865848448,51.640759429900335,NaN,NaN,-15.479470024912025,-0.9936083554981124,-0.02455785447891909,0.04613468206432003,0.07069253654323912,1968100,2188540,63.35626553840009,68.444907645971,NaN,NaN,3.5649583187645364,9.606122545519623
1993-10-01T09:30:00-04:00,45.875,46.21875,45.8125,46.15625,22700,189185,54.19573336511248,50.93079533335767,NaN,NaN,13.400335008387545,14.620067651460653,-0.011098055554428554,0.05681996710020343,0.06791802265463198,1990800,2152280,60.82148303262357,67.25724564424469,NaN,NaN,4.291851492775291,8.846940966556147
1993-10-04T09:30:00-04:00,46.21875,46.21875,46.09375,46.21875,1038500,209585,55.29290400353807,50.71387769175154,NaN,NaN,48.020765736547204,17.892493338341808,0.001289472403106104,0.06952986315851462,0.06824039075540851,3029300,2268800,65.58623867173193,66.44884859507984,NaN,NaN,5.212072688344728,8.327674069668802
1993-10-05T09:30:00-04:00,46.3125,46.3125,46,46.15625,436500,221590,53.902435004108995,50.21601061221444,NaN,NaN,42.479410489827266,19.942833210946855,0.004375400061295873,0.07370964083202836,0.06933424077073248,2592800,2329680,67.79036885969391,65.70500826879176,NaN,NaN,5.5587411868141166,7.93211222926099
1993-10-06T09:30:00-04:00,46.1875,46.375,46.125,46.125,209200,218555,53.18230033930122,49.87094269555327,NaN,NaN,52.17391304349004,28.11899085066799,0.003453824999204075,0.07365152201973757,0.0701976970205335,2383600,2392920,69.94384665940825,65.1048433285146,NaN,NaN,5.642065427854658,7.604962686202942
1993-10-07T09:30:00-04:00,46.1875,46.1875,45.96875,46,59400,209565,50.2881841602467,50.155658890301574,NaN,NaN,6.976916796569566,32.61026821496431,-0.005922042590851648,0.06279514378196893,0.06871718637282058,2324200,2464140,72.19820176104788,64.95027485352398,NaN,NaN,4.907139330469308,7.219559349669566
1993-10-08T09:30:00-04:00,46.125,46.15625,45.71875,46.0625,54400,206960,51.70339179392619,51.03144353487814,NaN,NaN,-9.532595325942165,28.023682148098366,-0.00812608897983716,0.05855957514802412,0.06668566412786128,2378600,2541700,74.44605236323281,65.34920597260312,NaN,NaN,4.673037036166952,6.855770447740621
1993-10-11T09:30:00-04:00,46.15625,46.25,46.15625,46.15625,467100,226970,53.82676709532775,52.234513751930216,NaN,NaN,59.33852140079018,30.287233280946964,-0.0037066140327066954,0.06205239658697792,0.06575901061968462,2845700,2504980,71.49863353485024,66.0111545350704,NaN,NaN,5.046437116250646,6.597294257527768
1993-10-12T09:30:00-04:00,46.21875,46.25,46.1875,46.21875,26200,219055,55.23962116625159,52.91394082956221,NaN,NaN,69.06614785993196,35.6045807549679,0.00264682571825145,0.06906754276749894,0.06642071704924749,2871900,2560800,73.23349083573497,66.95747398947073,NaN,NaN,5.7412831637112545,6.475006958411123
1993-10-13T09:30:00-04:00,46.25,46.25,46.15625,46.21875,139100,220960,55.23962116625158,53.242169581352115,NaN,NaN,66.40625000001036,38.451048146271965,0.005884742691006278,0.07377664541300533,0.06789190272199905,2871900,2658460,75.98739557550435,68.14244326851785,NaN,NaN,6.322478165609476,6.453217130868031
1993-10-14T09:30:00-04:00,46.40625,46.8125,46.28125,46.8125,108100,223650,66.52508627056008,54.54476068229494,NaN,NaN,181.26520681265666,73.30870614948938,0.044878498758763485,0.1239900261704534,0.07911152741168992,2980000,2789620,79.0978105220958,69.48891826681931,NaN,NaN,10.50810726453209,7.032487149962896
1993-10-15T09:30:00-04:00,47.03125,47.15625,46.90625,47.0625,1502500,288730,69.95950939128392,55.47612922540297,NaN,NaN,252.1236833163499,125.6399618779478,0.08219959582436945,0.18186102219215172,0.09966142636778227,4482500,3210400,85.5600507164157,71.04261729401507,NaN,NaN,15.259409974541285,8.20776183918838
1993-10-18T09:30:00-04:00,47.03125,47.03125,46.875,46.9375,722400,321960,66.29696683326266,56.2784537603364,NaN,NaN,201.550387596905,154.08233511717077,0.09239689561607556,0.21515754588787672,0.12276065027180116,3760100,3393280,87.38545370791219,72.42474329004658,NaN,NaN,18.0213918478973,9.609708983289654
1993-10-19T09:30:00-04:00,46.875,46.96875,46.59375,46.59375,880100,350055,57.39781419518999,56.662579531631835,NaN,NaN,134.28153106046562,167.1254117572775,0.07088826027126,0.21137097561087614,0.14048271533961615,2880000,3394900,87.4006478012912,73.87899568428159,NaN,NaN,17.531125420196034,10.741339902847708
1993-10-20T09:30:00-04:00,46.75,46.75,46.5625,46.65625,230400,339590,58.48885673694258,57.25279939437884,NaN,NaN,97.11286089240606,173.26673393575663,0.05639883447656141,0.2109812584353179,0.1545824239587565,3110400,3442600,87.86415987438922,75.62955956542366,NaN,NaN,17.483868334667182,11.70455825025049
1993-10-21T09:30:00-04:00,46.6875,46.6875,46.53125,46.59375,56200,337975,56.9190291037783,57.447320518569256,NaN,NaN,71.60867372668974,151.33542731856326,0.038962720556708824,0.2032858246546425,0.1643231040979337,3054200,3457440,88.0119218217933,77.57173376465008,NaN,NaN,16.970361995494,12.456815928142419
1993-10-22T09:30:00-04:00,46.65625,46.84375,46.375,46.375,390700,354835,51.68981370084479,57.18995692551973,NaN,NaN,45.60260586320321,110.0312118279339,0.010533395617322333,0.1774898486195866,0.16695645300226428,2663500,3093640,66.60280481864805,77.64434563228694,NaN,NaN,14.904703836615651,12.806514200781452
1993-10-25T09:30:00-04:00,46.40625,46.5625,46.28125,46.5,114500,346830,54.274929865008545,57.21656370129828,NaN,NaN,22.35772357724377,74.19267902400166,-0.0013826346266400669,0.1652281597189642,0.16661079434560427,2778000,2897220,58.349929527879354,76.97002853715733,NaN,NaN,13.958434868461875,12.97107429616437
1993-10-26T09:30:00-04:00,46.46875,46.5,46.3125,46.46875,186200,348225,53.50410949460972,57.23955006953459,NaN,NaN,14.860363822709923,50.308445576450524,-0.012292152343016088,0.15124560391683417,0.16353775625985026,2591800,2839580,56.151088206409185,75.98483150480025,NaN,NaN,12.965795965578097,12.970320248937758
1993-10-27T09:30:00-04:00,46.40625,46.53125,46.40625,46.5,118400,343095,54.204533596757024,57.519289314999625,NaN,NaN,23.715415019771918,35.628956401923695,-0.01798229227043263,0.14105989092180948,0.15904218319224211,2710200,2759540,53.15558200663433,74.62464437948502,NaN,NaN,12.33937744844421,12.880185563152965
1993-10-28T09:30:00-04:00,46.5625,46.96875,46.5625,46.84375,129600,344610,61.13933609067831,58.1932853361962,NaN,NaN,94.01193589486543,40.10960883555883,-0.00011873555382702072,0.15889376374995834,0.15901249930378536,2839800,2716660,51.56839520978722,72.99052601138176,NaN,NaN,13.852828399854591,13.019134539824625
1993-10-29T09:30:00-04:00,46.8125,46.875,46.78125,46.84375,80700,347510,61.13933609067831,58.71561169300695,NaN,NaN,94.83568075118296,49.956223813154786,0.009634333432136988,0.17105541609395658,0.1614210826618196,2839800,2751920,52.81602547062476,71.65605400679422,NaN,NaN,15.068411143462656,13.311888340344344
1993-11-01T09:30:00-05:00,46.78125,47,46.78125,46.96875,36400,297405,63.47211111148044,59.30364668909472,NaN,NaN,104.05228758170844,66.29513661404772,0.02174788322484872,0.1886059366928805,0.1668580534680318,2876200,2771560,53.53404420181782,70.24895067580015,NaN,NaN,16.784953228556756,13.808040467231832
1993-11-02T09:30:00-05:00,46.90625,47,46.65625,46.9375,262100,288685,62.46260849445589,59.819574355395034,NaN,NaN,82.74044795784869,79.87115344107546,0.024684846563770735,0.19771411167274522,0.17302926510897448,2614100,2776020,53.70632661845192,68.65744575029639,NaN,NaN,17.931520732814395,14.397109076600769
1993-11-03T09:30:00-05:00,46.90625,46.90625,46.125,46.34375,479100,302180,47.12615885290143,58.43393668270513,NaN,NaN,-24.343015214375637,70.25946739424596,-0.014237554833836485,0.15523232156667888,0.16946987640051536,2135000,2660980,48.69147896696958,66.48556492493023,NaN,NaN,14.009280168745494,14.341704946907159
1993-11-04T09:30:00-05:00,46.34375,46.34375,45.8125,45.84375,130400,305730,38.5437411566288,56.18995323737262,NaN,NaN,-143.87405886378275,22.68226844251634,-0.07134086224982869,0.08029379858822949,0.15163466083805818,2004600,2493940,42.48775618141664,63.40897245814458,NaN,NaN,7.257212138709409,13.329634545736052
1993-11-05T09:30:00-05:00,45.71875,46.0625,45.53125,46.0625,363200,321170,43.400256943889055,54.55447395956022,NaN,NaN,-169.6236559139694,-30.209598890514133,-0.09081461347718872,0.038116393991572295,0.12893100746876102,2367800,2399540,39.430264372481396,59.9836017913281,NaN,NaN,3.5633379466773154,11.93444931729909
1993-11-08T09:30:00-05:00,46.09375,46.25,45.96875,46.125,367600,316195,44.743814349316395,53.650616827712106,NaN,NaN,-108.0185553346475,-72.62376747378532,-0.09544656677045657,0.009622799005690297,0.10506936577614687,2735400,2371380,38.53931939021256,56.493506904822475,NaN,NaN,1.1574115962201237,10.394872500002096
1993-11-09T09:30:00-05:00,46.4375,46.46875,46.125,46.15625,246900,327230,45.441181382328814,52.71864001666827,NaN,NaN,-74.39999999999071,-104.05185706535319,-0.09230991396825157,-0.010318026684167592,0.08199188728408398,2982300,2445020,42.21630809924652,53.23294606374086,NaN,NaN,-0.5120594855486305,8.836739359209135
1993-11-10T09:30:00-05:00,46.15625,46.5,46.03125,46.5,46500,322600,52.537150083478494,52.40564865807543,NaN,NaN,-53.524982888421356,-109.88825060016234,-0.06431506498195252,0.0015980560566433155,0.06591312103859584,3028800,2623780,50.03138868430543,50.52005083963458,NaN,NaN,0.34988547786393204,7.624331661874106
1993-11-11T09:30:00-05:00,46.5,46.625,46.34375,46.375,88900,321640,49.99096347335813,52.284302213254946,NaN,NaN,-23.71649873191138,-85.85673857378808,-0.05197505932573965,0.0009442968814212804,0.05291935620716093,2939900,2810840,56.64003308530433,49.80842428725289,NaN,NaN,0.23930149166026174,6.569327351843557
1993-11-12T09:30:00-05:00,46.46875,46.75,46.4375,46.59375,108200,251925,54.17635493449088,52.27726114678941,NaN,NaN,22.624434389152633,-47.40712051316366,-0.028038306060504767,0.017871473631529966,0.04590977969203473,3048100,2946900,60.7103437086279,49.977025300163504,NaN,NaN,1.4953876467940717,5.844478822550774
1993-11-15T09:30:00-05:00,46.6875,46.6875,46.4375,46.5625,243300,227970,53.487658513064964,52.276086076679064,NaN,NaN,20.905349794253357,-21.622339487383492,-0.013978251203379907,0.028436965687809845,0.04241521689118975,2804800,2960780,61.111399332143115,50.33133323771592,NaN,NaN,2.2875179252645252,5.336341551509881
1993-11-16T09:30:00-05:00,46.65625,46.8125,46.46875,46.78125,492600,208595,57.555142465944904,52.51541528162106,NaN,NaN,61.359867330030916,5.529633978620838,0.009140504342653177,0.053840847319506224,0.04470034297685305,3297400,3023800,62.96011299123097,51.03165687947283,NaN,NaN,4.232141236648058,5.178598649386764
1993-11-17T09:30:00-05:00,46.8125,46.8125,46.40625,46.53125,39600,199055,51.962415627057894,51.85992096279103,NaN,NaN,29.873417721533244,22.20931410061176,0.0067897916437856115,0.053187582531585065,0.04639779088779945,3257800,3069600,64.2888025120418,51.94025740106243,NaN,NaN,4.164713315381932,5.0337578873860735
1993-11-18T09:30:00-05:00,46.46875,46.5625,46.28125,46.40625,240800,208285,49.37876160765986,51.01987992828971,NaN,NaN,-21.394950791598852,22.673623688674258,-0.0034397294127394354,0.04209812912187516,0.045537858534614596,3017000,3085020,64.74731340285817,52.79249225336481,NaN,NaN,3.3138675265628392,4.788059264411325
1993-11-19T09:30:00-05:00,46.25,46.375,46.21875,46.3125,106000,194050,47.47228657810394,49.87703531876282,NaN,NaN,-53.92770682025506,7.363195446792726,-0.01606914467926058,0.025451427685538874,0.04152057236479945,2911000,3057600,63.19354697001634,53.48245673680758,NaN,NaN,2.041473875424011,4.395689923127423
1993-11-22T09:30:00-05:00,46.1875,46.21875,45.875,46.03125,165300,196590,42.207438303802064,48.43023744800183,NaN,NaN,-119.87767584096332,-20.793409680250612,-0.04146989946018787,-0.010316801960435384,0.031153097499752487,2745700,3045780,62.497305344995354,54.11038378870354,NaN,NaN,-0.7301012971604597,3.663434034514869
1993-11-23T09:30:00-05:00,46.28125,46.3125,46.03125,46.28125,89700,191765,47.754081606601964,48.475089073266155,NaN,NaN,-64.38485575174809,-45.94235429660641,-0.03954628069590065,-0.01827975337012333,0.021266527325777322,2835400,2953380,57.19254406179179,54.717602724047985,NaN,NaN,-1.3669355644014507,2.944809806098252
1993-11-24T09:30:00-05:00,46.40625,46.5,46.34375,46.46875,77200,189705,51.512732174889585,49.4014455745705,NaN,NaN,0.14648795137985296,-51.887740250637094,-0.024495583244321613,-0.009352951729624692,0.015142631514696919,2912600,2884340,53.5360539409558,55.50676684972935,NaN,NaN,-0.7113105675232099,2.4225068955809004
1993-11-26T09:30:00-05:00,46.59375,46.59375,46.46875,46.5,1019800,234215,52.13084643901389,50.02505910993656,NaN,NaN,28.878078912840433,-41.83313430974924,-0.01192174919817535,0.00024044501697773057,0.01216219421515308,3932400,3067420,60.7096328580848,57.02672174155817,NaN,NaN,-0.0009373647702844111,2.0763005726735884
1993-11-29T09:30:00-05:00,46.625,46.71875,46.3125,46.3125,517500,256055,48.16354304426621,50.26932544529012,NaN,NaN,13.972055888237444,-28.253181768050734,-0.015492448189885091,-0.007203366022203284,0.008289082167681807,3414900,3168200,64.00414016805996,58.84563751140441,NaN,NaN,-0.5816744149537945,1.6965898601553908
1993-11-30T09:30:00-05:00,46.28125,46.5625,46.25,46.34375,230000,265735,48.86206055059889,50.513673957309415,NaN,NaN,2.77777777779531,-3.722091044299011,-0.014999621393357502,-0.010460444574015071,0.004539176819342431,3644900,3348040,68.99952905375577,60.75872472244079,NaN,NaN,-0.8535624601064826,1.332282385832266
1993-12-01T09:30:00-05:00,46.59375,46.625,46.40625,46.40625,379200,271590,50.30442298170287,50.354193450039716,NaN,NaN,46.81194511704529,18.517269129459667,-0.009957200985803525,-0.007907324412911976,0.0020498765728915497,4024100,3585780,74.1138193598128,62.478898342119884,NaN,NaN,-0.6780071651675151,1.0450981642608688
1993-12-02T09:30:00-05:00,46.5,46.5625,46.40625,46.53125,352000,265235,53.15052575097776,50.579876469869696,NaN,NaN,53.557154276595206,29.199402394502737,0.0016837830106897845,0.0041546053362537805,0.002470822325563996,4376100,3878480,78.75983018252035,64.05888384906389,NaN,NaN,0.2712227543810383,0.9345445342780359
1993-12-03T09:30:00-05:00,46.5,46.71875,46.5,46.71875,306000,274015,57.11774663255675,50.7899758768744,NaN,NaN,104.78654592498134,44.381095796930914,0.02083514551891797,0.028514754224211458,0.007679608705293489,4682100,4028420,80.67341143847872,65.48481725833895,NaN,NaN,2.2560633253961293,1.1233329330091921
1993-12-06T09:30:00-05:00,46.78125,46.9375,46.78125,46.875,99500,260830,60.146419987195316,51.265601696455136,NaN,NaN,191.14877589455446,79.81643979819432,0.041648132203831,0.05973977396008223,0.018091641756251237,4781600,4301760,83.5780040669029,67.08957473939321,NaN,NaN,4.863354789566367,1.6576217696602171
1993-12-07T09:30:00-05:00,46.875,46.90625,46.78125,46.84375,88800,246890,59.24517573217495,51.386318358328715,NaN,NaN,162.50000000002197,111.76088424263965,0.05035080509417654,0.08103014812397191,0.030679343029795372,4692800,4511340,85.39094436263093,68.69177698020751,NaN,NaN,6.7669829024952275,2.3875305029223615
1993-12-08T09:30:00-05:00,46.84375,46.84375,46.78125,46.84375,146700,241880,59.24517573217495,51.90651550869422,NaN,NaN,134.75413475415806,129.3493221700622,0.05288630174502521,0.09678722021107689,0.043900918466051674,4692800,4645080,86.42113411812906,70.27265780921373,NaN,NaN,8.339250569566932,3.2377762267287284
1993-12-09T09:30:00-05:00,46.84375,46.90625,46.625,46.6875,416500,260380,54.508874533701466,52.272952146268615,NaN,NaN,88.49940495512651,136.33777230576848,0.041331368331878185,0.09556512888089941,0.05423376054902122,4276300,4625120,85.45262350122447,71.75160853052562,NaN,NaN,8.460173649218284,3.9838330013700936
1993-12-10T09:30:00-05:00,46.71875,46.71875,46.5,46.59375,412900,276580,51.831459528208015,52.584321642704616,NaN,NaN,29.004329004349785,121.18132892164215,0.025444956474453183,0.0860399561420877,0.06059499966763452,3863400,4461380,77.75443523028994,72.79167197768801,NaN,NaN,7.83474695665882,4.53396356641134
1993-12-13T09:30:00-05:00,46.59375,46.875,46.53125,46.875,273200,284830,58.42851262262464,53.742969808334806,NaN,NaN,86.00823045269193,100.15321983326965,0.03155007953229291,0.10003259908300066,0.06848251955070775,4136600,4332380,72.23339676171037,73.48710707888195,NaN,NaN,9.1888485113066,5.198947129967806
1993-12-14T09:30:00-05:00,46.90625,46.90625,46.53125,46.53125,41900,274760,49.5043980850659,53.86799241393937,NaN,NaN,41.841841841861054,76.02158820163747,0.01116108109003873,0.08243387091325616,0.07127278982321743,4094700,4212760,67.45061785426685,74.2198266354873,NaN,NaN,7.582103671444463,5.539398064464471
1993-12-15T09:30:00-05:00,46.59375,46.625,46.46875,46.46875,82600,254260,48.06689634362693,53.62186128313489,NaN,NaN,-7.280291211627863,47.61470300848029,-0.006841814855225739,0.06272052125418526,0.069562336109411,4012100,4076620,62.38762459574698,74.8520816822581,NaN,NaN,5.8389093655080355,5.5821853931849805
1993-12-16T09:30:00-05:00,46.65625,46.65625,46.5625,46.625,78200,256190,51.83257065867029,53.600555870253196,NaN,NaN,29.236154004551555,35.76205281836529,-0.00842969858791004,0.05902521287452345,0.06745491146243349,4090300,4039420,61.03936566536722,74.87563402563542,NaN,NaN,5.509367790056182,5.571782878452295
1993-12-17T09:30:00-05:00,46.40625,46.59375,46.375,46.5625,104700,249385,50.262612033831495,53.75048936950787,NaN,NaN,-14.148453172825183,27.1314963829303,-0.01358663216013789,0.050471621262261124,0.06405825342239901,3985600,4063860,61.62611628325863,74.70577517672105,NaN,NaN,4.7722610230772196,5.45756547054157
1993-12-20T09:30:00-05:00,46.53125,46.65625,46.5,46.625,68800,247525,51.83374528486209,53.962752564812384,NaN,NaN,14.5903479237047,12.847919877132853,-0.01270206738833242,0.048180669186983494,0.06088273657531591,4054400,4047420,60.961049486300766,74.13159806475997,NaN,NaN,4.611328566353688,5.3366744842290155
1993-12-21T09:30:00-05:00,46.5625,46.5625,46.40625,46.46875,205700,249545,47.771004519836374,53.78179410325049,NaN,NaN,-51.50326797383063,-5.821102086005485,-0.022008342223938514,0.03337230879539277,0.05538065101933128,3848700,3998220,58.9120010940011,73.04575390291627,NaN,NaN,3.279945934111956,5.0428561199265785
1993-12-22T09:30:00-05:00,46.59375,46.8125,46.5,46.78125,410300,265575,55.31472570745938,53.93637981442775,NaN,NaN,51.37186223003685,5.909328602327457,-0.00724949621303847,0.046318780753033195,0.053568276966071665,4259000,4047600,60.35241461517576,71.73093850524882,NaN,NaN,4.432817129700912,4.955707692751483
1993-12-23T09:30:00-05:00,46.75,46.84375,46.6875,46.75,533800,288405,54.46750584752397,53.747076901211116,NaN,NaN,77.31582786290639,15.525263373998422,-0.00010158063917910937,0.05344130116709778,0.053542881806276886,3725200,3974580,57.16124906052941,70.05149833539528,NaN,NaN,5.105411806164755,4.977093994667665
1993-12-27T09:30:00-05:00,46.75,47,46.75,47,447100,259770,59.775394765057946,53.720575099629876,NaN,NaN,142.2402159244515,46.802997193453756,0.019850195110765315,0.07835562569473353,0.05850543058396822,4172300,4011920,58.3733622779508,68.25116677904155,NaN,NaN,7.376909725108881,5.319924813302124
1993-12-28T09:30:00-05:00,46.96875,47.125,46.9375,47.09375,880600,277925,61.58393913047901,53.88762962808017,NaN,NaN,179.93335801558115,79.87159921182904,0.03676452473208271,0.1044610864990716,0.06769656176698889,5052900,4211620,64.20646256789951,66.73798950798934,NaN,NaN,9.807927859039062,5.9610681055502575
1993-12-29T09:30:00-05:00,47.125,47.15625,47,47.03125,266700,279760,59.658185003779856,53.91713029033766,NaN,NaN,161.93181818184775,122.55861644296472,0.040833061096655326,0.11873788813780806,0.07790482704115273,4786200,4399120,68.64860850173271,65.46852339253245,NaN,NaN,11.241355979958453,6.715394944751428
1993-12-30T09:30:00-05:00,47,47,46.75,46.84375,219900,271795,54.18410414564069,53.89393240547618,NaN,NaN,64.72727272729979,125.22969854241731,0.028566548929972707,0.1136130132036186,0.0850464642736459,4566300,4460580,69.96443890613878,64.36222449288348,NaN,NaN,10.84056298789626,7.304704665200689
1993-12-31T09:30:00-05:00,46.9375,47,46.5625,46.59375,312900,269840,47.87621053800365,53.61141462046158,NaN,NaN,-8.923884514409668,107.98175606695409,0.0026508627115785083,0.08836004266311903,0.08570917995154052,4253400,4566220,72.1296768089606,63.960456034217096,NaN,NaN,8.478928060751254,7.472450864565055
1994-01-03T09:30:00-05:00,46.59375,46.65625,46.40625,46.46875,960900,302585,45.05209695200223,52.655956358274274,NaN,NaN,-105.11860174779089,58.50999253250561,-0.02249015215390754,0.0575964897591561,0.08008664191306364,3292500,4390260,63.87043822808429,63.363101853243805,NaN,NaN,5.62533892955605,7.2085777309923404
1994-01-04T09:30:00-05:00,46.53125,46.65625,46.46875,46.65625,164300,305825,49.832462606074095,52.679389538346285,NaN,NaN,-59.1194968553195,10.699421558325488,-0.025833404931388013,0.04779488574882862,0.07362829068021663,3456800,4071040,52.194064951264586,62.27334807445793,NaN,NaN,4.679963434028079,6.847347117140303
1994-01-05T09:30:00-05:00,46.71875,46.78125,46.53125,46.75,710900,336930,52.07740404948229,52.96585437447881,NaN,NaN,-10.498687664014957,-23.786679610847052,-0.021263010317384742,0.0470495277834857,0.06831253810087044,4167700,3947340,48.494387659360704,61.2809740075732,NaN,NaN,4.590409811159852,6.524927502000239
1994-01-06T09:30:00-05:00,46.8125,46.84375,46.6875,46.75,201000,339645,52.077404049482276,52.983342473822525,NaN,NaN,28.563729453004214,-31.01938826570617,-0.017906525750442798,0.04592938091281695,0.06383590666325975,4167700,3867620,46.220546755933015,60.222486942613614,NaN,NaN,4.51870011212642,6.238323589161122
1994-01-07T09:30:00-05:00,46.84375,47.0625,46.71875,47.03125,775500,357595,58.53350334013004,53.57412042427243,NaN,NaN,106.100136662969,-8.014584030230441,0.0025026815920436707,0.06696425865331435,0.06446157706127068,4943200,4005580,50.54242009717909,59.430794357893646,NaN,NaN,6.452143307100651,6.268869263152483
1994-01-10T09:30:00-05:00,47.09375,47.59375,46.96875,47.59375,593700,366635,67.8595319148957,54.71881946927482,NaN,NaN,245.7420924574487,62.15755481081747,0.050473334661724836,0.12755324538842672,0.07707991072670188,5536900,4454460,61.40920618361029,59.46280555055862,NaN,NaN,11.716881424668497,7.047156714797628
1994-01-11T09:30:00-05:00,47.5625,47.5625,47.34375,47.5,295200,367735,65.22649544435947,55.965640249597904,NaN,NaN,209.57891353266007,115.89723688841339,0.0712088862378725,0.1660910185240425,0.09488213228617001,5241700,4811440,67.52100620747547,60.07773448723536,NaN,NaN,14.939367744808102,8.174615433370553
1994-01-12T09:30:00-05:00,47.53125,47.53125,47.1875,47.34375,158400,373560,60.97966902126846,56.370279057727124,NaN,NaN,144.3781942078593,146.87261326278824,0.06963610850756059,0.18192726792062075,0.11229115941306016,5083300,4994560,70.13400378574201,60.77641942799009,NaN,NaN,16.15498300011402,9.314667942905334
1994-01-13T09:30:00-05:00,47.21875,47.3125,47.15625,47.21875,244300,381645,57.7407678881222,56.60408348919843,NaN,NaN,97.23650826306255,160.6071690247999,0.05599893697670477,0.1822898306339411,0.12629089365723634,4839000,5128820,71.91786904540594,61.83046371262412,NaN,NaN,16.094837351910353,10.283263572763195
1994-01-14T09:30:00-05:00,47.375,47.5,47.375,47.40625,137200,384595,61.08010476594947,56.69727706069068,NaN,NaN,128.65050582173924,165.11724285655396,0.05533030724205182,0.1954537777098011,0.14012347046774928,4976200,5135420,72.00638590335538,62.804251114438735,NaN,NaN,17.119724965128785,11.259900914529707
1994-01-17T09:30:00-05:00,47.40625,47.46875,47.3125,47.40625,17700,380245,61.08010476594947,56.66128889179571,NaN,NaN,106.75542406313654,137.31990917769153,0.05073323801021837,0.20354001798052224,0.15280677997030387,4976200,5023280,68.07979660628172,63.08091783146604,NaN,NaN,17.92588824644727,12.212184819089359
1994-01-18T09:30:00-05:00,47.46875,47.53125,47.375,47.46875,166400,385125,62.23379725351027,56.845261195347874,NaN,NaN,106.60527713831964,116.72518189882344,0.04778785765040078,0.21254160203330486,0.16475374438290408,5142600,5003460,67.38042819388107,62.99033352376235,NaN,NaN,18.926209996213885,13.171331272964292
1994-01-19T09:30:00-05:00,47.40625,47.46875,47.25,47.34375,200800,384880,58.49888284612294,57.153459673953755,NaN,NaN,74.89413188144036,102.82836943353963,0.03395739542261453,0.20720048866117224,0.17324309323855772,4941800,4975160,66.33261859077514,62.73091778695067,NaN,NaN,18.697035475820353,13.960717587658015
1994-01-20T09:30:00-05:00,47.40625,47.5,47.375,47.46875,281100,378420,61.018298524132895,58.09218024439156,NaN,NaN,87.12325483853223,100.8057187486336,0.029906410624172847,0.21062610651877378,0.18071969589460093,5222900,5051940,67.79582998451474,62.42135729949025,NaN,NaN,19.22780325116514,14.713158396730462
1994-01-21T09:30:00-05:00,47.53125,47.53125,47.34375,47.375,85600,356010,58.16624910979227,59.028905398519406,NaN,NaN,71.90476190477453,89.45656996524066,0.01816909541618192,0.20343106516482834,0.18526196974864642,5137300,5084160,68.41616277679685,62.74605191011258,NaN,NaN,18.860183924072437,15.305590614922172
1994-01-24T09:30:00-05:00,47.34375,47.5625,47.1875,47.1875,373800,352345,52.846091439558954,59.24416460091118,NaN,NaN,43.6806301468087,76.84161118197508,-0.0037948903519421373,0.18051835680871875,0.1843132471606609,4763500,5041620,66.59229543466566,63.77449694464123,NaN,NaN,16.96125450187059,15.542114027343375
1994-01-25T09:30:00-05:00,47.21875,47.25,47.09375,47.1875,310400,323835,52.846091439558954,59.29907084305952,NaN,NaN,11.295361691914842,57.779628092694125,-0.019042905387341325,0.16050961542648423,0.17955252081382556,4763500,4965800,63.35071336060545,64.83566306615872,NaN,NaN,15.420762795257522,15.524778137045397
1994-01-26T09:30:00-05:00,47.1875,47.34375,47.125,47.3125,145100,317755,55.960488931086616,59.5764340488884,NaN,NaN,28.202820282040072,48.441365772814066,-0.02126154332256966,0.15297559166061347,0.17423713498318313,4908600,4959160,63.061202893474764,66.03856707598312,NaN,NaN,14.946510092391208,15.442168416380513
1994-01-27T09:30:00-05:00,47.40625,47.8125,47.34375,47.75,344500,323985,64.73872220756435,60.01966396799086,NaN,NaN,107.29509194982745,52.47573319507312,0.004794163855317224,0.18022983980232965,0.17543567594701243,5253100,4965200,63.22583295768025,66.94452513744749,NaN,NaN,17.308956163249015,15.70885238021887
1994-01-28T09:30:00-05:00,47.9375,48.03125,47.875,47.875,356500,326165,66.77636660169871,59.94229501704821,NaN,NaN,166.50958215520373,71.39669724515896,0.027251852747532668,0.20950049188142827,0.1822486391338956,5609600,5059660,65.79345610189927,67.2576858458967,NaN,NaN,19.909133010200016,16.308892470216175
1994-01-31T09:30:00-05:00,48.0625,48.3125,48,48.21875,313800,293810,71.63133706704664,60.39978370438302,NaN,NaN,219.33333333333945,106.52723788246513,0.06017510579740129,0.2574675213806472,0.19729241558324592,5923400,5291640,71.12546351773089,67.51514708234352,NaN,NaN,23.899497292613077,17.39326458770145
1994-02-01T09:30:00-05:00,48.15625,48.15625,47.90625,47.96875,303600,300775,64.2749708717216,60.63516240798681,NaN,NaN,168.29440905875666,137.92704735583348,0.0599031912516261,0.27217140464777856,0.21226821339615246,5619800,5462900,74.30927919088177,67.81338103985351,NaN,NaN,24.753462710319777,18.44472146236121
1994-02-02T09:30:00-05:00,48.125,48.28125,48.09375,48.28125,307600,280610,68.61398581076125,61.41182083103245,NaN,NaN,190.28767484827875,170.34401826908123,0.074600347371374,0.30551864761036995,0.23091830023899595,5927400,5666660,77.48955413627108,68.21135854634387,NaN,NaN,27.00958990547553,19.668274097091825
1994-02-03T09:30:00-05:00,48.1875,48.1875,47.90625,48.0625,466100,293865,62.85870271465224,61.53886354165409,NaN,NaN,122.57430606733223,173.39986109258217,0.06383621459059538,0.3107135684772402,0.2468773538866448,5461300,5708300,78.08655573494552,68.64565639145745,NaN,NaN,26.846174476979208,20.693688437075735
1994-02-04T09:30:00-05:00,48.0625,48.125,46.96875,46.96875,1403200,325250,43.301346944059645,60.268952268661955,NaN,NaN,-49.08763813928541,130.28041703368436,-0.018308238664894033,0.22399205555552726,0.2423002942204213,4058100,5398000,64.38338831726773,68.38162722795646,NaN,NaN,18.150790529451232,20.330417307415093
1994-02-07T09:30:00-05:00,46.84375,47.3125,46.84375,47.1875,516400,321385,46.862268536964194,59.170985931765806,NaN,NaN,-101.79640718562206,66.05446892989205,-0.05708393401041059,0.17094537670740806,0.22802931071781865,4574500,5128220,55.29758161908923,67.51856675832848,NaN,NaN,13.20468586667795,19.312455673024072
1994-02-08T09:30:00-05:00,47.28125,47.28125,47.03125,47.21875,188200,316035,47.37078289786298,58.37612164974723,NaN,NaN,-80.79342041605348,16.236903034930013,-0.07847995219992454,0.12992937046791297,0.20840932266783752,4762700,4956800,50.4279367793984,66.38251805751584,NaN,NaN,9.804772326615232,17.954215194965666
1994-02-09T09:30:00-05:00,47.25,47.4375,47.1875,47.40625,144600,315345,50.43560955120991,57.620215294538454,NaN,NaN,-41.92340219885304,-30.205312374496337,-0.0777107291621836,0.11127091121510801,0.18898164037729162,4907300,4752780,45.31332138347644,64.7766245860131,NaN,NaN,8.204949148352085,16.561462902592297
1994-02-10T09:30:00-05:00,47.375,47.40625,47,47,883900,347325,44.40223089759722,56.63707113652452,NaN,NaN,-88.2986360373227,-72.37990079542732,-0.10080370569870561,0.06297700825390962,0.16378071395261523,4023400,4465200,39.267616515547125,62.69458556735241,NaN,NaN,4.688104321730228,14.865268819612002
1994-02-11T09:30:00-05:00,47.03125,47.28125,46.8125,47.15625,519400,366435,47.02698910289691,56.22142096962009,NaN,NaN,-93.00982091276013,-81.16433735012227,-0.10151528671815693,0.03688660555491907,0.138401892273076,4542800,4562140,42.07323947809839,60.943224427597606,NaN,NaN,2.8226137368334316,13.144889522072207
1994-02-14T09:30:00-05:00,47.0625,47.375,47,47.21875,2742100,502655,48.082804129458694,55.881186161755785,NaN,NaN,-64.12871062768274,-73.63079803853441,-0.09391287248436353,0.021010801667621593,0.11492367415198512,7284900,5104220,54.68091826525804,60.32395334935851,NaN,NaN,1.7035919588666335,11.510418441614268
1994-02-15T09:30:00-05:00,47.3125,47.5,47.25,47.46875,374700,513070,52.18783358384314,55.61171077980982,NaN,NaN,-18.149024912623318,-61.10191893784838,-0.06931807981239624,0.028276074386489825,0.09759415419888606,7659600,5683600,63.7597819308455,60.37385185202784,NaN,NaN,2.0821181300418394,10.163518397103921
1994-02-16T09:30:00-05:00,47.53125,47.53125,47.34375,47.4375,287600,517410,51.638203029775916,54.67595940996779,NaN,NaN,-12.387771337638691,-55.194792765605506,-0.053152821228512795,0.031153127663245073,0.08430594889175787,7372000,6176540,69.38019306777086,60.813449002748584,NaN,NaN,2.2172045048572744,9.028330698211544
1994-02-17T09:30:00-05:00,47.65625,47.6875,47.03125,47.15625,342400,520475,46.855340589736436,53.25302898054191,NaN,NaN,-41.862547571066656,-45.907575072354305,-0.05895171079373909,0.010616310399583995,0.06956802119332309,7029600,6777780,74.56217354243836,61.43978596278709,NaN,NaN,0.8639466394151007,7.861990118383481
1994-02-18T09:30:00-05:00,47.1875,47.21875,46.75,46.875,313300,531860,42.60554912406866,51.17975841318634,NaN,NaN,-105.89998929221088,-48.485608748244445,-0.07807895265574712,-0.028030669626360805,0.05004828302938631,6716300,7212480,77.52387464662203,61.89681532913646,NaN,NaN,-1.634448484931299,6.505356032195656
1994-02-22T09:30:00-05:00,47,47.34375,47,47.34375,154500,520895,50.64096906643146,50.205901141379904,NaN,NaN,-46.86005737965341,-45.031878098638586,-0.0565162603095042,-0.020597042357493933,0.035919217952010266,6870800,7129660,75.7151425685863,61.99723414182963,NaN,NaN,-1.2005179302874445,5.40451689469807
1994-02-23T09:30:00-05:00,47.40625,47.4375,47.0625,47.21875,391700,524960,48.68359110068827,48.78230151923184,NaN,NaN,-45.63428449288386,-50.528930014690694,-0.04834318336243389,-0.024509761251032103,0.02383342211140179,6479100,6893560,70.65430016336238,61.5090017151933,NaN,NaN,-1.4749152542297992,4.42174087342266
1994-02-24T09:30:00-05:00,47.0625,47.0625,46.5625,46.59375,770800,556245,40.296766284436345,47.170734631359274,NaN,NaN,-136.26866432247346,-75.30510861165766,-0.08078955216166733,-0.07715351809068238,0.003636034070984954,5708300,6560820,64.14687364838349,60.51331013758173,NaN,NaN,-4.646880611134896,3.126223518485866
1994-02-25T09:30:00-05:00,46.65625,46.8125,46.5625,46.8125,531300,565585,43.937116169323446,47.216146718878115,NaN,NaN,-126.17983109785831,-92.16856531701599,-0.08296422078014314,-0.10006924190419397,-0.017105021124050834,6239600,6402820,61.261544434705506,60.29032128882728,NaN,NaN,-5.965718695837733,1.8273746307253522
1994-02-28T09:30:00-05:00,46.9375,47.0625,46.8125,46.8125,333000,564410,43.93711616932345,47.007207264046635,NaN,NaN,-89.88170680184852,-88.96490881894351,-0.07982219618217673,-0.11688276635177175,-0.03706057016959502,6239600,6307480,59.52174853545844,60.592047497139376,NaN,NaN,-6.984748937119909,0.5684998353188864
1994-03-01T09:30:00-05:00,46.8125,46.90625,46.375,46.625,423600,569900,41.42614148762813,46.582590020458426,NaN,NaN,-138.37129054519545,-107.26715545205192,-0.0852963624333245,-0.14368102321125065,-0.058384660777926145,5816000,6096520,55.74900621249207,60.97212388521749,NaN,NaN,-8.60496143475424,-0.7419946318344173
1994-03-02T09:30:00-05:00,46.0625,46.6875,45.9375,46.6875,581500,583795,42.60363521174698,46.023163281925356,NaN,NaN,-169.26713947989037,-131.99372644945322,-0.07973520172674195,-0.1580536629363536,-0.07831846120961164,6397500,6080200,55.45616243694824,61.696612531894054,NaN,NaN,-9.573807494053211,-2.003682183579959
1994-03-03T09:30:00-05:00,46.625,46.625,46.4375,46.5625,223200,579575,40.835531800425784,45.768399060698826,NaN,NaN,-133.50785340311873,-131.4415642655823,-0.0793329164187871,-0.17748460673309552,-0.09815169031430841,6174300,6173400,56.850149067211916,62.95250771415582,NaN,NaN,-10.894243973303697,-3.273762439254779
1994-03-04T09:30:00-05:00,46.5625,46.8125,46.40625,46.6875,595800,586060,43.36668075822642,45.50694846465094,NaN,NaN,-98.30729166664723,-125.86705637934006,-0.06604997100892694,-0.1807141540754671,-0.11466418306654015,6770100,6279500,58.44449902940422,64.12188339639195,NaN,NaN,-11.293598272710716,-4.419453272605627
1994-03-07T09:30:00-05:00,46.875,47,46.875,46.9375,539800,542890,48.14486797665242,45.511381596593345,NaN,NaN,-18.237082066852235,-111.5381314323408,-0.037262242112783533,-0.16124198570751958,-0.12397974359473604,7309900,6493560,61.53266923392091,64.61129417986787,NaN,NaN,-10.256235982615678,-5.253279374035634
1994-03-08T09:30:00-05:00,46.96875,46.96875,46.6875,46.75,880300,561085,45.07332438292223,45.003202367956135,NaN,NaN,-48.376408217345606,-93.53915496677082,-0.028100815356283892,-0.15910576279009092,-0.13100494743380703,6429600,6616280,63.220180974421574,64.57275125440903,NaN,NaN,-10.25030133896219,-5.9671396547394275
1994-03-09T09:30:00-05:00,46.8125,47,46.59375,46.96875,2500100,676680,49.14933053947944,44.82542576150639,NaN,NaN,-31.489705288640604,-65.98366812852086,-0.005731058317043264,-0.1381687703301111,-0.13243771201306784,8929700,7122720,69.22095449199816,64.56137707042527,NaN,NaN,-9.044930258859175,-6.406824026756534
1994-03-10T09:30:00-05:00,46.96875,46.96875,46.46875,46.59375,207400,679820,43.22721756487841,44.56627411687367,NaN,NaN,-71.2788259957918,-53.5378626470555,-0.014133911023285373,-0.15010510079217454,-0.13597118976888917,8722300,7632320,73.84514815988808,64.51016097167168,NaN,NaN,-9.780574527637466,-6.888788384025239
1994-03-11T09:30:00-05:00,46.6875,46.90625,46.4375,46.84375,576600,664455,47.747442603636095,44.93355222255706,NaN,NaN,-52.16902200659539,-44.310208715045135,-0.001465694001307527,-0.1378033072705236,-0.13633761326921606,9298900,8138080,77.46390408258809,64.50587735995497,NaN,NaN,-8.999417015212812,-7.190306759909178
1994-03-14T09:30:00-05:00,47.03125,47.03125,46.84375,46.90625,345900,655780,48.844024173895804,44.805199015947366,NaN,NaN,3.496503496520276,-39.96349160237063,0.011782901089637254,-0.12160898690716948,-0.13339188799680674,9644800,8605060,80.18938679673619,64.82546623339424,NaN,NaN,-8.039443932194327,-7.311612070235628
1994-03-15T09:30:00-05:00,47.03125,47.125,46.84375,46.875,748600,556105,48.29824193071531,44.777674075235005,NaN,NaN,13.605442176888268,-27.56712152352386,0.018690991065556106,-0.11002814916486159,-0.1287191402304177,8896200,9098380,82.58542023079102,65.67768909535343,NaN,NaN,-7.409858225932576,-7.325647235335192
1994-03-16T09:30:00-05:00,46.96875,47.25,46.8125,47.25,455500,560145,54.82204000710801,45.81519362685441,NaN,NaN,69.32668329178914,-7.403843807437914,0.04714616715625222,-0.06978643128510242,-0.11693259844135465,9351700,9182780,82.96502773855521,67.02184295893711,NaN,NaN,-4.858095317942289,-6.9731398185647775
1994-03-17T09:30:00-05:00,47.09375,47.3125,47.09375,47.25,133000,552415,54.82204000710801,46.59268818669617,NaN,NaN,115.43859649124987,29.939640689970417,0.06357589245337406,-0.037462732874637084,-0.10103862532801114,9351700,9308660,83.54128535798134,68.6132530248854,NaN,NaN,-2.8043047861038373,-6.377591956784643
1994-03-18T09:30:00-05:00,46.75,47.03125,46.71875,46.96875,365500,553570,49.400111817119885,46.982902161538775,NaN,NaN,18.46452866863326,44.06635082501615,0.05351340454817158,-0.03414686964279667,-0.08766027419096825,8986200,9246120,82.05612926010338,70.22285164807433,NaN,NaN,-2.5619968594326306,-5.832506942877213
1994-03-21T09:30:00-05:00,46.8125,46.9375,46.71875,46.84375,324800,554145,47.167350909295486,47.392988548800716,NaN,NaN,-6.746031746006663,42.01784377651076,0.03722314498857175,-0.04113134295525356,-0.07835448794382531,8661400,9049440,77.3962175076489,71.7690810262998,NaN,NaN,-3.0050587023339808,-5.428585765656751
1994-03-22T09:30:00-05:00,46.84375,47.0625,46.75,46.96875,435700,568205,49.61957846386577,47.89412735252349,NaN,NaN,38.00217155268775,46.89718965167067,0.03375297800999308,-0.03616326543133397,-0.06991624344132705,9097100,9089620,77.67514398902654,73.35615113716254,NaN,NaN,-2.680435896863672,-5.03599292725774
1994-03-23T09:30:00-05:00,46.9375,47.0625,46.90625,46.9375,698500,583545,49.00716789313592,48.47781564485994,NaN,NaN,66.17214176383214,46.26628134607927,0.028451668746010017,-0.034351657508814526,-0.06280332625482454,8398600,8899000,73.0685260783462,74.51460663795784,NaN,NaN,-2.5797262603772797,-4.68509768913196
1994-03-24T09:30:00-05:00,46.75,46.84375,46.15625,46.375,1200500,605030,39.54591897472097,48.204904088895255,NaN,NaN,-143.22250639382716,-5.465939230936135,-0.011687442647119989,-0.07741262956372452,-0.06572518691660453,7198100,8468280,63.85350890391874,74.90096448613745,NaN,NaN,-5.454919206405793,-4.795072191599651
1994-03-25T09:30:00-05:00,46.40625,46.53125,45.9375,45.9375,100900,583510,34.041213247787184,47.1975001796906,NaN,NaN,-216.6666666666326,-52.49217829798931,-0.06355420892532274,-0.14516794807325795,-0.08161373914793521,7097200,8090480,57.05643442148396,74.58123342810624,NaN,NaN,-9.884246946455143,-5.522097156579007
1994-03-28T09:30:00-05:00,46,46.0625,45.59375,46,1117200,622720,35.42410913376659,46.50827051903662,NaN,NaN,-232.27103072061286,-97.59717809291055,-0.08799901568231513,-0.19161250875082914,-0.103613493068514,8214400,8001080,55.5495563784613,74.03333167125194,NaN,NaN,-12.956919149121566,-6.584214584085087
1994-03-29T09:30:00-05:00,46,46.03125,45.09375,45.09375,338400,618460,26.686977162949887,44.90381670642737,NaN,NaN,-265.35087719295143,-158.2677878420384,-0.155597626565976,-0.298110526275984,-0.142512899710008,7876000,7756860,51.54470908513136,72.77074271361859,NaN,NaN,-19.293384684412896,-8.399810312703345
1994-03-30T09:30:00-05:00,45.125,45.25,44.46875,44.46875,1123900,645580,22.555228696946713,43.42724607300368,NaN,NaN,-285.0729517395907,-228.51680654272295,-0.22839721855035988,-0.42800942289795785,-0.19961220434759797,6752100,7427560,46.659932967678394,70.82894162846075,NaN,NaN,-26.31462062027296,-10.959068928070433
1994-03-31T09:30:00-05:00,44.46875,44.6875,43.53125,44.59375,788800,673860,25.054396018274062,41.80631417404924,NaN,NaN,-247.3610133708477,-249.34450793812707,-0.25225659849715826,-0.5149329524690458,-0.26267635397188754,7540900,7496120,47.76973761707529,68.707929738067,NaN,NaN,-30.68654685076298,-13.777280059883655
1994-04-04T09:30:00-04:00,43.34375,44.03125,43.34375,43.90625,2627300,775435,21.033971709682604,39.81988185517688,NaN,NaN,-220.34201808575972,-250.0795782219525,-0.29546736158330567,-0.6320105559510196,-0.33654319436771396,4913600,7059400,41.80323506468046,65.96606175720586,NaN,NaN,-36.010467752771135,-16.95344973029615
1994-04-05T09:30:00-04:00,44.34375,44.8125,44.34375,44.8125,1179000,807395,35.68478348676638,38.91892053775195,NaN,NaN,-120.08131554051936,-227.64163518593378,-0.2461591855258744,-0.644242176275057,-0.3980829907491826,6092600,6635040,36.97103775876021,62.707891580632236,NaN,NaN,-34.61899013798474,-19.477098359965947
1994-04-06T09:30:00-04:00,44.875,44.90625,44.5,44.8125,516500,789205,35.68478348676638,37.55197364344183,NaN,NaN,-98.01176141136209,-194.17381202961593,-0.19872045812784778,-0.6464835634089923,-0.4477631052811445,6092600,6278360,33.469104537108905,59.172468494814645,NaN,NaN,-33.6224624194768,-21.497864654181782
1994-04-07T09:30:00-04:00,44.78125,45.125,44.53125,45.03125,666100,697505,38.86029812718785,36.41184922344753,NaN,NaN,-76.28328692795895,-152.4158790672896,-0.1405272433300776,-0.6234221594437415,-0.48289491611366386,6758700,6279680,33.49421099966064,55.5976774692203,NaN,NaN,-31.730517720995987,-22.95967223515524
1994-04-08T09:30:00-04:00,44.9375,44.9375,44.46875,44.6875,242400,699255,35.863659875209066,35.444959799025334,NaN,NaN,-79.62497219797977,-118.86867083271599,-0.11422105454276532,-0.6256712342921205,-0.5114501797493551,6516300,6074760,31.506482020192763,51.98698838065526,NaN,NaN,-31.208292221136407,-24.138046518866833
1994-04-11T09:30:00-04:00,44.8125,45.0625,44.70312,44.875,203300,680590,38.64296240407349,34.836074905795186,NaN,NaN,-60.54192863058921,-86.9086529416819,-0.0751165829986219,-0.6053459084976325,-0.5302293254990106,6719600,6435960,38.44115460365821,49.204483887513064,NaN,NaN,-29.875462628120303,-24.957677391617327
1994-04-12T09:30:00-04:00,44.92187,45,44.71875,44.8125,1409200,733755,38.05104425355587,34.009751033630195,NaN,NaN,-56.54050306672289,-74.2004904469226,-0.04582352684909996,-0.5875087340603855,-0.5416852072112855,5310400,6279520,36.70767736811865,46.27823627173394,NaN,NaN,-29.003787777792557,-25.53569316107093
1994-04-13T09:30:00-04:00,44.79687,44.90625,44.25,44.578,364100,714530,35.83323218885839,33.068755626181805,NaN,NaN,-67.21316893255892,-68.04077195116196,-0.0350878632878634,-0.5855450363211148,-0.5504571730332514,4946300,6050260,34.26882193133113,43.50682883266143,NaN,NaN,-28.946560774017136,-26.02295996292039
1994-04-14T09:30:00-04:00,44.5,44.82812,44.40625,44.59375,419900,712750,36.102611146137995,32.822805066997304,NaN,NaN,-59.938185448107994,-64.77175165519176,-0.020496052399897824,-0.5760772385331236,-0.5555811861332258,5366200,5771760,31.5284276081032,41.197894454388894,NaN,NaN,-28.82295788771608,-26.42295966646263
1994-04-15T09:30:00-04:00,44.57812,44.78125,44.51562,44.59375,387300,725465,36.102611146138,32.97004777402236,NaN,NaN,-53.844774408052785,-59.61571209720637,-0.005210623467882036,-0.5620944654680784,-0.5568838420001964,5366200,5541740,29.434797209505888,39.22492036781903,NaN,NaN,-28.722141074061362,-26.75141415326245
1994-04-18T09:30:00-04:00,44.64062,44.76562,44.15625,44.29687,369100,725645,33.06781993375566,32.80174140259301,NaN,NaN,-66.57234480374066,-60.82179533183667,-0.009226047595365383,-0.5684164014944031,-0.5591903538990377,4997100,5197240,26.587199658158397,37.15618060208311,NaN,NaN,-29.47923498201718,-27.141102843084553
1994-04-19T09:30:00-04:00,44.25,44.53125,43.98437,44.35937,472200,733015,34.31954830061159,33.34692505528313,NaN,NaN,-73.27576165961815,-64.1688470504157,-0.0021725572814513816,-0.561906050500852,-0.5597334932194006,5469300,5229020,27.2860507459294,35.42341929214011,NaN,NaN,-29.772397354678663,-27.51700205902657
1994-04-20T09:30:00-04:00,44.40625,44.51562,44.07812,44.3125,508000,736630,33.80891865654887,34.150760052397565,NaN,NaN,-71.9884419382839,-65.12390165156071,0.004474172352004535,-0.554140777779395,-0.5586149501313995,4961300,5232020,27.35635191480435,34.044592074077684,NaN,NaN,-30.15241503867111,-27.89348962754722
1994-04-21T09:30:00-04:00,44.5,44.96875,44.34375,44.90625,200300,711720,44.97750257464915,35.57383909213865,NaN,NaN,-15.443551973095111,-56.22497495655813,0.05139019397167299,-0.49437720766680826,-0.5457674016384813,5161600,5191100,26.973282335143736,32.55913098251114,NaN,NaN,-27.225767059081623,-27.79810068919499
1994-04-22T09:30:00-04:00,45.01562,45.04687,44.73437,44.85937,301800,666785,44.3413284517633,37.23865028800155,NaN,NaN,21.22165223251286,-41.211689628445,0.08008617366538362,-0.44565968455675176,-0.5257458582221354,4859800,5089820,26.002746756752714,31.430524674802022,NaN,NaN,-25.003351983219492,-27.398850874055633
1994-04-25T09:30:00-04:00,44.84375,45.35937,44.84375,45.32812,394600,681470,51.698040730168934,38.38245437681602,NaN,NaN,102.23693287380244,-7.4498340929363795,0.1285816627921162,-0.36501877973199015,-0.49360044252410634,5254400,5141280,27.431497909106852,30.749128971255352,NaN,NaN,-20.71427804149312,-26.443911897975273
1994-04-26T09:30:00-04:00,45.26562,45.34375,45.1875,45.28125,399000,645560,50.97256023864386,39.47443843052156,NaN,NaN,144.41051360723387,36.08742096043402,0.1537461597396439,-0.3014177428495515,-0.45516390258919537,4855400,5018500,26.134902699768148,30.225257411445305,NaN,NaN,-17.432066937276737,-25.15650547501834
1994-04-28T09:30:00-04:00,45.1875,45.25,44.8125,44.95312,287000,642990,46.095624575109746,39.99124746251598,NaN,NaN,89.54352679623629,68.39381470733807,0.14466830355027882,-0.2743285231513468,-0.41899682670162564,4568400,4939920,25.310343194723814,29.64069542537839,NaN,NaN,-15.965491840077354,-23.843503527169627
1994-04-29T09:30:00-04:00,44.875,45.15625,44.8125,45.09375,481900,610890,48.37535944001699,40.884940288573695,NaN,NaN,85.35546188030273,88.55361747801763,0.14418931978520633,-0.23876017697011775,-0.3829494967553241,5050300,4917660,25.06905454726602,29.180879177312196,NaN,NaN,-14.072455206775796,-22.44763948139908
1994-05-02T09:30:00-04:00,45.09375,45.71875,44.9375,45.375,275000,585200,52.685157845047186,41.88795424864323,NaN,NaN,150.1797510378708,114.34523723908924,0.1577704550480356,-0.18573642794527956,-0.34350688299331517,5325300,5010760,28.15402154947502,28.44608395915625,NaN,NaN,-11.136003622733554,-20.83169150158972
1994-05-03T09:30:00-04:00,45.39062,45.40625,45.0625,45.32812,183400,463005,51.907286105723564,42.87768580951236,NaN,NaN,122.70271000880611,118.43839266608995,0.15815217416631933,-0.14581666528541604,-0.30396883945173536,5141900,4988260,27.85553937265061,27.81378838805139,NaN,NaN,-8.951082181953579,-19.134461598784558
1994-05-04T09:30:00-04:00,45.42187,45.42187,45.07812,45.25,401900,424150,50.567454809451505,43.930130282411874,NaN,NaN,105.66637124820302,110.6895641942838,0.14788661999995822,-0.11911056445178758,-0.2669971844517458,4740000,4965180,27.533083136411037,27.332664188414242,NaN,NaN,-7.488601928941992,-17.47076736023562
1994-05-05T09:30:00-04:00,45.29687,45.375,45.1875,45.1875,659800,431315,49.467328086443324,44.8847529210051,NaN,NaN,94.46754525723954,111.67436788648442,0.1321454669106341,-0.10181535081345316,-0.23396081772408728,4080200,4867540,26.15374801969574,26.94875850352799,NaN,NaN,-6.551138943407181,-15.910820443545843
1994-05-06T09:30:00-04:00,44.96875,44.96875,44.59375,44.75,216300,408825,42.49755985185298,45.34153497141332,NaN,NaN,-21.882894013841288,90.22669670765563,0.08956468157134481,-0.12200496575990627,-0.21156964733125108,3863900,4630260,23.122214225741445,26.497859718973388,NaN,NaN,-7.709862484956755,-14.739255020890258
1994-05-09T09:30:00-04:00,44.625,44.75,44.28125,44.35937,499300,421670,37.42698758885888,45.65290408963498,NaN,NaN,-90.02323292720662,42.18609991464016,0.03518048771352256,-0.16759403768934789,-0.20277452540287044,3364600,4238120,19.1679261859463,25.96791161381538,NaN,NaN,-10.33326232459189,-14.109827492847634
1994-05-10T09:30:00-04:00,44.57812,44.84375,44.54687,44.70312,583400,440675,43.783495828334566,46.32890034161519,NaN,NaN,-32.52725660801458,11.140106591276012,0.023035287880586786,-0.17398041555213695,-0.19701570343272373,3948000,3999340,17.235094501213624,25.249986167764256,NaN,NaN,-10.621436213869567,-13.611485881565052
1994-05-11T09:30:00-04:00,44.65625,44.71875,44.17187,44.29687,210600,380745,38.77079681711437,46.68332021022701,NaN,NaN,-90.47906818237055,-28.088981294838703,-0.009914407302501843,-0.20940871256085103,-0.19949430525834919,3737400,3798820,15.794720466866863,24.424155350054434,NaN,NaN,-12.5265553138247,-13.456495800459287
1994-05-12T09:30:00-04:00,44.57812,44.625,44.40625,44.51562,305200,377800,42.58271209619743,46.51226374748046,NaN,NaN,-63.52625054412948,-59.6877404551125,-0.014268042826966115,-0.21732935879205684,-0.20306131596509072,4042600,3791300,15.741588609134894,23.62189151248237,NaN,NaN,-12.873357482348899,-13.373190326443517
1994-05-13T09:30:00-04:00,44.64062,44.64062,44.29687,44.51562,321300,372870,42.58271209619743,46.38664829351147,NaN,NaN,-67.63022602284612,-68.83720685691347,-0.01439759159128734,-0.2210583054541999,-0.20666071386291257,4042600,3827040,17.167734605103533,22.990819215936,NaN,NaN,-13.146576827651183,-13.340816969473183
1994-05-16T09:30:00-04:00,44.60937,44.75,44.51562,44.53125,450400,376025,42.877407136985234,45.75660303685549,NaN,NaN,-43.17312464235675,-59.46718519994349,-0.010842488339179501,-0.22021382428688696,-0.20937133594770746,4493000,4052720,25.717610206933372,22.868398665780752,NaN,NaN,-13.284027580957913,-13.332704199685287
1994-05-17T09:30:00-04:00,44.5625,45.1875,44.5,45.1875,470200,381080,53.637017418687485,45.94692140685861,NaN,NaN,26.88118990429639,-47.585495897481294,0.03574330304525658,-0.16469220714113675,-0.20043551018639333,4963200,4255760,32.4710278941712,23.320979036809543,NaN,NaN,-9.948989625611187,-12.849316403388986
1994-05-18T09:30:00-04:00,45.21875,45.6875,45.01562,45.51562,824800,398710,57.90629017176289,46.79054037804811,NaN,NaN,112.8944359093206,-6.910795079143068,0.0858358356980759,-0.09314071556379844,-0.17897655126187434,5788000,4665880,43.62090051177804,24.628875988027705,NaN,NaN,-5.708586934701946,-11.829212193576552
1994-05-19T09:30:00-04:00,45.42187,45.85937,45.42187,45.73437,531000,399860,60.516628538925694,47.65777388511301,NaN,NaN,154.53949329532392,36.70235368874761,0.12832501738130192,-0.018570279535246925,-0.14689529691654885,6319000,5121160,52.915131035740075,26.61788145149014,NaN,NaN,-1.3640546815778165,-10.334189691862447
1994-05-20T09:30:00-04:00,45.65625,45.6875,45.5,45.5625,370400,408365,57.49958872841558,48.00166180535361,NaN,NaN,119.95525253498975,74.2194494003148,0.1386002783517554,0.026355051023145393,-0.11224522732861,5948600,5502360,59.00838570035793,28.821764605124628,NaN,NaN,1.2686938828844314,-8.676634895470036
1994-05-23T09:30:00-04:00,45.51562,45.53125,45.34375,45.48437,262700,406410,56.129650192893244,48.303259240151455,NaN,NaN,83.61585208013834,99.57724474481381,0.13381220148359826,0.055020024525887834,-0.07879217695771043,5685900,5740940,62.296977408697494,31.28186732198512,NaN,NaN,2.995983843845666,-7.00911793271065
1994-05-24T09:30:00-04:00,45.60937,45.84375,45.60937,45.67187,549600,414160,58.67428162153575,48.88231829815748,NaN,NaN,119.3330590476335,118.06761857348124,0.1364806161501901,0.09180859323002721,-0.0446720229201629,6235500,5995400,65.47809592246598,33.9922253781319,NaN,NaN,5.2133401901621985,-5.263052486585957
1994-05-25T09:30:00-04:00,45.5,45.82812,45.34375,45.79687,738200,431120,60.326427981405395,49.657968290654765,NaN,NaN,100.9496087343532,115.67865313848775,0.1393830616283388,0.1295568041152606,-0.009826257513078203,6973700,6232540,68.17314902937062,36.99361116453725,NaN,NaN,7.5474184063426515,-3.4329852161675847
1994-05-26T09:30:00-04:00,45.78125,45.9375,45.73437,45.82812,369600,435250,60.7489064295034,50.96163590334408,NaN,NaN,115.40785113477303,107.85232470637757,0.13597945392256916,0.16014805989013325,0.024168605967564087,7343300,6437400,70.32818135115473,40.36546595920964,NaN,NaN,9.584194809355628,-1.5733880696642686
1994-05-27T09:30:00-04:00,45.75,45.875,45.67187,45.875,162000,419255,61.412755402657304,52.674905032901115,NaN,NaN,99.61786520675285,103.78484724073019,0.12948930239396328,0.18603023396001817,0.0565409315660549,7505300,6748740,73.2883918150015,44.23121350414215,NaN,NaN,11.469000925865151,0.28981035826850565
1994-05-31T09:30:00-04:00,45.73437,45.90625,45.65625,45.8125,160000,413505,59.956849100910446,53.83014455237082,NaN,NaN,90.10282491949823,105.08224180860218,0.11412928107956162,0.19920253291550694,0.08507325183594532,7345300,7080620,76.03324150334386,48.43108114715145,NaN,NaN,12.69170589833169,2.0615097211346747
1994-06-01T09:30:00-04:00,45.70312,46.01562,45.5625,46.01562,200500,414360,63.024762972825094,55.56257070635015,NaN,NaN,91.57935713926393,99.53150142692826,0.11070611906558134,0.22345590066792198,0.11274978160234064,7545800,7342680,77.95921345639006,52.87140207497453,NaN,NaN,14.609987638103512,3.854149423558794
1994-06-02T09:30:00-04:00,46.04687,46.04687,45.89062,45.96875,55100,397020,61.84725914820743,56.938609781493724,NaN,NaN,95.36035404220536,98.41365048849869,0.09873809759831606,0.23617240360023573,0.13743430600191966,7490700,7446080,78.68697684027252,57.3675012343415,NaN,NaN,15.925428998109984,5.578617934208964
1994-06-03T09:30:00-04:00,46,46.39062,45.85937,46.23437,550400,391550,65.75236002417796,58.593584633492334,NaN,NaN,107.01932153085104,96.7359445677143,0.1017590448979902,0.26463311212440743,0.16287406722641723,8041100,7585640,79.66303213185951,61.831451057681214,NaN,NaN,18.204731337073298,7.38234842033244
1994-06-06T09:30:00-04:00,46.32812,46.46875,46.1875,46.21875,99300,385700,65.32889575427632,60.19726239187027,NaN,NaN,113.38594937353125,99.48956140106996,0.09583641516773694,0.2826695861860884,0.18683317101835145,7941800,7672940,80.27166821067026,65.72816948651958,NaN,NaN,19.990388393130086,9.18349698787496
1994-06-07T09:30:00-04:00,46.14062,46.21875,46.03125,46.15625,120600,366765,63.56486470497414,60.90639434089075,NaN,NaN,89.92435956718327,99.45386833060698,0.08140839600249455,0.28859366602146963,0.20718527001897508,7821200,7768120,80.94136679740126,69.190336551036,NaN,NaN,21.060769984326804,10.880250273082366
1994-06-08T09:30:00-04:00,46.26562,46.26562,45.78125,45.78125,131900,344190,54.12187205558688,60.63607876116389,NaN,NaN,60.301596541445484,93.19831621104328,0.04227713797725419,0.2600316924905428,0.21775455451328862,7689300,7796820,81.14916438677409,71.87092682782144,NaN,NaN,19.357887663845304,12.091341328905642
1994-06-09T09:30:00-04:00,45.98437,46.03125,45.89062,46.03125,80500,337685,58.54346675447386,60.49513863370304,NaN,NaN,63.42223857112569,86.81069311682734,0.029503375359652223,0.2546337737128539,0.22513039835320167,7769800,7852640,81.57005137210209,73.91770685184729,NaN,NaN,19.139680405322267,13.098246911250873
1994-06-10T09:30:00-04:00,46.07812,46.20312,46.07812,46.10937,83100,326580,59.84576805798985,60.66272287152977,NaN,NaN,85.86221155654586,82.5792711219663,0.022883377760740176,0.2537346205541269,0.2308512427933867,7852900,7815000,80.2686085542378,75.436294198553,NaN,NaN,19.330504689433283,13.988569450991218
1994-06-13T09:30:00-04:00,46.04687,46.1875,46.03125,46.17187,109700,316000,60.90393456781771,61.00374318402438,NaN,NaN,83.76823647334624,76.6557285419293,0.019418484314876083,0.2551243481869818,0.23570586387210574,7962600,7819160,80.30600725612405,76.72265347336918,NaN,NaN,19.783918557052917,14.81647646614289
1994-06-14T09:30:00-04:00,46.3125,46.54687,46.3125,46.53125,161000,301530,66.38879240656718,61.5547796686695,NaN,NaN,157.95815803800252,90.26248823609316,0.03701471384799784,0.28197425618210303,0.2449595423341052,8123600,7879640,80.87359790588837,77.82233218647077,NaN,NaN,21.859612947602606,15.822638820637135
1994-06-15T09:30:00-04:00,46.54687,46.5625,46.3125,46.34375,142800,285160,61.53805112135367,61.6413241786658,NaN,NaN,134.1231940169562,105.0268077311953,0.03190425580530354,0.28483986209073464,0.2529356062854311,7980800,7937940,81.42921199120187,78.76919382660158,NaN,NaN,22.15367858494579,16.72707307268123
1994-06-16T09:30:00-04:00,46.34375,46.46875,46.29687,46.4375,44000,246120,62.993980804926544,61.80168663405317,NaN,NaN,120.9071645005042,116.523792917071,0.030705586243125915,0.29131758908933847,0.26061200284621255,8024800,7988940,81.92389958089956,79.59745941444051,NaN,NaN,22.825951334057017,17.598341395734913
1994-06-17T09:30:00-04:00,46.15625,46.20312,45.8125,45.875,403800,239760,50.614097628458,61.03035393589607,NaN,NaN,-6.019809660228333,98.14738867371616,-0.00992873996673066,0.24820107788779922,0.2581298178545299,7621000,7942560,79.84098331494599,80.06550166443652,NaN,NaN,19.282105849893828,17.838879174900473
1994-06-20T09:30:00-04:00,45.54687,45.625,45.4375,45.48437,137400,228110,44.12831241738466,59.899744172787095,NaN,NaN,-135.92208406128145,54.20932456679061,-0.062159481755661744,0.1804304656599527,0.24258994741561443,7483600,7846760,75.56718626735434,80.032212004723,NaN,NaN,13.913051739153772,17.278046684079516
1994-06-21T09:30:00-04:00,45.45312,45.45312,44.90625,45.09375,139200,221935,38.777232472376355,58.16777770846932,NaN,NaN,-224.39880322106117,-22.262067685022124,-0.11877829816873867,0.0941170747046911,0.21289537287342977,7344400,7690920,69.08843254787077,79.3985847969716,NaN,NaN,7.410974814716928,15.868464988456289
1994-06-22T09:30:00-04:00,45.21875,45.42187,45.17187,45.26562,279900,208450,42.1038588241145,56.757534828176965,NaN,NaN,-165.52053039142228,-82.19081256669782,-0.13901190534187172,0.039130491196090134,0.17814239653796185,7624300,7619620,66.28822709465969,78.51295981514212,NaN,NaN,3.3967652726047293,14.086793600477495
1994-06-23T09:30:00-04:00,45.34375,45.40625,44.9375,45,922500,217665,38.61198477210968,54.81893659588638,NaN,NaN,-179.98082392392288,-142.36841025158324,-0.1629820426316691,-0.025585156751624538,0.13739688588004456,6701800,7355020,57.04749957378149,76.89756463242226,NaN,NaN,-1.1151869321773598,11.915082095812517
1994-06-24T09:30:00-04:00,44.78125,44.78125,44,44.0625,353800,216875,29.357521357114308,52.2495527103748,NaN,NaN,-264.4042627729339,-194.04530087412437,-0.23054395332725391,-0.15078305577902285,0.07976089754823107,6348000,7100420,49.84700868776175,74.72437466650022,NaN,NaN,-9.125734785263816,8.909251112801613
1994-06-27T09:30:00-04:00,44.23437,44.82812,44.01562,44.82812,371200,227335,41.656014096649194,50.684634809780164,NaN,NaN,-170.97423736740353,-201.0557315353488,-0.21267204017614563,-0.18607915267195096,0.02659288750419466,6719200,6947540,46.08546249380139,72.2346672162431,NaN,NaN,-10.785447188667165,6.095722784020359
1994-06-28T09:30:00-04:00,44.84375,44.84375,44.25,44.60937,5382301,488450.05,39.53804033560262,49.642932544066994,NaN,NaN,-138.23693954226917,-183.82335879959038,-0.20452420771895927,-0.22906237214450442,-0.024538164425545156,1336899,5746039.8,28.123481379144863,68.44711842998386,NaN,NaN,-12.834694909034381,3.391377399298254
1994-06-29T09:30:00-04:00,44.67187,45.01562,44.625,44.75,311800,494015.05,41.594001538091575,48.432256457182554,NaN,NaN,-95.71522553712276,-169.86229782873048,-0.17949741943186107,-0.24890993871537148,-0.06941251928351042,1648699,4550919.6,19.840114700287344,64.03783723913995,NaN,NaN,-13.63566367363846,0.9589429603072945
1994-06-30T09:30:00-04:00,44.82812,44.84375,44.3125,44.46875,271900,504855.05,38.75564527735767,46.92581911570882,NaN,NaN,-107.5094799730725,-155.36802903856042,-0.17171745931101995,-0.28405934342228534,-0.1123418841112654,1376799,3485919.4,15.467974818902675,59.40922054375886,NaN,NaN,-15.265099399687237,-1.358777376834781
1994-07-01T09:30:00-04:00,44.6875,44.6875,44.375,44.5625,406900,497680.05,40.22003044153721,45.44839739240307,NaN,NaN,-95.6125488656693,-121.60968625710748,-0.15083231256724716,-0.30088227482032437,-0.1500499622530772,1783699,2573059.2,12.85336955768284,54.591174993870204,NaN,NaN,-16.050586544781346,-3.457607257970005
1994-07-05T09:30:00-04:00,44.65625,44.85937,44.51562,44.79687,112000,498315.05,43.83551464078731,43.83744898056165,NaN,NaN,-69.85380337710728,-101.38559945904822,-0.1135101054046353,-0.2919375940088713,-0.17842748860423602,1895699,1608359,10.779649638612042,49.584464403350474,NaN,NaN,-15.528404908707842,-5.182006922361124
1994-07-06T09:30:00-04:00,44.625,44.8125,44.46875,44.73437,174800,501025.05,43.08713650377565,42.51952650787751,NaN,NaN,-68.22677095400617,-87.38356574139564,-0.08652879634835764,-0.28658848403968307,-0.20005968769132543,1720899,1685159,11.996912989183926,44.6250144746349,NaN,NaN,-15.338215167101065,-6.632893814466829
1994-07-07T09:30:00-04:00,44.73437,44.92187,44.6875,44.92187,66700,497765.05,46.06218642742704,41.31011262377041,NaN,NaN,-46.697468163900396,-77.58001426675118,-0.05129173410960294,-0.2641743553283291,-0.21288262121872617,1787599,1712939,12.462147811233862,39.66346077680164,NaN,NaN,-14.284578257348032,-7.725991592021287
1994-07-08T09:30:00-04:00,44.64062,44.98437,44.625,44.90625,148400,501160.05,45.8471753450256,40.9696181749538,NaN,NaN,-42.977092530103384,-64.67353677815734,-0.02557305038298424,-0.24484893419745646,-0.21927588381447222,1639199,1765419,13.393621206710748,34.917220626213414,NaN,NaN,-13.49286220340753,-8.54983025079075
1994-07-11T09:30:00-04:00,44.9375,45.01562,44.53125,44.75,124000,503205.05,43.65212075914393,40.935604485079466,NaN,NaN,-46.454322652010596,-54.84189153542561,-0.016084909713160067,-0.23938202095592231,-0.22329711124276225,1515199,1711719,13.238391466549587,30.46516385472736,NaN,NaN,-13.428662746481713,-9.246806321603744
1994-07-12T09:30:00-04:00,44.76562,44.82812,44.51562,44.8125,257300,510585.05,44.790767802655495,41.36514272295655,NaN,NaN,-47.63287682711375,-50.39770622542691,-0.0032703682827864566,-0.22738507159624533,-0.22411470331345887,1772499,1687079,13.163006781538698,26.47049058570364,NaN,NaN,-13.0651532310164,-9.792284451519837
1994-07-13T09:30:00-04:00,44.82812,45.03125,44.82812,44.89062,532700,529170.05,46.25272578948873,41.66149036334043,NaN,NaN,-16.35918130468262,-40.02418829556219,0.011961623004075966,-0.2091626745583639,-0.22112429756243987,2305199,1803939,15.61721618545441,22.85113266361754,NaN,NaN,-12.367400014301804,-10.160158103345832
1994-07-14T09:30:00-04:00,45.10937,45.46875,45.07812,45.375,494200,546740.05,54.328388505723765,42.784090630027144,NaN,NaN,56.57243228746554,-19.37020820528901,0.05380964001841998,-0.1538622475394149,-0.2076718875578349,2799399,2006299,19.84193247465855,20.193592156537335,NaN,NaN,-9.329445832190599,-10.041484921752227
1994-07-15T09:30:00-04:00,45.34375,45.48437,45.32812,45.39062,49100,546995.05,54.565464364252875,44.584657987679904,NaN,NaN,97.21392786281663,8.66799587329504,0.08010851297283791,-0.10753624634178749,-0.1876447593146254,2848499,2248159,24.69474007847957,18.397001541588605,NaN,NaN,-6.783070110883181,-9.575997091628079
1994-07-18T09:30:00-04:00,45.39062,45.57812,45.39062,45.46875,72300,530420.05,55.80133115972163,45.59503777789936,NaN,NaN,130.05263077385956,43.96938655846907,0.09908951195027055,-0.06378286937678723,-0.16287238132705778,2920799,2529279,29.9994275862649,17.247999048193144,NaN,NaN,-4.295069819521239,-8.82157890989853
1994-07-19T09:30:00-04:00,45.54687,45.5625,45.375,45.375,609500,554025.05,53.906523927229216,46.62135803444412,NaN,NaN,123.51250374192664,78.19846267227715,0.10129396886023492,-0.03625492025176413,-0.13754888911199906,2311299,2637039,31.97747972186984,17.52328464410207,NaN,NaN,-2.667852359581036,-7.9424751169960315
1994-07-20T09:30:00-04:00,45.40625,45.40625,45.0625,45.17187,185300,556330.05,49.94890544353337,47.218136884832816,NaN,NaN,70.69834593589862,95.60996812039339,0.08565640743095326,-0.030478379823307478,-0.11613478725426074,2125999,2601199,31.6570727199409,18.367353074077325,NaN,NaN,-2.2959408269529424,-7.13582736127559
1994-07-21T09:30:00-04:00,45.17187,45.29687,45.07812,45.26562,86300,546650.05,51.71097452153967,48.14351754513154,NaN,NaN,72.59545909687174,98.81457348227464,0.07840652112907956,-0.0181266358429113,-0.09653315697199086,2212299,2483779,30.576138751077195,19.446507640661213,NaN,NaN,-1.5047225741565757,-6.331383820258588
1994-07-22T09:30:00-04:00,45.375,45.40625,45.25,45.34375,151600,508105.05,53.190011777391014,49.069944783406804,NaN,NaN,93.32247232164204,98.0362823740397,0.07561838189011276,-0.0020101796093499047,-0.07762856149946266,2363899,2386859,29.675435913199053,20.64808380891238,NaN,NaN,-0.43665027115956734,-5.489279027530157
1994-07-25T09:30:00-04:00,45.35937,45.45312,45.3125,45.40625,120900,496460.05,54.39339862004106,49.824079353353504,NaN,NaN,92.79995375971521,90.58574697121085,0.07460311846403721,0.01562533658058385,-0.05897778188345336,2484799,2299659,28.851939584118824,21.938961662162857,NaN,NaN,0.7905963911947539,-4.592153967712313
1994-07-26T09:30:00-04:00,45.39062,45.42187,45.3125,45.35937,489600,502380.05,53.28682867533332,50.55262879417905,NaN,NaN,77.42311935989794,81.36787009480511,0.06760186937159228,0.025524554831036994,-0.042077314540555286,1995199,2236439,28.240078061425464,23.09918773875154,NaN,NaN,1.562831583739324,-3.7128703175049362
1994-07-27T09:30:00-04:00,45.35937,45.35937,45.17187,45.35937,83200,237425,53.28682867533332,51.068674669029505,NaN,NaN,56.38337000404245,78.50487490843386,0.060053431222745944,0.032989474487877146,-0.027063956734868798,1995199,2210279,27.975699029715116,24.207298540071626,NaN,NaN,2.218040600236956,-2.8655973292560946
1994-07-28T09:30:00-04:00,45.35937,45.57812,45.35937,45.45312,828200,263245,55.391588166726756,51.750418442008154,NaN,NaN,84.054857067156,80.79675450249071,0.05840375924071678,0.04594074231602718,-0.0124630169246896,2823399,2332499,31.215660953309623,25.4803013791144,NaN,NaN,3.3197898506018597,-1.9819705892763868
1994-07-29T09:30:00-04:00,45.76562,46.04687,45.75,45.90625,459100,272605,63.866092023423704,53.19427353231385,NaN,NaN,162.9806239773988,94.72838483364208,0.0833394761868235,0.09171132830883977,0.008371852122016275,3282499,2516219,35.88463855047709,27.097890456537794,NaN,NaN,6.8692744373380785,-0.7175070140457489
1994-08-01T09:30:00-04:00,45.9375,46.15625,45.89062,46.125,486300,276575,67.11410063821853,54.78879730628264,NaN,NaN,183.92192468166476,112.95277901803199,0.10848369681222156,0.14397647313729323,0.03549277632507167,3768799,2773019,41.82846365038276,29.14542309002665,NaN,NaN,10.976894308719038,0.9531217463492205
1994-08-02T09:30:00-04:00,46.28125,46.375,46.03125,46.1875,505500,296250,67.99917557814311,56.34211514832938,NaN,NaN,192.46534926155925,135.96122499836423,0.12222173564983316,0.18826994588736312,0.06604821023752996,4274299,3228839,50.585229722805124,31.643138342694563,NaN,NaN,14.645159044938987,2.909127074719187
1994-08-03T09:30:00-04:00,46.17187,46.23437,46.09375,46.20312,144100,294715,68.22931056883283,57.33503815283717,NaN,NaN,168.35538897982238,158.35562879352022,0.12482008988219702,0.22207332259027623,0.09725323270807922,4418399,3713479,57.85027781083337,34.35802015242134,NaN,NaN,17.73765591497,5.02748833761216
1994-08-04T09:30:00-04:00,46.17187,46.21875,45.92187,45.9375,231700,302965,60.28921800056109,57.74387769828776,NaN,NaN,119.98341112075433,165.5413396042399,0.10206752558766935,0.2248376396926659,0.12277011410499655,4186699,3986139,61.297779249281156,36.97252295033574,NaN,NaN,18.27880157460444,6.920533085753915
1994-08-05T09:30:00-04:00,45.70312,45.84375,45.65625,45.78125,138400,302465,56.149733870691286,57.768763606214165,NaN,NaN,58.42641598619435,144.63049800599902,0.07136532906132378,0.21197677543165128,0.1406114463703275,4048299,4139299,63.12243358749601,39.338451950423675,NaN,NaN,17.52902165885118,8.436031453339238
1994-08-08T09:30:00-04:00,45.82812,45.9375,45.78125,45.89062,328600,312695,58.30760868386337,58.083126803116606,NaN,NaN,69.27703563660764,121.7015201969876,0.05407850877953824,0.2082095823447503,0.15413107356521205,4376899,4260919,64.5516091088335,41.66517547806394,NaN,NaN,17.50890794274337,9.732156666111257
1994-08-09T09:30:00-04:00,45.71875,45.96875,45.71875,45.96875,105900,305125,59.82842636377299,58.788806868848006,NaN,NaN,62.703895255416505,95.74922939575904,0.04398947043496132,0.2091179116089137,0.16512844117395237,4482799,4302619,65.05171835222092,44.05050730894108,NaN,NaN,17.91849518060423,10.90163359675311
1994-08-10T09:30:00-04:00,46,46.1875,45.9375,46.14062,840300,320505,63.02371814267066,59.596859984643075,NaN,NaN,93.5191523333944,80.78198206647345,0.04482275333078528,0.22115688283743395,0.17633412950664867,5323099,4483559,67.21319555926246,46.667439938097175,NaN,NaN,19.195762837257575,12.086509202539462
1994-08-11T09:30:00-04:00,46.03125,46.23437,45.73437,45.96875,876200,339605,58.051082027583654,59.94407928822826,NaN,NaN,63.49429024046389,69.48415789041535,0.030419409630992128,0.21435839154538883,0.1839389819143967,4446899,4535599,67.82946481777321,49.39272771699533,NaN,NaN,18.844874836449968,13.05199000738382
1994-08-12T09:30:00-04:00,46.04687,46.34375,46.04687,46.32812,184100,346355,64.37967249644751,60.65738456511444,NaN,NaN,105.98792593019095,78.99645987921468,0.041054254379450345,0.23525679988870962,0.19420254550925928,4630999,4652139,69.22454234579104,52.27648505711477,NaN,NaN,20.524602156566157,14.119506028695582
1994-08-15T09:30:00-04:00,46.375,46.48437,46.3125,46.3125,325900,359035,63.9282296240341,61.417484632878775,NaN,NaN,119.07864097343989,88.95678094658112,0.04280049773685485,0.24770316768032785,0.204902669943473,4305099,4637779,68.82847202937427,55.17565605482539,NaN,NaN,21.725897344077243,15.20613335946439
1994-08-16T09:30:00-04:00,46.34375,46.6875,46.15625,46.64062,1089500,383035,68.86692669647276,62.53034877724587,NaN,NaN,129.5356738636906,102.32313666823595,0.06072312974953803,0.28080658213039555,0.22008345238085752,5394599,4820139,71.09057071410669,58.255289746567655,NaN,NaN,24.396838538863676,16.519091242235717
1994-08-17T09:30:00-04:00,46.70312,46.73437,46.57812,46.60937,133700,380455,67.91324940119671,63.42475315113658,NaN,NaN,147.26495541820557,113.07229728519819,0.06477272065489886,0.3010493531994811,0.23627663254458225,5260899,4807699,70.71357904322515,61.07656961013304,NaN,NaN,26.241358710017387,17.907986594775956
1994-08-18T09:30:00-04:00,46.45312,46.5625,46.40625,46.45312,620000,407140,63.20058486780342,63.37721692573513,NaN,NaN,106.09673438745102,121.59278611459561,0.051789833803006446,0.3010139247983403,0.24922409099533388,4640899,4846499,71.22610334478654,63.60095995258372,NaN,NaN,26.379213722826023,19.118161898783107
1994-08-19T09:30:00-04:00,46.46875,46.51562,46.3125,46.42187,103200,404720,62.26989533316005,63.03120226108809,NaN,NaN,87.72782249904967,117.94076542836736,0.03667107271874098,0.2950629318937601,0.2583918591750191,4537699,4827839,70.58631946028419,65.65509251043382,NaN,NaN,26.22025871455565,20.132747158179185
1994-08-22T09:30:00-04:00,46.4375,46.4375,46.28125,46.375,79700,402660,60.82318199657295,62.51863129097593,NaN,NaN,70.72099795335825,108.26923682435101,0.019925724781638787,0.28329901515206757,0.2633732903704288,4457999,4858419,71.04533062189337,67.11652828894013,NaN,NaN,25.67996357917381,20.925206646892704
1994-08-23T09:30:00-04:00,46.57812,46.85937,46.51562,46.64062,268600,391610,65.68833639012387,62.33713313535389,NaN,NaN,128.96120206604354,108.15434246482161,0.022935649535687386,0.292042852290038,0.2691072027543506,4726599,4724819,66.18582048431523,67.71192419418882,NaN,NaN,26.621993907517933,21.739033398410594
1994-08-24T09:30:00-04:00,46.6875,47.14062,46.67187,47.14062,254700,400185,72.58894168153105,63.215684826851735,NaN,NaN,184.1618030105284,115.53371198328618,0.05307532032092971,0.3354513531555128,0.28237603283458307,4981299,4668899,64.20621163421094,67.91966936454095,NaN,NaN,29.8740760418843,22.901182347478265
1994-08-25T09:30:00-04:00,47.09375,47.20312,46.89062,47.01562,147400,366145,68.86039477032618,64.12358917682566,NaN,NaN,172.46902607224467,128.8081703202449,0.05863240970490524,0.3556665449657146,0.29703413526080935,4833899,4707499,64.98474380485524,68.05269152292375,NaN,NaN,31.268515236560372,24.096515617347137
1994-08-26T09:30:00-04:00,47.125,47.78125,47.125,47.6875,339500,360165,75.9971188405671,65.38712561659021,NaN,NaN,232.32408423151838,157.72742266673865,0.09921168632334298,0.4210487431649881,0.3218370568416451,5173399,4834639,67.49275058664897,68.26277305705342,NaN,NaN,35.30811960246732,25.698173329507163
1994-08-29T09:30:00-04:00,47.8125,47.98437,47.64062,47.65625,350300,353365,75.13459964065856,66.48042370779633,NaN,NaN,218.32233577281946,187.2476902306309,0.11451672121169698,0.46498295835626635,0.35046623714456937,4823099,4907659,68.87176923917025,68.53563383469267,NaN,NaN,38.02802704032139,27.459581002480626
1994-08-30T09:30:00-04:00,47.64062,47.85937,47.57812,47.78125,36000,329890,76.29359581613522,67.42827211304379,NaN,NaN,172.72446074068736,196.00034196555967,0.12288853900736596,0.5040769109037768,0.38118837189641086,4859099,4934159,69.37945106628068,68.69036637090825,NaN,NaN,40.57860791544636,29.333727704332873
1994-08-31T09:30:00-04:00,47.70312,47.89062,47.59375,47.65625,356200,340495,72.64698972440863,68.47083694853129,NaN,NaN,140.85331028704994,187.33864342086397,0.11024138233284725,0.5189900998124699,0.40874871747962266,4502899,4838479,65.24207568237806,68.50555286123718,NaN,NaN,41.461698937088,31.06629502329789
1994-09-01T09:30:00-04:00,47.5,47.53125,47.32812,47.5,294600,343640,68.25529814013831,68.74766735165205,NaN,NaN,94.42697323121885,171.73023285265882,0.08283736011274728,0.5122954176205567,0.42945805750780947,4208299,4713359,60.18743643592846,67.86004529624698,NaN,NaN,40.79268661643313,32.455779536602925
1994-09-02T09:30:00-04:00,47.71875,47.71875,47.21875,47.29687,99600,341700,62.929245429111056,68.67631133772899,NaN,NaN,78.27776589716915,140.92096918578895,0.04444000940471188,0.4850080692636993,0.44056805985898745,4108699,4500419,52.70369676822026,66.70827563473598,NaN,NaN,38.523960987654846,33.322662601038914
1994-09-06T09:30:00-04:00,47.26562,47.35937,47.125,47.3125,229800,336760,63.16740661478983,68.26920276046592,NaN,NaN,53.65895662671619,107.9882933565683,0.01502457031536042,0.459348772753188,0.44432420243782755,4338499,4403499,49.6760794691719,65.17866911724064,NaN,NaN,36.78931160351863,33.81789817282173
1994-09-07T09:30:00-04:00,47.42187,47.42187,47.21875,47.26562,27900,332860,61.883226863852144,67.8384868649413,NaN,NaN,51.65994156707083,83.775389521845,-0.011242660856323472,0.4302708763674232,0.4415135372237467,4310599,4293799,46.425264915773134,63.44378953670836,NaN,NaN,34.99404142656268,33.985918637641866
1994-09-08T09:30:00-04:00,47.35937,47.5625,47.34375,47.5,284800,305085,65.64381158144826,68.01300305877308,NaN,NaN,66.4913744044599,68.903002345327,-0.016184704209966427,0.42128265696128864,0.43746736117125506,4595399,4312299,47.05451545102242,61.71724754429664,NaN,NaN,34.49936144427864,34.05926761001855
1994-09-09T09:30:00-04:00,47.03125,47.125,46.8125,47,488400,285695,53.514301759067386,67.38760351776645,NaN,NaN,-5.411270085493664,48.9353536819845,-0.05433099063757013,0.3695536228742924,0.4238846135118625,4106999,4292039,46.41161659452955,59.9904830538856,NaN,NaN,29.97045103565207,33.475150956537625
1994-09-12T09:30:00-04:00,47,47.0625,46.78125,46.85937,129400,282960,50.67794341616572,66.66294361916594,NaN,NaN,-23.449626566639516,28.58987518922275,-0.08823137681870585,0.31359539248848023,0.4018267693071861,3977599,4265819,45.54434771271847,58.16898427465882,NaN,NaN,25.359715339554516,32.315803011254324
1994-09-13T09:30:00-04:00,46.95312,47.125,46.85937,47,389200,286125,53.3411795466885,65.78100384463485,NaN,NaN,-14.511860799211323,14.955711704037247,-0.09954294744026793,0.27739808500685115,0.3769410324471191,4366799,4271479,45.7798829807775,56.7114173101204,NaN,NaN,22.401528927898635,30.899478142203513
1994-09-14T09:30:00-04:00,46.84375,47.10937,46.84375,47.04687,423500,252825,54.22826915640423,64.46952723569721,NaN,NaN,-19.020921125619815,0.8195391654991127,-0.1018599805105665,0.24961605680891097,0.35147603731947746,4790299,4367419,49.74757514989084,55.6786575612404,NaN,NaN,20.28479178785954,29.38309437729723
1994-09-15T09:30:00-04:00,47.17187,47.64062,47.17187,47.64062,779800,285130,63.65518365523605,64.0977264417622,NaN,NaN,61.43925850676266,-0.19088401404033561,-0.0632851855062756,0.272369555436633,0.3356547409429086,5570099,4562359,56.683671115007755,55.08572379767986,NaN,NaN,21.461402261235747,28.25142407500273
1994-09-16T09:30:00-04:00,47,47.14062,46.84375,47.01562,571300,282695,51.60654240486843,62.35554241064087,NaN,NaN,-34.20391926700303,-5.949413850342206,-0.0787358774058659,0.2372348941855762,0.3159707715914421,4998799,4740719,61.86943245006982,54.684058216495636,NaN,NaN,17.995599932963202,26.786306340425657
1994-09-19T09:30:00-04:00,47.125,47.32812,47.01562,47.0625,167300,285900,52.33531708452843,60.72702222806015,NaN,NaN,-16.380463086765264,-4.535581154367356,-0.08418148009172105,0.21074392147679077,0.2949254015685118,5166099,4978419,67.46042771342331,54.58324810751371,NaN,NaN,15.644381623193118,25.194602809392435
1994-09-20T09:30:00-04:00,46.8125,46.85937,46.17187,46.17187,355600,299695,40.00844921746551,58.135226042440884,NaN,NaN,-179.37208948992304,-37.5076268925097,-0.1427084505823749,0.11653983834054316,0.25924828892291807,4810499,5067159,69.27187949480764,54.575564423837065,NaN,NaN,8.49411249272705,22.808818478440237
1994-09-21T09:30:00-04:00,46.3125,46.3125,45.73437,46.17187,397500,306140,40.00844921746551,55.80390172051637,NaN,NaN,-223.1654157670779,-78.33652582080131,-0.17427452619999081,0.041405131172929543,0.21567965737292036,4810499,5071199,69.35551945667456,54.86938183628681,NaN,NaN,3.311334976390931,20.023463692433193
1994-09-22T09:30:00-04:00,46.28125,46.28125,46.01562,46.0625,266400,306725,38.70992379577693,53.693517838776266,NaN,NaN,-181.3626943827571,-126.89691639870526,-0.1938698203805786,-0.02665761810280287,0.16721220227777572,4544099,4865999,60.36754160369948,54.882246491127596,NaN,NaN,-1.1534744052463468,16.998186821336116
1994-09-23T09:30:00-04:00,46.07812,46.17187,45.82812,45.90625,176600,308185,36.86887571704994,51.83206285934334,NaN,NaN,-171.9305360842721,-154.4422397621591,-0.2074847465116773,-0.09214373086182093,0.11534101564985638,4367499,4739739,55.59358205790514,55.08866686896223,NaN,NaN,-5.344688074889665,13.80634755044672
1994-09-26T09:30:00-04:00,46.07812,46.17187,45.98437,46.14062,223000,302360,41.37296915266116,50.275317326334154,NaN,NaN,-132.57862164005653,-177.68187147281733,-0.19123622133534676,-0.12370426101932708,0.06753196031601968,4590499,4624619,51.58776050675582,55.225215514503944,NaN,NaN,-7.378533053896715,10.779936035540516
1994-09-27T09:30:00-04:00,46.14062,46.26562,46,46.10937,479500,308820,40.953416290077314,48.780330856778804,NaN,NaN,-111.24275808087891,-164.05600519100852,-0.17363701980157936,-0.14951431443595453,0.024122705365624837,4110999,4484719,47.142182430770006,55.276423908432285,NaN,NaN,-9.117187975208411,7.93748974829067
1994-09-28T09:30:00-04:00,46.35937,46.53125,46.32812,46.46875,324000,323220,47.541706534662346,47.48732335343694,NaN,NaN,-58.44032046366596,-131.11098613032613,-0.13078897181124283,-0.13936350939842868,-0.008574537587185863,4434999,4409619,44.90508943241303,55.12289347853162,NaN,NaN,-8.57000737892367,5.5792758729743355
1994-09-29T09:30:00-04:00,46.46875,46.46875,46.09375,46.23437,195900,315205,44.08678855629773,46.81392955323911,NaN,NaN,-72.53034317700197,-109.34451588917509,-0.11195588303779747,-0.1485193913844327,-0.036563508346635236,4239099,4348619,43.1153854328866,54.88744839555712,NaN,NaN,-9.184613884316388,3.4701487647899465
1994-09-30T09:30:00-04:00,46.21875,46.4375,46.17187,46.17187,5200,300735,43.185538175034765,46.27875775030118,NaN,NaN,-65.10168775008736,-87.97874622233813,-0.09793801692735818,-0.15898602950583296,-0.06104801257847478,4233899,4321899,42.31973934943286,54.657119226751014,NaN,NaN,-9.948260543541712,1.5532331493139953
1994-10-03T09:30:00-04:00,46.20312,46.25,45.98437,46.0625,72600,299385,41.583542428790786,45.43892652759421,NaN,NaN,-78.57892541386533,-77.17880697709988,-0.0904409921524006,-0.17409925276897553,-0.08365826061657493,4161299,4236059,39.77999326057284,54.22855567530782,NaN,NaN,-11.046571242613688,-0.24673890667567355
1994-10-04T09:30:00-04:00,46.29687,46.29687,45.34375,45.375,84200,292105,33.23703981754208,43.939553003389776,NaN,NaN,-123.36324658677493,-79.60290467827909,-0.1241128834912376,-0.23879936498062193,-0.11468648148938433,4077099,4229279,39.57795883519863,53.50215450997267,NaN,NaN,-14.880762085779365,-2.3373136465476296
1994-10-05T09:30:00-04:00,45.29687,45.39062,45,45.39062,461900,313805,33.563314980346036,41.7901338123262,NaN,NaN,-161.55797052314946,-100.22643469017581,-0.13666916354120662,-0.2855229359158926,-0.148853772374686,4538999,4250079,40.57507924828955,52.35154080520708,NaN,NaN,-17.774535761522063,-4.542631091543978
1994-10-06T09:30:00-04:00,45.42187,45.45312,45.17187,45.25,345200,316825,32.04500808795359,40.39288136111799,NaN,NaN,-146.96670880376496,-115.11370781552841,-0.14499174169002335,-0.3300934494872152,-0.18510170779719184,4193799,4241019,40.26339692435166,50.808252553370075,NaN,NaN,-20.627490337551297,-6.840468126687881
1994-10-07T09:30:00-04:00,45.25,45.57812,45.20312,45.45312,188700,301840,36.51259075681415,39.26268662342412,NaN,NaN,-119.5281778207603,-125.99900582966299,-0.12795728493986408,-0.34504831397202196,-0.21709102903215788,4382499,4270739,41.84162707291773,48.97833822190538,NaN,NaN,-21.703085828674553,-8.963699226971691
1994-10-10T09:30:00-04:00,45.65625,46.01562,45.64062,45.9375,213600,306050,45.68329788589437,39.66803295688332,NaN,NaN,-53.89201814425461,-121.06162437574085,-0.0776815076725399,-0.31419291362283275,-0.23651140595029285,4596099,4357699,46.311227469204276,47.338291648647996,NaN,NaN,-19.702530692287553,-10.4978180077311
1994-10-11T09:30:00-04:00,46.14062,46.75,46.14062,46.625,461400,309660,55.50705386512432,40.77507614600181,NaN,NaN,41.86068681449548,-88.01683769548677,0.003933441726397813,-0.23159460379229557,-0.23552804551869339,5057499,4553779,54.75481922541798,46.29538448927253,NaN,NaN,-14.324830688922566,-11.044534105044166
1994-10-12T09:30:00-04:00,46.6875,46.75,46.57812,46.6875,162400,296605,56.281167516727784,42.03016498321258,NaN,NaN,72.01005596241899,-41.30323239837307,0.06101778157158305,-0.15925581855421456,-0.2202736001257976,5219899,4689959,59.51675745628466,46.23461419302861,NaN,NaN,-9.925832412023263,-10.88471957746975
1994-10-13T09:30:00-04:00,47.21875,47.32812,46.79687,46.84375,1564500,335840,58.23742287845087,43.5564897804555,NaN,NaN,133.5746639598194,14.8050421543438,0.10557818927935397,-0.08830086352660516,-0.19387905280595913,6784399,5208079,71.71445168472565,47.38610488065864,NaN,NaN,-5.737455845554871,-10.149396187196196
1994-10-14T09:30:00-04:00,47,47.0625,46.6875,47.04687,72800,310915,60.699344001093245,44.93694512677208,NaN,NaN,125.81337712798805,63.87335314409347,0.1427034086011457,-0.015499792054527006,-0.1582032006556727,6857199,5703019,78.4073623610989,49.30179072739744,NaN,NaN,-1.4855628980899325,-8.911705717323873
1994-10-17T09:30:00-04:00,47,47.0625,46.90625,46.95312,282300,316665,58.97139269384504,46.22394344132692,NaN,NaN,137.17903819322026,102.08756441158845,0.1539514307510919,0.034236087783192204,-0.11971534296789971,6574899,6098779,82.06230866031679,51.796085458079354,NaN,NaN,1.4513213208520963,-7.431273283298735
1994-10-18T09:30:00-04:00,46.90625,46.90625,46.6875,46.84375,132100,305490,56.93510449772077,46.89490043868823,NaN,NaN,100.25056765733405,113.76554058015616,0.14704276877007988,0.06408811799470016,-0.08295465077537972,6442799,6375839,84.0923627046954,54.595176406099526,NaN,NaN,3.2903619900140035,-5.899611101396915
1994-10-19T09:30:00-04:00,46.67187,47.23437,46.65625,47.0625,136700,292450,59.916362219585,48.025584271780176,NaN,NaN,111.5518831741684,121.67390602250605,0.14972072404441011,0.1041962542801329,-0.045524469764277195,6579499,6647759,85.79189428200397,57.64349846675077,NaN,NaN,5.752442370596109,-4.23503203396934
1994-10-20T09:30:00-04:00,47.0625,47.0625,46.60937,46.75,290300,293645,54.14928827829508,48.80870927915591,NaN,NaN,76.3857891266938,110.23613105588092,0.12402262473153453,0.10950381115014096,-0.01451881358139356,6289199,6548719,82.34128823760989,60.502180530191985,NaN,NaN,6.180518591648733,-2.747096230309615
1994-10-21T09:30:00-04:00,46.625,46.6875,46.35937,46.5625,87800,289205,50.97873489782623,49.479794455515595,NaN,NaN,33.83702362397936,91.84086035507919,0.0895806362972539,0.09745698179017381,0.007876345492919917,6201399,6417559,77.87426178712116,63.22319971065973,NaN,NaN,5.5898165182627615,-1.5561086947992753
1994-10-24T09:30:00-04:00,46.57812,46.76562,46.15625,46.17187,149600,285535,45.05935404686836,50.32424547189604,NaN,NaN,7.442694504086266,65.89359161725238,0.03829619906366954,0.05574659432250684,0.0174503952588373,6051799,6312939,74.40680151446648,65.71097418775028,NaN,NaN,3.199401088368675,-0.876750154346711
1994-10-25T09:30:00-04:00,46.01562,46.3125,46,46.21875,91800,266150,45.871658147407054,51.20341284097183,NaN,NaN,-20.40548853401407,41.76238037898275,0.00697723747111078,0.026171942097725776,0.019194704626614996,6143599,6253099,72.42052025915388,67.98564854566916,NaN,NaN,1.5173115784198574,-0.5347413353800583
1994-10-26T09:30:00-04:00,46.39062,46.4375,46.17187,46.39062,201000,260000,48.85709204595391,52.40427598082899,NaN,NaN,3.3607919612319583,20.124162136395462,-0.002225291801358869,0.01641308987491641,0.018638381676275278,6344599,6206119,70.82205665064413,70.16840995469006,NaN,NaN,0.9682596347625815,-0.32002691107396697
1994-10-27T09:30:00-04:00,46.5625,46.67187,46.45312,46.67187,210300,260720,53.3877373078665,53.60964359161845,NaN,NaN,39.51616082832953,12.750236476722609,0.00990218998735514,0.031016119160469202,0.02111392917311406,6554899,6259259,71.58600951680738,72.29300870068218,NaN,NaN,1.8496167410057003,-0.010077817919728782
1994-10-28T09:30:00-04:00,46.76562,47.70312,46.76562,47.65625,192100,270065,65.05591930453113,54.99340226437822,NaN,NaN,132.9561404981471,32.57405985155616,0.07961271170927739,0.1206298188097108,0.04101710710043341,6746999,6368379,73.141140404798,74.20943105322458,NaN,NaN,6.963211196195777,0.986106326953915
1994-10-31T09:30:00-05:00,47.54687,47.59375,47.46875,47.48437,36300,268250,62.13135560283209,55.46656667421449,NaN,NaN,134.66111036491372,58.017743023721664,0.10778956111284124,0.17575405849148495,0.06796449737864371,6710699,6500159,74.92593903316077,75.65022532520621,NaN,NaN,9.970517087729966,2.2695935784933505
1994-11-01T09:30:00-05:00,47.28125,47.28125,46.9375,46.95312,435200,285800,54.04442932638274,55.30679966061842,NaN,NaN,71.54322700028575,76.40748613058163,0.08527700428291729,0.17456075273229033,0.08928374844937303,6275499,6526539,75.2800659463049,76.77617593163622,NaN,NaN,9.682790462081945,3.328621704720293
1994-11-02T09:30:00-05:00,46.8125,47.23437,46.6875,46.6875,115600,268485,50.50484540701029,54.75447269837266,NaN,NaN,40.793566778355824,83.8940410940064,0.048930977569445575,0.15044747041118,0.10151649284173443,6159899,6489599,73.7101785501286,76.91872785059357,NaN,NaN,8.225324776225957,4.0281507149353875
1994-11-03T09:30:00-05:00,46.84375,47.01562,46.78125,46.9375,87000,255575,53.58600470116261,54.2463770340919,NaN,NaN,40.88919190065928,84.16864730847234,0.03861385893316459,0.14978381650819017,0.11116995757502558,6246899,6427999,71.04934862027704,76.39315544053487,NaN,NaN,8.079065662466284,4.606852850296944
1994-11-04T09:30:00-05:00,47.15625,47.15625,46.32812,46.32812,124400,252360,46.059347763515575,53.32408811049694,NaN,NaN,-30.702722255534873,51.43687475773595,-0.009779636703851055,0.09894541169521176,0.10872504839906282,6122499,6303099,65.85817277387623,75.23571716293198,NaN,NaN,5.287443313480013,4.704080059323097
1994-11-07T09:30:00-05:00,46.3125,46.59375,46.3125,46.46875,115000,247430,47.878795766428254,52.67720891540462,NaN,NaN,-77.4831496863514,9.00802274748292,-0.03161562496501674,0.06920551719279189,0.10082114215780863,6237499,6208459,62.1525470912398,73.66858747625658,NaN,NaN,3.7081732370805724,4.561807656145594
1994-11-08T09:30:00-05:00,46.625,46.98437,46.54687,46.82812,308300,239775,52.306057569857884,52.133615726138395,NaN,NaN,-0.4074890517591711,-5.38212046292607,-0.021629669332551546,0.0737840554921192,0.09541372482467074,6545799,6262519,63.41873055116755,72.0705043526254,NaN,NaN,3.862201572174033,4.461863929863942
1994-11-09T09:30:00-05:00,47.32812,47.32812,46.5,46.90625,318500,247580,53.2360777683874,52.06838640400213,NaN,NaN,29.24704045333176,-7.6914257279308815,-0.010120597436761997,0.08276297802871824,0.09288357546548023,6864299,6403399,66.55853934861587,70.94316514626868,NaN,NaN,4.276068106249934,4.435321669347656
1994-11-10T09:30:00-05:00,46.9375,47.03125,46.54687,46.57812,172100,177960,48.921468790368614,51.92143882489802,NaN,NaN,-18.05582694383346,-19.480429496829423,-0.024163687555217472,0.0626789660214584,0.08684265357667587,6692199,6492459,68.40476206805805,70.26677230919275,NaN,NaN,3.266002735945154,4.268276107433013
1994-11-11T09:30:00-05:00,46.51562,46.5625,46.28125,46.40625,302200,189430,46.782720445054714,52.04453642476847,NaN,NaN,-86.94450745380315,-30.728786536483078,-0.04345899372755868,0.032518911417227514,0.0759779051447862,6389999,6545959,69.49428369293244,69.91587817908318,NaN,NaN,1.7795396026046497,3.912742321028961
1994-11-14T09:30:00-05:00,46.60937,46.85937,46.60937,46.84375,181400,184385,52.47802958374021,52.51642009879227,NaN,NaN,5.31775446137752,-14.168605706937296,-0.02604717369847301,0.04341893802169494,0.06946611172016795,6571399,6612739,70.84571488058984,69.80339208061432,NaN,NaN,2.2757853672838646,3.6788913276368045
1994-11-15T09:30:00-05:00,46.79687,47.09375,46.32812,46.6875,316900,193625,50.40335158927424,52.626867209029434,NaN,NaN,-11.008397459152015,-16.288787388415862,-0.02437316559320976,0.03899965472865574,0.0633728203218655,6254499,6554479,68.01481205910298,69.60287460978995,NaN,NaN,2.0468236386438936,3.4457388006378173
1994-11-16T09:30:00-05:00,46.76562,46.84375,46.60937,46.84375,106900,192135,52.42871404591128,52.5583655474612,NaN,NaN,8.64610800296454,-20.40897387848931,-0.012652496063173202,0.047557200242899,0.0602096963060722,6361399,6453899,63.31133853039048,69.01182668218874,NaN,NaN,2.460751932120828,3.305026390849676
1994-11-17T09:30:00-05:00,46.875,46.875,46.34375,46.53125,104700,182855,48.19010843459338,51.353664771037074,NaN,NaN,-37.86859916631049,-24.371528322984723,-0.02513488296918167,0.028791092594595113,0.05392597556377678,6256699,6366799,59.475631148711784,68.03571887818258,NaN,NaN,1.5404731339192694,3.0529473541453322
1994-11-18T09:30:00-05:00,46.54687,46.625,46.26562,46.46875,269300,191930,47.3653453945603,50.298949756160525,NaN,NaN,-70.98113888966363,-21.17885461015682,-0.03612122597343578,0.008774443096982054,0.04489566907041784,5987399,6286279,56.09235136842546,66.69046261641576,NaN,NaN,0.551850700330919,2.6956478321718444
1994-11-21T09:30:00-05:00,46.4375,46.57812,46,46,283100,198605,41.612984808968676,49.41098943348809,NaN,NaN,-133.6698020904855,-48.97636592052942,-0.07143755373426523,-0.04440127309741371,0.02703628063685153,5704299,6112859,49.55414079905438,64.8528965344693,NaN,NaN,-2.102338021191202,2.0102212816914093
1994-11-22T09:30:00-05:00,45.82812,46,45,45,483600,218195,32.53516088837826,48.12744053930009,NaN,NaN,-292.89888993375007,-105.35446441544903,-0.15389241759953207,-0.16532924136256355,-0.011436823763031494,5220699,5906099,43.10328088370165,62.66668955829594,NaN,NaN,-7.912587030087592,0.5926772371515521
1994-11-23T09:30:00-05:00,45.03125,45.26562,44.60937,45.25,601600,238225,36.277721764921765,46.89113461528289,NaN,NaN,-277.71662490685105,-162.62701099741213,-0.1814475507348187,-0.23824626218155487,-0.05679871144673618,5822299,5798279,40.16683022016555,60.4607953868594,NaN,NaN,-11.281410324115017,-1.1036209858865291
1994-11-25T09:30:00-05:00,45.28125,45.53125,45.28125,45.46875,77300,231575,39.443253381868985,46.41855644516527,NaN,NaN,-165.93206734349246,-188.23970463284854,-0.1747288569445421,-0.2752097826274138,-0.1004809256828717,5899599,5726859,38.3052740073452,58.492731189250044,NaN,NaN,-12.95570569634965,-2.796775944524118
1994-11-28T09:30:00-05:00,45.45312,45.6875,45.34375,45.67187,79900,225965,42.30909397588648,46.020720602983715,NaN,NaN,-124.48596977984595,-198.940670810885,-0.14747942513877357,-0.28483020710633866,-0.1373507819675651,5979499,5725279,38.26302565000512,56.786336800590426,NaN,NaN,-13.40668475179979,-4.312477202706357
1994-11-29T09:30:00-05:00,45.65625,45.75,45.5,45.65625,105500,229425,42.14392158114025,45.294853746646744,NaN,NaN,-97.35611516425998,-191.67793342563988,-0.12241352507576048,-0.29036768831226567,-0.1679541632365052,5873999,5759219,39.79903597410012,55.09921575937131,NaN,NaN,-13.813380671157255,-5.669749126770771
1994-11-30T09:30:00-05:00,45.89062,45.95312,45.59375,45.59375,218800,218605,41.44668966232517,44.45275459621372,NaN,NaN,-75.16973772528078,-148.13210298394603,-0.10274298320221359,-0.29638289223927217,-0.19363990903705858,5655199,5846119,43.66384982204129,53.463880793187414,NaN,NaN,-14.344014255573256,-6.9089298594568405
1994-12-01T09:30:00-05:00,45.64062,45.64062,45.04687,45.14062,439000,234775,36.70536838417078,43.580175995771015,NaN,NaN,-113.2079569005319,-115.23036938268221,-0.11218023160102003,-0.33386519853833363,-0.2216849669373136,5216199,5724899,39.82323415906874,51.42234308540247,NaN,NaN,-16.239491742924756,-8.241867271380828
1994-12-02T09:30:00-05:00,45.04687,45.5625,45.04687,45.5625,318500,246350,43.21819523370264,43.32556705210301,NaN,NaN,-87.1308794861141,-99.47013181120654,-0.08327018741891012,-0.32577270121095125,-0.24250251379204113,5534699,5651919,37.67469706646614,49.149515469226294,NaN,NaN,-15.89095558017846,-9.334594172637633
1994-12-05T09:30:00-05:00,45.65625,45.8125,45.5,45.60937,139200,247090,43.90873483702606,42.71347457019486,NaN,NaN,-51.77205581812496,-84.92734901886233,-0.05558278795251026,-0.3119809987326789,-0.25639821078016867,5673899,5590799,35.92651911240141,46.65528720006997,NaN,NaN,-15.406616826715736,-10.202025980363077
1994-12-06T09:30:00-05:00,45.4375,45.65625,45.35937,45.64062,249900,253835,44.39428996051577,42.2842558824264,NaN,NaN,-55.9456747679284,-76.64526093959603,-0.030983285230485547,-0.2951273173182756,-0.26414403208779,5923799,5600759,36.4440694878313,44.400234159264855,NaN,NaN,-14.87443034760339,-10.869512318540265
1994-12-07T09:30:00-05:00,45.35937,45.5,45.26562,45.3125,531900,265015,40.43623864215427,41.42765049644375,NaN,NaN,-70.9604330983286,-75.8034000142056,-0.0324722996186112,-0.304734406611054,-0.2722621069924428,5391899,5548099,34.841639399519465,42.3666842213455,NaN,NaN,-15.53478671489713,-11.535980089448389
1994-12-08T09:30:00-05:00,45.5,45.5625,44.75,44.875,261500,262165,35.84703261472889,40.5460022235963,NaN,NaN,-98.0022971285856,-72.76226805981634,-0.05714139964718479,-0.3436888565514238,-0.286547456904239,5130399,5530939,34.31219322346465,40.56929579811356,NaN,NaN,-17.51527626437351,-12.390165257294834
1994-12-09T09:30:00-05:00,44.875,45.07812,44.6875,45.04687,235900,265355,38.78619049307367,39.93320544491868,NaN,NaN,-106.42529068267666,-76.62115029912886,-0.056027326686170276,-0.35658161526195187,-0.3005542885757816,5366299,5497259,33.24441416004504,38.93730028322925,NaN,NaN,-18.299115923511415,-13.234301066754346
1994-12-12T09:30:00-05:00,44.95312,45.34375,44.95312,45.34375,151100,257800,43.59348757789048,40.074669928413094,NaN,NaN,-67.86895804000716,-79.8405307435053,-0.030705718179359853,-0.3389364362999814,-0.3082307181206215,5517399,5465959,32.24028689839079,37.70059643318185,NaN,NaN,-17.532310646469128,-13.84830243528503
1994-12-13T09:30:00-05:00,45.3125,45.53125,45.3125,45.51562,70900,252275,46.22633106209724,41.0526106551073,NaN,NaN,-31.966686032032495,-75.0447329963261,0.0005534424587742559,-0.3075389150471537,-0.30809235750592795,5588299,5398859,30.138654295962766,36.77455167691479,NaN,NaN,-16.110212107443434,-14.171432388450516
1994-12-14T09:30:00-05:00,45.45312,45.95312,45.45312,45.75,203300,246595,49.67599022937394,42.0096298311396,NaN,NaN,18.16062877799165,-57.22052062106205,0.03788346964728412,-0.2607380204468228,-0.29862149009410693,5791599,5478799,35.530512059677505,36.443386094022785,NaN,NaN,-13.870436101897834,-14.12843291894299
1994-12-15T09:30:00-05:00,45.8125,46.03125,45.8125,45.89062,130100,247755,51.67886976851223,42.88360243018555,NaN,NaN,69.10306369055505,-23.799448457233925,0.07099180841726177,-0.2098817295725297,-0.2808735379897915,5921699,5637059,44.639915294429066,36.89586047167163,NaN,NaN,-11.41066342981154,-13.740180134781355
1994-12-16T09:30:00-05:00,45.67187,45.84375,45.625,45.75,266100,255825,49.55488804862317,43.40115914966673,NaN,NaN,49.399104710730285,7.365430621447468,0.08160859638331919,-0.17886279251064252,-0.2604713888939617,5655599,5694919,47.55742090115226,37.55974584675357,NaN,NaN,-9.928353490328615,-13.195633471288106
1994-12-19T09:30:00-05:00,45.75,45.84375,45.60937,45.8125,1120200,298370,50.5281143537307,44.00003006199462,NaN,NaN,70.04575739391488,34.948373708231884,0.09034820784639264,-0.1475361290859709,-0.23788433693236355,6775799,5946599,57.94065062968086,38.85557546500934,NaN,NaN,-8.423912253621843,-12.513959011621496
1994-12-20T09:30:00-05:00,45.85937,45.89062,45.67187,45.67187,675600,317995,48.27144619167691,44.487512671234036,NaN,NaN,80.6030620901942,57.462323332677215,0.08428389267741315,-0.1325294710855971,-0.21681336376301025,6100199,6048979,61.297547580909765,40.11512530492852,NaN,NaN,-7.738488826990669,-11.831748985245664
1994-12-21T09:30:00-05:00,45.70312,46.26562,45.70312,46.15625,544500,321040,55.62309176642895,45.838778627109626,NaN,NaN,146.67351995815437,83.16490156870975,0.10895324253952565,-0.08062181058860318,-0.18957505312812883,6644699,6219599,66.14679893662966,41.995379931897155,NaN,NaN,-4.912733913317191,-10.843318260684454
1994-12-22T09:30:00-05:00,46.15625,46.20312,45.96875,46.01562,222000,302060,53.25660458682636,46.555807866618466,NaN,NaN,141.33388571648484,97.61106597389572,0.11145764560775273,-0.05025299611843792,-0.16171064172619065,6422699,6319799,68.63244530429631,44.206647663170735,NaN,NaN,-3.2237280170434763,-9.754805368735742
1994-12-23T09:30:00-05:00,45.98437,46.17187,45.98437,46.0625,125800,304485,53.959807197141075,47.27374160662668,NaN,NaN,127.13150891090375,113.15754681393041,0.11165062010732854,-0.022147366592029982,-0.13379798669935852,6548499,6498379,72.50691959739632,46.81953341209895,NaN,NaN,-1.6326881887342624,-8.594502914449816
1994-12-27T09:30:00-05:00,46.21875,46.40625,46.1875,46.3125,95200,305250,57.62119719582633,48.21852069486314,NaN,NaN,160.87706346334207,131.32380802781586,0.12309288944456569,0.02006812510634859,-0.1030247643382171,6643699,6471959,71.10754975062976,49.29549628801312,NaN,NaN,0.8182480117757123,-7.249824210703312
1994-12-28T09:30:00-05:00,46.35937,46.35937,45.96875,46.07812,358200,317885,53.33852272082458,49.14011241476816,NaN,NaN,106.87004253825904,136.57720411742883,0.10979362259069625,0.03421726390015323,-0.07557635869054302,6285499,6509019,71.92604093136248,51.944382111716195,NaN,NaN,1.7240049942594502,-5.967848609994346
1994-12-29T09:30:00-05:00,46.25,46.25,46.0625,46.10937,220100,317950,53.831237036879315,50.424698444921766,NaN,NaN,97.07066248856798,126.65663262351154,0.09838565388497153,0.0474057086656714,-0.05097994521930013,6505599,6481199,70.31569819903028,54.516061038542304,NaN,NaN,2.606350134979908,-4.742963074998023
1994-12-30T09:30:00-05:00,46.20312,46.25,45.5625,45.5625,2209500,406475,44.89673731220949,50.86116607486004,NaN,NaN,20.074522313753725,102.40475994296533,0.051642630175453584,0.01357334250001685,-0.038069287675436735,4296099,6055879,51.377186626658506,55.81125907187184,NaN,NaN,0.6945111447787069,-3.9661810436013476
1995-01-03T09:30:00-05:00,45.70312,45.84375,45.6875,45.78125,324300,406765,48.573546565306636,51.21688457396119,NaN,NaN,11.922789713412053,79.36301610346699,0.03394500085704754,0.004361963395872692,-0.029583037461174848,4620399,5670259,40.67934956454209,56.41404926231122,NaN,NaN,0.19613877069041785,-3.3715639272739524
1995-01-04T09:30:00-05:00,45.98437,46,45.75,46,351800,417395,52.02123145773371,51.63080603079237,NaN,NaN,42.82396954369502,55.752397319537565,0.035302833489688094,0.014545504400935272,-0.020757329088752823,4972199,5335959,34.05851319352273,56.6940391835655,NaN,NaN,0.8244618516281305,-2.7721316731450836
1995-01-05T09:30:00-05:00,46.03125,46.10937,45.95312,46,89800,409390,52.02123145773371,51.7983232613895,NaN,NaN,61.942479151982795,46.76688464228231,0.03449250441861444,0.022358301434515226,-0.012134202984099212,4972199,5073299,29.935893059356587,56.294423540685436,NaN,NaN,1.3286608077065565,-2.1863041758805637
1995-01-06T09:30:00-05:00,46.09375,46.25,45.90625,46.04687,448400,405215,52.80742758562219,51.878934534040205,NaN,NaN,66.79341068852878,40.71143428227448,0.03527821089328909,0.031963560632512156,-0.003314650260776937,5420599,4856299,27.025377767307944,55.03624228874821,NaN,NaN,1.9639928814885528,-1.5934045962564043
1995-01-09T09:30:00-05:00,46.03125,46.09375,46,46.09375,36800,393980,53.62595664114519,52.16972514779178,NaN,NaN,59.452558959116345,48.587041611347004,0.03694332549393425,0.04286450660664087,0.005921181112706625,5457399,5088559,34.37928270076563,54.09494670300631,NaN,NaN,2.7164530829784543,-0.9777106420799959
1995-01-10T09:30:00-05:00,46.20312,46.39062,46.14062,46.14062,229800,393675,54.47609957223007,52.45172409197031,NaN,NaN,101.94416883488863,66.59131743564231,0.03898750852382968,0.054655566767493724,0.015668058243664046,5687199,5301919,40.32820781291735,52.836915073237485,NaN,NaN,3.5762651690513154,-0.32714266906123723
1995-01-11T09:30:00-05:00,46.29687,46.29687,45.8125,46.17187,222400,397240,55.06754796397162,52.9371599328485,NaN,NaN,53.96841634006812,68.82020679491693,0.0400764325220037,0.06576359889616867,0.025687166374164974,5909599,5489399,45.042846188697794,51.675864973793765,NaN,NaN,4.458033936437237,0.3564539888671162
1995-01-12T09:30:00-05:00,46.125,46.21875,46.03125,46.1875,40300,395710,55.37979804643968,52.91978180999213,NaN,NaN,69.2856476382211,70.2888404921646,0.03942136126501387,0.0749638679554323,0.03554250669041844,5949899,5684939,49.52248142293432,50.48841372281554,NaN,NaN,5.2877252001801605,1.0609213047689796
1995-01-13T09:30:00-05:00,46.4375,46.73437,46.375,46.73437,170600,394075,64.63905455659304,53.73281395068976,NaN,NaN,244.06716437148438,105.74359122875572,0.07152017395668547,0.12494272413627527,0.0534225501795898,6120499,5824919,52.50692757017884,49.33659102752143,NaN,NaN,8.839423780408806,2.1721359441460977
1995-01-16T09:30:00-05:00,46.71875,47.03125,46.71875,47.01562,105100,392825,68.28418876617596,54.75598406276367,NaN,NaN,290.65416769245206,151.98391297542284,0.10535155695038756,0.18511199636757425,0.07976043941718669,6225599,5978559,55.60921188895194,48.12961190548969,NaN,NaN,13.116091830213461,3.7355582135842926
1995-01-17T09:30:00-05:00,46.92187,47.0625,46.85937,47.03125,89500,383995,68.478655588401,55.53151680509044,NaN,NaN,240.41400089443994,179.67787938733312,0.12130401907173134,0.23139046325685086,0.11008644418511952,6315099,6104139,58.02281315874312,47.19498786321208,NaN,NaN,16.637144893526344,5.578642025004585
1995-01-18T09:30:00-05:00,47,47.07812,46.875,46.98437,84500,332210,67.14874963058952,56.517961584359355,NaN,NaN,184.53695990730614,205.7915881007807,0.12094834697595772,0.2612718779050667,0.14032353092910896,6230599,6168339,59.24285754289739,46.28904619260742,NaN,NaN,19.202664220976377,7.5249309101434125
1995-01-19T09:30:00-05:00,46.82812,46.875,46.6875,46.71875,139100,305385,60.034568001648886,56.96105665327148,NaN,NaN,111.1114778521069,214.15675414355786,0.09615455568136905,0.2605167255308203,0.16436216984945123,6091499,6196659,59.79793496914514,45.53777739047276,NaN,NaN,19.45868403370498,9.229752784937922
1995-01-20T09:30:00-05:00,46.65625,46.67187,46.45312,46.54687,78700,282095,55.906927193405814,57.747498787642634,NaN,NaN,58.4015876800723,177.02363880527545,0.06310626835126762,0.24324500528853576,0.18013873693726815,6012799,6175119,59.138221679652425,46.092137037115194,NaN,NaN,18.46233165617951,10.548692623686721
1995-01-23T09:30:00-05:00,46.23437,46.6875,46.20312,46.6875,53700,273680,58.42555658142539,58.45121378879397,NaN,NaN,45.98642678479951,128.09009062374497,0.046416494822822923,0.2381593554657968,0.19174286064297388,6066499,6143299,58.11817470517552,47.33776740430329,NaN,NaN,18.336690132602186,11.66126369638893
1995-01-24T09:30:00-05:00,46.67187,46.75,46.64062,46.75,32400,269010,59.531908636269,58.987690730117926,NaN,NaN,74.69319186631766,94.9459288181205,0.0357629596802109,0.2364465602432375,0.20068360056302662,6098899,6100059,56.68727984965614,48.9541078797414,NaN,NaN,18.541814770390285,12.64419956410341
1995-01-25T09:30:00-05:00,46.51562,47.04687,46.51562,46.875,15700,265035,61.72566902359491,59.68086484196515,NaN,NaN,83.15292651718414,74.6691221400961,0.03335839070217472,0.24238158894074502,0.2090231982385703,6114599,6076859,55.89215812757008,50.80812681318521,NaN,NaN,19.332479037630755,13.599668060321601
1995-01-26T09:30:00-05:00,46.84375,46.98437,46.75,46.92187,9800,247615,62.54554761065146,60.37644484375295,NaN,NaN,86.14946265487977,69.67671910065067,0.03118806079205455,0.24800827422863847,0.21682021343658392,6124399,6083439,56.080319194784536,52.88347977229069,NaN,NaN,20.21847787722355,14.545212319879022
1995-01-27T09:30:00-05:00,47.23437,47.23437,46.92187,47.10937,91200,241170,65.7100123879005,61.2395916828069,NaN,NaN,108.90095413073554,79.77659239078332,0.038181913835370784,0.2645476057307974,0.2263656918954266,6215599,6123999,57.289808990040264,54.519945935810306,NaN,NaN,21.897255156692015,15.595504153709449
1995-01-30T09:30:00-05:00,47.01562,47.04687,46.84375,46.90625,26600,132025,59.8142796229448,61.62089025785796,NaN,NaN,76.58306790283999,85.8959206143914,0.025537589735351002,0.25828767906461536,0.23275008932926436,6188999,6148499,58.041459961522634,55.78517823213925,NaN,NaN,21.671561103596023,16.463512289407532
1995-01-31T09:30:00-05:00,47,47.17187,46.92187,47.09375,127500,122185,63.10511160641557,62.19500194660395,NaN,NaN,94.04811125183387,89.76690449149464,0.02611752352741009,0.265396993738527,0.2392794702111169,6316499,6192019,59.4080313067476,56.811262883428526,NaN,NaN,22.441060798663674,17.317447790729837
1995-02-01T09:30:00-05:00,47.15625,47.32812,47,47.07812,380200,123605,62.64457957741227,62.71391491310199,NaN,NaN,100.62389350841123,93.26109788974006,0.02193295571165596,0.26669566485068685,0.2447627091390309,5936299,6156359,57.74833530913661,57.398823875300124,NaN,NaN,22.938899876945424,18.12051237447492
1995-02-02T09:30:00-05:00,47.0625,47.35937,47.0625,47.35937,131700,125700,67.27287799093895,62.90204515841241,NaN,NaN,117.09526096709023,99.45025755218215,0.03387765094298123,0.2871097728177574,0.2532321218747762,6067999,6145079,57.203930813598724,57.73432410697297,NaN,NaN,24.777112138659305,19.071455197929833
1995-02-03T09:30:00-05:00,47.65625,48.10937,47.57812,48.03125,405100,123535,75.18324430406948,63.394834839690525,NaN,NaN,223.32725219908852,122.33551716585275,0.08015757511261479,0.35342909076554463,0.27327151565292984,6473099,6196579,59.099725363099125,57.983646497983486,NaN,NaN,29.451374358078965,20.55430079223685
1995-02-06T09:30:00-05:00,48.01562,48.375,47.96875,48.23437,405400,141965,76.99367416329919,64.00305045218325,NaN,NaN,243.63308154073556,155.74551989343186,0.11543422207888032,0.4175642932515302,0.3021300711726499,6878499,6334479,63.732552548175164,58.391485025800066,NaN,NaN,33.85982856984109,22.455090474751742
1995-02-07T09:30:00-05:00,48.3125,48.3125,48.14062,48.29687,702900,165620,77.53670216702093,64.74504706192835,NaN,NaN,212.04558230405877,179.34501410387685,0.13272783010900618,0.46803985880890764,0.33531202869990145,7581399,6587459,70.36447085142348,59.18588597640911,NaN,NaN,37.481589806937414,24.601733236492553
1995-02-08T09:30:00-05:00,48.23437,48.46875,48.20312,48.29687,521500,180575,77.53670216702093,65.99519950231206,NaN,NaN,182.73279893656306,195.7667951895072,0.13355234065254085,0.5022524545155775,0.3687001138630367,7581399,6916479,76.40708178903549,60.37225360640128,NaN,NaN,40.31869094674546,26.847012909385825
1995-02-09T09:30:00-05:00,48.21875,48.29687,48.125,48.29687,390700,198095,77.53670216702095,67.54018342899886,NaN,NaN,139.64627465946955,200.27699792798307,0.12370672494658813,0.5233335200462719,0.39962679509968374,7581399,7219159,80.37199903769405,61.88895198911854,NaN,NaN,42.59556200684712,29.09680563759458
1995-02-10T09:30:00-05:00,48.23437,48.35937,48.09375,48.35937,148300,196980,78.17995923651684,68.95121219007682,NaN,NaN,120.15055521811466,179.64165853178832,0.11139605560571914,0.5388718646068327,0.42747580900111354,7729699,7470479,82.93622139425106,63.66166960976678,NaN,NaN,44.680986611146814,31.3231172052449
1995-02-13T09:30:00-05:00,48.32812,48.46875,48.32812,48.375,79700,195710,78.34695050559458,70.29514375217151,NaN,NaN,113.58805912806922,153.63265404925505,0.09494065598480783,0.5461516289821233,0.4512109729973155,7809399,7656659,84.54682273567958,65.65163695876846,NaN,NaN,46.456868467103405,33.485081671224684
1995-02-14T09:30:00-05:00,48.53125,48.53125,48.25,48.4375,170200,199745,79.03779591365424,71.5317242443186,NaN,NaN,99.62109933688951,131.1477574558212,0.07952478390414564,0.5506169528774976,0.47109216897335193,7979599,7736299,85.19073864466625,67.74439270998961,NaN,NaN,48.15996151867012,35.5814930780026
1995-02-15T09:30:00-05:00,48.4375,48.76562,48.39062,48.70312,431500,217095,81.70877258255905,72.90052602802629,NaN,NaN,105.83099423392157,115.7673965152929,0.07834998384061959,0.5690296487741264,0.49067966493350684,8411099,7902239,86.45701976326808,69.91415703630987,NaN,NaN,50.50471135275394,37.71338140296708
1995-02-16T09:30:00-05:00,48.64062,48.6875,48.5,48.64062,99300,215105,79.15310118262879,73.86074665622117,NaN,NaN,93.69443714600126,106.57702901259924,0.06504436946902581,0.5719851267697891,0.5069407573007633,8311799,8048319,87.47253033984087,72.07006570415277,NaN,NaN,51.766675774753026,39.720994884650786
1995-02-17T09:30:00-05:00,48.59375,48.625,48.4375,48.45312,49100,213625,71.88865330048333,74.72320191890249,NaN,NaN,76.70288762677309,97.88749549433093,0.03670744074155252,0.5528250582277039,0.5161176174861514,8262699,8154919,88.16966757901244,74.22208053397347,NaN,NaN,50.79031279429138,41.302326014599444
1995-02-21T09:30:00-05:00,48.45312,48.53125,48.42187,48.4375,168000,219340,71.30157203282448,75.3086633779317,NaN,NaN,67.33075687980515,88.63603504467811,0.011319960383588845,0.5302675679656375,0.5189476075820486,8094699,8211979,88.53737160246455,76.30274769795325,NaN,NaN,49.82260034421084,42.519508061686786
1995-02-22T09:30:00-05:00,48.48437,48.79687,48.45312,48.79687,386400,237040,76.13120237252562,76.27199357758265,NaN,NaN,84.80088777627437,85.67199273255508,0.013017176069991532,0.535219077669538,0.5222019015995465,8481099,8312279,89.17432861439683,78.54746150547183,NaN,NaN,50.33920801195164,43.636608054581764
1995-02-23T09:30:00-05:00,48.98437,49.15625,48.85937,48.875,402800,256395,77.03602516847847,76.96936123312119,NaN,NaN,109.77297222652594,86.46038833107595,0.013623835119004113,0.5392316954983016,0.5256078603792975,8883899,8406839,89.75247285142723,80.87235736531673,NaN,NaN,51.03233723100704,44.69314079407109
1995-02-24T09:30:00-05:00,48.9375,49.01562,48.8125,49,307600,271285,78.4439487128061,77.20226869088809,NaN,NaN,104.69818606272885,88.66113811442146,0.01647523475256063,0.5462019038199983,0.5297266690674377,9191499,8582779,90.7430557307302,83.13259524871896,NaN,NaN,52.034958552003175,45.7419719023471
1995-02-27T09:30:00-05:00,48.85937,49,48.53125,48.60937,280900,280770,65.02668673641995,76.34748387468244,NaN,NaN,74.21871710894278,88.1643040108554,-0.012359733170747011,0.514277002604004,0.526636735774751,8910599,8712359,91.40225169321292,85.10900233050737,NaN,NaN,48.540253353685465,46.14172639539544
1995-02-28T09:30:00-05:00,48.5625,49.01562,48.5625,49.01562,493500,304115,70.64926921839609,75.85552437835209,NaN,NaN,95.67158554151428,93.83246974319722,-0.00866033547064815,0.5158113164364408,0.524471651907089,9404099,8974239,92.55597979916189,86.69411011248869,NaN,NaN,47.34890102198877,46.3141799134802
1995-03-01T09:30:00-05:00,48.96875,49.03125,48.65625,48.70312,237900,309635,62.34600229308596,74.77047438735674,NaN,NaN,81.48941527858676,93.1701752436597,-0.0306121634462021,0.4862064475993364,0.5168186110455385,9166199,9111259,93.07926368621729,87.88498024800165,NaN,NaN,43.32911097286756,45.88774149339268
1995-03-02T09:30:00-05:00,48.6875,48.76562,48.54687,48.76562,488600,315055,63.27563271338264,73.75182656923971,NaN,NaN,55.62602724144002,82.34078624664252,-0.043489536387961936,0.462456690560586,0.505946226948548,9654799,9265439,93.62252334695181,88.8314462700915,NaN,NaN,40.53899912618784,45.12363544093485
1995-03-03T09:30:00-05:00,48.60937,48.78125,48.48437,48.78125,290000,322970,63.518203832264994,72.70455832607887,NaN,NaN,45.17130180135059,70.43540939436687,-0.052896176000168715,0.43982600694833707,0.4927221829485058,9944799,9416099,94.1091415472125,89.62951199530303,NaN,NaN,38.44096317609883,44.1689679745297
1995-03-06T09:30:00-05:00,48.45312,48.8125,48.39062,48.8125,85700,307000,64.02977220229332,71.68190273298592,NaN,NaN,35.32153473511696,62.65597291960171,-0.058516922614752054,0.4195760296800657,0.47809295229481774,10030499,9640079,94.75043755651839,90.35834162536295,NaN,NaN,36.90683133427324,43.13151988306449
1995-03-07T09:30:00-05:00,48.64062,48.75,48.21875,48.4375,180900,295775,54.2067184935942,69.90825434583877,NaN,NaN,-38.62918731592556,35.795818348113734,-0.08726265004050504,0.36901463974418647,0.4562772897846915,9849599,9729179,94.98435359938244,91.05788555069982,NaN,NaN,32.29455724997853,41.58338236405221
1995-03-08T09:30:00-05:00,48.51562,48.625,48.34375,48.5625,155900,268425,56.59699315585256,68.11455581535974,NaN,NaN,-30.832938421180184,13.331347608160339,-0.09688804776196003,0.3351672300822415,0.4320552778442015,10005499,9897039,95.40019745574125,91.69668395730505,NaN,NaN,29.25525083394537,39.822220716894094
1995-03-09T09:30:00-05:00,48.54687,48.59375,48.42187,48.54687,63500,245525,56.201962164499996,66.47518874263625,NaN,NaN,-32.67924298473605,-4.329706437074849,-0.10277846459672058,0.3035821970983008,0.4063606616950214,9941999,9954479,95.53656910389829,92.2726867261663,NaN,NaN,26.712917534477654,37.94946311940603
1995-03-10T09:30:00-05:00,48.59375,49.39062,48.53125,49.26562,192100,235595,67.45222517440456,66.1583010193449,NaN,NaN,169.553796251058,20.546792452866633,-0.0589184135211977,0.33271264479352425,0.39163105831472195,10134099,9992339,95.62856320194356,92.8054649849471,NaN,NaN,28.140058477850605,36.54811959918383
1995-03-13T09:30:00-05:00,49.23437,49.39062,49.17187,49.21875,261300,241245,66.25702206896472,65.79797602192635,NaN,NaN,214.84762808085267,56.45201112201378,-0.03490074212861577,0.3480051306539522,0.382905872782568,9872799,9960799,93.89241253533315,93.18796790872342,NaN,NaN,28.8366231677664,35.44647725183848
1995-03-14T09:30:00-05:00,49.35937,49.64062,49.35937,49.57812,223300,248425,70.56385404555645,65.40030828428569,NaN,NaN,237.94115631779127,111.76607984875713,0.0014258976680516233,0.38468824486763253,0.3832623471995809,10096099,10010099,94.07353220732462,93.53791102250398,NaN,NaN,30.945878388273723,34.80353455704351
1995-03-15T09:30:00-05:00,49.5,49.57812,49.29687,49.48437,278500,253840,68.12115119233161,64.76353157170377,NaN,NaN,176.19319243994957,153.17130602098308,0.014642948172714276,0.40156603241547373,0.38692308424275945,9817599,9972519,91.83783941992445,93.68686577739665,NaN,NaN,31.804547718801935,34.37510786586614
1995-03-16T09:30:00-05:00,49.4375,49.8125,49.4375,49.78125,20400,233285,71.48721493088374,64.26662201585218,NaN,NaN,187.8720366222426,197.28156194237883,0.03757821596493638,0.43389585419892995,0.3963176382339936,9837999,9951719,90.55506973840109,93.673438206516,NaN,NaN,33.67523305117327,34.27512574948145
1995-03-17T09:30:00-05:00,49.4375,49.625,49.40625,49.5625,89900,232815,65.96063639236776,64.33333270556273,NaN,NaN,130.7681093304958,189.5244245582664,0.032410419093675036,0.43683066210108734,0.4044202430074123,9748099,9874519,85.76673445684087,93.27090126106086,NaN,NaN,33.38319827720849,34.14770753915674
1995-03-20T09:30:00-05:00,49.625,49.625,49.46875,49.5625,91700,234945,65.96063639236776,63.99843036084642,NaN,NaN,117.30325013855114,170.01554896980608,0.023785314248586875,0.4341518858181459,0.410366571569559,9748099,9849579,84.21742709546123,92.67529035365365,NaN,NaN,33.156098409730944,34.006049092095914
1995-03-21T09:30:00-05:00,49.5625,49.875,49.35937,49.4375,104400,231765,62.74590512013973,64.02699484849312,NaN,NaN,102.91982664751072,143.01128303574995,0.005413958473328151,0.4171340196612192,0.41172006118789106,9643699,9759099,78.66549894227063,91.64573572908603,NaN,NaN,31.99425253794234,33.71864958435969
1995-03-22T09:30:00-05:00,49.53125,49.53125,49.32812,49.48437,74900,216190,63.464922672999435,64.04051555989432,NaN,NaN,73.33695448386544,122.44003544453312,-0.007147099367891485,0.4027861869780267,0.4099332863459182,9718599,9739299,77.4620487272273,90.49141611339142,NaN,NaN,31.25318687747504,33.36644062623331
1995-03-23T09:30:00-05:00,49.42187,49.65625,49.35937,49.51562,220500,207075,63.96431062724243,64.07238033096414,NaN,NaN,75.57066328357479,99.97976077679957,-0.016388445843693922,0.38944772904130076,0.4058361748849947,9939099,9759519,77.83496631585103,89.32897502543703,NaN,NaN,30.780695276736076,32.99704843344799
1995-03-24T09:30:00-05:00,49.67187,50.21875,49.67187,50.21875,134000,198395,72.9300448035855,64.7081140881993,NaN,NaN,141.56040200568071,102.13821931183654,0.019850549652649097,0.43064936195080605,0.41079881229815696,10073099,9824519,79.035828121955,88.20650292296821,NaN,NaN,33.30742081965893,33.041387345763845
1995-03-27T09:30:00-05:00,50.29687,50.42187,50.17187,50.42187,132100,190955,74.87479731407637,66.18440543251944,NaN,NaN,163.77083850414837,111.431736984956,0.05074132086698774,0.47422546338189164,0.4234841425149039,10205199,9915939,80.62570362985946,87.1808850680023,NaN,NaN,36.03831556361526,33.469519948314044
1995-03-28T09:30:00-05:00,50.29687,50.42187,50.23437,50.42187,121900,172375,74.87479731407637,67.48996287239257,NaN,NaN,147.11193617351802,120.27015889015745,0.06358228983323583,0.5029620048064487,0.4393797149732129,10205199,10028239,82.39220361273634,86.2517426506448,NaN,NaN,38.16592165498455,34.140434477838404
1995-03-29T09:30:00-05:00,50.375,50.89062,50.125,50.40625,246100,172785,74.39810692352705,68.78968749803735,NaN,NaN,145.78634710104512,134.7600374135934,0.06329509881251805,0.5184985884888604,0.4552034896763424,9959099,10076339,83.10284624553124,85.36361958933287,NaN,NaN,39.7366169891328,34.93988912230903
1995-03-30T09:30:00-05:00,50.51562,50.51562,50.10937,50.3125,298400,163275,71.45758772773667,69.07578482327537,NaN,NaN,116.32423968659407,142.91075269419724,0.04966415006701419,0.5172836772601102,0.46761952719309596,9660699,10020659,79.12193946055221,84.18457503637634,NaN,NaN,40.22153264398221,35.6944096254052
1995-03-31T09:30:00-05:00,49.92187,50.17187,49.54687,50.10937,541300,175840,65.4238591795174,69.01627318831484,NaN,NaN,61.41339295247718,126.88135088355655,0.021290578636073143,0.4942327504881874,0.47294217185211423,9119399,9829919,67.23921609607443,82.28077529071501,NaN,NaN,38.88794353825155,36.15062875581182
1995-04-03T09:30:00-04:00,50.09375,50.23437,50.0625,50.23437,193300,181220,67.2561235534902,68.78000672459584,NaN,NaN,85.11433211904591,111.15004960653604,0.006055970910606112,0.48051213549037186,0.47445616457976575,9312699,9651419,58.400012664038236,79.73266675190884,NaN,NaN,38.279221357438445,36.45471341318706
1995-04-04T09:30:00-04:00,50.25,50.5625,50.25,50.5625,66900,175520,71.52228568911174,69.02294490293727,NaN,NaN,111.63817790561227,104.0552979529549,0.012804713671253187,0.49046205666883225,0.47765734299757906,9379599,9486299,51.63758609141209,76.86122008558652,NaN,NaN,39.03264136427873,36.822988834771586
1995-04-05T09:30:00-04:00,50.45312,50.60937,50.42187,50.5625,107200,173085,71.52228568911175,69.02544995709641,NaN,NaN,109.07703509296182,96.71343555133825,0.012008739819966086,0.4926682677725367,0.4806595279525706,9379599,9370399,47.4815179877095,73.78453781767998,NaN,NaN,39.634885825840094,37.22468840492423
1995-04-06T09:30:00-04:00,50.6875,50.79687,50.59375,50.75,352500,187535,73.78572961000081,69.58438518692734,NaN,NaN,124.34168946407438,98.31692550683431,0.01846405164498971,0.5037395925088077,0.485275540863818,9732099,9384679,48.0364565905528,71.08951797008798,NaN,NaN,40.82640087611288,37.73921875795118
1995-04-07T09:30:00-04:00,50.85937,50.85937,50.46875,50.70312,361400,196000,72.23972178037336,70.0328912860706,NaN,NaN,108.31815830523163,107.6978785773852,0.01412626338422407,0.5029333700940981,0.48880710670987404,9370699,9434939,50.0374972666209,68.6480944108851,NaN,NaN,41.37263078188098,38.25827761851258
1995-04-10T09:30:00-04:00,50.625,50.79687,50.59375,50.79687,285400,197205,73.43829248870668,70.79663324096823,NaN,NaN,106.04023945412492,111.88306004440099,0.012193444566250544,0.5040489124176872,0.4918554678514367,9656099,9503619,52.71700270750002,66.79463039411577,NaN,NaN,42.17222487948661,38.81741294150887
1995-04-11T09:30:00-04:00,50.92187,50.9375,50.59375,50.625,250300,198555,67.66997268143842,71.09699395585673,NaN,NaN,94.82138806132865,108.51970207554427,-0.005109703630608808,0.4854683383131757,0.4905780419437845,9405799,9508859,52.92444228346164,65.04194421956109,NaN,NaN,41.23046699562078,39.162134949239146
1995-04-12T09:30:00-04:00,50.78125,50.79687,50.60937,50.79687,144400,191850,70.1914351628013,71.54178856553952,NaN,NaN,90.32120377951765,104.76853581285543,-0.009191287079971633,0.47908893309381995,0.4882802201737916,9550199,9542979,54.32947061529775,63.36298024095014,NaN,NaN,41.13310089792283,39.44370151333681
1995-04-13T09:30:00-04:00,50.89062,51.09375,50.85937,51.07812,243400,203000,73.79336199180705,71.6034540789839,NaN,NaN,123.0743428563902,104.51506649131859,0.0022294383298743226,0.4910670180861345,0.4888375797562602,9793599,9555279,54.85259286667078,61.63560629414412,NaN,NaN,42.147251836781074,39.82992298811456
1995-04-17T09:30:00-04:00,51.26562,51.3125,50.625,50.78125,178900,207450,64.88141496296723,70.88964105390468,NaN,NaN,100.95183376619268,103.0418015835108,-0.014131331841988337,0.47117341495377474,0.4853047467957631,9614699,9604079,56.95903041549919,59.94512963597554,NaN,NaN,40.18247688224426,39.88028783013309
1995-04-18T09:30:00-04:00,50.82812,50.82812,50.48437,50.60937,329500,219340,60.3379268175029,69.85129316129229,NaN,NaN,51.378254525174704,92.10940459772075,-0.03903856865584948,0.43650653597595124,0.4755451046318007,9285199,9529899,52.917319027405725,57.83978073702334,NaN,NaN,37.08371734202275,39.48077776040304
1995-04-19T09:30:00-04:00,50.60937,50.71875,50.29687,50.5625,223000,225270,59.122095852842065,68.76014951338622,NaN,NaN,23.911352692287494,77.92739752391253,-0.059930063728792726,0.4006325249708098,0.46056258869960254,9062199,9461179,49.41886266192991,55.43378190962325,NaN,NaN,34.22203972204438,38.72952946920895
1995-04-20T09:30:00-04:00,50.70312,50.78125,50.4375,50.64062,207900,231920,60.548993646285034,67.98096422185397,NaN,NaN,37.74106693362207,67.41137015473342,-0.06909624044467949,0.37419228814375316,0.44328852858843265,9270099,9405159,46.70795857851291,53.118497560906164,NaN,NaN,32.27061600500662,37.806827545751474
1995-04-21T09:30:00-04:00,50.65625,50.90625,50.65625,50.89062,145000,228145,64.78532905214976,67.93535492704201,NaN,NaN,85.0848433513167,59.813470253718705,-0.05930624427600162,0.3691557232434306,0.4284619675194322,9415099,9329459,43.254971934839496,51.405337263675094,NaN,NaN,31.82652331830596,36.95249837040212
1995-04-24T09:30:00-04:00,50.85937,51.48437,50.85937,51.48437,169000,229895,72.37307933047593,68.30085176825528,NaN,NaN,199.62342149001617,79.54778779848341,-0.01607560109730466,0.4083674661478014,0.42444306724510605,9584099,9323339,42.97834534093856,50.303789597739396,NaN,NaN,34.07696138154435,36.541707371993866
1995-04-25T09:30:00-04:00,51.40625,51.48437,51.3125,51.34375,293200,237950,68.6029163294022,68.09232538541889,NaN,NaN,197.74259700224587,108.82065629389763,-0.0009803682075005815,0.4232176069857303,0.4241979751932309,9290899,9324479,43.051405231855014,49.690490964913884,NaN,NaN,34.59278171566631,36.26328942108993
1995-04-26T09:30:00-04:00,51.25,51.42187,51.125,51.39062,204400,242075,69.17923023719263,67.92496428171037,NaN,NaN,156.39469440763,135.31732463696613,0.007656225781545067,0.43376825742016223,0.42611203163861716,9495299,9411099,48.45546159621425,49.76005836552137,NaN,NaN,35.182038201494784,36.10882496114777
1995-04-27T09:30:00-04:00,51.3125,51.54687,51.28125,51.51562,502200,254880,70.72270820282552,67.70617703834071,NaN,NaN,159.85497972671013,159.74010719558376,0.01676054949085687,0.44706271850218826,0.4303021690113314,9997499,9556579,56.00632919319197,50.329334979995586,NaN,NaN,36.149037733431626,36.1145696429026
1995-04-28T09:30:00-04:00,51.5,51.67187,51.17187,51.59375,130800,246500,71.67744120371795,67.66601414000819,NaN,NaN,140.8748225879083,170.89810304290208,0.022651438848631467,0.4586164675721207,0.43596502872348925,10128299,9699219,61.89971820782535,51.17663647579592,NaN,NaN,37.22820174335627,36.27365994296741
1995-05-01T09:30:00-04:00,51.54687,51.65625,51.45312,51.45312,518700,245370,67.41597831884968,67.23584884216126,NaN,NaN,130.16171453082205,157.00576165106324,0.012207020307270666,0.45122380410757756,0.4390167838003069,9609599,9704319,62.0952341862131,51.84651015284685,NaN,NaN,36.875969115050474,36.35970411040785
1995-05-02T09:30:00-04:00,51.5,51.64062,51.39062,51.5625,228400,247125,68.96165752213693,67.3281120450683,NaN,NaN,115.504409936476,140.55812423790925,0.007998692783290573,0.44901514977942014,0.44101645699612957,9837999,9813739,66.11311404565491,52.78855813586063,NaN,NaN,37.031667358299316,36.45569886010663
1995-05-03T09:30:00-04:00,51.73437,52.28125,51.73437,52.28125,724700,280015,76.76232779139858,67.79746151853952,NaN,NaN,187.9885768055766,146.8769007174986,0.04678997294034393,0.49950392317155945,0.4527139502312155,10562699,10027219,72.28552637829935,54.07113354750361,NaN,NaN,39.949005329771175,36.95474264148728
1995-05-04T09:30:00-04:00,52.34375,52.6875,52.125,52.25,311400,290225,75.86952078797238,67.94575857540848,NaN,NaN,191.57229496820588,153.22036376579777,0.06252917946942926,0.5308754245680021,0.4683462450985728,10251299,10077979,73.52056648680276,55.40456023465589,NaN,NaN,41.90072234815463,37.661311171011185
1995-05-05T09:30:00-04:00,52.46875,52.46875,52.07812,52.1875,314900,288345,74.01536585278019,68.59818363896655,NaN,NaN,150.15942442441212,155.07728413309852,0.060857898984659264,0.5444186188293969,0.48356071984473764,9936399,10039599,70.94619294520692,56.403643272492154,NaN,NaN,42.882465953867296,38.40719042570492
1995-05-08T09:30:00-04:00,52.14062,52.73437,52.09375,52.5625,183100,279430,77.55905596579095,69.8282642924157,NaN,NaN,158.70337126313711,160.78561547956153,0.07614319427961624,0.578739712694258,0.5025965184146417,10119499,10141579,73.5921925993444,57.880419956202054,NaN,NaN,44.933303722078456,39.33949232518685
1995-05-09T09:30:00-04:00,52.78125,52.84375,52.4375,52.51562,180600,274190,76.16072106842633,71.04530895067171,NaN,NaN,153.31530144054037,168.34779378037442,0.07415832057938565,0.5952944191388738,0.5211360985594882,9938899,10161759,74.09495401474769,59.64299790997476,NaN,NaN,46.122760638864754,40.30853065571227
1995-05-10T09:30:00-04:00,52.65625,52.67187,52.32812,52.57812,330300,278190,76.762241000685,72.20339804741457,NaN,NaN,126.37277693957098,156.0246338071733,0.06826424414604715,0.6064664037420471,0.5382021595959999,10269199,10103059,69.92470614692108,61.30133702200391,NaN,NaN,47.269167656516004,41.3029073701128
1995-05-11T09:30:00-04:00,52.65625,52.71875,52.48437,52.71875,351700,288555,78.1011784688196,73.15453014860528,NaN,NaN,120.21283736456333,141.75274228644477,0.06505941845279939,0.6195264326619991,0.5544670142091997,10620899,10176979,72.05749158505324,63.35865985416204,NaN,NaN,48.63667315334833,42.3505881962893
1995-05-12T09:30:00-04:00,52.51562,52.875,52.5,52.75,94600,281115,78.39902742695133,73.58495501263921,NaN,NaN,109.790665017666,133.67899040509556,0.05657950563936687,0.6251913962584084,0.5686118906190415,10715499,10332799,75.93205077125377,65.7124959563274,NaN,NaN,49.84057524380647,43.42058634593461
1995-05-15T09:30:00-04:00,52.89062,53,52.78125,53,147200,279530,80.66471764634424,74.44651224956365,NaN,NaN,115.50224326377509,125.03876480522312,0.05906895927839517,0.6424480897170355,0.5833791304386403,10862699,10481439,78.93298872791821,68.2754662060462,NaN,NaN,51.59096076992083,44.587782692218354
1995-05-16T09:30:00-04:00,52.98437,53.15625,52.89062,53.03125,221600,274135,80.9339227377815,75.28613314246286,NaN,NaN,112.2111604745275,116.81793661202057,0.05420855395776969,0.6511398228858525,0.5969312689280828,11084299,10710519,82.54517122583185,70.71044546530462,NaN,NaN,53.1019380650481,45.8040906026226
1995-05-17T09:30:00-04:00,53.03125,53.04687,52.78125,52.82812,189200,272445,73.74635364056276,75.50210781658696,NaN,NaN,90.81614086034664,109.7066093961757,0.029915053604689712,0.6343250859339449,0.6044100323292552,10895099,10835699,84.1449730815853,72.72034860018985,NaN,NaN,52.352057856051516,46.73951449596959
1995-05-18T09:30:00-04:00,52.73437,52.76562,52.0625,52.0625,577800,290940,54.206321835787044,74.2541707188776,NaN,NaN,25.081663066416603,90.68037453654634,-0.04125020898065923,0.5528472711034311,0.5940974800840904,10317299,10774979,80.30038572136087,74.03468199401381,NaN,NaN,44.57292611713524,46.430001870421826
1995-05-19T09:30:00-04:00,51.98437,52.1875,51.90625,52.09375,363900,301885,54.73353078141538,73.34828160906088,NaN,NaN,-9.925769457153468,66.73708764158246,-0.08711478407980944,0.4852039999843285,0.5723187840641379,10681199,10768119,79.85646168815653,75.30334110129549,NaN,NaN,38.781032462152616,45.33729195495479
1995-05-22T09:30:00-04:00,52.26562,52.75,52.23437,52.67187,216000,304235,63.179026804031786,72.93523655776764,NaN,NaN,48.60788265654703,53.358215520136845,-0.07961856357767427,0.4727955795920451,0.5524141431697194,10897199,10775019,79.97636841023561,76.2935735559084,NaN,NaN,36.49427732647442,44.07400415088617
1995-05-23T09:30:00-04:00,52.76562,53.15625,52.60937,53.15625,136800,296415,68.48451578887077,72.3439642718728,NaN,NaN,101.02738433311997,51.12146029185534,-0.04487059542337801,0.49632589889049683,0.5411964943138748,11033999,10764959,79.23580403856326,76.79002196021295,NaN,NaN,36.55262876062846,42.999521952277924
1995-05-24T09:30:00-04:00,53.25,53.42187,52.79687,53.125,370800,304735,67.80571094865557,71.76797785477875,NaN,NaN,114.56241731306581,55.87071558239917,-0.027667338534685615,0.5066123211455178,0.5342796596802034,10663199,10718579,75.75308143025651,76.9494873133168,NaN,NaN,36.36111619992145,42.05117827336986
1995-05-25T09:30:00-04:00,52.96875,53.21875,52.71875,53.17187,379900,298620,68.31300895691972,71.36066664793158,NaN,NaN,96.71587953985198,70.19755887708625,-0.01731409456439359,0.5126370414747115,0.529951136039105,11043099,10863739,78.88172918133745,77.51631133018327,NaN,NaN,36.37704999373075,41.2405885191357
1995-05-26T09:30:00-04:00,52.96875,52.98437,52.35937,52.5625,518600,318010,55.96558953695735,69.81827618872917,NaN,NaN,23.865876736981523,76.95588811591325,-0.053637281521306424,0.462904534137472,0.5165418156587784,10524499,10832399,76.58412308249675,77.73002065040843,NaN,NaN,31.998299879540546,39.9202615706221
1995-05-30T09:30:00-04:00,52.6875,52.82812,52.375,52.54687,61500,295150,55.68755832444224,68.35590742130174,NaN,NaN,4.6104434088882025,68.1564002663815,-0.07929887969975374,0.41741821603408624,0.49671709573384,10462999,10745559,70.45995605289514,77.47037793884753,NaN,NaN,28.571339234696396,38.29898695120414
1995-05-31T09:30:00-04:00,52.57812,53.64062,52.45312,53.64062,564500,311955,67.75830443016636,67.7127690948361,NaN,NaN,145.72121212123312,77.09516582400413,-0.025953999127481475,0.46427459682448813,0.4902285959519696,11027499,10744259,70.36923682504835,77.50213013014233,NaN,NaN,29.894941281609437,37.0984089984049
1995-06-01T09:30:00-04:00,53.40625,53.90625,53.25,53.5,810100,316225,65.29563404088279,66.79808734998349,NaN,NaN,185.25019694315253,91.23272175002148,-0.004601270344580355,0.48447700802124416,0.4890782783658245,10217399,10655099,64.25843098443619,76.94505437295541,NaN,NaN,29.981226453884684,36.08166863490201
1995-06-02T09:30:00-04:00,53.28125,53.92187,53.09375,53.54687,112900,306300,65.74255555778198,65.89405364504282,NaN,NaN,151.37471176849422,102.16448819574993,0.007555713176241763,0.49852291983612673,0.49096720665988497,10330299,10512539,55.89974883570603,75.51417566327343,NaN,NaN,30.19867391230391,35.241240817388
1995-06-05T09:30:00-04:00,53.54687,54.04687,53.5,53.875,257200,303415,68.77431534126995,65.04473919468037,NaN,NaN,180.31661325421624,133.45463549919685,0.0312438276800181,0.5300219912599076,0.49877816357988947,10587499,10525139,56.43908829609099,73.90746848957149,NaN,NaN,31.410756538012404,34.6940287774772
1995-06-06T09:30:00-04:00,53.82812,54.01562,53.78125,53.78125,165800,302550,66.95122424654949,64.04597501673523,NaN,NaN,164.0307336179708,165.33869354101338,0.03392305456909195,0.5411819817912544,0.5072589272221625,10421699,10516879,55.95596088696476,72.0082391796524,NaN,NaN,31.784583998213943,34.27839380901102
1995-06-07T09:30:00-04:00,53.67187,53.70312,53.4375,53.5,41900,295615,61.669693390993004,63.18335642748024,NaN,NaN,96.92806316883473,155.58006375053372,0.011250738741209299,0.5213223506486742,0.5100716119074649,10379799,10387339,48.888023472507136,69.48988563614684,NaN,NaN,30.410593522357864,33.725850910917714
1995-06-08T09:30:00-04:00,53.48437,53.64062,53.375,53.375,141100,286155,59.4259180862595,63.55618473108541,NaN,NaN,74.48405775350064,133.42683591260334,-0.016177045398610645,0.4898503051592016,0.5060273505578122,10238699,10391599,49.115649000811274,67.26240444182187,NaN,NaN,28.60329822821092,32.99405767053103
1995-06-09T09:30:00-04:00,53.26562,53.32812,52.75,53.0625,304900,283815,54.12412076863557,63.51265544445828,NaN,NaN,0.8275313535335241,103.31739982961119,-0.0570765963878192,0.4346816050730382,0.4917582014608574,9933799,10312299,45.09007750332806,64.77909128576269,NaN,NaN,25.38640260869473,31.907249804554414
1995-06-12T09:30:00-04:00,53.23437,53.57812,53.20312,53.35937,378500,298010,57.961181693258794,63.139952222260206,NaN,NaN,53.301889366517635,77.91445505207146,-0.06525730889142356,0.41018656534657794,0.4754438742380015,10312299,10257259,42.48718893144411,62.10129275156329,NaN,NaN,23.849529238623397,30.75614686656427
1995-06-13T09:30:00-04:00,53.60937,53.96875,53.5625,53.9375,120000,296650,64.23480905655813,62.83640174138073,NaN,NaN,113.84826509883084,67.87796134824347,-0.03440355010153989,0.43243943661107664,0.46684298671261654,10432299,10259379,42.624574979012834,59.48620496159541,NaN,NaN,24.581702807100328,29.87408342949799
1995-06-14T09:30:00-04:00,53.85937,53.95312,53.6875,53.89062,389400,305040,63.40846249850972,62.522312566370324,NaN,NaN,102.74494745098909,69.04133820467433,-0.020509411360338903,0.4412062225121929,0.4617156338725318,10042899,10191999,39.402870336178204,56.88976131201838,NaN,NaN,24.893792340007746,29.162613273856525
1995-06-15T09:30:00-04:00,53.96875,54.23437,53.875,54.125,274500,309305,65.77877173279624,62.34129562179008,NaN,NaN,121.88220711851636,78.52096807767748,0.00002251360747707043,0.4617437758818781,0.461721262274401,10317399,10207739,40.53359215168763,54.15060866704339,NaN,NaN,25.89829052072954,28.696281451981243
1995-06-16T09:30:00-04:00,53.70312,53.96875,53.70312,53.96875,325100,296670,62.85561186083673,62.83344007349575,NaN,NaN,86.83787400360971,95.7230366076927,-0.0012905883775252702,0.4601080268024944,0.4613986151800197,9992299,10219439,41.408781582995886,51.6380842742219,NaN,NaN,25.84079133497611,28.288354292409082
1995-06-19T09:30:00-04:00,54.125,54.60937,54.09375,54.57812,134600,285205,68.69793443514791,63.762752652831864,NaN,NaN,160.14349717210425,117.09135816881003,0.03263612621184686,0.5021937729448283,0.4695576467329814,10126899,10182359,39.42827329277922,49.42153550564219,NaN,NaN,27.721596061990105,28.207388830920657
1995-06-20T09:30:00-04:00,54.42187,54.60937,54.39062,54.4375,287800,288795,66.11368520074305,63.6452798507302,NaN,NaN,154.74590349134763,125.27088584731341,0.038934986661472604,0.5182263800598221,0.47929139339834953,9839099,10063719,33.84978833914178,46.81300347093458,NaN,NaN,28.419004869142974,28.237619693523843
1995-06-21T09:30:00-04:00,54.60937,54.65625,54.40625,54.40625,158200,289865,65.52378666760592,63.66157646692471,NaN,NaN,137.0822626648803,132.13834889009163,0.03447804388503556,0.522388948254644,0.48791090436960843,9680899,9991319,30.970113714842412,44.435266523106456,NaN,NaN,28.79927179270327,28.31785570769233
1995-06-22T09:30:00-04:00,54.64062,55.15625,54.64062,55.125,297000,286175,71.76402596290762,64.09168149586225,NaN,NaN,178.2693995875041,143.41578738388918,0.07129787775317986,0.5770332515610832,0.5057353738079033,9977899,9923419,28.519653799267715,42.47954544907515,NaN,NaN,31.240850845455338,28.735426441658475
1995-06-23T09:30:00-04:00,55,55.03125,54.84375,55.01562,315400,282950,69.69656275502382,64.15755631113038,NaN,NaN,156.38702662369462,157.32561790790618,0.0790472148020328,0.6045443923104443,0.5254971775084115,9662499,9857459,26.339403780661655,40.32956798368733,NaN,NaN,32.53362774832711,29.278026628325424
1995-06-26T09:30:00-04:00,54.85937,54.95312,54.35937,54.35937,132900,263665,58.75898059313091,63.57239605017191,NaN,NaN,93.82359873247712,144.06163821998075,0.03308936417628394,0.5668588827287664,0.5337695185524824,9529599,9737999,22.921693139804688,37.96997743031875,NaN,NaN,29.981596147896962,29.378536559692787
1995-06-27T09:30:00-04:00,54.34375,54.70312,54.21875,54.25,127700,266975,57.1493189102123,63.24951215868758,NaN,NaN,61.1074483204512,125.33394718580146,-0.009296738096861823,0.5221485959314052,0.531445334028267,9401899,9650559,20.79475223917086,35.96331519936616,NaN,NaN,27.448600203215545,29.102831365910323
1995-06-28T09:30:00-04:00,54.25,54.75,54.07812,54.53125,212600,249380,60.17093618164112,63.30272773692912,NaN,NaN,62.17368532067813,110.35223171696103,-0.02227254319088634,0.5036046550396591,0.5258771982305455,9614499,9637279,20.483871806818485,33.9181882569381,NaN,NaN,26.297354755865783,28.702048993046816
1995-06-29T09:30:00-04:00,54.53125,54.67187,54.0625,54.4375,89200,213335,58.685426725983554,63.62853530531112,NaN,NaN,47.52025836217845,84.20240347189588,-0.04001519094105621,0.4758582095542252,0.5158734004952814,9525299,9546759,18.45823759868091,32.01591397803474,NaN,NaN,24.917822648637024,28.161445229559703
1995-06-30T09:30:00-04:00,54.54687,54.73437,54.29687,54.40625,714100,243395,58.169900926159606,63.643443821946896,NaN,NaN,54.459939077294,63.81698596261575,-0.055735697702613884,0.4462037783670141,0.501939476069628,8811199,9376499,15.377897305256539,30.079536004735626,NaN,NaN,23.655425280136477,27.517728093927815
1995-07-03T09:30:00-04:00,54.46875,54.60937,54.46875,54.60937,9500,231010,60.593050931393556,63.38331824157799,NaN,NaN,60.88852022340749,57.22997026080183,-0.054280691928367486,0.43408861115916864,0.4883693030875361,8820699,9234719,13.376080363392589,27.99035781790561,NaN,NaN,23.270440686416244,26.91097274999759
1995-07-05T09:30:00-04:00,54.76562,55.0625,54.64062,54.8125,409300,243185,62.90717872178703,63.34751225752637,NaN,NaN,92.76597263208764,63.56167512312915,-0.04201232659520865,0.4358538948435253,0.477866221438734,9229999,9200339,12.936322296445312,26.099890100781835,NaN,NaN,23.605320979375488,26.43873678276586
1995-07-06T09:30:00-04:00,54.82812,55.51562,54.71875,55.51562,202500,251215,69.56872111037514,63.618222927353436,NaN,NaN,142.30640043606405,79.58821814620633,0.008394463359323867,0.4883593006378888,0.4799648372785649,9432499,9163939,12.46891674588241,24.09527042893861,NaN,NaN,26.07946881940928,26.387412788000635
1995-07-07T09:30:00-04:00,55.40625,55.78125,55.375,55.76562,481700,268245,71.52674204967059,64.23758936941299,NaN,NaN,190.71607370762547,108.22738121529574,0.0511270792707027,0.5438736863669433,0.49274660709624063,9914199,9241719,19.188001567438235,22.508071856398775,NaN,NaN,28.762707216674105,26.726740563525418
1995-07-10T09:30:00-04:00,55.8125,55.95312,55.70312,55.79687,400400,273020,71.7712446899879,64.457111530473,NaN,NaN,197.95665221879347,136.92672384359562,0.072732914311197,0.5836627499852369,0.5109298356740399,10314599,9542399,38.75894529441804,22.460262713658693,NaN,NaN,30.973985147522747,27.333489789810752
1995-07-11T09:30:00-04:00,55.75,55.79687,55.45312,55.53125,420500,275120,66.5408979371577,64.48762672593118,NaN,NaN,138.7187524818523,152.4927702952846,0.060852955939197706,0.5869960305980371,0.5261430746588394,9894099,9757079,48.37258851479035,23.497605583347877,NaN,NaN,31.30500390940773,27.90084894975318
1995-07-12T09:30:00-04:00,55.64062,56.3125,55.53125,56.21875,203400,279290,72.18998037790949,64.9637834195243,NaN,NaN,167.01095005219423,167.34176577930592,0.08929471357443575,0.637761466626884,0.5484667530524483,10097499,9930579,54.5784221830389,25.183913331076194,NaN,NaN,33.48331491781568,28.698344088047822
1995-07-13T09:30:00-04:00,56.14062,56.26562,56.03125,56.09375,215600,270600,69.87984434666816,64.82919901836433,NaN,NaN,154.79169908457553,169.83882550900822,0.089463005142008,0.6602955094799583,0.5708325043379503,9881899,10020459,57.43299510498395,27.249151995770212,NaN,NaN,34.49927347509581,29.527048286197534
1995-07-14T09:30:00-04:00,55.79687,56.09375,55.75,56.04687,543700,284060,68.98818772331215,64.77860080181351,NaN,NaN,117.39856496402474,155.17532376028808,0.07668274541656506,0.6666859361086566,0.5900031906920915,9338199,9905259,52.84855657045287,29.14266290932673,NaN,NaN,35.046783865645665,30.31558194040441
1995-07-17T09:30:00-04:00,56.125,56.42187,56.07812,56.35937,171500,276380,71.5904834927001,65.6951367232113,NaN,NaN,133.01008470026935,142.18601025658322,0.07921656346363992,0.6890238950216414,0.6098073315580015,9509699,9744279,47.18099890088951,30.875470463689933,NaN,NaN,36.30963379118056,31.17187506194386
1995-07-18T09:30:00-04:00,56.26562,56.26562,55.82812,55.875,221200,280710,62.79488000803685,66.09839108734164,NaN,NaN,88.52417042722499,132.14709384565776,0.0401811895081956,0.6600338184432459,0.6198526289350503,9288499,9623159,43.409002684801,32.49077406694923,NaN,NaN,34.63430100113033,31.6665073389705
1995-07-19T09:30:00-04:00,55.65625,55.71875,54.20312,55.26562,486600,290650,53.833788111749946,65.64573765377797,NaN,NaN,-14.568863921660121,95.83113105088688,-0.030932077072259867,0.5811875325947256,0.6121196096669854,8801899,9364039,36.657023809772554,33.64599921001737,NaN,NaN,30.087138224670866,31.440883179784837
1995-07-20T09:30:00-04:00,55.32812,55.57812,55.03125,55.46875,318900,298685,56.08353976342387,65.4598885850237,NaN,NaN,14.431841015198215,67.75915943701139,-0.06650027986572282,0.5289942598348318,0.5954945397005547,9120799,9211819,33.373029712590466,34.71134150386806,NaN,NaN,27.15524856649707,30.82864966360087
1995-07-21T09:30:00-04:00,55.42187,55.625,55.1875,55.40625,94000,288535,55.19233047662204,65.24720498148531,NaN,NaN,17.576609043010475,47.79476825280858,-0.09472529978616095,0.4770879149678535,0.5718132147540145,9026799,9149539,32.10570207149851,35.90618470145677,NaN,NaN,24.553179209602703,29.932153884458277
1995-07-24T09:30:00-04:00,55.48437,55.875,55.48437,55.8125,108400,278185,59.677601440244516,65.18181573211753,NaN,NaN,50.26608194730928,31.245967702216568,-0.08673772472532038,0.463391058847364,0.5501287835726844,9135199,9074639,30.600682055836458,37.13651339377419,NaN,NaN,23.701653755618597,29.04208243748118
1995-07-25T09:30:00-04:00,55.875,56.3125,55.70312,56.23437,107400,276910,63.737069915520536,65.24109367452706,NaN,NaN,85.23310459597954,30.58775453596748,-0.05527699383956941,0.4810325412732226,0.536309535112792,9242599,9065459,30.41250880014246,38.38481242975256,NaN,NaN,24.28021389396926,28.361815502693762
1995-07-26T09:30:00-04:00,56.20312,56.46875,56.17187,56.1875,167800,278915,62.97846460684353,64.77036106713196,NaN,NaN,100.0371281874762,53.50895295779475,-0.04054087142033003,0.48563344583737944,0.5261743172577095,9074799,9120039,33.04860909536971,39.85479045471594,NaN,NaN,24.50909540626009,27.81142691748895
1995-07-27T09:30:00-04:00,56.45312,56.70312,56.45312,56.65625,187700,277670,67.18502279342562,64.46023826311445,NaN,NaN,131.0019887945973,76.82298251367456,-0.004061836801688257,0.5210970212555992,0.5251588580572875,9262499,9148379,34.43740329642549,40.94403343535788,NaN,NaN,26.048853719909093,27.559630746406114
1995-07-28T09:30:00-04:00,56.70312,56.70312,56.25,56.29687,415600,293990,61.42268663827073,63.721055545134654,NaN,NaN,101.18881991939807,93.54542468895208,-0.008707121509757165,0.514274956170091,0.5229820776798482,8846899,9112399,33.4876539354146,40.56751262400049,NaN,NaN,25.52356037761526,27.268763550864563
1995-07-31T09:30:00-04:00,56.34375,56.39062,56.03125,56.15625,342500,275410,59.28022127367368,63.20243578345721,NaN,NaN,65.25776910741585,96.5437621209734,-0.024904221933035542,0.4918518002635537,0.5167560221965892,8504399,8986239,30.329132645640797,39.278694347632666,NaN,NaN,24.438235762022924,26.8644024381729
1995-08-01T09:30:00-04:00,56.23437,56.23437,55.75,56.0625,141000,281985,57.83191165287514,62.176859445954754,NaN,NaN,31.85466745462209,85.86807469270191,-0.044444802219596236,0.461200019422094,0.5056448216416902,8363399,8810399,26.56784845118807,37.27793908107189,NaN,NaN,23.125529087905036,26.33027767384892
1995-08-02T09:30:00-04:00,56.39062,56.79687,55.84375,55.9375,240400,273540,55.87185724166287,61.17628893845438,NaN,NaN,57.883439774871675,77.437337010181,-0.06694966470237362,0.42195774076372317,0.4889074054660968,8122999,8620039,23.21180364096749,34.833568262213575,NaN,NaN,21.46858539663817,25.635750205675954
1995-08-03T09:30:00-04:00,55.54687,55.95312,55.45312,55.92187,1193600,323095,55.61802325136752,60.22127719045833,NaN,NaN,-33.23108832826888,44.59072158560777,-0.08300041003907055,0.38515689291725863,0.4681573029563292,6929399,8153419,17.40719948386203,32.30204275602851,NaN,NaN,20.039476444973026,24.836282525575538
1995-08-04T09:30:00-04:00,56.03125,56.07812,55.92187,55.98437,240500,311035,56.46966011098162,59.14121837747844,NaN,NaN,11.462500872895204,26.64545777630719,-0.08898918439466652,0.35692082246299606,0.4459100068576626,7169899,7818019,14.584091483715781,29.973692226230387,NaN,NaN,19.05981048639827,24.0110722342645
1995-08-07T09:30:00-04:00,56.10937,56.28125,56.07812,56.10937,193100,300670,58.19735194680838,58.81282351596212,NaN,NaN,45.35751906422121,22.66540776766826,-0.08416594048387943,0.3407025812528133,0.4248685217366927,7362999,7589739,13.034610873465454,27.804092811134996,NaN,NaN,18.66627648036186,23.24752998370698
1995-08-08T09:30:00-04:00,56.14062,56.3125,55.9375,56.10937,951900,327240,58.19735194680838,59.12450664703772,NaN,NaN,33.14940267261939,22.924354811267712,-0.08060415217698969,0.3241133315154556,0.4047174836924453,7362999,7389659,11.846598574359987,26.031919580034096,NaN,NaN,18.3360734943185,22.54589334236577
1995-08-09T09:30:00-04:00,56.29687,56.29687,56.04687,56.09375,107100,322425,57.86451850976641,59.25171941463362,NaN,NaN,37.540282713455944,18.85572339898456,-0.07883285337425816,0.3061764169746226,0.38500927034888077,7255899,7216239,10.91776718890749,24.427972256913883,NaN,NaN,17.97325252155996,21.89265893939351
1995-08-10T09:30:00-04:00,56.15625,56.28125,55.73437,55.96875,280800,325685,55.146482484104276,59.248444558025206,NaN,NaN,1.712357849475487,25.844412634533434,-0.08507735316466059,0.278662578893055,0.3637399320577156,6975099,7225379,11.31244036573267,22.94273927793061,NaN,NaN,16.980376043140677,21.19090423992882
1995-08-11T09:30:00-04:00,55.92187,55.98437,55.42187,55.65625,257200,311360,48.95538012814448,58.48257160716092,NaN,NaN,-67.55032969104944,10.041846521744507,-0.1077905566924161,0.22900173619219544,0.33679229288461154,6717899,7134979,10.802658835887001,21.528594762219935,NaN,NaN,14.404708134228692,20.22144765340023
1995-08-14T09:30:00-04:00,55.79687,56.15625,55.67187,56.15625,254800,315525,57.22913847502675,58.017719361411366,NaN,NaN,8.547232960831495,2.6797893010665637,-0.08753783267588477,0.22737000203975555,0.3149078347156403,6972699,7056919,10.368173763118648,20.09685654528966,NaN,NaN,14.35018743531707,19.382696193674064
1995-08-15T09:30:00-04:00,56.14062,56.14062,55.65625,56.04687,44400,306685,55.12416101908328,57.45669767657135,NaN,NaN,-2.3451453954884705,-4.419120312555008,-0.08010627047137281,0.2147749966264243,0.2948812670977971,6928299,6969979,9.891017171375466,18.442742836432927,NaN,NaN,13.69880571990969,18.570711840279152
1995-08-16T09:30:00-04:00,56,56.20312,55.9375,56.20312,374900,301100,57.5274467122628,56.76687081363115,NaN,NaN,31.55842323631419,-5.615492207983347,-0.06396587444016621,0.2149239240475893,0.2788897984877555,7303199,6979439,10.374350961977825,16.72395338397238,NaN,NaN,13.833724836311855,17.893999411140967
1995-08-17T09:30:00-04:00,56.23437,56.23437,55.90625,56.10937,353800,302845,55.60333794937142,56.35120305013834,NaN,NaN,13.144264600042293,-3.329110857869984,-0.05902168110283845,0.20511269710920743,0.2641343782120459,6949399,6974299,10.34189191744666,15.07068466840324,NaN,NaN,13.409676735226398,17.253381886010313
1995-08-18T09:30:00-04:00,56.39062,56.40625,56.125,56.17187,85400,302415,56.644438691941446,56.1629328657289,NaN,NaN,62.03892745341919,22.58874057102374,-0.05124820117056633,0.20007412674883795,0.2513223279194043,7034799,7037679,13.918397744671154,13.898489318333976,NaN,NaN,13.337714126349814,16.694000777487386
1995-08-21T09:30:00-04:00,56.40625,56.64062,56,56.01562,266700,310330,53.280592172242685,55.83783861711229,NaN,NaN,49.38238611471174,30.755771201799792,-0.05595218681929787,0.18138209439528197,0.23733428121457983,6768099,6996759,13.542780704434065,12.968127336422977,NaN,NaN,12.353963272147189,16.073995419581642
1995-08-22T09:30:00-04:00,56.09375,56.21875,55.8125,56.125,220200,315970,55.28256578025318,55.79574636986873,NaN,NaN,-27.029016183770914,25.818997044143305,-0.05115080307323336,0.17339577737303813,0.2245465804462715,6988299,7008759,14.27341803122144,12.329671221441117,NaN,NaN,12.053367892370783,15.49962005855152
1995-08-23T09:30:00-04:00,56.17187,56.20312,55.92187,55.92187,176500,316405,50.91881315010264,55.46008850549267,NaN,NaN,-38.7264642433373,11.762019548213008,-0.06047040950271512,0.1489585685678776,0.20942897807059271,6811799,6910479,13.283325058729815,12.035108762503103,NaN,NaN,10.569626488312323,14.795335262803063
1995-08-24T09:30:00-04:00,55.9375,56.09375,55.75,55.98437,167400,315390,52.16983373256313,55.15295804989135,NaN,NaN,-66.38294711415872,-4.143422794627196,-0.06106251950117941,0.13310082869411843,0.19416334819529785,6979199,6916439,13.674394087921243,11.97013037708921,NaN,NaN,9.658229899308063,14.061463068018062
1995-08-25T09:30:00-04:00,56.07812,56.39062,56.07812,56.29687,195000,304360,57.942162110437,55.13473020443625,NaN,NaN,115.45328484852749,6.539448684394463,-0.04005977464381219,0.14408862989053262,0.1841484045343448,7174199,6944319,15.592026981173618,12.152802956211222,NaN,NaN,10.498129294936314,13.55241538614924
1995-08-28T09:30:00-04:00,56.45312,56.45312,56,56.09375,293000,301885,53.42868759316917,54.79411132203346,NaN,NaN,73.66887062410042,11.3967455862722,-0.039437151203478515,0.13485196552999668,0.1742891167334752,6881199,6966939,17.199135564516126,12.53512702693666,NaN,NaN,9.90464288962122,13.03130502950238
1995-08-29T09:30:00-04:00,56.15625,56.25,55.76562,56.23437,1133100,351490,55.98490078734153,54.65985291328882,NaN,NaN,13.975023644356371,19.597553551897658,-0.029594462982770825,0.13729603800501167,0.1668905009877825,8014299,7172139,30.185228574718778,13.911374268780325,NaN,NaN,10.151132598055534,12.619851825009974
1995-08-30T09:30:00-04:00,56.28125,56.42187,56.21875,56.35937,437400,361340,58.182191248050145,54.87668925357067,NaN,NaN,148.9236483324051,57.12757606704613,-0.015418166902207375,0.14761779236002326,0.16303595926223063,8451699,7500119,45.02597816777123,16.31948411178308,NaN,NaN,11.000694825574573,12.388543682233488
1995-08-31T09:30:00-04:00,56.34375,56.5,56.29687,56.40625,491900,326255,59.0086856238899,55.59478250326678,NaN,NaN,170.9257679882956,104.589319087537,-0.00421908901307072,0.15776209799589225,0.16198118700896297,8943599,7892999,56.85686841254031,19.609070510115455,NaN,NaN,11.939024757687225,12.324326693012592
1995-09-01T09:30:00-04:00,56.39062,56.75,56.34375,56.65625,629900,345725,63.18713666660116,56.02035380266495,NaN,NaN,222.8173349815771,126.06212911414691,0.017499112055360616,0.18385507707816373,0.16635596502280312,9573499,8372859,66.37516765606958,23.609570073897665,NaN,NaN,14.014144924445898,12.565729297503065
1995-09-05T09:30:00-04:00,56.82812,57.21875,56.73437,57.1875,272200,349680,70.15030623998913,57.09364988987251,NaN,NaN,310.2493279415502,173.37822057763685,0.06258082568830842,0.24458199713318862,0.1820011714448802,9845699,8965759,74.00600645960134,28.189212165913798,NaN,NaN,18.341259948765213,13.39080510482623
1995-09-06T09:30:00-04:00,57.23437,57.35937,57.21875,57.29687,214500,312810,71.35171276918445,58.08109746536691,NaN,NaN,279.3484038058404,226.45289660993367,0.09287704807566183,0.2980974815394575,0.20522043346379565,10060199,9374939,77.75756784796899,33.002299086341736,NaN,NaN,22.22941520893838,14.653463691127966
1995-09-07T09:30:00-04:00,57.35937,57.39062,57.25,57.32812,258800,320395,71.70217375359081,59.23101430852544,NaN,NaN,212.4615635394398,239.16047965134058,0.10712071147606078,0.33912132280887164,0.23200061133281086,10318999,9748399,80.52083996398221,38.015081089665706,NaN,NaN,25.44939773108262,16.19573998255006
1995-09-08T09:30:00-04:00,57.54687,57.54687,57.17187,57.54687,107300,311720,74.09145241787837,60.47722957466379,NaN,NaN,181.23147850391805,241.2216217544651,0.12227792771726942,0.38484802097939763,0.2625700932621282,10426299,10044939,82.39147176022382,42.906014947919466,NaN,NaN,28.978127585972512,18.021795354467553
1995-09-11T09:30:00-04:00,57.64062,57.8125,57.64062,57.70312,260700,311895,75.67155310491516,62.07658392699754,NaN,NaN,181.6298864809073,232.98413205433113,0.13294587473900404,0.42875243668588325,0.2958065619468792,10686999,10267639,83.66051946745182,47.914424859563596,NaN,NaN,32.4433011502904,20.082010468156533
1995-09-12T09:30:00-04:00,57.71875,57.96875,57.57812,57.96875,139500,306130,78.1151372644826,63.707481890156785,NaN,NaN,160.22496186943172,202.97925883990743,0.14691816890240533,0.47945427307488586,0.33253610417248053,10826499,10463799,84.70607874405137,52.9453291961943,NaN,NaN,36.249794280554674,22.391693869927696
1995-09-13T09:30:00-04:00,57.90625,58.3125,57.89062,58.23437,239800,315900,80.25123532004714,65.80265490229569,NaN,NaN,160.9585649972062,179.30129107818058,0.16189361868814206,0.5349031275326581,0.37300950884451606,11066299,10665019,85.71582217759092,58.11907899039867,NaN,NaN,40.231535451911604,24.940242667353967
1995-09-14T09:30:00-04:00,58.4375,58.8125,58.28125,58.76562,457600,320035,83.6818447197077,68.05351282994886,NaN,NaN,172.10318891735733,171.22961615376408,0.19329568689525617,0.6146291174635863,0.4213334305683301,11523899,10905999,86.83668389711276,63.34495683391235,NaN,NaN,45.10465871223885,27.82087353090895
1995-09-15T09:30:00-04:00,58.40625,58.57812,58.20312,58.4375,431200,323905,75.01434022843627,69.27295412409167,NaN,NaN,130.57763830926464,161.0988481148334,0.1780639472624173,0.6439133646463517,0.4658494173839344,11092699,11039279,87.42443436648935,68.47584307572062,NaN,NaN,46.11126599525235,30.433786740100864
1995-09-18T09:30:00-04:00,58.23437,58.26562,57.9375,58.21875,307500,335010,69.82208885891421,70.44391135735917,NaN,NaN,95.65037722937636,143.9029462645272,0.14097540742058756,0.6420686766596688,0.5010932692390813,10785199,11058919,87.51291534418773,73.49825591712572,NaN,NaN,45.126030315441014,32.53267867943517
1995-09-19T09:30:00-04:00,58.32812,58.53125,58.125,58.5,549600,349155,72.46135472160886,71.62080092409256,NaN,NaN,103.769813557614,132.6119166021637,0.12371921162769328,0.6557422837736979,0.5320230721460046,11334799,11160579,87.98418442137839,77.62675276331571,NaN,NaN,45.20374464050196,34.34283095958757
1995-09-20T09:30:00-04:00,58.59375,58.78125,58.54687,58.78125,290800,352685,74.83180434351262,72.81005900233988,NaN,NaN,116.89225261485613,123.79865412569366,0.11951616205717441,0.6814182747174726,0.5619021126602982,11625599,11272439,88.49854770873478,80.73193630195594,NaN,NaN,46.06918037176006,36.01802373275507
1995-09-21T09:30:00-04:00,58.70312,58.75,58.0625,58.29687,508500,369285,64.52969560568499,73.20441685818238,NaN,NaN,82.59347351328974,105.89671104488013,0.0745817830033848,0.6551293414145292,0.5805475584111444,11117099,11191079,85.62743365199827,82.78697667620295,NaN,NaN,43.12704532368008,37.03359824574436
1995-09-22T09:30:00-04:00,57.82812,58.375,57.78125,58.3125,449900,383410,64.69858000989834,73.31237709698932,NaN,NaN,58.768569109003636,91.53489720482793,0.03821281324266845,0.6283135749644799,0.5901007617218115,11566999,11285939,86.1899889155828,84.20232105188246,NaN,NaN,40.941719466927545,37.591901277341954
1995-09-25T09:30:00-04:00,58.375,58.375,58.01562,58.21875,130000,380160,62.76812032792836,72.7850781032707,NaN,NaN,56.916273927897855,83.78807654453223,0.002051526779606405,0.5926651701963195,0.5906136434167131,11436999,11416299,86.94615177816654,85.1266171460657,NaN,NaN,38.58213161854085,37.733362754656085
1995-09-26T09:30:00-04:00,58.39062,58.53125,58.0625,58.20312,466600,388840,62.433650382108546,72.14807364705099,NaN,NaN,57.445212551468444,74.52315634330311,-0.027103193372957413,0.5567346517005163,0.5838378450734737,10970399,11343419,84.17133551980302,85.58474340833956,NaN,NaN,36.60041829901869,37.571513546707884
1995-09-27T09:30:00-04:00,57.95312,58.1875,57.59375,58.15625,654400,364905,61.377447235514815,71.41059318147414,NaN,NaN,23.558141667028558,55.8563341537376,-0.05226988505311736,0.518500488757077,0.5707703738101944,10315999,11081499,74.91768305877525,85.18451791511049,NaN,NaN,34.671823605187626,37.1572721264907
1995-09-28T09:30:00-04:00,58.20312,58.59375,58.15625,58.59375,456200,365845,66.99090140222162,70.90341096607007,NaN,NaN,71.66033847583167,53.66970714624599,-0.04258718271936135,0.5175363954109926,0.560123578130354,10772199,11012519,72.65232075408667,84.48886427181499,NaN,NaN,34.58178370325836,36.78934520888608
1995-09-29T09:30:00-04:00,58.54687,58.90625,58.40625,58.48437,606600,371580,64.46812483100709,70.10316608936236,NaN,NaN,88.31203009063049,59.57839934257136,-0.046372677803556916,0.5021577308759078,0.5485304086794647,10165599,10732239,64.16267798698897,83.09616130892478,NaN,NaN,33.75495439124226,36.355860806365534
1995-10-02T09:30:00-04:00,58.48437,58.625,58.04687,58.1875,293100,354740,58.07563545584593,68.67177310303117,NaN,NaN,37.90080383287214,55.775305323566215,-0.07026081727567812,0.46070438708486705,0.5309652043605452,9872499,10419339,56.25898671342506,81.06422616388002,NaN,NaN,31.05968488558495,35.59926424625402
1995-10-03T09:30:00-04:00,58.1875,58.34375,57.95312,58.25,839700,383115,58.99743064417797,67.15364419761194,NaN,NaN,12.203830614257551,46.727028936124036,-0.08240235659176609,0.4279622586208376,0.5103646152126037,10712199,10367699,55.05367560467777,78.87407283724338,NaN,NaN,29.132725303902973,34.6754729687753
1995-10-04T09:30:00-04:00,58.28125,58.28125,58.10937,58.1875,248800,384830,57.63277780246351,65.29299656066593,NaN,NaN,5.940628022066634,43.203526207131645,-0.09433427128387428,0.3924467761077608,0.4867810473916351,10463399,10397179,55.63798709446337,76.645594494197,NaN,NaN,27.15071565804176,33.600507638670514
1995-10-05T09:30:00-04:00,58.25,58.35937,58.09375,58.35937,268800,385330,60.34889861678294,64.2454650169764,NaN,NaN,16.507466787991216,32.17295186956356,-0.09033735388300446,0.3738593550378795,0.46419670892088394,10732199,10389179,55.42740473872448,74.36009237792807,NaN,NaN,26.20439861360372,32.54392063508954
1995-10-06T09:30:00-04:00,58.39062,58.57812,58.39062,58.40625,75300,383730,61.08179752676036,63.62115849325113,NaN,NaN,67.97149149310361,28.104844150058234,-0.08433675083146275,0.3587757703815555,0.44311252121301825,10807499,10517559,58.163894854819496,72.26373377154464,NaN,NaN,25.6183062987827,31.55454715847428
1995-10-09T09:30:00-04:00,58.1875,58.21875,57.8125,57.92187,358200,388605,50.662096425216546,62.0640686149374,NaN,NaN,-113.93794273168515,-2.2629051628532295,-0.11110638952446372,0.3042295343074386,0.4153359238319023,10449299,10632919,60.51004172787466,70.30129500772294,NaN,NaN,21.8473396720732,30.167803231845554
1995-10-10T09:30:00-04:00,57.32812,57.89062,57.26562,57.89062,360800,399670,50.06868198099505,60.295274160471855,NaN,NaN,-217.87593762482416,-48.278858810669576,-0.12784154024090383,0.2555339985307725,0.38337553877167635,10088499,10508179,56.80073231894834,68.03716533702392,NaN,NaN,18.626487490796535,28.519043840267123
1995-10-11T09:30:00-04:00,58.09375,58.09375,57.875,58.07812,228100,399085,53.58184847171567,59.51328507947404,NaN,NaN,-89.66157722533148,-67.3992998601492,-0.12315849334989026,0.22942742208431355,0.3525859154342038,10316599,10478819,55.93165528008211,65.91603831045846,NaN,NaN,16.87429225070839,26.85550789890159
1995-10-12T09:30:00-04:00,58.125,58.46875,58.125,58.4375,199800,386195,59.46835047228349,59.13969725535869,NaN,NaN,34.39769360774766,-63.82125449619791,-0.09404674501863564,0.23502748416090924,0.3290742291795449,10516399,10435659,54.6089049547545,63.66024659897074,NaN,NaN,17.12411310065566,25.46530864200931
1995-10-13T09:30:00-04:00,58.70312,58.85937,58.625,58.625,488100,389040,62.1642508673944,59.096563722463415,NaN,NaN,153.8957068972765,-46.63641141536333,-0.06190427434101331,0.25169388625327827,0.3135981605942916,11004499,10475059,55.6402610871928,61.42411154961546,NaN,NaN,18.175607510461784,24.42392276607395
1995-10-16T09:30:00-04:00,58.45312,58.5625,58.34375,58.34375,443600,395845,56.133045565061536,58.64652052124576,NaN,NaN,47.38336549492356,-14.372149770041585,-0.059320604588733616,0.23944740485837457,0.2987680094471082,10560899,10497379,56.24676115572438,59.429499095038416,NaN,NaN,17.1842584232088,23.3896850028075
1995-10-17T09:30:00-04:00,58.40625,58.79687,58.29687,58.73437,146000,375665,61.69207154048954,58.668993685886825,NaN,NaN,104.78917258961953,50.16087227284716,-0.03238688139870144,0.2582844076987314,0.29067128909743284,10706899,10621059,59.54726141052284,58.33161183444896,NaN,NaN,18.159258094401885,22.642481158749554
1995-10-18T09:30:00-04:00,59.01562,59.09375,58.71875,58.90625,228100,372530,63.86216719240369,58.445512670899824,NaN,NaN,189.37757443127057,105.96870260416756,-0.005488586257872241,0.28381055627509255,0.2892991425329648,10934999,10744739,62.58661514346593,57.61263286226176,NaN,NaN,19.66341096447489,22.2168997024246
1995-10-19T09:30:00-04:00,58.875,59.1875,58.79687,59.1875,500600,372135,67.14221629373222,58.63651920395163,NaN,NaN,191.84539544937388,137.4582429724928,0.02696969767951879,0.3230112646323633,0.2960415669528445,11435599,10928579,66.60325322778019,57.78695966517544,NaN,NaN,22.02122268585567,22.188945842914755
1995-10-20T09:30:00-04:00,59.14062,59.1875,58.82812,58.82812,748400,387060,59.68724720732047,58.75163432905695,NaN,NaN,138.38827000651906,134.35675559434134,0.0202663786330049,0.3213745402441006,0.3011081616110957,10687199,10865119,64.04713946997515,58.343256290643296,NaN,NaN,21.55862746584723,22.098900360476538
1995-10-23T09:30:00-04:00,58.54687,58.8125,58.54687,58.70312,533000,407210,57.303964113050235,58.63067243397639,NaN,NaN,67.65309187389526,138.41070087013566,0.004280117452846066,0.30645830842715327,0.3021781909743072,10154199,10783779,60.82492036879007,58.755488059508465,NaN,NaN,20.420150142307058,21.85907890073804
1995-10-24T09:30:00-04:00,58.78125,58.84375,58.625,58.76562,172200,392490,58.20262892605997,58.67137608566186,NaN,NaN,73.2437676957027,132.1016198913523,-0.004730429076747922,0.29626515462837233,0.30099558370512025,10326399,10707679,57.89046479637414,58.91637932393066,NaN,NaN,19.782509439201846,21.562426120518584
1995-10-25T09:30:00-04:00,58.8125,58.89062,58.28125,58.28125,302700,374905,49.506017319897445,57.89688456445576,NaN,NaN,8.268826793400905,95.87987036377838,-0.04378556927433419,0.24626362211220254,0.29004919138653673,10023699,10525419,51.484115186150795,58.634715784461115,NaN,NaN,16.335577510169422,20.815733461897274
1995-10-26T09:30:00-04:00,58.375,58.42187,57.28125,57.75,606800,382435,42.079511113299375,56.539578392065685,NaN,NaN,-133.62245297270672,30.786300679362245,-0.10251671964828696,0.16190329182617802,0.264420011474465,9416899,10121679,40.731206267591745,57.38952374251628,NaN,NaN,10.652809253349604,19.363887146390464
1995-10-27T09:30:00-04:00,57.6875,58.1875,57.42187,58.1875,905800,397395,48.880567567872994,56.41232633082685,NaN,NaN,-95.9536944991673,-16.08209222177502,-0.10844460989746502,0.12886424910263372,0.23730885900009874,10322699,10048779,39.14155724647392,55.86320342241623,NaN,NaN,8.28101933075551,17.78062031558547
1995-10-30T09:30:00-05:00,58.32812,58.59375,58.32812,58.5625,488700,407175,53.87948748544287,56.68452672400171,NaN,NaN,20.793781192214258,-25.453954358111233,-0.08470712665389085,0.1314249506827352,0.21613207733662604,10811399,10180219,43.42857974256828,54.90804966696051,NaN,NaN,8.117766804572652,16.400212671155067
1995-10-31T09:30:00-05:00,58.71875,58.84375,58.3125,58.3125,508200,390600,50.34489750909591,56.45331594095744,NaN,NaN,16.92840348757689,-36.71702719973639,-0.08331329532471304,0.11199045818073472,0.19530375350544776,10303199,10175579,43.312588771959994,54.00668777352322,NaN,NaN,6.765931942598566,15.023886852789854
1995-11-01T09:30:00-05:00,58.28125,58.78125,58.23437,58.78125,415700,398945,56.153084484571636,56.216511227549454,NaN,NaN,37.10153586696963,-30.950485385022652,-0.04993826536694318,0.1328809217967688,0.18281918716371198,10718899,10314619,47.810760066746006,53.52110599580833,NaN,NaN,7.6829924987452545,13.975187659354912
1995-11-02T09:30:00-05:00,58.6875,59.15625,58.6875,59.15625,326000,401805,60.16721969759241,56.07386614399216,NaN,NaN,114.2860963905284,18.631224487624372,-0.004136700482220285,0.17764831156093663,0.18178501204315692,11044899,10640219,56.51311823038312,53.58345293460764,NaN,NaN,9.857445466841169,13.386938774710092
1995-11-03T09:30:00-05:00,59.23437,59.25,59.0625,59.23437,615000,428790,60.968860529638164,56.41928149860478,NaN,NaN,133.28220544525433,64.4784044765087,0.028115822380948674,0.21692979001934276,0.1888139676383941,11659899,10907659,62.10282997725766,54.00174356471717,NaN,NaN,11.806805208496415,13.161205408108138
1995-11-06T09:30:00-05:00,59.21875,59.21875,59.01562,59.03125,311200,426440,57.71638904276367,56.13530417733864,NaN,NaN,104.70375815861173,81.26039986978819,0.032173176231783784,0.22903043792812383,0.19685726169634005,11348699,11015119,64.09963284209886,54.326912952686875,NaN,NaN,12.360208829803724,13.046777325493222
1995-11-07T09:30:00-05:00,59,59,58.625,58.8125,358200,426310,54.353496692577494,55.456113427351056,NaN,NaN,44.05423315760947,86.6855658037947,0.017274851921499634,0.21845082659821458,0.20117597467671494,10990499,11152579,66.52909455169721,54.6085186247034,NaN,NaN,11.763661926076155,12.863475125576498
1995-11-08T09:30:00-05:00,58.89062,59.375,58.89062,59.34375,357200,432765,60.389623420664236,54.973785364989055,NaN,NaN,121.29926144358254,103.52511091911728,0.03910034553238159,0.25005140659219194,0.21095106105981035,11347699,11278339,68.62126684695427,54.75266245464441,NaN,NaN,13.233564144433307,12.916344985413184
1995-11-09T09:30:00-05:00,59.57812,59.57812,59.28125,59.5625,503700,447960,62.58366990706681,55.18067270068523,NaN,NaN,159.89875750959234,112.64764314293006,0.0627673507779824,0.28941024953228833,0.22664289875430593,11851399,11439639,71.11515276494058,55.25752054714194,NaN,NaN,15.143179657648556,13.234464224303952
1995-11-10T09:30:00-05:00,59.23437,59.60937,59.21875,59.53125,795600,463335,62.05486034498183,55.520022431537484,NaN,NaN,132.9783404366189,112.58687014120301,0.07025044087400309,0.3144559498468098,0.2442055089728067,11055799,11318819,66.83059824789555,55.686497538506615,NaN,NaN,16.495325236741067,13.700301511794969
1995-11-13T09:30:00-05:00,59.42187,59.65625,59.3125,59.46875,818500,482080,60.94569576744302,55.71595577735055,NaN,NaN,122.84829607339275,116.2157777241592,0.06504307358149886,0.32550935094968025,0.2604662773681814,10237299,11096539,59.703839945356776,55.81602433486252,NaN,NaN,17.277331219667865,14.211305755776811
1995-11-14T09:30:00-05:00,59.35937,59.48437,59.07812,59.07812,341800,491870,54.40089415696721,56.06558983714125,NaN,NaN,66.36374339119826,120.67767977087695,0.031065815901075322,0.29929854724452554,0.2682327313434502,9895499,10877539,53.635154499177695,55.96967000007873,NaN,NaN,16.00525654155076,14.467584439458804
1995-11-15T09:30:00-05:00,59.14062,59.6875,59.10937,59.67187,584700,509700,61.218084435203885,57.432630788705865,NaN,NaN,104.28809572917268,117.27544662799498,0.04358731891368478,0.3227168799855562,0.2791295610718714,10480199,10704039,49.354962624165104,56.58565259697683,NaN,NaN,17.051196535938416,14.836671881813034
1995-11-16T09:30:00-05:00,59.67187,60.0625,59.65625,60,577700,513555,64.38682566257133,58.54022065261289,NaN,NaN,153.47050640750894,115.9897964075783,0.06754635423941796,0.36356250387114386,0.2960161496317259,11057899,10545339,45.75794669295318,57.05825184315392,NaN,NaN,18.96336663415554,15.42619970357625
1995-11-17T09:30:00-05:00,60.09375,60.20312,60.01562,60.1875,267000,489485,66.09174178051794,59.412524530832535,NaN,NaN,159.97086991388468,121.38830230303145,0.08828961114778588,0.4063781635664583,0.3180885524186724,11324899,10599159,47.16428741707133,57.32508810561842,NaN,NaN,21.06363688591013,16.23154787248109
1995-11-20T09:30:00-05:00,60.28125,60.29687,59.85937,59.875,448800,485275,60.862091622969984,60.163752681823546,NaN,NaN,125.97823671941984,122.01429043223689,0.07381982284858823,0.4103633309794077,0.33654350813081946,10876099,10726919,50.44861255387159,57.83480409004068,NaN,NaN,21.190725894041552,16.94000187556116
1995-11-21T09:30:00-05:00,59.9375,60.35937,59.92187,60.35937,119200,482625,65.42832180326064,60.826269633158475,NaN,NaN,134.5941220872487,135.66036617144695,0.08872384167406472,0.44744831022340037,0.35872446854933565,10995299,10946879,55.56937351626053,58.388990765006,NaN,NaN,22.79922260584406,17.777033408458717
1995-11-22T09:30:00-05:00,60.3125,60.375,60.17187,60.17187,351600,485070,62.393666195087455,60.9853015258367,NaN,NaN,124.64866397671534,139.7324798209555,0.07817810707419226,0.456447102392076,0.3782689953178837,10643699,10979579,56.29251491863648,58.373233385595526,NaN,NaN,23.142499672700914,18.543528589064746
1995-11-24T09:30:00-05:00,60.23437,60.32812,60.1875,60.32812,62400,457850,63.896451559014835,61.19441517079217,NaN,NaN,118.29421506750714,132.6972215529551,0.0739929231221863,0.4707601492206166,0.3967672260984303,10706099,10909219,54.24665217984789,57.81207782863769,NaN,NaN,23.883896319925057,19.30643826490193
1995-11-27T09:30:00-05:00,60.45312,60.64062,60.34375,60.34375,273000,426210,64.05120628383737,61.64690211658315,NaN,NaN,129.22250776322866,126.54754912282392,0.06487111862530454,0.477856124380061,0.41298500575475644,10979099,10840059,52.23701333691919,56.96474786398199,NaN,NaN,24.52346164719536,20.05172731951528
1995-11-28T09:30:00-05:00,60.29687,60.98437,60.15625,60.98437,479000,425725,69.77059734816144,62.748123591982,NaN,NaN,141.217197734477,129.59534132583536,0.09287086338190365,0.529073584982136,0.4362027216002323,11458099,10956459,55.242362325835145,56.15855270499185,NaN,NaN,26.93775670898491,21.035445803725228
1995-11-29T09:30:00-05:00,61.09375,61.09375,60.84375,61.04687,549200,427775,70.26760105700097,63.45369342314891,NaN,NaN,152.79969233841288,133.2364553760682,0.1055639438693784,0.5681576514369553,0.4625937075675769,12007299,11158859,59.960147050763986,55.53990129097826,NaN,NaN,29.023259021758633,22.17656197773
1995-11-30T09:30:00-05:00,61.04687,61.20312,60.84375,60.90625,286200,421300,67.57562081453862,63.810261345111186,NaN,NaN,135.26238142124703,135.35919886497453,0.09479446602274005,0.581086790096002,0.4862923240732619,11721099,11374339,64.27729066043545,55.05148256922789,NaN,NaN,29.96907652376218,23.289778341448883
1995-12-01T09:30:00-05:00,60.98437,61.07812,60.84375,60.98437,465200,428260,68.30213905330605,64.25649553856292,NaN,NaN,120.42821244257284,135.78599833998766,0.0836270850024784,0.5908261803263599,0.5071990953238815,12186299,11670379,69.19197854033482,55.22015259011641,NaN,NaN,30.956111184835315,24.384968747646944
1995-12-04T09:30:00-05:00,61.125,61.73437,61.04687,61.73437,631700,429095,74.26419805638292,65.20781713063005,NaN,NaN,159.3247965702538,141.8064561013927,0.11548292747102284,0.65155275466266,0.5360698271916372,12817999,12038159,73.98116546058401,56.239961555489785,NaN,NaN,33.82223863171242,25.733150159656297
1995-12-05T09:30:00-05:00,61.67187,62.20312,61.625,62.14062,567700,441920,76.8087285880313,66.80837673284891,NaN,NaN,183.94728186479253,150.35247292745584,0.15043442613370117,0.7241128598587636,0.5736784337250624,13385699,12423679,77.865458587919,57.97069756182845,NaN,NaN,37.114586936979066,27.359069699273835
1995-12-06T09:30:00-05:00,62.29687,62.53125,62,62.28125,272800,437650,77.63314049663995,67.9808807372372,NaN,NaN,181.06261587012352,156.00505763379795,0.16819988846136325,0.7839282943017665,0.6157284058404032,13658499,12753919,80.54479591066428,60.198542796578394,NaN,NaN,40.03090561390234,29.169331972792193
1995-12-07T09:30:00-05:00,62.20312,62.28125,61.90625,61.95312,289700,434275,71.26720720651551,68.47233656180464,NaN,NaN,137.51617411969494,156.45581617348753,0.14396365161152613,0.795682970354811,0.6517193187432848,13368799,13083459,82.78426731295815,62.84327998372161,NaN,NaN,40.50968014725872,30.789381712001695
1995-12-08T09:30:00-05:00,62.21875,62.23437,61.76562,62.15625,296900,423935,72.75653431853516,68.94839317166301,NaN,NaN,120.19129646909661,156.4084329787923,0.12824771680641134,0.812028964751299,0.6837812479448877,13665699,13379339,84.50849815432875,65.51072360781141,NaN,NaN,41.36191913679545,32.299744201257944
1995-12-11T09:30:00-05:00,62.28125,62.54687,62.15625,62.42187,186500,393480,74.60984804319068,69.93037577310734,NaN,NaN,129.30008691647535,150.4034910480366,0.12239166085260378,0.8367708240106424,0.7143791631580386,13852199,13586179,85.5946657466505,68.0211559787242,NaN,NaN,42.648496024483876,33.778137318861646
1995-12-12T09:30:00-05:00,62.14062,62.35937,62.14062,62.23437,299400,367525,70.94116584503826,70.32415034752003,NaN,NaN,106.49278944726224,134.91259256453057,0.09382655489353953,0.831662356774963,0.7378358018814235,13552799,13619599,85.76829261148615,70.17822162838317,NaN,NaN,42.613819656263644,35.040377652776215
1995-12-13T09:30:00-05:00,62.3125,62.70312,62.3125,62.625,390700,369970,73.828467116552,71.14092184191036,NaN,NaN,116.23626335276235,121.94732206105832,0.08920634267970551,0.8493437302310554,0.7601373875513499,13943499,13676599,86.07653614093638,72.3056517156903,NaN,NaN,43.47008909968889,36.24462214519231
1995-12-14T09:30:00-05:00,62.6875,62.79687,62.01562,62.17187,395000,360485,65.67644317670064,71.26806410031648,NaN,NaN,88.0462948899354,112.05334621510642,0.045786413812149096,0.8173704048165362,0.7715839910043871,13548499,13712539,86.27834093900975,74.59362948420187,NaN,NaN,41.59876299796072,37.00949940987351
1995-12-15T09:30:00-05:00,61.875,61.875,61.59375,61.8125,416700,352435,60.01645384168645,70.9798674973057,NaN,NaN,37.625277388384575,95.54014239896401,-0.013797093698454055,0.7543376238813195,0.7681347175797736,13131799,13605759,82.45453982629996,76.75202423344335,NaN,NaN,38.17263982790507,37.175662326735164
1995-12-18T09:30:00-05:00,61.26562,61.26562,60.60937,60.625,862300,382200,45.93056497368045,69.27700804198564,NaN,NaN,-43.732465207055675,60.933631974257786,-0.13320602881109123,0.6016271815659096,0.7348332103770008,12269499,13289219,72.23431533289023,77.96573516251871,NaN,NaN,29.49909375610089,36.07900967378741
1995-12-19T09:30:00-05:00,60.65625,61.34375,60.57812,61.26562,1022600,410890,52.418462163714544,68.00206954960804,NaN,NaN,-30.570670847155885,33.52093991537416,-0.1668828181782228,0.5262296876542223,0.6931125058324451,13292099,13237079,70.68024376842382,78.73145635663728,NaN,NaN,24.805539019964442,34.46851386609841
1995-12-20T09:30:00-05:00,61.45312,61.51562,60.67187,60.67187,1349800,472420,46.81190498864033,66.5189469906153,NaN,NaN,-46.521881640457394,0.9693109167302112,-0.22345321653991135,0.4137959851575559,0.6372492016974672,11942299,12836839,60.007686720900146,78.42648464667047,NaN,NaN,18.878826449907198,32.24141566378538
1995-12-21T09:30:00-05:00,61.03125,61.17187,60.75,60.98437,857600,497720,49.852062850052604,65.20108440466863,NaN,NaN,-51.29655659750408,-26.899259380757684,-0.2330633188210206,0.34592005317119146,0.5789833719922121,12799899,12687119,56.566757471903706,77.52468314178252,NaN,NaN,15.367815135738505,29.83090130263583
1995-12-22T09:30:00-05:00,61.3125,61.375,61.14062,61.20312,332800,511240,51.92361662866737,63.60532858840323,NaN,NaN,-30.51779006508553,-40.5278728714517,-0.21818754738487478,0.3062489377611186,0.5244364851459934,13132699,12687299,56.56998177781419,76.28102716444184,NaN,NaN,13.333223139630432,27.4740901364922
1995-12-26T09:30:00-05:00,61.45312,61.53125,61.32812,61.5,432200,519200,54.66098225519084,62.023346707486056,NaN,NaN,-13.391509464244825,-34.45968172288953,-0.18326094956331868,0.29536029819184506,0.47862124775516374,13564899,12946379,61.0517371272086,75.08004706010537,NaN,NaN,12.598907596456414,25.349064059344233
1995-12-27T09:30:00-05:00,61.65625,61.65625,61.35937,61.46875,151800,502840,54.310441821741726,60.357439659279045,NaN,NaN,-14.00460164244749,-31.14646788194785,-0.15812059343827467,0.2809705059573204,0.4390910993955951,13413099,12970579,61.451891318070494,73.71626816063439,NaN,NaN,11.916193876832004,23.430082604699628
1995-12-28T09:30:00-05:00,61.34375,61.65625,61.25,61.40625,256200,488190,53.57049413127326,59.09338872533316,NaN,NaN,-25.191701403693674,-26.880431834595107,-0.1420658762054855,0.2615087541387382,0.4035746303442237,13156899,13213499,65.30521959942728,72.46776475252504,NaN,NaN,11.14950260799661,21.675714033742054
1995-12-29T09:30:00-05:00,61.46875,61.53125,61.25,61.48437,339200,490840,54.40664781618638,57.78268254659396,NaN,NaN,-31.452198703076007,-22.911560255709492,-0.12324963946390988,0.24951258101433638,0.37276222047824625,13496099,13352739,67.32162920259772,71.24013125597283,NaN,NaN,10.7544150586604,20.115528465873247
1996-01-02T09:30:00-05:00,61.40625,62.14062,61.34375,62.14062,514400,493300,60.79419583256488,56.79585024583498,NaN,NaN,26.613273643888604,-11.485347513914665,-0.06651309717401765,0.28962084901072416,0.3561339461847418,14010499,13528299,69.71182746127947,70.10564280701774,NaN,NaN,12.338246325789026,19.00448816014693
1996-01-03T09:30:00-05:00,62.34375,62.5,62,62.3125,610300,492230,62.28456047507637,56.1775212908377,NaN,NaN,76.26653540639884,6.446261460214056,-0.019742830325049643,0.3314554082784298,0.35119823860347943,14620799,13739479,72.33328607426972,69.14599948293086,NaN,NaN,14.09351327470913,18.302920319370102
1996-01-04T09:30:00-05:00,62.39062,62.625,61.21875,61.71875,1129700,520330,54.56769790890179,54.80175206171983,NaN,NaN,18.57063468736558,12.961308726176672,-0.030486726560888466,0.3130898304023688,0.3435765569632573,13491099,13755079,72.52247860467378,68.17785251605497,NaN,NaN,13.280386509680811,17.58541548941449
1996-01-05T09:30:00-05:00,61.3125,61.75,61.17187,61.59375,302400,521810,53.07677241479092,53.90177557872629,NaN,NaN,-26.859787094593337,12.62769158799674,-0.04673215785845236,0.28516135964019185,0.3318935174986442,13188699,13761439,72.60472922921306,67.2011659653552,NaN,NaN,12.173155729471738,16.812235523708384
1996-01-08T09:30:00-05:00,61.8125,61.90625,61.73437,61.82812,179900,516320,55.53014074132308,53.58132464298605,NaN,NaN,22.512754657170838,23.420682260046107,-0.04253356651048701,0.2787265593605355,0.3212601258710225,13368599,13735939,71.67828979538164,66.43143382028961,NaN,NaN,11.965211761192213,16.119803557634647
1996-01-09T09:30:00-05:00,62.0625,62.0625,60.625,60.76562,415500,522250,44.23788232576479,53.46041873956351,NaN,NaN,-72.41999272404466,3.6140289864594566,-0.10840742600462494,0.18575084336524128,0.2941582693698662,12953099,13524459,64.34527458894905,65.8679309100081,NaN,NaN,7.956272572764202,14.953584845510298
1996-01-10T09:30:00-05:00,60.6875,60.8125,59.64062,59.96875,787700,552310,37.99701764188882,52.4303155594331,NaN,NaN,-201.52369725997488,-51.94401754681529,-0.197549155099233,0.04722182549582499,0.24477098059505797,12165399,13033379,51.23698215225955,64.47912650885351,NaN,NaN,2.228348103509796,13.135693882367368
1996-01-11T09:30:00-05:00,60.0625,60.32812,59.78125,60.32812,513200,563000,41.97278694059755,52.084664270287185,NaN,NaN,-175.61510713712474,-90.78116591171336,-0.222362987249927,-0.03318275346735078,0.18918023378257623,12678599,12870879,47.76911494146295,63.60494281032228,NaN,NaN,-0.9976841727489946,11.116639874493602
1996-01-12T09:30:00-05:00,60.48437,60.5,59.67187,60.23437,390400,562985,41.23004735702477,51.4688060207852,NaN,NaN,-154.17698194434456,-116.2446048816636,-0.2339668073520815,-0.10327827540752565,0.13068853194455585,12288199,12690779,44.19858777781706,62.72150211788752,NaN,NaN,-3.7521983984837473,8.992520121211124
1996-01-15T09:30:00-05:00,60.25,60.45312,59.85937,60.10937,154100,550940,40.20838174101598,50.632003528810095,NaN,NaN,-135.80257766903574,-147.90767134690492,-0.2381436007122536,-0.16699096894576115,0.07115263176649245,12134099,12443879,39.805951749466026,61.52407140157693,NaN,NaN,-6.276438430802276,6.8112403280663525
1996-01-16T09:30:00-05:00,60.40625,60.89062,59.89062,60.84375,454500,552830,48.31201949842228,50.17850618904091,NaN,NaN,-74.74440266449095,-148.37255333499417,-0.18205992181704955,-0.1564222705048195,0.02563765131223006,12588599,12370979,38.58655793521984,59.919415745006305,NaN,NaN,-5.903466366360776,4.9948536574339055
1996-01-17T09:30:00-05:00,60.70312,61.125,60.45312,60.65625,407600,530095,46.576337492319766,49.626070165510775,NaN,NaN,-47.58329959127896,-117.58447380125499,-0.14956342200457548,-0.1613166261934893,-0.011753204188913811,12180999,12374099,38.673146075152694,58.29236251336932,NaN,NaN,-6.141377176907466,3.403963538242281
1996-01-18T09:30:00-05:00,60.89062,60.90625,60.375,60.85937,425500,500240,48.72542043138709,49.27999347266177,NaN,NaN,-47.59602285460248,-91.98065694475054,-0.10828508816687162,-0.14710956439750333,-0.03882447623063172,12606499,12359679,38.40364360408513,56.37082137084489,NaN,NaN,-5.682112491837759,2.1059526768022754
1996-01-19T09:30:00-05:00,60.85937,61.42187,60.79687,61.26562,169800,441240,52.813875220427356,49.16622400153613,NaN,NaN,6.287747665815172,-59.88771102271859,-0.0504562636925059,-0.10189480584626409,-0.05143854215375819,12776299,12457299,41.38177684621821,54.51797477396063,NaN,NaN,-4.028590440841102,1.229589374281793
1996-01-22T09:30:00-05:00,61.21875,61.42187,61.10937,61.28125,288100,412765,52.96925312299654,48.60729952228125,NaN,NaN,18.144891873254142,-29.09821711426061,-0.010098850669160178,-0.06406210549020841,-0.05396325482104823,13064399,12643359,46.67387648088218,52.872406846789396,NaN,NaN,-2.656144519342328,0.67448453233549
1996-01-23T09:30:00-05:00,61.25,61.42187,61.125,61.42187,362100,414230,54.42333961825045,48.04578374679368,NaN,NaN,24.018034817898755,-9.345729617782675,0.025191804980061495,-0.022473498595971364,-0.04766530357603286,13426499,12810939,50.967584458138155,51.34628530278,NaN,NaN,-1.0961614507215076,0.42153510618449036
1996-01-24T09:30:00-05:00,61.51562,62.04687,61.48437,61.92187,1506500,467945,59.24798151644802,48.380089718761276,NaN,NaN,81.47057304878695,16.465044910230503,0.07833409558587107,0.05025231590630597,-0.028081779679565093,14932999,13361339,61.83641030805787,50.58299471016458,NaN,NaN,1.7383552465177154,0.6096522690892368
1996-01-25T09:30:00-05:00,61.96875,62,61.625,61.70312,298400,475275,56.433352401941704,48.61984543212919,NaN,NaN,73.20412139887686,40.62507376092638,0.0938321533336516,0.0892084119874994,-0.004623741346152191,14634599,13766959,67.54586910895905,50.221647558717855,NaN,NaN,3.323971155033292,0.9974121099383875
1996-01-26T09:30:00-05:00,61.65625,62.26562,61.57812,62.23437,726300,498780,61.24812619909829,49.028272964827416,NaN,NaN,95.0174375475111,58.371011737265555,0.1325724868250526,0.16109186718516355,0.02851938036011096,15360899,14283879,73.07429473493181,50.32136219725715,NaN,NaN,6.21279775209381,1.7424672016748763
1996-01-29T09:30:00-05:00,62.1875,62.48437,62.14062,62.48437,254800,494560,63.303416296289534,50.3900968198649,NaN,NaN,120.02797373075104,78.74762810876493,0.1655989187150096,0.23551802875387295,0.06991911003886336,15615699,14794139,77.20258290821195,51.239741362918785,NaN,NaN,9.259138098578687,2.816277329803992
1996-01-30T09:30:00-05:00,62.60937,63.14062,62.53125,63.01562,272100,482445,67.27532601938492,52.48140456111462,NaN,NaN,158.38144225483666,105.62030959615251,0.21088397216033497,0.33352407523928207,0.1226401030789471,15887799,15286399,80.33503104342489,53.31817342657346,NaN,NaN,13.201938491587686,4.299943210058806
1996-01-31T09:30:00-05:00,63,63.6875,62.96875,63.67187,498000,476830,71.39423634284398,54.582936661275085,NaN,NaN,189.39940533224285,127.2060760528437,0.2689751355232116,0.4588590224829616,0.18988388695975,16385799,15576959,81.91464594539143,55.75713992685406,NaN,NaN,18.06313769018064,6.26611385007621
1996-02-01T09:30:00-05:00,63.60937,63.90625,63.5625,63.90625,373900,439040,72.71512117831668,56.83187050565308,NaN,NaN,185.3958006923645,149.64441191154123,0.3045118791355592,0.570523735879199,0.2660118567436398,16759699,16001979,83.94605735581673,58.596244896711184,NaN,NaN,22.445843875387943,8.577503853692171
1996-02-02T09:30:00-05:00,63.875,64.01562,63.5,63.64062,496200,448730,68.83570452688991,58.87667927607265,NaN,NaN,149.33318120808354,160.50756064365572,0.2914455403237174,0.6303187821482865,0.3388732418245691,16263499,16182499,84.73056036350565,61.805145511999726,NaN,NaN,24.881548256909564,10.906653054151798
1996-02-05T09:30:00-05:00,63.53125,64.25,63.4375,64.15625,295300,454500,71.96267647159652,60.56601191701366,NaN,NaN,140.77744653917162,164.65745520533983,0.29779461481260483,0.7111165103403252,0.41332189552772036,16558799,16371119,85.52641911706687,65.15799273927452,NaN,NaN,27.991258242792888,13.347310938243382
1996-02-06T09:30:00-05:00,64.1875,64.82812,64.09375,64.76562,301600,448805,75.1376261075543,62.60610396095899,NaN,NaN,150.50979027931103,163.0831248102347,0.32128359888472663,0.8149263941336287,0.49364279524890203,16860399,16565639,86.31839360844887,68.56122470593853,NaN,NaN,31.745272925853673,15.97559122218771
1996-02-07T09:30:00-05:00,64.75,65.14062,64.6875,65.14062,585100,438675,76.87322827048652,64.6166616637518,NaN,NaN,148.14366933982325,154.8319776117508,0.3385949986898259,0.9168865436111844,0.5782915449213585,17445499,16777579,87.14382383537037,72.04266615103033,NaN,NaN,35.421794259674975,18.75362022754303
1996-02-08T09:30:00-05:00,65.04687,65.90625,64.92187,65.84375,1526600,489345,79.73043152470677,66.53927282834319,NaN,NaN,151.18632181418985,147.99008183611585,0.371295679708292,1.0424111445567235,0.6711154648484314,18972099,17220059,88.67942104228548,75.42106930789228,NaN,NaN,39.595968261067824,21.731098518046572
1996-02-09T09:30:00-05:00,65.8125,66.375,65.51562,65.82812,804600,510055,79.49531902862472,68.43399182160235,NaN,NaN,144.44551261923425,147.012548118346,0.3652119983120391,1.1276304627384803,0.7624184644264412,18167499,17600859,89.80772148615037,78.50205823684,NaN,NaN,42.76305579476651,24.735663843292276
1996-02-12T09:30:00-05:00,65.95312,66.625,65.89062,66.32812,626500,533675,81.38627177343372,70.35991554697259,NaN,NaN,141.61151293461117,147.17936139743392,0.3672118565391581,1.2214332851003888,0.8542214285612307,18793999,18047899,90.948288838571,81.35782283544235,NaN,NaN,46.08307998291064,27.785294720380612
1996-02-13T09:30:00-05:00,66.04687,66.6875,66,66.1875,1045900,563245,79.17482473673516,71.78326149127881,NaN,NaN,126.0546187965963,142.28832710089097,0.33245366302990154,1.2697885073486077,0.9373348443187062,17748099,18225439,91.36172748378218,83.46677406227981,NaN,NaN,48.092866321022534,30.686376377615172
1996-02-14T09:30:00-05:00,66.14062,66.35937,65.57812,65.60937,431400,564435,70.672478149412,72.8003419018124,NaN,NaN,98.20962410251073,132.30151805342845,0.24779972150964746,1.2470844962057654,0.999284774696118,17316699,18199679,90.71430099141584,85.12166205388385,NaN,NaN,47.17316333727865,33.041631657567095
1996-02-15T09:30:00-05:00,65.46875,65.90625,65.125,65.20312,889500,587635,65.36091478337632,73.09411251497512,NaN,NaN,73.27583188951715,116.7194200684939,0.1467139856428079,1.1826772567496278,1.0359632711068198,16427199,17690699,78.82801212159495,85.53264186721694,NaN,NaN,44.710989385782845,34.70868276159791
1996-02-16T09:30:00-05:00,65.07812,65.23437,64.73437,64.9375,606100,609450,62.07582941840763,73.00642773798354,NaN,NaN,48.12970118264349,97.45625778117575,0.04926848793889138,1.0975488810304341,1.0482803930915428,15821099,17221419,69.7529591197127,85.00052588232414,NaN,NaN,41.65358133823233,35.700811129688546
1996-02-20T09:30:00-05:00,64.4375,64.625,63.875,64.29687,492300,619660,54.90788781393301,72.12303929473698,NaN,NaN,10.182198765855599,71.17039494742463,-0.06483167995520289,0.9672407931475391,1.032072473102742,15328799,16528379,58.95797320540602,83.47359317960851,NaN,NaN,36.633597142823064,35.83406627442205
1996-02-21T09:30:00-05:00,64.42187,65.14062,64.42187,65.09375,434000,623255,60.94848833199851,71.37691443681945,NaN,NaN,34.95158785574838,52.949788759255036,-0.09150305870008824,0.9176936497276316,1.0091967084277198,15762799,16131319,53.81898666493657,81.46676037386172,NaN,NaN,34.19608451668192,35.600068880459176
1996-02-22T09:30:00-05:00,65.45312,66.32812,65.40625,66.125,721400,584000,67.09223907942442,70.97528000118425,NaN,NaN,85.4746888509573,50.40280170894437,-0.04681210858829876,0.9506815726923463,0.9974936812806451,16484199,15964819,51.780788630993946,79.16924117923153,NaN,NaN,34.225911680755516,35.40376070907294
1996-02-23T09:30:00-05:00,66.5,66.60937,65.32812,65.9375,1430400,640600,65.08724264122407,70.70753272363669,NaN,NaN,80.07668420833485,51.762972172707904,-0.03740649023354792,0.9507355684887102,0.9881420587222581,15053799,15690139,48.516434807754585,76.58251792524932,NaN,NaN,33.56986865519519,35.141776129947544
1996-02-26T09:30:00-05:00,65.75,65.89062,64.96875,65,1408400,674705,56.065477223973225,69.5720184916636,NaN,NaN,32.834689585617696,48.70396985330275,-0.09838808319527537,0.8651569547281639,0.9635450379234393,13645399,15254999,43.80513991125198,73.6024265534054,NaN,NaN,29.79445373231613,34.37787293028591
1996-02-27T09:30:00-05:00,65.15625,65.17187,64.5,64.79687,601000,692015,54.30895135727372,68.08425600950069,NaN,NaN,-9.556566426796012,44.75621681477243,-0.15320023659169302,0.772044742183823,0.925244978775516,13044399,14798119,39.47113996067743,70.25619414999315,NaN,NaN,26.25995882485045,33.2181709152237
1996-02-28T09:30:00-05:00,65.3125,65.73437,64.5,64.5,865900,721705,51.75681711535273,66.29022664127685,NaN,NaN,-12.022036118971045,35.36149201982854,-0.20690525461450815,0.6666134105073809,0.873518665121889,12178499,14081259,33.81756619377535,66.44717574702206,NaN,NaN,22.57898547247004,31.69828728054461
1996-02-29T09:30:00-05:00,64.125,64.95312,63.875,63.875,914300,742520,46.77337732672656,63.936151341421116,NaN,NaN,-83.14756421236885,1.6370414071633292,-0.277569946946423,0.5265562314388603,0.8041261783852833,11264199,13037259,27.61420845719111,62.08537484808676,NaN,NaN,17.79899644251934,29.712674303683855
1996-03-01T09:30:00-05:00,64.64062,64.89062,63.60937,64.89062,1452600,796455,54.448725693125134,62.14710896031401,NaN,NaN,-66.89479643191952,-27.757254720887545,-0.24982710096362104,0.491842302180757,0.741669403144378,12716799,12569859,25.370405198636803,57.48270939897865,NaN,NaN,16.206905148229758,27.783278710047554
1996-03-04T09:30:00-05:00,65.03125,65.65625,64.8125,65.26562,652600,804275,56.91897034139123,60.399444572310976,NaN,NaN,6.29837015851644,-33.0645186063078,-0.20217210756224502,0.48895426869157177,0.6911263762538168,13369399,12514659,25.110897962808096,52.78003862213843,NaN,NaN,15.758049436703514,26.06538881385555
1996-03-05T09:30:00-05:00,65.10937,65.875,65.07812,65.875,402000,809610,60.65311708855967,59.076465454584145,NaN,NaN,41.74343563824141,-22.80451819330031,-0.12911634424761798,0.5297309459442943,0.6588472901919122,13771399,12660059,27.22258099365871,48.19867101570104,NaN,NaN,16.635836216299246,24.718309871347504
1996-03-06T09:30:00-05:00,65.78125,65.96875,65.29687,65.29687,624700,825765,55.718779130199245,58.00834409606896,NaN,NaN,26.0103837358417,-15.198034222337764,-0.11945940597193871,0.5095230327269888,0.6289824386989276,13146699,12853699,30.05139576172043,43.865606356437084,NaN,NaN,15.729263859363796,23.434160441064115
1996-03-07T09:30:00-05:00,65.42187,65.65625,65.23437,65.625,534200,823220,57.81638862191334,57.469449370250175,NaN,NaN,21.038216900036797,5.639122000143365,-0.09193818749132632,0.5140597043347697,0.605997891826096,13680899,13337039,36.66852767899901,40.85421461053738,NaN,NaN,15.67119820106527,22.325165835349996
1996-03-08T09:30:00-05:00,64.1875,64.875,62,63.5,2289900,861385,43.458825914223375,56.13966340566559,NaN,NaN,-200.76794361515036,-21.135507436502802,-0.21100617193083337,0.34224017691255426,0.5532463488433876,11390999,13071879,34.72761645261214,38.352404420030204,NaN,NaN,10.173389495686337,20.589197786826617
1996-03-11T09:30:00-05:00,63.25,64.32812,63.0625,64.23437,1511400,896725,48.242319966931504,55.663551416594046,NaN,NaN,-132.30913832497652,-48.857009133201394,-0.23275244922275534,0.2623057873149435,0.4950582365376988,12902399,12978479,34.04405582039388,36.57283889252934,NaN,NaN,7.579605848664113,18.7306846528034
1996-03-12T09:30:00-05:00,63.8125,64.04687,62.90625,63.73437,1385300,934665,45.42451777806954,54.55469637702769,NaN,NaN,-145.792214423604,-86.36413914557048,-0.2706035098935422,0.15680384917077106,0.42740735906431326,11517099,12527619,30.883865538141265,34.934615954901105,NaN,NaN,4.548541583974557,16.70466421439928
1996-03-13T09:30:00-05:00,64.15625,64.4375,63.79687,64.17187,1019300,933335,48.27162541281064,53.210366829412415,NaN,NaN,-79.71405778602764,-107.50902744994434,-0.2561187016728427,0.10725898197325989,0.36337768364610257,12536399,12405559,30.070056469103662,33.38384937190894,NaN,NaN,3.1155280827904512,14.763359052740876
1996-03-14T09:30:00-05:00,64.26562,64.8125,64.23437,64.45312,725600,948045,50.074749896470884,52.13804591907291,NaN,NaN,-35.68305726140181,-118.85328228223207,-0.21897786597009727,0.089655351183481,0.3086332171535783,13261999,12321779,29.495544651885524,32.02521436077543,NaN,NaN,2.5641825252933352,13.020619548819798
1996-03-15T09:30:00-05:00,64.0625,64.32812,63.75,64.125,869200,947030,47.97375291979269,51.560065611631444,NaN,NaN,-73.52200825452516,-93.40409521010702,-0.20797313009100626,0.04866680453982042,0.2566399346308267,12392799,12522139,32.80209983528121,31.239282926777516,NaN,NaN,1.461875237080648,11.36937036142849
1996-03-18T09:30:00-05:00,64.71875,65.35937,64.57812,65.35937,917600,962605,55.53245354430684,51.64745862499095,NaN,NaN,34.753584165761545,-59.991550711959405,-0.11373840730964338,0.11446692549377246,0.22820533280341584,13310399,12603739,34.156466211637365,30.859663373274657,NaN,NaN,2.9984284981918012,10.173521523823249
1996-03-19T09:30:00-05:00,65.9375,66,65,65.21875,858500,980915,54.559963562719325,51.84768337123142,NaN,NaN,61.457368660548845,-18.541634095128842,-0.059766097789909545,0.1534977105660289,0.21326380835593844,12451899,12790699,37.275779244929225,31.106678591214223,NaN,NaN,3.904616716007635,9.277963694135304
1996-03-20T09:30:00-05:00,65.53125,65.53125,64.64062,65.14062,744300,996430,53.99419249011412,52.36345588290196,NaN,NaN,27.924532950703558,2.9860840522173917,-0.029734621701770658,0.17609553122872512,0.20583015293049578,11707599,12624939,35.66262868770659,31.68156575053676,NaN,NaN,4.462344524364162,8.590018098453712
1996-03-21T09:30:00-05:00,65.21875,65.25,64.76562,64.98437,650800,992900,52.814664961591575,52.246737259220986,NaN,NaN,23.487519059104894,14.820199316318726,-0.021200760478615355,0.1793292023322266,0.20052996281084196,11056799,12183899,31.728241487304302,32.13569691401301,NaN,NaN,4.5866429403065085,8.01810736157554
1996-03-22T09:30:00-05:00,65.01562,65.32812,64.9375,65.15625,344500,938605,54.00497979856923,52.03859507759085,NaN,NaN,46.135128539649436,38.751626675153645,-0.005599736031599745,0.19353029277134226,0.199130028802942,11401299,11985599,30.119307776622776,32.49344047214263,NaN,NaN,5.020262081658557,7.589843750158828
1996-03-25T09:30:00-05:00,65.75,65.8125,64.85937,65.03125,802400,908305,52.95866779680469,51.48899155675121,NaN,NaN,57.651108449840216,43.33113153196938,-0.005320407173600078,0.19247951983594191,0.197799927009542,10598899,11443299,26.205604430479212,32.42079928905838,NaN,NaN,5.105357097454928,7.234917085486842
1996-03-26T09:30:00-05:00,64.92187,65.51562,64.85937,65.34375,969400,926725,55.29077868707796,51.45842009652825,NaN,NaN,54.21496215479023,41.88265023081766,0.01327329104384406,0.21439154081434708,0.20111824977050302,11568299,11266579,25.06272104484077,32.064465380709834,NaN,NaN,5.804787780833483,7.0306128991077905
1996-03-27T09:30:00-05:00,65.4375,65.48437,64.6875,64.75,809600,923910,50.1986442924775,50.91429550156855,NaN,NaN,23.373167693466314,40.97237717937021,-0.015493641567650901,0.1817511978109394,0.1972448393785903,10758699,11076799,23.85930723594271,31.149521063348676,NaN,NaN,5.025562772379848,6.744177166718084
1996-03-28T09:30:00-05:00,64.51562,65.03125,64.5,65,1001300,928260,52.19501596059784,51.53830907630959,NaN,NaN,5.366761903882168,37.348225748325675,-0.018555822922910997,0.17405006072495155,0.19260588364786255,11759999,11217439,26.669365420101997,30.573931703883662,NaN,NaN,4.908454182988274,6.481931026185254
1996-03-29T09:30:00-05:00,65.1875,65.1875,64.375,64.6875,457700,878515,49.52263322259452,51.62976002314265,NaN,NaN,-7.923866186249209,26.53642680314594,-0.04120138299141851,0.1411041549085894,0.18230553790000792,11302299,11197639,26.520967141978957,30.036568226854026,NaN,NaN,4.0767907357910955,6.138339556128946
1996-04-01T09:30:00-05:00,65,65.45312,64.79687,65.4375,773400,884555,55.4217688357312,52.34384938440421,NaN,NaN,51.9821220254143,25.402629518260756,-0.007034133673210874,0.1735128708084943,0.1805470044817052,12075699,11492999,32.55027596771741,30.155597543252323,NaN,NaN,5.0287336710461386,5.979824429688545
1996-04-02T09:30:00-05:00,65.51562,65.5625,65.29687,65.5625,638800,896395,56.33763574971333,52.91999297989725,NaN,NaN,84.13292672256513,31.386222431815735,0.021081172581060986,0.20689847020803143,0.18581729762697044,12714499,11722239,36.87938685961308,30.64197828543157,NaN,NaN,6.075238453833323,5.99345500456637
1996-04-03T09:30:00-05:00,65.32812,65.60937,65.17187,65.5625,288000,879560,56.33763574971333,53.36734196941457,NaN,NaN,81.70584509052982,43.05275791122844,0.03590413112249127,0.23069746153008452,0.19479333040759325,12714499,12113399,43.53854488462351,31.64504973062714,NaN,NaN,6.93740709558487,6.128305303283299
1996-04-04T09:30:00-05:00,65.5625,65.71875,65.5,65.51562,934900,899595,55.83864628535636,53.92912006695483,NaN,NaN,97.25305978296682,61.43001748704537,0.03854505479529158,0.24297464890170772,0.20442959410641615,11779599,12117319,43.602757785927835,32.416525298530466,NaN,NaN,7.535538152864674,6.329338567509209
1996-04-08T09:30:00-04:00,63.875,64.39062,63.59375,64.39062,2217200,895960,45.437975800730655,53.208085942413675,NaN,NaN,-97.9941310886514,43.41596450656493,-0.035478878257004964,0.16008099628515993,0.1955598745421649,9562399,11769339,39.32699245683527,32.78584860175889,NaN,NaN,5.0647038605359755,6.148676466513033
1996-04-09T09:30:00-04:00,64.64062,64.64062,64.01562,64.14062,1180900,879435,43.49897644958689,52.41801543433279,NaN,NaN,-85.58797715660273,15.901944670161527,-0.0977530819895113,0.07336852205527578,0.17112160404478707,8381499,11030499,32.1240357726967,32.417866925170856,NaN,NaN,2.4231679033532623,5.616460957490208
1996-04-10T09:30:00-04:00,64.03125,64.3125,62.75,63,939500,857145,35.95925888962185,51.12980589144048,NaN,NaN,-209.90611128616274,-42.905862931584046,-0.20601275505357688,-0.08639433977218403,0.11961841528139286,7441999,9975999,25.06724118925679,31.66105353242444,NaN,NaN,-2.5391017948310606,4.451380564301456
1996-04-11T09:30:00-04:00,63.15625,63.46875,62.125,62.92187,1276000,869980,35.50528531710988,49.89342163112036,NaN,NaN,-232.21249399674087,-105.68953074903818,-0.26914490408494096,-0.21681271482478337,0.05233218926015762,6165999,8666299,19.3745368237728,30.778646056457905,NaN,NaN,-6.628494069248432,2.868541330937186
1996-04-12T09:30:00-04:00,63.35937,63.8125,63.17187,63.71875,411300,854265,43.35956251403665,49.13303468222518,NaN,NaN,-125.66464703957476,-150.2730721135465,-0.24422797404896673,-0.2529527783010508,-0.008724804252084058,6577299,7625839,16.222640768594857,29.78602698445591,NaN,NaN,-7.773631002340559,1.348230997611794
1996-04-15T09:30:00-04:00,64.04687,64.32812,63.84375,64.25,484200,835015,47.91360519482647,48.77267306779816,NaN,NaN,-65.0185674219552,-143.67795938020726,-0.18182501477823396,-0.2360060727248765,-0.054181057946642554,7061499,7125659,14.962469823145511,28.982945941074927,NaN,NaN,-7.278134937611204,0.1158930068656514
1996-04-16T09:30:00-04:00,64.375,64.65625,64.23437,64.4375,429700,810620,49.45817806759333,48.35605873783497,NaN,NaN,-28.41269799165354,-132.24290354721742,-0.12072071079844046,-0.20508194644469313,-0.08436123564625267,7491199,6947599,14.529765488356787,28.230591972754645,NaN,NaN,-6.400345329657278,-0.8149981840661957
1996-04-17T09:30:00-04:00,64.375,64.5625,63.84375,64.28125,525300,793960,48.17608645384021,48.211590320789455,NaN,NaN,-44.934843586574964,-99.24865000729987,-0.08529574239868472,-0.19098091364460856,-0.10568517124592385,6965899,6852379,14.29174210688464,27.54719446353621,NaN,NaN,-6.057718924397455,-1.5639582898278042
1996-04-18T09:30:00-04:00,64.4375,64.57812,64.09375,64.375,818600,797675,49.0298406876319,47.98550637272046,NaN,NaN,-28.251178580820174,-58.45638692411573,-0.05167429722470131,-0.17027804277680048,-0.11860374555209917,7784499,7176079,19.141140170252214,27.00946408854694,NaN,NaN,-5.533442591881777,-2.1310274758355146
1996-04-19T09:30:00-04:00,64.6875,64.85937,64.42187,64.53125,885100,809390,50.493690920368806,48.05486763684719,NaN,NaN,1.415271162969704,-33.04040328360684,-0.016839377016794735,-0.13965296682309258,-0.12281358980629785,8669599,7594539,25.045323519460183,26.904060972652747,NaN,NaN,-4.686691472368357,-2.4961223324830635
1996-04-22T09:30:00-04:00,65.125,65.28125,64.59375,65.03125,828900,833610,54.952192971010646,48.02132650365287,NaN,NaN,43.36777568158655,-11.363134662898485,0.038905724037999065,-0.07418143475879901,-0.11308715879679808,9498499,8081939,31.33441091955885,26.81721346921285,NaN,NaN,-2.6505627645588135,-2.518185251351028
1996-04-23T09:30:00-04:00,64.92187,65.28125,64.78125,65.23437,225400,804760,56.65979533199175,48.04433790238705,NaN,NaN,59.3696582994827,6.193336595328763,0.08579980898929021,-0.005837397560185309,-0.09163720654947552,9723899,8528479,36.584245136689404,26.796131917575444,NaN,NaN,-0.44495788739117886,-2.222009913642478
1996-04-24T09:30:00-04:00,65.5625,65.5625,64.85937,65,699000,791240,54.11101286239509,47.88529341043574,NaN,NaN,65.15618644070032,28.211542600783822,0.09657283823384885,0.02907884124283555,-0.0674939969910133,9024899,8940279,41.05962584068165,26.6190662715796,NaN,NaN,0.7425340209272251,-1.7985036372753775
1996-04-25T09:30:00-04:00,65.14062,65.5625,64.75,65.29687,475500,774535,56.76409847695977,47.951397138407415,NaN,NaN,69.76097283806968,47.81397288456178,0.11782353624145843,0.07978542331080973,-0.038038112930648696,9500399,9283459,44.57033903799682,26.688179218155955,NaN,NaN,2.5150878323356114,-1.1822762844738077
1996-04-26T09:30:00-04:00,65.46875,65.8125,65.23437,65.4375,563300,752635,58.002780067264624,48.84888315744555,NaN,NaN,94.06849726935205,66.34461810583825,0.1342880218716904,0.1298219144089643,-0.004466107462726097,10063699,9562279,47.316005599529255,27.258823014062667,NaN,NaN,4.354079934856552,-0.3913682531408993
1996-04-29T09:30:00-04:00,65.15625,65.5625,65.15625,65.4375,219900,740745,58.002780067264624,49.88486913013683,NaN,NaN,75.14590139372987,72.70024324826691,0.13760875913690743,0.1675448414584082,0.029936082321500766,10063699,9675319,48.43128779201537,28.423626729728284,NaN,NaN,5.884778809111943,0.5052241843237923
1996-04-30T09:30:00-04:00,65.4375,65.5625,65.125,65.39062,184400,711295,57.367362756300516,51.41401940632816,NaN,NaN,71.1268344686759,75.05167848210556,0.1292117607517278,0.1914507832611605,0.06223902250943271,9879299,9706399,48.75251489101257,30.115431994139414,NaN,NaN,7.027441884581981,1.436969570074962
1996-05-01T09:30:00-04:00,65.375,65.79687,65.28125,65.53125,561900,707450,58.82457684276796,53.0796830867323,NaN,NaN,88.23603732604916,79.66764865917533,0.12558244760470938,0.21921708201531942,0.09363463441061005,10441199,9989659,51.705187516172394,32.424764186453665,NaN,NaN,8.393377202591324,2.430742089005871
1996-05-02T09:30:00-04:00,65.01562,65.375,64.09375,64.40625,1299600,758030,45.44299778501189,53.22849989180196,NaN,NaN,1.030092004948747,65.92147249255115,0.04407590413353189,0.14872951457752492,0.10465361044399303,9141599,9917899,50.90501220353617,34.90207643180662,NaN,NaN,5.783363173429191,2.9096879582092026
1996-05-03T09:30:00-04:00,64.78125,64.98437,63.75,64.3125,1329300,777750,44.53383410720817,52.98708767125779,NaN,NaN,-23.24619658114826,42.45853372245109,-0.016258362969429646,0.08433065673220597,0.10058901970163561,7812299,9467619,46.08552852390429,37.12515205328939,NaN,NaN,3.3780634916234176,2.9765987486969476
1996-05-06T09:30:00-04:00,64.5625,64.5625,63.6875,64.25,647500,699265,43.90321825371878,52.59030482740962,NaN,NaN,-44.3158247305178,18.566188497601548,-0.05812807734850367,0.027928923016006024,0.0860570003645097,7164799,8887839,40.73743596730887,38.997128516071676,NaN,NaN,1.2130885066974502,2.724668714125591
1996-05-07T09:30:00-04:00,64.25,64.25,63.76562,63.98437,582100,669325,41.23095072220619,52.09422370372147,NaN,NaN,-60.40601971014479,-7.7403823381625845,-0.09906048458882788,-0.037768605371525155,0.061291879217302725,6582699,8228519,35.66829472498556,40.52402513165031,NaN,NaN,-1.425705488975344,2.1317581136826003
1996-05-08T09:30:00-04:00,63.67187,64.78125,63.07812,64.78125,1694700,707085,50.88850617985335,52.22698552459443,NaN,NaN,-44.62141282801606,-34.311872368975635,-0.06922697658292983,-0.025241841511359553,0.04398513507157027,8277399,7795759,32.7846192053303,41.49855934844161,NaN,NaN,-0.9557957938544103,1.6906789840344558
1996-05-09T09:30:00-04:00,64.5625,65.0625,64.5,64.73437,593400,672955,50.364158337146684,52.21773319722142,NaN,NaN,11.574412453371547,-32.20300827929107,-0.05029169539150559,-0.01887948416781171,0.03141221122369388,7683999,7504239,30.96831911651779,41.92163046251715,NaN,NaN,-0.7311933503590726,1.3446972219782376
1996-05-10T09:30:00-04:00,65.375,65.59375,65.0625,65.375,925100,698645,56.899737128402634,52.356843494177994,NaN,NaN,83.14452615929723,-10.924863731201974,0.004810076635296125,0.03742480701781403,0.03261473038251791,8609099,7663599,33.148654303084385,42.05121927562612,NaN,NaN,1.5315568049166446,1.3713914481122957
1996-05-13T09:30:00-04:00,65.53125,66.64062,65.46875,66.35937,867500,717810,64.61052221835618,52.924752557489754,NaN,NaN,172.27140957210494,32.392583129322574,0.10161749913836629,0.15963660430547577,0.05801910516710948,9476599,8125959,39.15342678733064,42.23473225067192,NaN,NaN,6.337627310801739,2.0808537142107877
1996-05-14T09:30:00-04:00,66.625,66.9375,66.5625,66.76562,632300,727940,67.21718366356976,53.86090761471652,NaN,NaN,210.4137625906085,86.55653958947323,0.1823645356910639,0.28597477478093936,0.10361023908987546,10108899,8831199,46.97679456475467,42.65738715953428,NaN,NaN,11.162571165339479,3.3782419215148867
1996-05-15T09:30:00-04:00,66.78125,67.3125,66.64062,66.6875,466100,724980,66.20730332404669,54.5354222466513,NaN,NaN,193.75177300086028,134.2311767552485,0.21748533289844488,0.3754669052129316,0.1579815723144867,9642799,9104279,49.675023787791346,43.022007498805316,NaN,NaN,14.615500010202515,4.983564505613119
1996-05-16T09:30:00-04:00,66.3125,66.9375,66.28125,66.82812,514400,709770,67.1636471566697,55.18976989589452,NaN,NaN,149.07897580377556,161.73208942532932,0.23563117970438452,0.45252054694496735,0.21688936724058283,10157199,9598919,54.21943891233247,43.515109878291256,NaN,NaN,17.703714141934988,6.800728739373386
1996-05-17T09:30:00-04:00,67,67.29687,67,67.1875,427700,686900,69.5364579218505,56.013604028364945,NaN,NaN,167.85855647330604,178.67489548813109,0.25560992219890305,0.5364017699892116,0.2807918477903086,10584899,9994079,57.51971495763182,44.16428324726387,NaN,NaN,21.065828590181884,8.838600146631743
1996-05-20T09:30:00-04:00,67.65625,67.75,66.98437,67.64062,788500,684880,72.25842755072284,57.07725151368082,NaN,NaN,159.84015898886685,176.18864537148346,0.28108985059607455,0.6321541610354018,0.35106431043932723,11373399,10373439,60.46617928633437,45.00097356121542,NaN,NaN,24.82424789906365,11.122264111264872
1996-05-21T09:30:00-04:00,67.75,67.875,67.5,67.54687,352700,691245,70.84792861760398,57.93606235474054,NaN,NaN,143.24541313834285,162.75497548103033,0.2731414893510756,0.6924911721281717,0.4193496827770961,11020699,10555799,61.836507524988974,45.724639276130894,NaN,NaN,27.448353634655504,13.454562614606392
1996-05-22T09:30:00-04:00,67.625,68.1875,67.39062,68.1875,1218100,717200,74.50961636325718,60.01224939604377,NaN,NaN,136.07082049764048,151.21878498038637,0.29090146125179184,0.7829765093418359,0.4920750480900441,12238799,11074999,65.50281786992409,46.76733968087289,NaN,NaN,30.964842065829718,15.956031107638296
1996-05-23T09:30:00-04:00,68.28125,68.4375,67.53125,67.90625,967900,741820,70.33285123991944,61.85503633409458,NaN,NaN,118.91709287649178,145.18640839492963,0.26434866004734636,0.822510873149227,0.5581622131018806,11270899,11297739,66.96888081327941,48.25900770154254,NaN,NaN,32.59883560857325,18.33357460777186
1996-05-24T09:30:00-04:00,67.96875,68.32812,67.9375,68.17187,659100,746610,71.93305677132287,63.85716765678058,NaN,NaN,113.02652498628069,134.22000209752454,0.24571087460068364,0.8653008063527352,0.6195899317520516,11929999,11566759,68.6990838899007,50.25626826744195,NaN,NaN,34.44732597235979,20.63553908842728
1996-05-28T09:30:00-04:00,68.375,68.375,67.3125,67.48437,456400,758435,62.5315819497166,65.37864131588847,NaN,NaN,81.6167690173732,118.57532410322581,0.17162517467896332,0.8341214001007557,0.6624962254217924,11473599,11586799,68.83006465547456,52.62496611961974,NaN,NaN,33.06715667510004,22.41148445795196
1996-05-29T09:30:00-04:00,67.625,67.6875,66.8125,67.03125,649600,781695,57.22317023931168,65.83111732013549,NaN,NaN,48.630061196856516,99.65225371492853,0.08123590653587898,0.7640411085916412,0.6828052020557622,10823999,11547459,68.22649849756861,55.15652892620819,NaN,NaN,30.163439717819486,23.518906637933036
1996-05-30T09:30:00-04:00,66.9375,67.71875,66.75,67.375,895800,798390,59.997550147972326,66.51921673519448,NaN,NaN,49.497060429702834,82.337501701341,0.036035461184552475,0.7278495285364528,0.6918140673519003,11719799,11443659,66.56783302529081,57.699351348263406,NaN,NaN,28.6273479530464,24.248683968663517
1996-05-31T09:30:00-04:00,67.35937,67.64062,66.875,66.875,923500,779585,54.46428914893344,66.34525616523239,NaN,NaN,37.645603647296454,66.08320385550194,-0.03240030940978711,0.6513136805896664,0.6837139899994535,10796299,11348739,65.01136548332866,59.97525928970942,NaN,NaN,25.510336934527484,24.428920106644085
1996-06-03T09:30:00-04:00,66.89062,67.10937,66.70312,67.0625,503100,738275,56.09935225052852,65.73731545324469,NaN,NaN,23.57540952013868,48.192980762273535,-0.06786352481040547,0.5988845839864467,0.6667481087968522,11299399,11222619,62.90669817413545,61.671921531624044,NaN,NaN,23.48887303072395,24.294627667226923
1996-06-04T09:30:00-04:00,67.375,67.59375,67.25,67.53125,627100,737255,59.969260774380274,65.21960667544545,NaN,NaN,51.54688783806213,42.179004526411326,-0.06269774839950037,0.5883759232974768,0.6510736716969772,11926499,11313199,63.81281054400937,62.874494101570804,NaN,NaN,22.96445871304302,24.104603530914936
1996-06-05T09:30:00-04:00,67.5625,68.20312,67.42187,68.125,428000,729550,64.26617162733487,65.0809544113946,NaN,NaN,84.22828499820884,49.298649286681794,-0.024217196742756464,0.6208021757685316,0.645019372511288,12354499,11619299,66.76720906955626,64.09536447883974,NaN,NaN,23.899212965394284,24.075262021554842
1996-06-06T09:30:00-04:00,68.5,68.5,67.5,67.625,523300,670980,58.565145573799015,64.46677572690383,NaN,NaN,80.00675803892375,55.40058880852597,-0.036618177390848716,0.5992466507727272,0.6358648281635759,11831199,11641579,66.97853224942185,65.00672828863183,NaN,NaN,22.824194493519904,23.89653808897842
1996-06-07T09:30:00-04:00,66.1875,67.64062,66.1875,67.625,1422800,712450,58.56514557379902,63.68311055918588,NaN,NaN,-11.719710093736696,45.52752606031934,-0.04826834470911712,0.5755293972771796,0.6237977419862967,11831199,11848559,68.95363186307493,65.82343663902063,NaN,NaN,21.9819861101528,23.623030663431905
1996-06-10T09:30:00-04:00,67.53125,67.73437,67.29687,67.40625,548800,693635,56.042615148594734,62.52483824474815,NaN,NaN,21.60429663931532,45.133303484154666,-0.07268729639495364,0.5329386214926046,0.6056259178875583,11282399,11845159,68.88074895223072,66.42447732944179,NaN,NaN,20.529519863486854,23.181100549154042
1996-06-11T09:30:00-04:00,67.65625,68.03125,67.34375,67.34375,688700,684695,55.30959768002413,61.41495746349245,NaN,NaN,29.22258207741492,40.66844233202523,-0.09369221392901783,0.48851065047628595,0.5822028644053038,10593699,11578599,63.237323531542444,66.52453561562417,NaN,NaN,19.133355597355497,22.60285127032568
1996-06-12T09:30:00-04:00,67.5625,67.73437,67.10937,67.21875,1120600,709110,53.79413400438522,59.93528015214446,NaN,NaN,-18.96225828914636,20.03033367455419,-0.1152312289925479,0.43816382816461896,0.5533950571571669,9473099,11002319,53.10706593840244,65.63912476337264,NaN,NaN,17.541642732600145,21.87982147922203
1996-06-13T09:30:00-04:00,67.375,67.46875,66.82812,67.21875,1502000,760905,53.79413400438522,58.753943206749156,NaN,NaN,-62.44725738397181,-8.460469410024924,-0.12773605202221938,0.3937249921293926,0.521461044151612,9473099,10530699,46.5367479484375,64.17968670159823,NaN,NaN,16.22441348221845,21.071906051078663
1996-06-14T09:30:00-04:00,67.25,67.25,66.71875,66.9375,1468200,808595,50.20458182679958,57.201909282140356,NaN,NaN,-114.19312568996777,-28.95515252927114,-0.15158047666781538,0.33198544831684274,0.4835659249846581,8004899,9765439,38.26437371502239,62.00577883196405,NaN,NaN,14.090108801277315,20.074506443964186
1996-06-17T09:30:00-04:00,66.96875,67.21875,66.71875,66.89062,1101000,842260,49.61034798859245,56.278963999202915,NaN,NaN,-113.81009754025173,-56.03803136518455,-0.1659799513438755,0.2760909858048137,0.4420709371486892,6903899,8889739,31.38839827854217,59.3313740907546,NaN,NaN,12.135717758191442,18.94039377456808
1996-06-18T09:30:00-04:00,66.84375,67.03125,66.32812,66.34375,718000,838735,43.188457465836684,55.276484515383274,NaN,NaN,-162.5434992548448,-94.3912476316365,-0.20523456195037731,0.1855277347107176,0.3907622966610949,6185899,8008179,26.27052361296427,56.33451874185429,NaN,NaN,8.479129507892052,17.445927450757218
1996-06-19T09:30:00-04:00,66.65625,67,66.42187,66.64062,552100,848705,47.18525978239087,54.36132091784174,NaN,NaN,-123.26258617219086,-115.25131320824539,-0.20369681193002448,0.13614128174856432,0.3398380936785888,6737999,7461159,23.689390562414744,53.271772851648855,NaN,NaN,6.412449157182007,15.86971626596076
1996-06-20T09:30:00-04:00,66.70312,66.92187,66.1875,66.59375,1234400,849520,46.62751986589531,53.801551683339014,NaN,NaN,-131.16354343726002,-128.99457041890304,-0.19814422946786442,0.0921578068437583,0.2903020363116227,5503599,6667259,20.535829826074476,50.094948876130694,NaN,NaN,4.546856404671167,14.252164857205104
1996-06-21T09:30:00-04:00,66.5625,66.8125,66.375,66.8125,573300,829790,49.6205857853586,53.33878265011259,NaN,NaN,-104.72697035284335,-127.10133935147815,-0.17296344471662342,0.07409773041584344,0.24706117513246686,6076899,6281659,19.198983595580046,46.97296926337674,NaN,NaN,3.7423332304208086,12.750760339093063
1996-06-24T09:30:00-04:00,66.96875,67.21875,66.84375,66.9375,416500,817660,51.301184138182855,52.719634318955634,NaN,NaN,-38.01901686715104,-111.94312321685803,-0.1423887886834746,0.06907518927812362,0.21146397796159822,6493399,6199559,18.916623298768158,43.766098745859516,NaN,NaN,3.5102721165972928,11.430690593022238
1996-06-25T09:30:00-04:00,67.125,67.17187,66.78125,66.85937,454400,817560,50.17454011951305,51.71308921125408,NaN,NaN,-45.63874072027945,-88.56217150994493,-0.1226748818185329,0.05812037568843209,0.18079525750696498,6038999,6170179,18.810010889724765,40.34058459015727,NaN,NaN,3.018238266508985,10.22891168923463
1996-06-26T09:30:00-04:00,66.78125,66.92187,66.39062,66.40625,838200,826990,44.12252781867522,50.681473657316666,NaN,NaN,-110.43691905247931,-85.99703808600263,-0.1344531025828531,0.012728879278398608,0.1471819818612517,5200799,5862739,17.68668967560353,36.819738692027386,NaN,NaN,0.8581664451869564,8.89023379722782
1996-06-27T09:30:00-04:00,66.40625,67.04687,66.15625,66.875,1090500,836725,50.741765499319335,50.122660794853836,NaN,NaN,-77.62518266797,-75.28936593214465,-0.10621450948480064,0.014413845005250892,0.12062835449005153,6291299,6020279,20.312833173134138,33.345395928460185,NaN,NaN,0.8671906028304064,7.744084769456761
1996-06-28T09:30:00-04:00,67.15625,67.5,66.96875,67.10937,1060800,843590,53.69529791598939,49.95499527823916,NaN,NaN,20.83494484082339,-50.17698289341129,-0.06908996611806519,0.034265896842470056,0.10335586296053524,7352099,6275319,24.511682341126956,30.176176884809923,NaN,NaN,1.7589767173334836,6.88906933343915
1996-07-01T09:30:00-04:00,67.28125,67.70312,67.1875,67.6875,471300,842000,60.05748551430692,50.294130123545074,NaN,NaN,77.2393538913368,-27.125308741713713,-0.006246581058867412,0.09554763663695098,0.1017942176958184,7823399,6541319,28.729700929308635,27.711346698936076,NaN,NaN,4.616587461414038,6.5644290660069915
1996-07-02T09:30:00-04:00,67.625,67.64062,67.32812,67.4375,389400,830115,56.44578227606152,50.48353357152195,NaN,NaN,66.27540939608564,-4.7424787184406965,0.016587436912317538,0.12252851383621532,0.10594107692389779,7433999,6820319,32.960906499142155,26.272335310417482,NaN,NaN,5.8716680307178315,6.465463203822826
1996-07-03T09:30:00-04:00,67.40625,67.5,67.0625,67.29687,308300,824130,54.461704051725626,50.531217146331976,NaN,NaN,41.67339876815782,25.67958484568673,0.020089293517207965,0.13105269382040774,0.11096340030319977,7125699,7205299,38.39572498263084,25.69083367000272,NaN,NaN,6.3012511644995595,6.4420043410623595
1996-07-05T09:30:00-04:00,66.125,66.4375,65.375,65.57812,842900,840110,37.23511179619313,49.60482642986009,NaN,NaN,-231.95504645227257,-5.186387911173783,-0.0894671663933717,-0.0008705576885148503,0.08859660870485685,6282799,7203599,38.3809281820623,25.699158989077002,NaN,NaN,0.039192610731770744,5.527316951015132
1996-07-08T09:30:00-04:00,65.625,65.98437,65.125,65.3125,942000,816070,35.372971341222396,48.58787095504794,NaN,NaN,-228.7844064980306,-55.110258178944584,-0.17120398253737984,-0.12540836946686795,0.04579561307051188,5340799,6801339,34.94882642072953,25.953475284947526,NaN,NaN,-5.427895638146558,3.962286581134891
1996-07-09T09:30:00-04:00,65.60937,65.8125,65.375,65.57812,739200,825590,38.675730027246374,48.26553328086292,NaN,NaN,-175.76816071318981,-105.7117610998499,-0.19692650172488738,-0.20036251408559735,-0.003436012360709971,6079999,6452659,32.25627636548444,26.38102905298468,NaN,NaN,-8.542018750447177,2.1759572480517386
1996-07-10T09:30:00-04:00,65.5625,65.84375,64.92187,65.84375,1132300,847770,41.87483078004252,47.88621692355232,NaN,NaN,-159.9713340494105,-150.96110978894913,-0.1857424542888783,-0.23561408022180785,-0.04987162593292955,7212299,6408319,31.91950076899741,26.96889406774059,NaN,NaN,-9.940014105727064,0.44510419751190966
1996-07-11T09:30:00-04:00,65.5625,65.6875,63.875,64.51562,1587400,871110,32.691858234617825,46.89081252131821,NaN,NaN,-217.44845386739942,-202.78548031606059,-0.25329906740050234,-0.3664954601835575,-0.11319639278305516,5624899,6108159,29.661803307809876,27.620749316435973,NaN,NaN,-14.771919102352427,-1.728756273897281
1996-07-12T09:30:00-04:00,64.625,64.90625,64.07812,64.5625,1312000,861610,33.24830575779957,45.72136394792114,NaN,NaN,-182.69970503621312,-192.93441203284868,-0.2783401260542953,-0.4611215503509243,-0.18278142429662897,6936899,6238979,31.921880218601174,28.52952764665177,NaN,NaN,-18.161178048721123,-4.076245098872115
1996-07-15T09:30:00-04:00,64.71875,64.71875,62.65625,62.65625,1951300,885765,24.411011362777785,43.80063732110649,NaN,NaN,-219.83442313967515,-191.1444153611776,-0.39943036544655636,-0.6820693811048244,-0.28263901565826804,4985599,6167939,31.333105809427252,29.41641925455599,NaN,NaN,-25.121020101957154,-7.082641527884263
1996-07-16T09:30:00-04:00,62.84375,63.5,60.375,62.8125,4141000,1037765,26.14386246643555,42.08416034588667,NaN,NaN,-230.4061018785596,-202.07200359425156,-0.4418403058795385,-0.8349393980076911,-0.39309909212815264,9126599,6777259,41.328792837777,31.024903679416862,NaN,NaN,-29.51603381587777,-10.287411854740478
1996-07-17T09:30:00-04:00,63.75,64,63,63.5625,1340500,1068890,33.968750772495014,41.358890556873796,NaN,NaN,-129.2995911030766,-195.9376550049848,-0.39381297873499144,-0.8853653155468919,-0.49155233681190047,10467099,7428219,49.745359515599276,33.31480866798798,NaN,NaN,-30.1279685979204,-13.121777103766181
1996-07-18T09:30:00-04:00,63.75,64.54687,63.32812,64.4375,1432500,1112910,41.72584415414018,40.71489617507529,NaN,NaN,-86.21471776069166,-169.69090778364324,-0.2827442087682521,-0.8449825977722156,-0.5622383890039635,11899599,8683159,61.277842737880604,36.24088077975559,NaN,NaN,-27.67762327038487,-15.201183698997422
1996-07-19T09:30:00-04:00,64.28125,64.375,63.625,63.96875,1216000,1111990,39.07738710566569,39.67075968862359,NaN,NaN,-82.47006405611249,-149.64497958762314,-0.22309524672030145,-0.8411074474043403,-0.6180122006840388,10683599,9432499,66.25715132885611,39.222699993164824,NaN,NaN,-26.71785469332462,-16.846422412472737
1996-07-22T09:30:00-04:00,63.53125,63.75,63.01562,63.5,519800,1109315,36.57714378690777,37.9935924223808,NaN,NaN,-98.15000846443081,-125.30809665257425,-0.19829364206961742,-0.8658792532710606,-0.6675856112014432,10163799,10468139,71.67779797176367,42.29042121048303,NaN,NaN,-26.824927280227772,-18.271923107866314
1996-07-23T09:30:00-04:00,63.59375,63.9375,62.57812,62.6875,1479800,1162480,32.67471217295464,36.29565884358745,NaN,NaN,-101.31671650113151,-99.49021957708862,-0.2181191976448893,-0.9402346082575548,-0.7221154106126655,8683999,10379619,70.63332720216161,44.98130840355585,NaN,NaN,-28.28577996055628,-19.702474086822022
1996-07-24T09:30:00-04:00,61.9375,63.1875,61.625,62.8125,2463400,1262930,33.84411812900376,34.8229741348216,NaN,NaN,-111.5941731406297,-95.94913598459924,-0.20455070669314124,-0.977803793979092,-0.7732530872859508,11147399,10515679,71.3249815111289,47.33339815559143,NaN,NaN,-29.025368700523334,-21.03431617449364
1996-07-25T09:30:00-04:00,63.4375,63.5625,63.125,63.375,1989800,1320510,38.98045222074927,34.94764130800418,NaN,NaN,-68.34888203303413,-92.37596883906774,-0.1423763166878591,-0.9512234831457747,-0.8088471664579155,13137199,10763199,72.58975227006249,49.77688559044858,NaN,NaN,-27.955010032314675,-22.02298672561093
1996-07-26T09:30:00-04:00,63.5625,63.8125,63.39062,63.71875,642300,1298100,41.94675946277433,35.41719760240075,NaN,NaN,-50.587602643049266,-85.9994765564551,-0.0666315846055685,-0.8921366472148762,-0.8255050626093077,13779499,11382379,75.50081194267162,52.67345598487302,NaN,NaN,-26.138460485361907,-22.610911548432497
1996-07-29T09:30:00-04:00,63.625,63.71875,62.9375,63.01562,1297900,1309955,37.88940848803868,35.36103177817163,NaN,NaN,-65.06179560934714,-79.38183398543836,-0.053009458066556214,-0.8917668851925029,-0.8387574271259467,12481599,11845939,77.43314876980551,55.900375442324524,NaN,NaN,-25.87900353744504,-23.077781832577145
1996-07-30T09:30:00-04:00,63.4375,63.6875,62.9375,63.625,1868200,1379800,43.03232971691944,35.44371027366284,NaN,NaN,-50.19441245722119,-69.15737317665631,0.004843469665103184,-0.8327030900445678,-0.837546559709671,14349799,12979099,81.31318951003634,59.428496066684446,NaN,NaN,-23.992917820818953,-23.20851554518312
1996-07-31T09:30:00-04:00,63.67187,64.26562,63.51562,64.09375,767100,1398685,46.68910244504689,36.44351343155063,NaN,NaN,-11.85408994594702,-49.20935653771976,0.07840094331238467,-0.7395453805691901,-0.8179463238815747,15116899,13772999,83.45897798807057,63.271151400988785,NaN,NaN,-21.26053042040788,-22.930231955929514
1996-08-01T09:30:00-04:00,64.15625,65.39062,64.0625,65.15625,1168600,1441700,53.91082480183717,37.91940764898188,NaN,NaN,67.38462237286267,-22.062655656540393,0.19565876405846705,-0.5733728688084909,-0.769031632866958,16285499,14402659,84.93640286202263,67.05790301837604,NaN,NaN,-16.394830432155942,-21.996603166819003
1996-08-02T09:30:00-04:00,66,66.59375,65.75,66.5625,1098500,1454480,61.369668526383414,40.55931173209657,NaN,NaN,172.05339916251108,22.465544704571677,0.35565164306313124,-0.32446707903804395,-0.6801187221011752,17383999,15123559,86.43075315735621,70.99344925751382,NaN,NaN,-9.343732849054886,-20.18905026428127
1996-08-05T09:30:00-04:00,66.57812,66.59375,65.96875,66.17187,710200,1442890,58.53578647083639,42.873020589553775,NaN,NaN,156.50868483747087,66.77964079393527,0.4185596517793482,-0.15691915737698992,-0.5754788091563381,16673799,15961999,87.93042840605852,74.32213751239105,NaN,NaN,-4.781163600561022,-17.987923598035522
1996-08-06T09:30:00-04:00,66.15625,66.51562,65.79687,66.375,640000,1437930,59.58100397385836,44.702467246794015,NaN,NaN,146.85462460015106,106.18944820540973,0.4542573968338397,-0.007657063114038465,-0.46191445994787816,17313799,16554799,88.86726578551969,77.11655938881394,NaN,NaN,-0.8610835239085466,-15.541232158874525
1996-08-07T09:30:00-04:00,66.625,66.75,66.125,66.54687,917800,1427205,60.48854640787419,46.04266026491787,NaN,NaN,151.0052180026212,138.7613097951234,0.4679986563269388,0.12308386046079534,-0.3449147958661435,18231599,17177739,89.76620775765932,79.15144260451243,NaN,NaN,2.5530720681779093,-12.956331555009893
1996-08-08T09:30:00-04:00,66.5625,66.5625,66.1875,66.4375,925100,1394090,59.57189200090841,47.50655347172093,NaN,NaN,126.65603518627039,150.61559235780493,0.448242933132745,0.21538887054978773,-0.23285406258295724,17306499,17381939,90.04983903870328,80.85092029807295,NaN,NaN,5.0480983917730295,-10.384270134040904
1996-08-09T09:30:00-04:00,66.67187,66.76562,66.0625,66.21875,648800,1360930,57.68885466017788,49.014532819811656,NaN,NaN,107.23539977557495,137.6519924804177,0.40052556540596107,0.2678028941744941,-0.13272267123146697,16657699,17236679,88.1776443517206,82.02948075378414,NaN,NaN,6.594554235282804,-7.9587237955660886
1996-08-12T09:30:00-04:00,66.25,66.85937,66,66.70312,764200,1301575,60.65454605769885,51.01309238300767,NaN,NaN,100.57329749477947,126.46491501187943,0.38174240086060884,0.34445532984429406,-0.03728707101631476,17421899,17386299,88.44414510526839,83.30168203257749,NaN,NaN,8.78596916672865,-5.566624800952555
1996-08-13T09:30:00-04:00,66.57812,66.625,66,66.17187,805200,1134785,56.016909506066206,52.59686319565498,NaN,NaN,78.16234983233906,112.72646005831703,0.31639471496726446,0.35820632269276587,0.04181160772550138,16616699,17246879,86.48769465259087,84.38473297125334,NaN,NaN,9.348404488971182,-3.4359063309634497
1996-08-14T09:30:00-04:00,66.1875,66.46875,66,66.40625,533800,1094450,57.558710133724375,53.92388161801034,NaN,NaN,71.43684437085396,96.81278533196357,0.2734265132673994,0.3835947493097507,0.11016823604235124,17150499,17030659,83.40625371349398,85.15734021721273,NaN,NaN,10.2539515975406,-1.4802123411771568
1996-08-15T09:30:00-04:00,66.23437,66.625,66.20312,66.28125,632600,1054455,56.42273004683835,54.95787951687206,NaN,NaN,67.88374778544399,85.05832785179828,0.2231798164770144,0.3891430066386192,0.16596319016160482,16517899,16872939,81.13541862027775,85.55981212275604,NaN,NaN,10.696656063509725,0.25934028806382625
1996-08-16T09:30:00-04:00,66.46875,66.875,66.46875,66.84375,475100,1017410,60.22679122277468,56.553406855067486,NaN,NaN,76.9699825573297,79.00524440814924,0.21437108677449745,0.43392704862972664,0.2195559618552292,16992999,16939999,81.36770027341055,85.84085151587068,NaN,NaN,12.159956198758245,1.9594282753058858
1996-08-19T09:30:00-04:00,66.85937,66.92187,66.625,66.875,436400,1013240,60.43343768317978,57.7963431383718,NaN,NaN,74.3091735791286,73.75241962501904,0.19760491124988472,0.4665621009175851,0.2689571896677004,17429399,16941499,81.37322508911828,85.84513977151938,NaN,NaN,13.42216386928241,3.5969619315882464
1996-08-20T09:30:00-04:00,66.89062,66.90625,66.67187,66.82812,645700,971535,59.93039280701281,58.74214959279794,NaN,NaN,69.5104939852114,72.02204845559352,0.17129361783293162,0.4830742119588649,0.3117805941259333,16783699,16974899,81.50473298545495,85.70555084276113,NaN,NaN,14.349472413045364,5.133034857510692
1996-08-21T09:30:00-04:00,66.65625,66.8125,66.375,66.59375,266400,861685,57.35978373357837,58.98850380220802,NaN,NaN,55.72079416863921,68.87883841515057,0.1280233243256374,0.47180974953298005,0.34378642520734265,16517299,16848259,79.2209065767193,85.2973011080966,NaN,NaN,14.490408506865526,6.469802521704239
1996-08-22T09:30:00-04:00,66.75,67.34375,66.71875,67.21875,584800,791435,62.036277720595365,59.03611874465173,NaN,NaN,84.02759110767371,72.10760707959653,0.1309429531009742,0.5074651165835604,0.3765221634825862,17102099,16965099,79.78374822863373,84.82251504175929,NaN,NaN,15.898694293893778,7.816787060588459
1996-08-23T09:30:00-04:00,67.09375,67.20312,66.64062,66.85937,757100,797175,58.0910780508772,59.00435385751179,NaN,NaN,71.3115729681277,70.97592516175612,0.09954120116471254,0.5009486649384769,0.40140746377376435,16344999,16835499,77.28315744024022,84.06199568705799,NaN,NaN,16.030384333627357,8.990158099594016
1996-08-26T09:30:00-04:00,66.70312,66.78125,66.42187,66.53125,784700,771515,54.67242464296404,58.653741048162196,NaN,NaN,44.75262446374006,65.06461533867842,0.050041670077860645,0.46395955137109013,0.4139178812932295,15560299,16461679,70.42658546623143,82.74480423568025,NaN,NaN,15.185594092136363,9.875220384242922
1996-08-27T09:30:00-04:00,66.71875,66.84375,66.5,66.78125,389400,697575,56.760372139340824,58.3874428861241,NaN,NaN,62.33516621463553,63.629549784563245,0.028573861563098046,0.449635208247102,0.42106134668400397,15949699,16294879,67.54689525312943,81.15771048535669,NaN,NaN,15.03333706775756,10.612094196173585
1996-08-28T09:30:00-04:00,66.9375,67,66.65625,66.67187,227600,670600,55.554615057122,58.1004945329965,NaN,NaN,72.27166171471066,66.93972329377753,0.002801254054857427,0.42456291425257575,0.4217616601977183,15722099,16135839,64.82514880920603,79.35594689753545,NaN,NaN,14.579318507644127,11.178840526383663
1996-08-29T09:30:00-04:00,66.59375,66.59375,65.625,66.01562,680200,646180,48.84970965529491,57.46912703264771,NaN,NaN,-131.98129471444648,23.737946129353496,-0.05922482582849503,0.3477306279120995,0.40695545374059455,15041899,15723799,58.273764967523014,77.21995551294991,NaN,NaN,12.219511273352914,11.327507775950698
1996-08-30T09:30:00-04:00,66,66.01562,65.125,65.32812,1500900,666300,42.99531830923743,56.207753622043334,NaN,NaN,-249.31548597521422,-40.387465659314884,-0.14258168688564948,0.22872834513353268,0.37131003201918217,13540999,15162999,50.75537461742189,74.52790047810372,NaN,NaN,8.278045561748621,10.891870316778974
1996-09-03T09:30:00-04:00,64.46875,65.84375,64.375,65.75,1782000,719890,47.17872031343384,55.57645439399816,NaN,NaN,-235.60110867210093,-96.45821228648309,-0.16381555154758937,0.16654059258469545,0.3303561441322848,15322999,15115539,50.16549779692364,71.93345784555606,NaN,NaN,6.171755271963804,10.217568167519664
1996-09-04T09:30:00-04:00,65.75,66.75,65.48437,65.8125,930200,734400,47.79001191990478,54.87869023586819,NaN,NaN,-83.9695465817637,-125.71915484576293,-0.16756023456289593,0.1209058509286649,0.28846608549156083,16253199,15176239,50.95065771647674,69.61520098862626,NaN,NaN,4.640660645936044,9.420867093007718
1996-09-05T09:30:00-04:00,65.5,65.76562,65.01562,65.01562,616600,719340,41.237218574266876,53.79401084497023,NaN,NaN,-190.1685528166606,-178.2071977520372,-0.21460845513550791,0.020205516572175952,0.23481397170768387,15636599,15159139,50.70827650608391,67.44183369475527,NaN,NaN,1.1817053372731332,8.243843985045634
1996-09-06T09:30:00-04:00,65.25,66.17187,65.14062,65.9375,804900,713330,49.810858657859406,53.050015661762,NaN,NaN,-92.83137969039132,-170.37721474722616,-0.1761557647108502,0.014619265819121097,0.1907750305299713,16441499,15439059,54.52219293593628,65.52429745636427,NaN,NaN,0.8965061414043934,7.194224293096886
1996-09-09T09:30:00-04:00,66.1875,66.73437,66.07812,66.71875,719200,716850,55.708562979551665,52.71252461150284,NaN,NaN,26.06939807170114,-115.30023793784308,-0.09470169671538531,0.07239790963573967,0.16709960635112497,17160699,16162999,62.58515240751694,64.18229226482131,NaN,NaN,2.681565813429926,6.549558796001605
1996-09-10T09:30:00-04:00,66.625,66.90625,66.375,66.6875,669900,712135,55.427989234790076,52.39092435634408,NaN,NaN,47.18899579024261,-58.74221704537437,-0.042201162703300626,0.11434815297199918,0.1565493156752998,16490799,16396559,64.75614783766466,62.985964754264806,NaN,NaN,3.973183343037243,6.181505159863839
1996-09-11T09:30:00-04:00,66.5625,67.125,66.40625,67.0625,713500,707550,58.15174613702067,52.447493099447094,NaN,NaN,72.43010160989235,-27.462287407043164,0.015421803297379744,0.1758265697970245,0.16040476649964475,17204299,16586779,66.4629462486588,62.074681873689066,NaN,NaN,5.907189043745681,6.14231714327553
1996-09-12T09:30:00-04:00,67.25,67.73437,67.15625,67.53125,713300,716525,61.33261399233616,52.397231404571436,NaN,NaN,144.19208636845835,39.40984042998062,0.07918247590900557,0.2593828613859017,0.18020038547689615,17917599,17042979,70.19136539471991,61.389511671266646,NaN,NaN,8.551089831808047,6.486427527351604
1996-09-13T09:30:00-04:00,68.3125,68.625,68.125,68.5625,2008800,785335,67.23336735014276,53.05025206880469,NaN,NaN,235.3777614354931,105.0516686551575,0.17916466731727332,0.4041562196234878,0.22499155230621448,19926399,17739959,74.80069804369512,61.21219314294199,NaN,NaN,12.959624619107998,7.411169969031089
1996-09-16T09:30:00-04:00,68.65625,69.15625,68.5625,68.8125,1220200,822590,68.48878582730279,54.037135010543174,NaN,NaN,234.85164051463303,146.8081171437439,0.24634267091784617,0.5329198909535222,0.28657722003567604,21146599,18537139,78.83239945889858,61.8126084281325,NaN,NaN,16.892223628298712,8.765606206069322
1996-09-17T09:30:00-04:00,68.875,68.98437,68.23437,68.65625,604700,831005,66.7669840035883,54.751893000846565,NaN,NaN,175.48179776118536,172.46667753793244,0.2629506724652104,0.6152655606171891,0.35231488815197864,20541899,19347359,81.98683171627329,62.84403246121421,NaN,NaN,19.520082325171302,10.301959937369604
1996-09-18T09:30:00-04:00,68.5625,68.75,68.21875,68.48437,225500,809995,64.83603783841247,55.41485177093874,NaN,NaN,136.0901014282219,185.19867750159835,0.24539496968736907,0.65905860026119,0.41366363057382094,20316399,19969779,83.96386726976804,64.21108377982578,NaN,NaN,21.09908514351205,11.844406395389953
1996-09-19T09:30:00-04:00,68.375,68.79687,68.28125,68.75,410000,817175,66.45086552935123,56.67207719051419,NaN,NaN,123.47935873726405,181.0561319753595,0.23470797917109493,0.7070486045376896,0.47234062536659466,20726399,20531539,85.50967172207308,66.15650569086507,NaN,NaN,22.896723722759926,13.42330887072852
1996-09-20T09:30:00-04:00,68.59375,68.78125,68.375,68.64062,948400,835355,65.12463456488379,58.25274263734607,NaN,NaN,105.82172796797796,155.14492528185647,0.2044191850642536,0.7278646066969117,0.5234454216326581,19777999,20501859,85.04323530229736,68.6056385969276,NaN,NaN,24.011464271895598,14.935902499466675
1996-09-23T09:30:00-04:00,68.46875,68.75,68.15625,68.625,466800,820840,64.92535596889088,59.52035946987871,NaN,NaN,87.14075673453215,125.60274852583629,0.16894978034085872,0.7346326470587314,0.5656828667178727,19311199,20134779,79.28301762665652,70.68546144190852,NaN,NaN,24.87820136794911,16.35623090924988
1996-09-24T09:30:00-04:00,68.5625,69.25,68.3125,68.60937,1269800,845095,64.71197159201736,60.72907087502961,NaN,NaN,88.14893706399846,108.13617638639892,0.13170692515306448,0.7303165231592033,0.5986095980061388,18041399,19634679,72.1164038697022,72.19730045285318,NaN,NaN,25.54890155148904,17.6694695724269
1996-09-25T09:30:00-04:00,68.9375,68.9375,68.5,68.65625,1353300,893290,65.08265470838585,62.432316313180976,NaN,NaN,77.50846341696145,96.41984878414684,0.098993893022711,0.7223519642845275,0.6233580712618165,19394699,19450339,69.61833242186994,73.5480187325522,NaN,NaN,26.21232640991838,18.88987769206854
1996-09-26T09:30:00-04:00,68.75,69.1875,68.39062,68.625,773200,920570,64.59554689854019,63.4883654732296,NaN,NaN,71.9366267364865,86.11130238399133,0.06562323624683797,0.705387116570364,0.639763880323526,18621499,19029359,64.1530261496757,74.23593539067643,NaN,NaN,26.66227025160123,20.0002194862875
1996-09-27T09:30:00-04:00,68.71875,68.71875,68.375,68.6875,407600,906940,65.15722469034806,64.16326988114363,NaN,NaN,58.98205186359908,76.74336716311555,0.03942307540733225,0.6890427245826913,0.6496196491753591,19029099,18879579,62.279695601031506,74.21411704735604,NaN,NaN,27.186467207093717,21.02682630354553
1996-09-30T09:30:00-04:00,68.78125,69.0625,68.57812,68.625,578200,860805,64.06271555719619,64.78003604702978,NaN,NaN,62.53196192557137,71.8216082013234,0.011023637089537242,0.6633991955372807,0.6523755584477434,18450899,18707519,60.108282939937375,73.88212669751839,NaN,NaN,27.38641571761576,21.935339076984135
1996-10-01T09:30:00-04:00,68.70312,69.04687,68.4375,69,561400,799775,67.58144883024126,65.45358623940268,NaN,NaN,62.72935825917599,66.7376924403589,0.010629582561342166,0.6656625366494211,0.6550329540880789,19012299,18901699,61.729958885753014,73.54405617159655,NaN,NaN,28.448311757386698,22.865763745613073
1996-10-02T09:30:00-04:00,69.25,69.59375,69.15625,69.46875,609000,783715,71.35679975479594,66.16959950814982,NaN,NaN,96.47174558240671,70.53034887344793,0.03376809604164288,0.6972430741401325,0.6634749780984897,19621299,18947019,62.117034137827964,72.96731822467568,NaN,NaN,30.46281846697462,23.951057277236153
1996-10-03T09:30:00-04:00,69.5,69.53125,69.20312,69.40625,342200,769995,70.1831992018433,66.38030178327128,NaN,NaN,97.97488769632653,75.73800106541594,0.03646330991224611,0.7090541154887973,0.6725908055765512,19279099,19078539,63.27781845569165,72.14425539696116,NaN,NaN,31.860996023626285,25.08104852672046
1996-10-04T09:30:00-04:00,69.6875,70.34375,69.5,70.34375,754100,767455,76.44209304633074,66.948395156059,NaN,NaN,172.903352756658,98.52226124402772,0.08993832863391993,0.785013716368951,0.6950753877350311,20033199,19279359,65.03933640524008,71.15903660741412,NaN,NaN,35.20574986681764,26.527434432448626
1996-10-07T09:30:00-04:00,70.3125,70.625,70.25,70.42187,235100,743250,76.87764921495864,67.67058552829972,NaN,NaN,217.5338202459765,129.52263290810873,0.1173892848480248,0.8418119937950621,0.7244227089470373,20268299,19642839,68.02868989098909,70.16202647703668,NaN,NaN,38.05753620392912,28.17459182837441
1996-10-08T09:30:00-04:00,70.45312,70.6875,70.01562,70.14062,386200,729065,71.73536850759291,68.16339486181262,NaN,NaN,177.00928339563617,152.37861793540077,0.10388813059523261,0.854282872191078,0.7503947415958454,19882099,19816799,69.37821708842695,69.1201943212266,NaN,NaN,38.990429274303196,29.719711463507092
1996-10-09T09:30:00-04:00,70.25,70.375,69.51562,69.59375,528800,719830,62.922133033099335,67.91134254065177,NaN,NaN,102.73820489172134,153.63190979726372,0.048238709764253485,0.8106931288011623,0.7624544190369088,19353299,19763199,68.41991200084529,67.89949719828175,NaN,NaN,37.06549214271008,30.769108703393233
1996-10-10T09:30:00-04:00,69.59375,69.85937,69.375,69.45312,1562200,762275,60.851736292624636,67.60613552120468,NaN,NaN,60.109071288150524,146.0587465156285,-0.005095851442009303,0.7560846047343972,0.7611804561764065,17791099,19465599,63.20014015276478,66.33927611617229,NaN,NaN,34.856537890895765,31.353027158750738
1996-10-11T09:30:00-04:00,69.71875,70.3125,69.71875,70.3125,331300,678400,67.82004681555138,67.812899153109,NaN,NaN,109.72363223336414,133.42280241096972,0.00964629881836876,0.7732383296993675,0.7635920308809987,18122399,19083439,57.16865869453124,64.75967904959191,NaN,NaN,35.07207483505865,31.884319683937584
1996-10-14T09:30:00-04:00,70.3125,70.6875,70.29687,70.40625,201600,627470,68.47919492261556,68.08198653386602,NaN,NaN,127.62158313546225,115.44035498886687,0.01740210126909114,0.7853446574673626,0.7679425561982715,18323999,18694579,51.756126999979145,63.30537355889741,NaN,NaN,35.44998942348476,32.393701075301465
1996-10-15T09:30:00-04:00,71.125,71.125,69.95312,70.3125,776900,636080,67.00122689236815,68.21902740415047,NaN,NaN,112.64189373999247,102.56687705773815,0.008366949405768542,0.7784012429554821,0.7700342935497135,17547099,18227579,46.11005534781469,61.6262109107506,NaN,NaN,35.30764703978382,32.80997907022751
1996-10-16T09:30:00-04:00,70.5,70.65625,69.9375,70.65625,590100,654310,69.5926651419867,68.57596442153951,NaN,NaN,97.16665943329654,101.45256796605318,0.01718234821387321,0.7915122288170551,0.7743298806031819,18137199,17984359,43.45143787379007,60.14752603390163,NaN,NaN,35.96924906732515,33.261303355527176
1996-10-17T09:30:00-04:00,70.875,71.03125,70.54687,70.84375,792500,673435,70.93351112097568,68.98855630944148,NaN,NaN,119.618631524465,113.35448001331608,0.026713336569191393,0.8077215513146712,0.7810082147454798,18929699,18212079,46.55833427428901,59.024571653420026,NaN,NaN,36.91862281610551,33.78377756418122
1996-10-18T09:30:00-04:00,70.875,71.3125,70.71875,71.21875,695800,660805,73.45468659350897,69.65941138346383,NaN,NaN,128.81685438720098,117.17312444408344,0.04809813929885265,0.8411308888690456,0.793032749570193,19625499,18512699,50.430228637049325,58.33328206035659,NaN,NaN,38.50924039770447,34.45884368325597
1996-10-21T09:30:00-04:00,71.28125,71.625,70.9375,71.125,879200,681425,71.77847281775394,69.95919881114331,NaN,NaN,128.37893453687883,117.32459472436676,0.0457675012327583,0.8502421261111408,0.8044746248783825,18746299,18597159,51.4935412691314,57.60210937345504,NaN,NaN,39.32285658133623,35.153702668696006
1996-10-22T09:30:00-04:00,71.0625,71.07812,70.59375,70.625,848900,660380,63.46085052217456,69.39520243738463,NaN,NaN,79.79365240757824,110.75494645788392,0.0026644208999060393,0.8078051510032651,0.8051407301033591,17897399,18667219,52.405560536080394,56.90843268761593,NaN,NaN,37.494947744603266,35.48816625096847
1996-10-23T09:30:00-04:00,70.46875,70.89062,70.1875,70.85937,735900,629510,65.48010540265838,69.05926716601428,NaN,NaN,63.53528788662713,104.02867214855004,-0.016874796633190803,0.7840472343118705,0.8009220309450613,18633299,18766439,53.73233112396516,56.22661216392118,NaN,NaN,36.56478134602691,35.641968407405386
1996-10-24T09:30:00-04:00,70.85937,70.98437,70.21875,70.25,379300,609815,56.70560447121901,67.64951798207773,NaN,NaN,43.28421704070169,88.7617892517974,-0.0744274179957427,0.7078877584503829,0.7823151764461256,18253999,18631299,51.621564786796995,55.26819990546096,NaN,NaN,32.88280350815837,35.24780199322724
1996-10-25T09:30:00-04:00,70.23437,70.5625,70.125,70.3125,568300,617850,57.33706672829077,66.25376209017288,NaN,NaN,20.511998417118413,67.10081805778088,-0.10974229199366037,0.6451373114540502,0.7548796034477105,18822299,18470659,49.14994329835437,53.91971800598704,NaN,NaN,30.133890049062707,34.51724314406088
1996-10-28T09:30:00-05:00,70.375,70.73437,69.8125,69.84375,975400,637710,51.29436295852555,64.7936902652395,NaN,NaN,-15.406851061109005,38.34366093818331,-0.16292072173123862,0.5512287012836623,0.7141494230149009,17846899,18290779,46.46701282410276,52.28320341567818,NaN,NaN,25.80157319508857,33.27214743706483
1996-10-29T09:30:00-05:00,70.0625,70.57812,69.70312,70.40625,815900,650435,57.13268497379978,64.38015826100381,NaN,NaN,-13.624624566441003,19.66000554337947,-0.15832468587956228,0.516243565665448,0.6745682515450103,18662799,18443859,49.017525945991736,50.897318697474354,NaN,NaN,23.886252414729658,31.931305291016947
1996-10-30T09:30:00-05:00,70.625,70.625,70.09375,70.17187,495400,644755,54.21644944722161,63.90620920061788,NaN,NaN,-10.882225860043981,4.7765027940452445,-0.16825183202597516,0.4642534615125413,0.6325052935385165,18167399,18350679,47.5329918689845,49.77823667720433,NaN,NaN,21.3884955636317,30.4251896156762
1996-10-31T09:30:00-05:00,70.26562,70.875,70.1875,70.84375,726300,663960,60.4488198410146,63.37969298815097,NaN,NaN,51.40286081647131,6.400231549199174,-0.1285425539127475,0.4718271011475821,0.6003696550603296,18893699,18478619,49.781878538641195,49.250609523212184,NaN,NaN,21.263349313181706,29.116355286748416
1996-11-01T09:30:00-05:00,70.98437,71.15625,70.26562,70.59375,821300,667320,57.32203249459719,62.58275281472108,NaN,NaN,54.074002524049135,13.112632370585317,-0.11834300610444992,0.4524408974297671,0.570783903534217,18072399,18328639,47.22636896411027,48.927055377792975,NaN,NaN,20.142507922571742,27.834377091866035
1996-11-04T09:30:00-05:00,70.6875,71.0625,70.53125,71.0625,1608400,735985,61.3580707649056,62.17967023418805,NaN,NaN,92.78343686015631,34.75068995483836,-0.08103558918469123,0.469489417053353,0.5505250062380442,19680799,18695419,53.51142872070242,49.45572490442782,NaN,NaN,20.525372551334574,26.790233586075825
1996-11-05T09:30:00-05:00,71.29687,71.79687,71.28125,71.46875,764000,754875,64.49216809257639,61.815349016373034,NaN,NaN,188.82564210380727,75.24074328888801,-0.032497109004109626,0.5099036199829072,0.5424007289870169,20444799,19051819,58.66308869362163,50.54227139155865,NaN,NaN,21.88305040549465,26.08920741742137
1996-11-06T09:30:00-05:00,71.59375,72.875,71.53125,72.84375,1665000,811685,72.59414558210632,61.93396576359665,NaN,NaN,285.0210686749163,134.42140219588006,0.0824337460176724,0.6454429115091074,0.563009165491435,22109799,19840299,67.29729368068396,52.02362563487258,NaN,NaN,26.282761271426974,26.1168579679936
1996-11-07T09:30:00-05:00,72.625,73.29687,72.53125,73.01562,1446300,805890,73.41082899724609,61.930833078149305,NaN,NaN,276.3354714425512,179.40792432109603,0.15598436097065038,0.757989616704748,0.6020052557340976,23556099,20772779,74.16893111629207,53.71924724053277,NaN,NaN,29.912549411729,26.659099602812944
1996-11-08T09:30:00-05:00,73.03125,73.4375,72.75,73.42187,1355700,857110,75.28556073453557,62.18133935791942,NaN,NaN,227.5927489353304,214.1116736033523,0.21434506247904994,0.8699365838329101,0.6555915213538601,24911799,22140659,80.60654457574691,55.7987474767196,NaN,NaN,33.49563714734904,27.635747823460957
1996-11-11T09:30:00-05:00,73.25,73.51562,73.21875,73.34375,655900,879825,74.20212237982275,62.948573062037156,NaN,NaN,188.09490461776147,233.1739671548733,0.22872575853004573,0.9414987195164173,0.7127729609863716,24255899,23055679,83.55839299641423,58.02394979531488,NaN,NaN,35.93164698242845,28.820876274742027
1996-11-12T09:30:00-05:00,73.54687,73.59375,73.01562,73.125,719900,876975,71.11588282792889,63.35112859241362,NaN,NaN,145.0818808226159,224.42521489863503,0.20529078901183695,0.9693864472511677,0.7640956582393308,23535999,23673919,85.19776443519721,60.27148074611716,NaN,NaN,36.95601729033264,29.983039276969258
1996-11-13T09:30:00-05:00,73.20312,73.5625,73.01562,73.45312,481900,871565,72.93433283795241,64.51032347575172,NaN,NaN,126.9026001547882,192.80152119460942,0.1938142593303922,1.006363482402321,0.8125492230719289,24017899,24055539,86.11789038843322,62.73550400337689,NaN,NaN,38.37534418286571,31.18193997781161
1996-11-14T09:30:00-05:00,73.1875,73.9375,73.15625,73.9375,558800,859880,75.39680825272949,65.80030501321163,NaN,NaN,125.11045146755298,162.5565171996098,0.19996507296164956,1.062505564273991,0.8625404913123413,24576699,24259659,86.5977741105136,65.41034906138826,NaN,NaN,40.37204988788554,32.49481282210788
1996-11-15T09:30:00-05:00,74.125,74.5,73.71875,74.03125,2250900,937635,75.85469246003281,67.55461426331928,NaN,NaN,125.47750502729697,142.13346841800313,0.1914570732014822,1.101861832814194,0.9104047596127118,26827599,24642819,87.47316344073924,68.33935981971943,NaN,NaN,42.11898119009106,33.86969401753405
1996-11-18T09:30:00-05:00,74.17187,74.25,73.73437,74.04687,1518200,969585,75.9350531315244,68.89764056029962,NaN,NaN,105.49534579571674,125.61355665359417,0.16878477313053275,1.1213857260258777,0.952600952895345,28345799,25460799,89.10867047825592,71.20301300059545,NaN,NaN,43.555834831788346,35.253428419570376
1996-11-19T09:30:00-05:00,74.14062,74.59375,74.03125,74.57812,1029300,978605,78.54988107217328,70.63574281922475,NaN,NaN,109.73952002345818,118.54508449376264,0.17094469082149444,1.166281816422213,0.9953371256007186,29375099,26628619,90.92946806726582,74.30276130047268,NaN,NaN,45.62414029609821,36.73495868764578
1996-11-20T09:30:00-05:00,74.5625,75.01562,74.3125,74.70312,730000,978310,79.12464284754485,71.96973017683403,NaN,NaN,109.87490483543995,115.13954542989298,0.16224019161628123,1.1981373651210703,1.035897173504789,30105099,27846059,92.3628680843368,77.34426055373665,NaN,NaN,47.50076023468795,38.27293033722323
1996-11-21T09:30:00-05:00,74.79687,74.84375,74.375,74.59375,653000,991995,77.17608282891709,73.38787662928546,NaN,NaN,97.88182487080948,109.69382011054427,0.13185566652767067,1.2007167566643773,1.0688610901367066,29452099,28821139,93.27897753060005,80.6337325942002,NaN,NaN,48.52850867754393,39.73801295726904
1996-11-22T09:30:00-05:00,74.70312,75.25,74.70312,75.17187,965100,1011835,79.98229653400789,74.71817846993564,NaN,NaN,108.58472382890929,106.31526387086674,0.13304880820276166,1.2351721003901588,1.1021232921873971,30417199,29539059,93.86271042960452,83.51596700197892,NaN,NaN,50.296891247083686,41.24642414152828
1996-11-25T09:30:00-05:00,75.25,76.15625,75.07812,76.125,2058800,1066005,83.56912141608717,76.08081799304354,NaN,NaN,134.86460634183473,112.18911598009034,0.17760069014747404,1.3241241548717397,1.1465234647242657,32475999,30365099,94.4590241350021,86.07281953350609,NaN,NaN,53.15632682680672,42.947838810853774
1996-11-26T09:30:00-05:00,76.28125,76.6875,75.46875,75.875,2861800,1168300,79.54314493959389,76.57717509000693,NaN,NaN,138.2952014505739,117.90025226551347,0.16980777345802567,1.358783181546798,1.1889754080887722,29614199,30412919,94.49238634574994,88.01532615243939,NaN,NaN,54.195064429935194,44.554585327865404
1996-11-27T09:30:00-05:00,76.0625,76.1875,75.64062,75.73437,872000,1187130,77.28756777840732,76.85408500294703,NaN,NaN,120.13922519145899,119.95311633671729,0.13620738026945145,1.3592346334255865,1.223027253156135,28742199,30140339,91.12438488282254,89.22642999290585,NaN,NaN,54.34387258175233,45.953054935563536
1996-11-29T09:30:00-05:00,76,76.21875,75.85937,76.01562,1073400,1204485,78.59485876269159,77.0904634335296,NaN,NaN,118.51387171103922,124.07952570476326,0.11480570075793617,1.3665343791035554,1.2517286783456192,29815599,30213039,91.21432956051733,89.98412892038945,NaN,NaN,54.859070632171814,47.22534289222186
1996-12-02T09:30:00-05:00,75.92187,76.125,75.39062,76.04687,1350600,1230950,78.74127458742663,77.41468859121561,NaN,NaN,101.47718610766566,122.65801816051453,0.08595576868618382,1.3591733892033488,1.273217620517165,31166199,30362839,91.40755132391632,90.54478308663961,NaN,NaN,55.31737508705932,48.381347491484355
1996-12-03T09:30:00-05:00,76.0625,76.57812,74.75,74.75,1777800,1239420,60.305611862382484,76.64252637939084,NaN,NaN,66.50755021419279,108.98660693498614,-0.031003648935671535,1.2344630593475756,1.2654667082832471,29388399,29745319,83.27682761546541,90.40757331380162,NaN,NaN,49.492472779859625,48.54007967553797
1996-12-04T09:30:00-05:00,74.875,75.0625,74.09375,74.95312,2365100,1319475,61.813626834159834,75.84819023626281,NaN,NaN,18.90064504322284,85.10769565351592,-0.10126065806073692,1.138890885707326,1.240151543768063,31753499,30173179,84.31768818253842,90.278987441952,NaN,NaN,45.33047465018755,48.08156467191648
1996-12-05T09:30:00-05:00,74.84375,75.14062,74.53125,74.75,1697700,1321110,59.38404785057994,74.70442163610927,NaN,NaN,19.763190746147036,65.03248876445353,-0.16425700803011867,1.0348302837304146,1.1990872917605333,30055799,30435899,84.93761958090609,90.16040497555146,NaN,NaN,41.18814604604661,47.0967905825065
1996-12-06T09:30:00-05:00,73.25,74.75,72.65625,74.3125,3401800,1418885,54.422309938017435,73.17353717025104,NaN,NaN,-56.56346349172656,30.017021723900353,-0.23398335383964097,0.906608099460982,1.140591453300623,26653999,29803579,77.04359368162409,89.41543570704323,NaN,NaN,36.075704719689554,45.522349744961225
1996-12-09T09:30:00-05:00,74.6875,75.42187,74.57812,75.40625,1864600,1444330,62.792246466624,72.23476526561528,NaN,NaN,38.4815429834543,17.417893099058084,-0.20601866728125673,0.8830681191990521,1.0890867864803089,28518599,29274059,71.08547102218421,88.12806431732382,NaN,NaN,34.206089744606274,43.90574117348195
1996-12-10T09:30:00-05:00,75.5625,75.67187,74.96875,75.04687,1331600,1478115,58.96087471058619,70.83555052550193,NaN,NaN,40.681941682037774,12.252771392627078,-0.21055489291065932,0.8258931703419847,1.036448063252644,27186999,28833779,66.48177354231171,86.38180042268424,NaN,NaN,31.40162460281024,42.11943880624313
1996-12-11T09:30:00-05:00,73.625,74.625,73.3125,74.35937,1847900,1534515,52.37685433697332,68.92499420331825,NaN,NaN,-71.47401540586763,-5.8221606971910145,-0.25568421886883497,0.7168427896666003,0.9725270085354353,25339099,27550899,55.25318840538381,83.73110901704472,NaN,NaN,26.73337139685913,39.92142917633113
1996-12-12T09:30:00-05:00,74.78125,74.875,72.9375,73.125,2540200,1637430,43.07605085402812,66.48927763368332,NaN,NaN,-119.58885256454792,-33.69256935933,-0.3582079696122139,0.5247670465201679,0.8829750161323818,22798899,26099519,45.82362356440951,80.34144087660255,NaN,NaN,19.047961913540952,36.93950528164682
1996-12-13T09:30:00-05:00,73.0625,73.57812,72.40625,73.3125,1678300,1693405,44.68292139852567,63.96789369543459,NaN,NaN,-164.79946077548374,-55.339768816081445,-0.39977411939654894,0.38325736688669565,0.7830314862832446,24477199,25664159,43.42937121550189,76.73905950416666,NaN,NaN,13.761932721463191,33.62842348733487
1996-12-16T09:30:00-05:00,73.5,73.6875,72.0625,72.375,1831100,1672415,38.78729389298305,60.76919172949858,NaN,NaN,-178.28607329946414,-98.69329207266513,-0.4718379652990127,0.19323402965947878,0.6650719949584915,22646099,24489659,37.70567708406847,72.68524900052854,NaN,NaN,7.104844967722871,29.839340841676012
1996-12-17T09:30:00-05:00,72.15625,73.28125,71.875,72.95312,2023200,1697665,43.71883811696906,58.21031267073967,NaN,NaN,-158.98122659842628,-138.62592572875795,-0.4614407286064389,0.08827108420044283,0.5497118128068817,24669299,23986119,35.54290181170603,68.47457153381113,NaN,NaN,3.48447988929436,26.07436070562149
1996-12-18T09:30:00-05:00,73.375,73.76562,73.26562,73.53125,1666800,1729540,48.21210111772406,56.13349362354801,NaN,NaN,-84.46481811713119,-141.22408627101066,-0.3988511682709871,0.0511478524681479,0.449999020739135,26336099,24185519,37.08196227888903,64.61439849067301,NaN,NaN,2.1175586502260866,22.651960411993578
1996-12-19T09:30:00-05:00,74.1875,75.125,73.89062,75.04687,2269300,1806505,57.73786339736106,54.64370824031011,NaN,NaN,3.6380473291293067,-116.5787062922752,-0.24609203464244167,0.1423839774360829,0.38847601207852456,28605399,25346819,45.277128497915804,61.33316984334433,NaN,NaN,4.527922292657853,20.06281210923133
1996-12-20T09:30:00-05:00,75.125,75.71875,74.75,74.84375,1543200,1851015,56.24472424501733,53.03681178728089,NaN,NaN,32.697550452215594,-77.07930404673534,-0.15394932353973223,0.19603935765385927,0.3499886811935915,27062199,25863819,48.49356435067921,58.26788505954169,NaN,NaN,5.825929589733727,18.028971749303103
1996-12-23T09:30:00-05:00,75.09375,75.20312,74.32812,74.65625,1263700,1865945,54.83501100920874,52.64605458348276,NaN,NaN,6.05569249318137,-40.21095088820624,-0.10328237135765728,0.22088571699651993,0.3241680883541772,25798499,26494299,52.184529184048465,56.04700660015476,NaN,NaN,6.371918514193821,16.363678430001777
1996-12-24T09:30:00-05:00,74.84375,75.20312,74.79687,75.20312,633000,1794655,58.13116415750981,52.38302153515061,NaN,NaN,35.23826951434274,-1.367051665652434,-0.034166487510645716,0.28145997896587005,0.31562646647651577,26431499,26846739,54.161967478654276,53.89302654987731,NaN,NaN,7.908565361336314,15.15580513447814
1996-12-26T09:30:00-05:00,75.4375,75.82812,75.375,75.78125,1384300,1720780,61.34304349692741,52.522949795604006,NaN,NaN,83.76824048284331,32.27956005434246,0.044962472956058486,0.3718295576715889,0.3268670847155304,27815799,27142679,55.81438051431819,51.812795187978175,NaN,NaN,10.24292063087187,14.453964491105815
1996-12-27T09:30:00-05:00,75.78125,76.03125,75.5,75.875,410400,1697700,61.85407414880736,53.05379009637472,NaN,NaN,95.22659916740986,50.597270421998566,0.0952048864295536,0.4458731927524724,0.3506683063229188,28226199,27066839,55.264562808981836,50.2571501256466,NaN,NaN,12.250006817718964,14.139113394907692
1996-12-30T09:30:00-05:00,76.125,76.125,75.15625,75.21875,694100,1678735,56.24858382158541,52.58638562172911,NaN,NaN,75.18311400604634,59.09438313276471,0.07662774247978421,0.446452984422649,0.3698252419428648,27532099,27160819,55.84502515600819,49.168546849491165,NaN,NaN,12.250293080810142,13.869281921465186
1996-12-31T09:30:00-05:00,75.28125,75.375,73.84375,73.84375,1378100,1680110,46.69924649029207,51.71055503456524,NaN,NaN,-11.569969055803545,55.56925082296773,-0.03015391821764013,0.3321328441708147,0.3622867623884548,26153999,27231919,56.30693132060773,48.44177240508373,NaN,NaN,9.003166993567556,13.174122646051238
1997-01-02T09:30:00-05:00,74.375,74.375,72.75,74.03125,2031900,1692815,47.99577924489965,51.39762109941712,NaN,NaN,-58.06138832269902,36.909319255559375,-0.08683896351072146,0.253738058000053,0.34057702151077446,28185899,27582799,58.60817389680805,48.68141422589974,NaN,NaN,6.865896406275778,12.272947468940458
1997-01-03T09:30:00-05:00,74.375,75.125,74.07812,75.09375,2123200,1680720,54.71766743471032,52.229165140894416,NaN,NaN,29.615580128961525,26.07878718478302,-0.0531145176551997,0.27418387444177483,0.32729839209697453,30309099,28081459,61.69581412732878,49.81514212325112,NaN,NaN,7.246232974111738,11.554845398250642
1997-01-06T09:30:00-05:00,75.09375,75.4375,74.3125,74.4375,1374100,1664540,50.38570123567814,52.63650655783389,NaN,NaN,27.007027132476093,12.434872777796269,-0.07405659640631673,0.23472764658907863,0.30878424299539536,28934999,28223219,62.55104941430442,51.180976280308435,NaN,NaN,6.1200242161586855,10.778442372237505
1997-01-07T09:30:00-05:00,74.4375,75.46875,74.125,75.34375,939000,1541400,55.61191618336394,53.83826529286109,NaN,NaN,43.9401453165188,6.186279039890765,-0.02828088566260034,0.2734331359171449,0.30171402157974525,29873999,28691599,65.30723002425765,53.15251577603624,NaN,NaN,6.939712368085983,10.23005237164443
1997-01-08T09:30:00-05:00,75.75,75.78125,74.6875,74.6875,1802200,1538280,51.39040062896186,54.38623404371772,NaN,NaN,50.704479435370864,18.641168738125646,-0.04273803725589331,0.24829147500987858,0.2910295122657719,28071799,29075159,67.4217666031892,55.429577546856464,NaN,NaN,6.2037360979035565,9.65486433253859
1997-01-09T09:30:00-05:00,75.0625,75.875,74.9375,75.3125,1415700,1542485,54.90161172219009,54.86405622975101,NaN,NaN,77.05890617659972,45.6652276379854,-0.012326321883431635,0.2756216099114823,0.28794793179491396,29487499,29335479,68.81118795289292,57.695950809285314,NaN,NaN,6.75978493120179,9.241281560919047
1997-01-10T09:30:00-05:00,74.25,76.25,74.25,76.125,2369500,1568565,59.043390783820506,54.95730818592669,NaN,NaN,83.59079356673432,56.46027032553995,0.056608003822705755,0.35870793657329614,0.3020999327505904,31856999,29645059,70.42650978728311,59.49233518709726,NaN,NaN,8.61055653489856,9.151177985773263
1997-01-13T09:30:00-05:00,76.5,76.5,75.64062,76.01562,1364600,1509785,58.267586507335466,55.10179834752085,NaN,NaN,118.56509618316187,74.77188413567711,0.08711265510535449,0.4109907516322835,0.323878096526929,30492399,29956539,71.99792995088382,61.17121844425474,NaN,NaN,9.823901372843444,9.24728132678329
1997-01-14T09:30:00-05:00,76.6875,77.39062,76.5,76.96875,2111200,1531430,62.848537983624624,55.6741931314077,NaN,NaN,181.22642036207324,102.229139144788,0.1595395853599344,0.523302578226847,0.3637629928669126,32603599,30502459,74.5503656420785,62.768778191256885,NaN,NaN,12.36560632575563,9.69275632663648
1997-01-15T09:30:00-05:00,76.71875,77.20312,76.375,76.78125,1583900,1519070,61.420212063599585,55.90912512469982,NaN,NaN,158.15498621017775,123.71924049974936,0.18128988367392151,0.5903753474593145,0.409085463785393,31019699,31092039,76.98977130255811,64.39933560725001,NaN,NaN,13.966235741571914,10.30325338591297
1997-01-16T09:30:00-05:00,77.03125,77.29687,76.5,77.09375,1308400,1483330,62.93224701893506,56.02263966198608,NaN,NaN,156.40224058792253,139.58790738201395,0.2016324998715464,0.661126088624826,0.4594935887532796,32328099,31660159,79.07149334011605,66.06055795194986,NaN,NaN,15.740254927700349,11.079967891882596
1997-01-17T09:30:00-05:00,77.20312,77.75,77.10937,77.5625,1604000,1480190,65.13930612922866,56.25729908915895,NaN,NaN,177.38687878895675,158.3471244264584,0.22953836335254574,0.7464165429439618,0.516878179591416,33932099,32075179,80.46206715818937,67.86037969117898,NaN,NaN,17.901055249892263,12.054408943026834
1997-01-20T09:30:00-05:00,77.75,78.09375,77.46875,77.65625,1889900,1461220,65.58070814730745,56.9238793981391,NaN,NaN,166.58504106034073,167.9511134018942,0.23626706393785046,0.8122120095137291,0.5759449455758786,35821999,33141099,83.4952879698432,69.83539846359577,NaN,NaN,19.79292098834667,13.15991066378681
1997-01-21T09:30:00-05:00,77.375,78.54687,77.10937,78.28125,2785800,1523350,68.44888800674931,58.47742522074319,NaN,NaN,153.0622338220679,162.31827609389313,0.2627342329591259,0.904362736774786,0.6416285038156601,38607799,34341939,86.11126194915829,71.96427922277795,NaN,NaN,22.291858035402196,14.46447457401758
1997-01-22T09:30:00-05:00,78.3125,78.84375,77.875,78.84375,1201600,1520245,70.80672844033775,60.10677873470306,NaN,NaN,157.73252141430686,162.23378313471895,0.2955982104121688,1.0111262668308711,0.7155280564187023,39809399,36099879,88.88793030485608,74.12711896620995,NaN,NaN,25.15549364400142,15.991763012586699
1997-01-23T09:30:00-05:00,79.0625,79.6875,76.90625,77.75,2601100,1618650,61.225669608075336,60.571636032800555,NaN,NaN,114.55189831222475,153.8637146795794,0.22437706564734528,0.9959993884778839,0.7716223228305387,37208299,37075919,90.07442341361232,76.15416248665876,NaN,NaN,24.786154755036723,17.248104690079558
1997-01-24T09:30:00-05:00,77.875,77.90625,76.75,76.75,2176000,1658235,54.027523517426005,60.83176619578255,NaN,NaN,52.92334491758445,128.97100790530493,0.0971224180996837,0.8930253454551433,0.7959029273554596,35032299,37295959,90.3252247531122,78.13803215371648,NaN,NaN,22.111371688877416,17.942857118479253
1997-01-27T09:30:00-05:00,76.875,77.23437,76.375,76.53125,2108500,1743140,52.571494006519515,60.6145931831508,NaN,NaN,26.935123067045687,101.04102430664594,-0.008945856319283352,0.7847206069563555,0.7936664632756388,32923799,36716319,84.28353728281718,79.49348267218501,NaN,NaN,19.511911055054817,18.167007680847192
1997-01-28T09:30:00-05:00,77.625,77.84375,76,76.75,4376000,1927235,53.90918016367416,60.79450600705883,NaN,NaN,31.759808307991854,76.78053920383073,-0.06823403095854463,0.7083739245774581,0.7766079555360027,37299799,36454719,81.62977581397737,80.5083404729556,NaN,NaN,17.785768004109347,18.112544869884644
1997-01-29T09:30:00-05:00,76.875,77.5,76.59375,77.5,1122700,1914465,58.25631814521954,61.03412789441807,NaN,NaN,45.34376076951981,54.30278707487331,-0.06103470819135315,0.7003145702968112,0.7613492784881644,38422499,36177339,78.7967563538731,81.22159535873989,NaN,NaN,17.596058960771426,18.038761168582756
1997-01-30T09:30:00-05:00,77.875,78.53125,77.40625,78.5,2126300,1919185,63.23532923111115,61.333552069224545,NaN,NaN,98.61246553971583,51.114900520371506,0.003553815877993416,0.7657915483356561,0.7622377324576627,40548799,36845439,80.54788774148744,81.94455092689734,NaN,NaN,19.01825981491743,18.178689546630565
1997-01-31T09:30:00-05:00,78.9375,79.40625,78.375,78.40625,3208100,1973430,62.48289346012667,61.63464542299534,NaN,NaN,130.47654390198818,66.62554031725224,0.03091827268493763,0.8008855733138347,0.7699673006288971,37340699,37307119,81.67421180885422,82.63571391675237,NaN,NaN,19.92532500686119,18.428208898092084
1997-02-03T09:30:00-05:00,78.71875,78.89062,78.35937,78.64062,755000,1942475,63.647448385528506,61.69171045170277,NaN,NaN,114.7872453257833,84.19596476899977,0.05438629809267048,0.8379501732447352,0.7835638751520647,38095699,38341499,83.9206243511467,83.30501811025724,NaN,NaN,21.01433486589651,18.797655464921288
1997-02-04T09:30:00-05:00,78.75,79.20312,78.4375,79.125,654100,1928230,65.99665466126952,62.01859920867919,NaN,NaN,123.50080288857257,102.54416368511593,0.09001297987132717,0.8960800999912237,0.8060671201198966,38749799,38631499,84.49449668389308,83.84106992320973,NaN,NaN,22.6370392685686,19.34613886544233
1997-02-05T09:30:00-05:00,79.23437,79.46875,77.125,77.64062,2255400,1950890,54.39568529856059,61.40884480008101,NaN,NaN,54.31174546834589,104.33776062488114,0.005546040775284866,0.8129996710890026,0.8074536303137178,36494399,38245879,80.38609162423626,83.93496980064688,NaN,NaN,20.410252833537324,19.49815514659876
1997-02-06T09:30:00-05:00,77.78125,78.20312,77.40625,78.15625,2483100,2004260,57.20951210463137,60.842430941181206,NaN,NaN,35.207509922875936,91.65676950151315,-0.022142031499357562,0.7797760909395208,0.8019181224388784,38977499,37931619,77.09612406066856,83.69454529368112,NaN,NaN,19.465171427256557,19.49344318669273
1997-02-07T09:30:00-05:00,78.8125,79.25,77.78125,79.21875,2321000,2001835,62.36279765007799,60.612580191379095,NaN,NaN,101.39287048362233,85.84003481783999,0.022159676441844245,0.8296177179911837,0.8074580415493394,41298499,38723179,79.38476854286415,83.4009367631826,NaN,NaN,20.346544846983246,19.615314852448517
1997-02-10T09:30:00-05:00,79.25,79.53125,78.42187,78.46875,1670000,2017105,57.132380831729506,59.80425825030625,NaN,NaN,100.13487078958342,82.9095599106,-0.006459206841407772,0.7993840329975797,0.8058432398389874,39628499,39029739,80.2095544919991,82.97938623052838,NaN,NaN,19.34746626774511,19.57705076891946
1997-02-11T09:30:00-05:00,78.78125,79.375,78.125,79.375,1664300,1994760,61.350562912801365,59.128817855482225,NaN,NaN,106.36436318578559,79.4822719700426,0.026429672691590023,0.8388803307034749,0.8124506580118849,41292799,39538339,81.52984394856847,82.4538086336507,NaN,NaN,19.91580840124001,19.625444716393822
1997-02-12T09:30:00-05:00,79.375,80.64062,79.26562,80.5,2675400,2049335,65.84375755587098,59.45868128032477,NaN,NaN,199.94889770992822,108.60970241835908,0.11004621233289402,0.9500084234280024,0.8399622110951084,43968199,41033099,84.74991615792115,82.07348668681561,NaN,NaN,21.95461587784394,19.95818345374384
1997-02-13T09:30:00-05:00,80.8125,81.5625,80.6875,81.375,1104800,2039155,68.87462451122639,60.51918849416764,NaN,NaN,243.7843406684653,150.32506856747696,0.20486931586182566,1.0960488559223904,0.8911795400605648,45072999,42252199,86.77500107290086,81.81989928108624,NaN,NaN,24.687668681075714,20.633824200505536
1997-02-14T09:30:00-05:00,81.1875,81.46875,80.90625,81.1875,1112900,2014600,67.49255290974347,61.584978415826505,NaN,NaN,200.5028183454612,170.14705813984472,0.23347248633565243,1.1830201479801303,0.9495476616444779,43960099,42784519,87.55228347002522,82.0533811516011,NaN,NaN,26.378272001237967,21.454459600610168
1997-02-18T09:30:00-05:00,81.34375,81.9375,80.75,81.875,833100,1961760,69.87922907541655,62.725696195236665,NaN,NaN,187.13813212840822,187.54771040760969,0.27437918502056036,1.2925216429201782,1.0181424578996179,44793199,43817459,88.91388369051447,82.57367457135375,NaN,NaN,28.558884097819742,22.46937738592582
1997-02-19T09:30:00-05:00,81.65625,82,81.15625,81.32812,648100,1854875,65.74425794709586,63.260549038227836,NaN,NaN,153.69234780784896,197.01330733202235,0.24145248656194274,1.3199580661020462,1.0785055795401035,44145099,44387919,89.5910592061639,83.34469620366023,NaN,NaN,29.062830929894773,23.41129932077853
1997-02-20T09:30:00-05:00,81.03125,81.35937,80.15625,80.34375,1193900,1854490,58.97916164404412,62.95653706772305,NaN,NaN,89.21108739107085,174.86574526825086,0.13550460830506617,1.2478863399214362,1.11238173161637,42951199,44184519,87.53787344889534,83.84398089704652,NaN,NaN,27.311348121336493,23.968449149429667
1997-02-21T09:30:00-05:00,80.40625,80.76562,80.14062,80.375,1844400,1816655,59.122965942522356,62.716542245037026,NaN,NaN,69.00933137977525,139.91074341051288,0.05384808536916541,1.1796918383278268,1.1258437529586613,44795599,44129039,86.95252301180756,84.2210031258289,NaN,NaN,25.973521889387946,24.25488811228085
1997-02-24T09:30:00-05:00,79.96875,81.375,79.96875,81.32812,787300,1747220,63.343789049828644,62.694852292487035,NaN,NaN,81.09892462047586,116.0299646655158,0.05040634227469587,1.1888516808020313,1.1384453385273354,45582899,44453599,87.47995803532056,84.47524124612703,NaN,NaN,26.105913327479,24.519320285880585
1997-02-25T09:30:00-05:00,81.40625,81.53125,80.875,81.39062,1653900,1724490,63.609143981885744,62.5243158153882,NaN,NaN,88.71475306287888,96.34528885240994,0.0392163557734857,1.1874657832441926,1.148249427470707,47236799,44942319,88.25019255041379,84.74350523659278,NaN,NaN,26.28970893045165,24.772232949390737
1997-02-26T09:30:00-05:00,81.3125,81.4375,79.625,80.59375,1597800,1585580,57.858229904644226,62.77164043010845,NaN,NaN,46.62947662763666,74.93271461636749,-0.03117584976612675,1.1092796152630484,1.1404554650291752,45638999,45241099,88.70757601653611,85.33789697889992,NaN,NaN,24.719155157791047,24.76465040773364
1997-02-27T09:30:00-05:00,80.8125,80.8125,79.375,79.39062,1813100,1620100,50.4429497293166,62.288314546157395,NaN,NaN,3.194476074051534,57.72939235296362,-0.1608402915641689,0.9394051005739641,1.100245392138133,43825899,45416039,88.97811379359344,86.18661053125167,NaN,NaN,20.936598793344892,24.217785891392392
1997-02-28T09:30:00-05:00,79.25,79.875,79.0625,79.15625,2961200,1661845,49.12221821914179,61.3425588725191,NaN,NaN,-31.42429238048233,37.64266760091212,-0.2586676108964512,0.7769108785175689,1.03557848941402,40864699,44629859,79.73330257594321,86.21150581932876,NaN,NaN,17.47740718087765,23.254874647033144
1997-03-03T09:30:00-05:00,78.75,79.75,78.6875,79.6875,1210400,1561960,52.17866849808118,60.9887222772585,NaN,NaN,-33.821216220759545,14.65863943266504,-0.28196213334297116,0.6831258227353061,0.9650879560782772,42075099,43928299,72.49479263215072,85.66045140076815,NaN,NaN,15.473602436430422,22.143264331232757
1997-03-04T09:30:00-05:00,79.90625,80.125,79.09375,79.25,1478700,1598145,49.53928383606362,60.145059486062955,NaN,NaN,-30.46258061032343,-9.176827301975417,-0.31850051836911375,0.5669623081168851,0.8854628264859988,40596399,42600219,61.17304166448969,84.20639409476254,NaN,NaN,13.006848387124123,20.838062053502952
1997-03-05T09:30:00-05:00,79.71875,80.59375,79.45312,80.59375,1254800,1628180,56.77197888339968,59.497075295172145,NaN,NaN,14.642489414039115,-15.574224744694925,-0.2470233565814003,0.5766836307592484,0.8237069873406487,41851199,41842659,55.81804854379842,82.13983212232519,NaN,NaN,13.046896884953776,19.72503845799593
1997-03-06T09:30:00-05:00,80.625,80.90625,79.875,80.125,1528500,1591835,53.87122373166515,58.42540381091777,NaN,NaN,14.654367249280632,-13.282246509649108,-0.22669759306316373,0.5403349960116941,0.7670325890748578,40322699,41142019,51.34162635594108,79.60887678539949,NaN,NaN,12.17853053470735,18.646965897526133
1997-03-07T09:30:00-05:00,80.4375,81.15625,80.25,80.84375,1859300,1560645,57.460376483491125,57.708819780471174,NaN,NaN,44.42569242683082,1.887750451813524,-0.1631978796690412,0.5630352394885563,0.7262331191575975,42181999,41405479,52.87214460015435,77.13172400898013,NaN,NaN,12.563756648548189,17.777936004814997
1997-03-10T09:30:00-05:00,80.9375,81.6875,80.54687,81.6875,1074900,1498340,61.270048382116116,57.093878302378286,NaN,NaN,88.03898461482666,26.259790618930765,-0.06761716185903821,0.6417116668337997,0.7093288286928379,43256899,41641839,54.262100790927356,74.65659665900964,NaN,NaN,14.107075876065336,17.253527414993616
1997-03-11T09:30:00-05:00,81.75,81.79687,81.25,81.25,624600,1446070,58.351960677944454,56.565857068867466,NaN,NaN,93.30987041116313,51.01428082322808,-0.03855145973769092,0.6611395040207242,0.6996909637584151,42632299,42049019,56.634899680784585,72.30258526433968,NaN,NaN,14.480719554064036,16.85741200628939
1997-03-12T09:30:00-05:00,81.3125,81.34375,80.29687,80.53125,1055600,1415635,53.81718721573591,56.1971446097026,NaN,NaN,13.712868069857224,50.8283565543917,-0.07056060434782796,0.6114902083236302,0.6820508126714582,41576699,41994119,56.211471013335206,70.06498509037111,NaN,NaN,13.395001692035576,16.36278196139599
1997-03-13T09:30:00-05:00,80.25,80.46875,79.0625,79.28125,2514100,1407570,46.97927814660597,55.32973833856572,NaN,NaN,-107.87059735809191,26.323363632917186,-0.17291461943267072,0.4659075383806197,0.6388221578132904,39062599,41742099,54.2078941647193,67.7260830298648,NaN,NaN,10.196125184748476,15.481830993303486
1997-03-14T09:30:00-05:00,79.64062,80.03125,79.25,79.6875,1642700,1434465,49.23673728484537,54.32209178392406,NaN,NaN,-90.56038449596201,-0.6738517516413765,-0.20790175682897982,0.3789449617770657,0.5868467186060455,40705299,41446759,51.874403248764345,65.18282911653937,NaN,NaN,8.30788077886029,14.456980962668744
1997-03-17T09:30:00-05:00,79.25,80.03125,78.4375,79.90625,3013500,1529495,50.459862283301035,53.382857376882285,NaN,NaN,-99.45198014964849,-38.172044704536404,-0.2103225186554072,0.32394357028678655,0.5342660889421937,43718799,41539139,52.56227551106014,62.63369218515696,NaN,NaN,7.147787287108762,13.412810437588746
1997-03-18T09:30:00-05:00,80,80.10937,78.71875,79.04687,1352500,1555465,45.791856067663716,52.520973531383675,NaN,NaN,-105.04016108535717,-77.84205100384047,-0.2605287771829616,0.20860511746349175,0.46913389464645333,42366299,41485939,52.100435683424685,60.018896447077566,NaN,NaN,4.701560138327085,12.168346109122794
1997-03-19T09:30:00-05:00,78.84375,79.5,78.0625,78.78125,1510000,1598560,44.42393021808153,52.09104356629546,NaN,NaN,-139.38393058034453,-108.46141073388083,-0.2995679903988099,0.09467390664794095,0.39424189704675083,40856299,41341859,50.79863055067239,57.29179050115464,NaN,NaN,2.290830010272247,10.757272380715573
1997-03-20T09:30:00-05:00,78.75,79,77.875,78.375,1808200,1629275,42.34064348348265,51.60664537089123,NaN,NaN,-150.23239388814795,-116.93377003989204,-0.3378533179050778,-0.028074750334596388,0.3097785675704814,39048099,41338959,50.77113259182875,55.22306407371788,NaN,NaN,-0.34581174231786943,9.17111750599651
1997-03-21T09:30:00-05:00,78.6875,78.75,78.34375,78.4375,2810600,1677585,42.78518456145097,50.9356822325605,NaN,NaN,-124.44889669475268,-123.71147247965015,-0.3429745783556474,-0.1189396553740778,0.22403492298156955,41858699,41569639,52.95275352401119,53.8272041374222,NaN,NaN,-2.381155201229748,7.520792833535616
1997-03-24T09:30:00-05:00,78.5,79.57812,78.09375,79.53125,2145600,1745500,50.04380651702788,50.9717195669151,NaN,NaN,-70.67593287249521,-117.95626302421951,-0.26044710488249306,-0.1015239581215468,0.15892314676094627,44004299,41626739,53.50204661230293,53.27927591940886,NaN,NaN,-2.10084314706255,6.146273407735878
1997-03-25T09:30:00-05:00,79.34375,79.96875,78.53125,78.75,2125800,1769095,45.594290389076015,50.173313245891975,NaN,NaN,-64.22195647285052,-109.7926221017182,-0.2463738375767932,-0.14904415021004525,0.09732968736674796,41878499,41529179,52.3768468283021,53.033475796873404,NaN,NaN,-3.198143138638623,4.811356758253806
1997-03-26T09:30:00-05:00,79.0625,79.65625,78.6875,79.09375,1335300,1755970,47.793780695076194,49.739210171849905,NaN,NaN,-53.93439810340214,-92.7027156063297,-0.20358767683864815,-0.15715490868156223,0.04643276815708592,43213799,42000679,57.07536045207639,53.44302823231163,NaN,NaN,-3.4575958629971786,3.630077812360809
1997-03-27T09:30:00-05:00,79.375,79.375,76.15625,77,2898500,1810240,37.77620376472077,48.33319783479488,NaN,NaN,-186.03286157508134,-99.86280914371636,-0.3001392900633705,-0.3287413444221272,-0.028602054358756714,40315299,42254119,59.39439124503609,53.90890299266032,NaN,NaN,-7.10783693262418,2.0960899916486677
1997-03-31T09:30:00-05:00,75.6875,75.6875,75.6875,75.6875,4270699,1875714.95,33.09353317900796,46.32058960600144,NaN,NaN,-273.25836593907974,-129.62470299258177,-0.4284220974660117,-0.5641296761912713,-0.13570757872525963,36044600,41091299.2,46.8800074006334,53.38161060763933,NaN,NaN,-11.891035500735986,0.09792920702228858
1997-04-01T09:30:00-05:00,75.25,76.1875,75.04687,75.85937,3210900,1975739.95,34.24301637414294,44.5985221557299,NaN,NaN,-213.46598017502487,-158.18271245308773,-0.47416311964060476,-0.7284114782760156,-0.25424835863541084,39255500,40141539.4,39.550111638523525,52.16126860462068,NaN,NaN,-15.21578024963071,-2.089743572499568
1997-04-02T09:30:00-05:00,75.625,75.9375,74.4375,74.5,2672700,2035439.95,29.871660338074747,42.88812737875411,NaN,NaN,-201.62810946350444,-185.6639430512185,-0.5624101758496954,-0.9572610784475302,-0.39485090259783473,36582800,39082399.6,33.297688019999185,50.52456981938239,NaN,NaN,-19.6119111101712,-4.592910363595515
1997-04-03T09:30:00-05:00,74.4375,75.125,74.1875,74.90625,2284200,2086909.95,32.63918730254356,41.8638351756068,NaN,NaN,-171.4620059078293,-209.16946461210392,-0.5587135440606772,-1.0932428326736812,-0.534529288613004,38867000,38213039.8,29.215071536403357,48.73936820307411,NaN,NaN,-22.206805522167432,-7.109181100534361
1997-04-04T09:30:00-05:00,74.5,75.85937,74.15625,75.84375,3706700,2195819.95,38.65557721388463,41.10803802768104,NaN,NaN,-125.0739116816083,-196.97767463340932,-0.46240561834026495,-1.112536311538335,-0.6501306931980702,42573700,38664720,33.75935329386843,47.44543606343869,NaN,NaN,-22.41396058423962,-9.295578169635112
1997-04-07T09:30:00-04:00,76.1875,76.625,76.14062,76.14062,2596200,2232664.95,40.46880747316155,40.39439125552821,NaN,NaN,-73.7756731141096,-157.0811360684153,-0.3529289424024187,-1.0912918712010935,-0.7383629287986748,45169900,40489780,48.22337249058189,47.13551441911881,NaN,NaN,-22.00782645761014,-11.11161363934583
1997-04-08T09:30:00-04:00,76.125,76.78125,75.84375,76.6875,1822700,2270054.95,43.76630807036833,40.24970925572139,NaN,NaN,-59.82130107111616,-126.35220024763355,-0.22417784662268692,-1.0185852370770334,-0.7944073904543465,46992600,42037200,56.83048264668728,47.47337491649471,NaN,NaN,-20.6471404024868,-12.473831748365969
1997-04-09T09:30:00-04:00,77,77.04687,75.84375,76.0625,2453200,2361484.95,40.9730488463413,40.003217729168526,NaN,NaN,-56.64408804230073,-97.35539596339281,-0.1643709603011695,-0.9998710908308084,-0.8355001305296389,44539400,43628520,63.54238794542777,48.383643301834375,NaN,NaN,-20.344702999577496,-13.598241927110472
1997-04-10T09:30:00-04:00,76.09375,76.54687,75.6875,75.78125,1996500,2408529.95,39.74380520268048,39.8177292805398,NaN,NaN,-62.006465803905144,-75.46428794260798,-0.12860018799925643,-0.9962503655287094,-0.867650177529453,42542900,44363700,66.1600813767749,49.48285392933053,NaN,NaN,-20.455753519117962,-14.5778864402544
1997-04-11T09:30:00-04:00,75.0625,75.3125,73.375,73.375,4221602,2493905.05,31.136885387123087,38.98570791094495,NaN,NaN,-127.39904921608225,-75.92931544950277,-0.24508937907133,-1.1740119013686154,-0.9289225222972854,38321298,43513219.6,60.72790144943153,50.03822163828913,NaN,NaN,-23.489532071808885,-15.85097867333361
1997-04-14T09:30:00-04:00,73.73437,74.45312,73.3125,74.35937,3988500,2611195.05,37.13468199499774,38.0636275879428,NaN,NaN,-114.77463355718902,-84.12910753811865,-0.23396555397046015,-1.2213794647603606,-0.9874139107899005,42309798,42941199.2,57.31904322231241,50.310864253289814,NaN,NaN,-23.95885983357689,-17.00924741051122
1997-04-15T09:30:00-04:00,75.25,75.64062,74.5,75.625,2760400,2598540.05,43.900177840597905,37.94261954876579,NaN,NaN,-61.42066843483642,-84.4489810108627,-0.12495688095114876,-1.1436100119788364,-1.0186531310276876,45070198,42556718.8,55.08099314694344,50.50401756176419,NaN,NaN,-22.002728212567934,-17.72260181080504
1997-04-16T09:30:00-04:00,75.375,76.60937,75.25,76.5,2273300,2644580.05,48.061788801683825,37.96176298495205,NaN,NaN,-20.62202858514776,-77.2445691194321,0.015045411621597449,-0.9998463665006909,-1.0148917781222884,47343498,43117538.4,57.676859980079534,50.54698181376442,NaN,NaN,-18.98040135383667,-17.902287459809557
1997-04-17T09:30:00-04:00,76.5,77,76,76.1875,1386000,2638380.05,46.72854699554085,38.60121607286777,NaN,NaN,-2.770399995347421,-65.39735595772056,0.09131698564484447,-0.9007455460662328,-0.9920625317110773,45957498,43800458,60.658366284384215,50.63726574514642,NaN,NaN,-17.021036527478138,-17.776394469476497
1997-04-18T09:30:00-04:00,76.8125,76.98437,76.25,76.5625,1702100,2633075.05,48.57217411082724,39.706833282283434,NaN,NaN,13.462511641697985,-37.225043786164534,0.1673116120001905,-0.7829230167108392,-0.9502346287110297,47659598,45668118,67.41832677982285,52.104288557945665,NaN,NaN,-14.86128451252264,-17.35995018991166
1997-04-21T09:30:00-04:00,76.75,76.90625,75.46875,76.0625,2809400,2633015.05,46.27270866953747,40.56609701766876,NaN,NaN,-5.926940147542779,-15.455505104235282,0.18292709618607417,-0.721575758478437,-0.9045028546645112,44850198,46176198,68.9798711549272,54.20641423768878,NaN,NaN,-13.760539223350357,-16.845748623260047
1997-04-22T09:30:00-04:00,76.10937,77.73437,76,77.73437,3215000,2686485.05,54.097809444411936,42.29653623954999,NaN,NaN,69.907995837987,10.810227750329407,0.2980662559752407,-0.5319200346954602,-0.829986290670701,48065198,46775198,70.75917444811571,56.882234696839966,NaN,NaN,-10.204090104255755,-15.896940263402291
1997-04-23T09:30:00-04:00,77.65625,78.03125,77.1875,77.8125,2047700,2682580.05,54.43181731808077,43.85315266923122,NaN,NaN,118.9068707902495,38.716007625408864,0.3671610257012142,-0.37103500854418314,-0.7381960342453974,50112898,47329078,72.33913308335686,59.962524807336635,NaN,NaN,-7.295088846971229,-14.668104346769283
1997-04-24T09:30:00-04:00,78.04687,78.28125,76.875,77.42187,2689900,2750310.05,52.37962466757177,44.833441773066006,NaN,NaN,123.58201831779098,63.98649128803654,0.37302199942314995,-0.2719185349664599,-0.6449405343896099,47422998,47622178,73.16542891772372,62.777244494754875,NaN,NaN,-5.492204406076669,-13.35726149809891
1997-04-25T09:30:00-04:00,77.0625,77.20312,76.42187,76.53125,1606200,2685695.05,47.941603375515,45.367212908948396,NaN,NaN,64.11081547337652,74.11615205437224,0.30618362660117515,-0.2622110011381409,-0.568394627739316,45816798,47253618,70.3207683813676,64.35562991552528,NaN,NaN,-5.256688343594913,-12.200036761741197
1997-04-28T09:30:00-04:00,76.5,77.8125,76.375,77.28125,1666500,2555485.1,51.656276469996484,45.93078208035041,NaN,NaN,91.54107542657003,93.60975516919481,0.30128517092729784,-0.19178816408019372,-0.49307333500749156,47483298,47780238,71.99615856949436,65.43889248144008,NaN,NaN,-3.9354379077671684,-11.01937978260205
1997-04-29T09:30:00-04:00,78.59375,79.78125,78.29687,79.71875,3197400,2554810.1,61.31714863865311,47.383932065515545,NaN,NaN,219.7037935926814,123.56891472013368,0.4424718583310299,0.06001648790629588,-0.38245537042473404,50680698,48303338,73.59089547476478,66.15664301924986,NaN,NaN,0.6520348187769595,-9.352034839547905
1997-04-30T09:30:00-04:00,79.25,80.6875,79.21875,80.09375,3372200,2589785.1,62.5568579144055,49.01343583063876,NaN,NaN,226.32728280321896,145.0529971227276,0.535188229330718,0.2865299162386634,-0.24865831309205455,54052898,49091338,75.8243436963013,66.84694747064461,NaN,NaN,4.683893403387229,-7.346902233414314
1997-05-01T09:30:00-04:00,80.21875,80.53125,79.3125,80,2149500,2583050.1,62.02171493248012,51.21949508387855,NaN,NaN,184.03090372938118,157.1427742050456,0.5615296675134489,0.45325377129975664,-0.1082758962136923,51903398,49987418,78.09319723304611,68.08732574090278,NaN,NaN,7.7057548976224215,-5.196522643266208
1997-05-02T09:30:00-04:00,80.28125,81.67187,80.0625,81.4375,1448300,2470130.1,66.72246647530571,53.33290826104342,NaN,NaN,196.67648122857568,183.65590735608544,0.641328680008719,0.6933849537972065,0.052056273788487484,53351698,51494398,81.27576499688786,69.79852015337246,NaN,NaN,11.911182764062639,-2.7525647279335157
1997-05-05T09:30:00-04:00,81.65625,83.5625,81.29687,83.375,3636200,2522130.1,71.79056329100501,55.325078650358215,NaN,NaN,213.46263082555896,208.04021843588325,0.7808977824607892,1.028178501864474,0.2472807194036848,56987898,53395318,84.36195199985943,71.89001721429504,NaN,NaN,17.444755601201877,0.1327667476572545
1997-05-06T09:30:00-04:00,82.96875,83.46875,82.5,83.3125,1721100,2517050.1,71.41273676987548,56.993003505229055,NaN,NaN,179.69561869564112,200.03858345647518,0.8211980247402197,1.2737782503289594,0.4525802255887397,55266798,54312538,85.59564298427277,73.88421600030884,NaN,NaN,21.599589425441035,3.199455701626366
1997-05-07T09:30:00-04:00,83,83,81.40625,81.5,2327200,2510750.1,61.33194792328371,58.03610357149639,NaN,NaN,119.41638305546947,178.6564035069253,0.6836132752370134,1.3070968196350066,0.6234835443979931,52939598,54089878,83.86597392760576,75.54190226053895,NaN,NaN,21.902603991464524,5.871334028746102
1997-05-08T09:30:00-04:00,81.3125,83.21875,81.1875,82.0625,2923700,2557110.1,63.074073423656664,59.071953522412784,NaN,NaN,107.47624704335965,163.34547216972095,0.5917549376383295,1.363177216445905,0.7714222788075755,55863298,54881858,85.02510323728396,76.7995291503576,NaN,NaN,22.707256535596997,8.276465815439087
1997-05-09T09:30:00-04:00,82.96875,83.125,81.65625,82.625,2558200,2473940,64.7827777703094,60.39410131532505,NaN,NaN,102.69152966141884,144.54848185628958,0.5320236657966134,1.4364518610533423,0.9044281952567289,58421498,55895818,86.37476353581032,78.04202146327783,NaN,NaN,23.8970422678225,10.507976737208146
1997-05-12T09:30:00-04:00,82.9375,84.25,82.875,84,2357900,2392410,68.60692209958916,61.43046650498057,NaN,NaN,122.16745735347845,126.2894471618735,0.5461994906380472,1.5871775585542878,1.0409780679162406,60779398,56654118,87.29686055471272,79.22328475660618,NaN,NaN,26.164934655317545,12.744685011223774
1997-05-13T09:30:00-04:00,83.9375,84.09375,83.01562,83.65625,1195100,2314145,66.6581671245921,62.30377720544567,NaN,NaN,107.09046065540532,111.76841555382637,0.4950242228888797,1.6597583465273402,1.1647341236384605,59584298,57517618,88.27033415680916,80.3612276904242,NaN,NaN,27.382174094854438,14.83575488031387
1997-05-14T09:30:00-04:00,84.23437,84.5,83.4375,83.8125,2772000,2339080,67.11540666435945,63.35633306235907,NaN,NaN,105.1479330780842,108.9147255583493,0.4363514200352767,1.7101733986825565,1.2738219786472798,62356298,59400958,90.05957617035911,81.56795249418387,NaN,NaN,28.497082830053312,16.787373158848077
1997-05-15T09:30:00-04:00,83.8125,84.59375,83.51562,84.375,884100,2313985,68.77551625816476,64.84446969683405,NaN,NaN,100.21581989853264,107.46264012938391,0.4009864254822537,1.7750550105000968,1.3740685850178431,63240398,60876378,91.19297855110497,83.05882464916512,NaN,NaN,29.91824148480944,18.663211491128273
1997-05-16T09:30:00-04:00,84.125,84.3125,83,83.21875,1934200,2325590,61.86224120544887,65.57346717793779,NaN,NaN,75.92090184521348,102.10851456614284,0.2714836662155977,1.7134231677873402,1.4419395015717424,61306198,61453318,91.59647559006405,84.45884729349152,NaN,NaN,29.09522299186311,20.153498848376106
1997-05-19T09:30:00-04:00,83.3125,83.90625,83.0625,83.46875,1375800,2253910,62.73446961899478,65.67470439081934,NaN,NaN,69.72809452424627,91.6206420002964,0.1788907519647036,1.665552941527622,1.4866621895629184,62681998,61833838,91.86132353277033,85.76387786906334,NaN,NaN,28.66866015500204,21.369950463608383
1997-05-20T09:30:00-04:00,83.28125,84.6875,82.75,84.46875,1756400,2180980,66.07657003150548,65.92611239918364,NaN,NaN,78.03308763925267,85.80916739706588,0.16174160672838034,1.6888391979733939,1.5270975912450135,64438398,62804658,92.50991027645772,86.95570405336022,NaN,NaN,29.273441250080023,22.499020575961474
1997-05-21T09:30:00-04:00,84.6875,84.98437,83.65625,84.28125,1208000,2138995,64.90126311500227,66.13179441222094,NaN,NaN,83.62456622077465,81.50449402560398,0.11662602323044369,1.672880120283068,1.5562540970526244,63230398,62979478,92.62390322158954,87.99361162397047,NaN,NaN,29.435014464107624,23.48987684569664
1997-05-22T09:30:00-04:00,84.375,84.46875,83.5625,84,907600,2049880,63.08854508153449,65.87222859838013,NaN,NaN,70.93974997416252,75.64928004072995,0.05009793118612604,1.6188765110352819,1.5687785798491558,62322798,62795958,91.05721603916967,88.69228669841917,NaN,NaN,29.067473193834044,24.28667632400198
1997-05-23T09:30:00-04:00,84.375,85.21875,84.15625,84.78125,644400,2001790,65.93477845369463,65.45395825285796,NaN,NaN,95.98478519860767,79.66205671140878,0.04132849061892019,1.620439193122806,1.5791107025038857,62967198,63128158,91.34267510421472,89.1909097773017,NaN,NaN,29.538704659893906,25.036966086272255
1997-05-27T09:30:00-04:00,84.375,85.53125,84.26562,85.125,1531000,1995015,67.13558383075136,65.14844732863482,NaN,NaN,107.07614586670162,87.13166697989985,0.04120633848163813,1.6306186256059334,1.5894122871242953,64498198,63491398,91.65629858894374,89.6238137490639,NaN,NaN,30.26770211414561,25.784214090254164
1997-05-28T09:30:00-04:00,85.125,85.45312,84.51562,85.10937,716700,1870980,67.01990173511197,65.5547297437654,NaN,NaN,107.57986171668644,93.0410217953866,0.023481833019918907,1.618764578399194,1.595282745379275,63781498,63360018,90.38096989459778,90.08917060384906,NaN,NaN,30.84077246771753,26.50657957274893
1997-05-29T09:30:00-04:00,85.09375,85.25,84.5,84.60937,1282700,1766505,63.264395806551455,65.56832419968646,NaN,NaN,91.76303523735398,94.66871559870245,-0.035311220297338686,1.5511437200076017,1.5864549403049404,62498798,63213698,88.89740006012687,90.36576323405211,NaN,NaN,30.34174975413443,27.054461027232573
1997-05-30T09:30:00-04:00,83.21875,85.5625,83.125,85.15625,2143300,1766195,65.53896769885029,65.6223377660108,NaN,NaN,79.02369758863574,96.2855051215971,-0.04987329746344993,1.524113318475628,1.5739866159390778,64642098,63677558,89.48657354321936,90.58803537743847,NaN,NaN,30.509083681356874,27.54797854925033
1997-06-02T09:30:00-04:00,85.34375,85.5,84.71875,84.78125,1479100,1767735,62.67334337886882,65.19851071453078,NaN,NaN,104.74924496406939,98.03839707468944,-0.0946674441136457,1.4556523107970207,1.5503197549106664,63162998,63716718,89.53705280297112,90.74804910945693,NaN,NaN,29.88297875499794,27.881550007214276
1997-06-03T09:30:00-04:00,84.40625,85.4375,84.34375,84.5,1562100,1664030,60.53550069749127,64.76117739830929,NaN,NaN,77.43446316801962,92.11006053495305,-0.14986361080043986,1.3629902414101167,1.5128538522105566,61600898,63137258,83.17323479331517,90.38397058349308,NaN,NaN,28.776446920856685,28.009392423448904
1997-06-04T09:30:00-04:00,84.53125,84.75,84.07812,84.40625,1063100,1631130,59.80321451850651,64.2388779593198,NaN,NaN,41.24189647659018,78.84246748693378,-0.19637870641138488,1.2673804691963255,1.4637591756077104,60537798,62488518,76.60840773170294,89.42317283787477,NaN,NaN,27.65015058973445,27.958072161489696
1997-06-05T09:30:00-04:00,84.59375,85.3125,84.42187,84.71875,1180800,1573810,61.47609321477421,63.717490599077614,NaN,NaN,74.30801808521198,75.35146405650538,-0.20864076395663833,1.2029582206619125,1.4115989846185508,61718598,62332478,75.07352065672528,88.27178298827623,NaN,NaN,27.08794352901464,27.833768071136117
1997-06-06T09:30:00-04:00,84.59375,86.4375,84.59375,86.375,1511100,1503180,68.87053420246296,64.2180829560072,NaN,NaN,169.5057002364284,93.44786458606391,-0.1125603632555916,1.2708985305490614,1.383458893804653,63229698,62049998,72.25135541829702,86.88998869029287,NaN,NaN,28.70175149788287,27.95776570352851
1997-06-09T09:30:00-04:00,86.4375,86.875,86.34375,86.8125,1823400,1466440,70.4822734395905,64.77149751462117,NaN,NaN,238.29193143028593,120.15640187930721,-0.031130931979358234,1.3445452288304551,1.3756761608098134,65053098,62428018,73.67740963462042,85.59113769756787,NaN,NaN,30.54238642369988,28.32699723498156
1997-06-10T09:30:00-04:00,86.84375,87.40625,86.5,87.07812,1217500,1409420,71.44880232996084,65.15522839308227,NaN,NaN,227.49458019476543,150.1684252846564,0.025948863788724852,1.4081122405457194,1.3821633767569945,66270598,63361958,76.84371008630788,84.47212339827146,NaN,NaN,32.358532054230075,28.90293078058849
1997-06-11T09:30:00-04:00,87,87.40625,86.82812,87.28125,1673800,1433355,72.1985201401957,65.67646103773895,NaN,NaN,201.66641234245827,182.25332845783,0.06072745401563484,1.458072694276538,1.3973452402609032,67944398,64843278,80.79057646223495,83.62688577260329,NaN,NaN,34.09016215359378,29.64396383387496
1997-06-12T09:30:00-04:00,87.875,89,87.5625,88.96875,4273301,1508420.05,77.48729987492905,66.70494352298142,NaN,NaN,234.67597716817502,214.32692027442263,0.17429554497631505,1.6152146714812972,1.440919126504982,72217699,66943098.2,84.75680225751324,83.17685621677069,NaN,NaN,37.467440671923654,30.761603382167632
1997-06-13T09:30:00-04:00,89.0625,90,88.90625,89.71875,2132900,1570860.05,79.36606222325562,67.6643209350929,NaN,NaN,222.03812577236025,224.83340538160897,0.2710676269676906,1.7797536602145954,1.5086860332469048,74350599,69167278.4,87.66256702310729,82.91399135383445,NaN,NaN,40.94619103701987,32.21654447571795
1997-06-16T09:30:00-04:00,89.75,90,89.46875,89.75,800400,1514170.05,79.4430419831488,68.54342508883558,NaN,NaN,183.78328227157445,213.93167554986667,0.30575257966144,1.8908767578237047,1.5851241781622647,75150999,71186858.6,89.60100367121315,82.76718457399654,NaN,NaN,43.732144774076666,33.86163023262634
1997-06-17T09:30:00-04:00,89.4375,90.23437,88.9375,89.625,2048100,1547785.05,78.18651742932474,69.34104049556507,NaN,NaN,147.1561935164805,197.86399821420972,0.2890358980566896,1.9464190507331267,1.657383152676437,73102899,72553318.8,90.66923348271004,82.78777483029026,NaN,NaN,45.65436859714092,35.54630714184271
1997-06-18T09:30:00-04:00,89.125,89.625,88.96875,89.3125,1971900,1558560.05,74.99306176478059,70.17880234972428,NaN,NaN,115.85427831529971,180.70157140877797,0.2283534007180783,1.942824903574035,1.7144715028559567,71130999,73190639,91.1270452146048,82.94703519846725,NaN,NaN,46.38332505702614,37.09445255829748
1997-06-19T09:30:00-04:00,89.60937,90.5,89.375,90.23437,2029900,1599655.05,77.86522124567978,71.05924903164068,NaN,NaN,124.19696518453524,158.60576901205002,0.22154920471566641,1.9914080087505397,1.7698588040348733,73160899,73379279,91.26367926805338,83.07397132166967,NaN,NaN,47.88999994073274,38.63667361293109
1997-06-20T09:30:00-04:00,89.9375,90.34375,89.5,89.57812,1396900,1624120.05,71.56397032068149,71.69429381319873,NaN,NaN,102.99149544292865,134.79644294616372,0.14765468431621276,1.9544271594301392,1.8067724751139265,71763999,72861959,87.29373924531812,82.91373463898016,NaN,NaN,47.288574384729365,39.8726594374737
1997-06-23T09:30:00-04:00,89.40625,89.90625,87.34375,87.40625,3991500,1791475.05,55.543774086866925,71.33774191243984,NaN,NaN,43.06965440762323,106.65371737337348,-0.06147694132385695,1.7299262984591053,1.7914032397829622,67772499,71386259,77.0036158470855,82.47304757139234,NaN,NaN,41.01683799469698,40.03611351707703
1997-06-24T09:30:00-04:00,88.25,89.875,88,89.625,4895102,1959680.15,64.32891856026058,71.66100648685084,NaN,NaN,68.568077838184,90.93609423771417,-0.06407030966506388,1.7113153527016323,1.7753856623666961,72667601,71299199.4,76.43120027593095,82.46038989598006,NaN,NaN,38.6710346148375,39.84110224532852
1997-06-25T09:30:00-04:00,89.48437,90.25,87.9375,89,4708898,2159290.05,60.690652506829124,71.60490357914048,NaN,NaN,58.376813977332496,79.44060137012073,-0.11840900327418469,1.6273744082739654,1.74578341154815,67958703,70664740.2,72.21795060530064,82.25642060659258,NaN,NaN,35.51972005464727,39.22376193237406
1997-06-26T09:30:00-04:00,88.84375,89.625,87.6875,88.5625,2569900,2223650.05,58.208889859151796,70.84335755461825,NaN,NaN,38.04013197982933,62.20923472917955,-0.19009645014231502,1.5081628488702563,1.6982592990125713,65388803,69110321,63.04800055354667,81.59903811625328,NaN,NaN,32.207667035837204,38.22146266144022
1997-06-27T09:30:00-04:00,88.96875,89.71875,88.6875,88.90625,2617900,2247380.05,59.606541096815874,70.06651953013434,NaN,NaN,50.74564184753012,51.760064010099846,-0.21860896690929654,1.4249980903759507,1.6436070572852473,68006703,68358861.8,59.13856102041979,80.56054892952467,NaN,NaN,30.058424203196804,37.05531431026259
1997-06-30T09:30:00-04:00,88.90625,89.46875,87.875,88.3125,2384900,2292670.05,56.11558793318064,68.97128993036434,NaN,NaN,24.22411967707112,47.99095706398943,-0.2778964064560763,1.296236549215152,1.5741329556712282,65621803,67928722.6,56.96129576229894,79.14037647780974,NaN,NaN,27.166698553381845,35.64265491642248
1997-07-01T09:30:00-04:00,88.5,89.5625,88.39062,89.34375,1749000,2302015.05,60.448304044385175,68.13198878066359,NaN,NaN,44.13855172008295,43.10505184036922,-0.24902794001631912,1.2628480306508294,1.5118759706671485,67370803,66869363,51.893994145615615,77.07633488376551,NaN,NaN,26.10828046316952,34.28060142310063
1997-07-02T09:30:00-04:00,89.5625,90.8125,89.21875,90.8125,1961800,2346950.05,65.65000342113757,67.28646760539276,NaN,NaN,104.29956620400704,52.289602285704134,-0.13793057931286534,1.339462746526067,1.4773933258389322,69332603,67144143,53.06043402859987,74.81230858170026,NaN,NaN,26.968380487676868,33.23599843232581
1997-07-03T09:30:00-04:00,91.875,92.15625,91.46875,92.0625,2539100,2414865.05,69.34510808805828,66.57068516716438,NaN,NaN,196.09826224381686,83.90122833850162,0.00523660977953555,1.4839390880633516,1.478702478283816,71871703,68440723,58.20961668650479,72.70852641480009,NaN,NaN,28.987579460531776,32.62908143635523
1997-07-07T09:30:00-04:00,92.375,92.5,90.90625,91.125,1158600,2397240.05,63.801683643079,65.45344528573081,NaN,NaN,167.20047708448627,107.19219538589286,0.02138641049142942,1.505435491398103,1.4840490809066735,70713103,68982003,60.17377166999632,70.60658127185603,NaN,NaN,28.737217450874446,32.07310086700083
1997-07-08T09:30:00-04:00,91.25,92.1875,91.1875,92.07812,3396500,2475895.05,66.71490258591216,64.63404422548706,NaN,NaN,167.5470648494968,135.856784420378,0.07768378127396902,1.5811538074991347,1.5034700262251657,74109603,70679563,65.62972060974307,68.81804463807273,NaN,NaN,29.52402293845509,31.708946877208582
1997-07-09T09:30:00-04:00,92.3125,92.375,90.03125,91.0625,5390301,2684535.1,61.07446532575302,63.639858765556525,NaN,NaN,110.07308334299374,149.04369074496014,0.03037622546997376,1.5414403080626329,1.5110640825926591,68719302,70949262.8,66.41687938561957,67.05303279314522,NaN,NaN,28.26703098691449,31.21724460716657
1997-07-10T09:30:00-04:00,91.125,91.84375,90.48437,91.46875,2072200,2704455.1,62.44230640960541,62.53822199155121,NaN,NaN,104.45012601599655,149.07380270735806,0.011282237179882859,1.5251668790675126,1.5138846418876297,70791502,71241042.6,67.28969626660444,65.34060543589887,NaN,NaN,27.70800166069537,30.715924186242113
1997-07-11T09:30:00-04:00,91.59375,92.1875,91.375,91.78125,2260400,2603810.05,63.50468546298783,61.96255878743023,NaN,NaN,121.18034614440447,134.09021948747557,0.004864284353753856,1.5199649973298222,1.5151007129760683,73051902,71477082.4,68.01392824036175,63.96347607840198,NaN,NaN,27.58566965122672,30.2687449669542
1997-07-14T09:30:00-04:00,91.89062,92.3125,91.21875,92.0625,3186400,2656485.05,64.47854980728897,62.60075705317467,NaN,NaN,109.08918257105238,122.46796058478878,0.004722475990851294,1.5210038079646324,1.5162813319737811,76238302,72582122.2,71.22590341653358,63.55078233336256,NaN,NaN,27.77430545845398,29.91239646573988
1997-07-15T09:30:00-04:00,92.3125,92.76562,91.46875,92.53125,2983100,2765620.05,66.10210664298639,62.72741334479794,NaN,NaN,114.51801553422283,111.862150721734,0.02047691570484611,1.5418774766048386,1.5214005608999925,79221402,73604482,73.8429451237972,63.365906965353005,NaN,NaN,28.405689325852407,29.6971525886131
1997-07-16T09:30:00-04:00,93.125,94.09375,92.89062,93.75,2621300,2794280.05,69.94808622334912,63.388658610263654,NaN,NaN,157.7123465347474,121.39000336008473,0.0931855188194608,1.6378824594243184,1.5446969406048576,81842702,76229162,79.09874278878219,63.857392121315975,NaN,NaN,30.148557957858586,29.761639069933885
1997-07-17T09:30:00-04:00,93.625,93.8125,92.78125,93.28125,1794800,2785425.05,66.80846612061367,64.00291405751094,NaN,NaN,125.22113865277962,125.54420588744135,0.08987568670835944,1.657041548990307,1.5671658622819475,80047902,78080442,81.86641082011182,65.2015642832135,NaN,NaN,30.666314961118406,29.890878482960247
1997-07-18T09:30:00-04:00,93.01562,93.21875,91.0625,91.29687,3961900,2882025.05,55.45973517772793,63.70671363471894,NaN,NaN,52.970952035747395,111.90232706570994,-0.05783633169387015,1.49487044766461,1.5527067793584801,76086002,78687262,82.67617370683406,66.88282233224308,NaN,NaN,27.422300994384983,29.538224556020925
1997-07-21T09:30:00-04:00,91.28125,91.59375,90.6875,91.3125,3810300,3002695.05,55.5238210188048,63.66444456940638,NaN,NaN,19.765496295798982,94.03758981065926,-0.16054574832995128,1.352024593946041,1.5125703422759922,79896302,79418862,83.62555191829992,68.78741205767173,NaN,NaN,24.903495069754662,28.876120343697174
1997-07-22T09:30:00-04:00,91.6875,93.79687,91.625,93.73437,4243398,3015289.95,64.13490479635597,63.92777319454715,NaN,NaN,102.16098919897799,91.56618454361029,-0.07573767706485302,1.4178982459449259,1.4936359230097789,84139700,80402521.6,84.82935463092753,71.13993780662258,NaN,NaN,25.458841209348364,28.387937610218774
1997-07-23T09:30:00-04:00,93.9375,94.48437,93.53125,93.65625,3204300,2930749.85,63.70644526505156,63.78894761196958,NaN,NaN,135.2837287192919,87.08046098051918,-0.03721395631647706,1.4471184776141826,1.4843324339306596,80935400,80221061.2,83.60823166936697,73.32192335239166,NaN,NaN,25.751248992424948,28.0112678076768
1997-07-24T09:30:00-04:00,93.9375,94.26562,92.6875,94.09375,4152699,2902939.9,65.11213742635823,63.48659256470529,NaN,NaN,115.88819696668135,85.21387264329954,0.003270635057561533,1.4884207277526116,1.48515009269505,85088099,81229100.6,84.90792947951998,75.22894569474988,NaN,NaN,26.42418244151737,27.78454132679688
1997-07-25T09:30:00-04:00,94.5625,94.8125,93.625,94.03125,2364800,2892684.9,64.72645559082548,63.55264770383004,NaN,NaN,133.42639705059923,101.30496164626989,0.010945706626239948,1.49883222597785,1.48788651935161,82723299,82556560,86.43343853483847,77.10463618509576,NaN,NaN,26.852183191742373,27.65134730750338
1997-07-28T09:30:00-04:00,94.25,94.5625,93.5,93.96875,2794700,2901524.9,64.31618330511527,63.381310612344556,NaN,NaN,112.66580668754503,119.8850237246191,-0.002370880606637815,1.4849229185933126,1.4872937991999504,79928599,82563019.4,86.44062079919016,78.59112905577055,NaN,NaN,27.08889706337824,27.570997272628357
1997-07-29T09:30:00-04:00,93.625,94.46875,93.42187,94.28125,2737100,2919134.9,65.49390023065311,63.69698453412313,NaN,NaN,103.29384800536718,120.11159548589694,-0.004209527744834407,1.4820318895189075,1.486241417263742,82665699,82268219.2,84.24845291203812,79.86481287908616,NaN,NaN,27.610046719363428,27.576575765019083
1997-07-30T09:30:00-04:00,94.5,95.625,94.40625,95.40625,4839801,3073674.95,69.40826192765883,64.19455278541265,NaN,NaN,147.32177615970315,122.51920497397919,0.05310380674193271,1.5526211756911579,1.4995173689492252,87505500,83582239.2,85.95786918457374,81.19825380179826,NaN,NaN,29.216716858127533,27.810881635463147
1997-07-31T09:30:00-04:00,95.40625,96.03125,95.03125,95.3125,2138700,3082519.95,68.70877321465522,64.56627333910318,NaN,NaN,146.83069257172747,128.7077040949884,0.06658918555218829,1.5827538508894605,1.5161646653372722,85366800,83637979.4,86.02714172308235,82.48491190770687,NaN,NaN,30.348757894087296,28.173435386695168
1997-08-01T09:30:00-04:00,95.5,95.71875,93.8125,94.9375,7077699,3309449.9,65.85006124715596,64.66423844195081,NaN,NaN,99.79841071018215,121.98210682690498,0.033796636820044856,1.5584104613623282,1.5246138245422833,78289101,82751139.8,79.32235559605024,83.06322992052948,NaN,NaN,30.543463360177874,28.51201081147841
1997-08-04T09:30:00-04:00,94.78125,95.54687,94.40625,95.1875,2339500,3368494.9,66.84057081645348,64.71698588291277,NaN,NaN,101.95374095485502,119.839693680367,0.013526029762785496,1.5415213617457653,1.5279953319829798,80628601,82891140.2,79.59275313597011,83.47393049282755,NaN,NaN,30.97310425607463,28.86359558927787
1997-08-05T09:30:00-04:00,95.09375,95.6875,94.90625,95.25,1467000,3272019.9,67.09750522421704,64.51337295440332,NaN,NaN,104.5564736520164,120.09221880969685,-0.009830088649108282,1.5157077211715944,1.5255378098207026,82095601,82777120.6,78.69023192202467,83.44475114520203,NaN,NaN,31.400683373366107,29.226036701290475
1997-08-06T09:30:00-04:00,95.4375,96.53125,95.0625,96.03125,2478200,3126414.85,70.20527798407386,64.7560023732219,NaN,NaN,126.91971979728679,116.01180753721357,0.01199557114888572,1.54053227375681,1.5285367026079242,84573801,82190780.8,74.040702834317,82.88577200335953,NaN,NaN,32.63073707205099,29.712422468541977
1997-08-07T09:30:00-04:00,96.5,96.625,95.125,95.3125,3641900,3204899.85,64.19753569091958,65.38013098130703,NaN,NaN,108.16417638661946,108.27850430019198,-0.03475767899904092,1.485089603859123,1.519847282858164,80931901,81303801,67.5394821514742,81.80457974940525,NaN,NaN,32.06284890366195,30.048197673559116
1997-08-08T09:30:00-04:00,94.3125,94.75,92.40625,93.375,7167602,3450259.95,51.42294453335223,65.08721123234612,NaN,NaN,-23.44791935481372,83.6292382871928,-0.19974253667456732,1.2701691120149547,1.469911648689522,73764299,80398840.6,61.596793091389145,80.23109697605449,NaN,NaN,27.39383425370211,29.66900289929383
1997-08-11T09:30:00-04:00,93.75,94.28125,92.625,94.0625,6355898,3608734.85,54.85573219529745,64.42441318941337,NaN,NaN,-21.772630599890146,58.88396397624378,-0.2622072753914073,1.1421525544502629,1.4043598298416702,80120197,80297159.8,60.947892697890595,78.52527826655184,NaN,NaN,24.564299729292543,28.939759589293647
1997-08-12T09:30:00-04:00,94.21875,94.54687,92.46875,92.5625,6160801,3767619.9,47.04437191579836,63.234265093038154,NaN,NaN,-59.32010595676671,26.10864805448715,-0.3961434010495082,0.9091805785297851,1.3053239795792932,73959396,78669918.8,51.58261065557357,76.23773390842373,NaN,NaN,19.373079852325926,27.573091055441115
1997-08-13T09:30:00-04:00,93.6875,93.84375,91.46875,92.28125,6982301,3985669.95,45.72948937086257,61.849790231931316,NaN,NaN,-97.5118328528814,-18.777662475546485,-0.48917458566524585,0.6938557474977358,1.1830303331629817,66977095,75150577.6,37.9871700595918,72.88625109271459,NaN,NaN,14.833894869003075,25.753205885949967
1997-08-14T09:30:00-04:00,93.09375,93.3125,91.71875,92.625,3462700,4069064.95,47.65518572331392,60.63041381282335,NaN,NaN,-90.2040086408668,-58.45129948104373,-0.5106895295551166,0.544668421219086,1.0553579507742026,70439795,73052156.4,32.48873884816388,69.03305825795212,NaN,NaN,11.738669630034385,23.751129277962026
1997-08-15T09:30:00-04:00,92.125,92.125,89.625,89.78125,4907102,4116325.05,36.20873900702575,58.62273922010267,NaN,NaN,-205.08529046204245,-94.77877370248947,-0.6885064690264423,0.19472486449114967,0.883231333517592,65532693,71405835.2,28.948485866987383,64.9264771913662,NaN,NaN,4.474338000699297,20.99730195263878
1997-08-18T09:30:00-04:00,90.375,91.78125,89.34375,91.78125,5638898,4207754.95,46.02749303608867,57.232281563348074,NaN,NaN,-174.35698013873434,-125.29564361025832,-0.6442829588294724,0.07787763498075151,0.7221605938102239,71171591,69616114,25.673282051560705,60.74253641561783,NaN,NaN,1.981224074618625,18.2807193986359
1997-08-19T09:30:00-04:00,92.21875,92.90625,91.53125,92.84375,3802800,4185725.05,50.395653210012114,55.87423808351616,NaN,NaN,-81.80546737673322,-129.79271589425161,-0.5215676745400011,0.0702010006352225,0.5917686751752236,74974391,69819113,26.686469523973045,56.50886501128921,NaN,NaN,1.6439748215131735,15.904041601904082
1997-08-20T09:30:00-04:00,92.9375,94.3125,92.60937,94.25,3558200,4203420.05,55.52603932692938,54.93261423439289,NaN,NaN,-5.318167991966138,-111.35398292206858,-0.33296212469766095,0.1755660193031474,0.5085281440008084,78532591,72130212.2,37.184773788266,53.02012444451661,NaN,NaN,3.2828860535660858,14.10101938071294
1997-08-21T09:30:00-04:00,94.125,94.25,92.09375,92.59375,5392602,4265415.2,49.08668845300221,53.7352304633819,NaN,NaN,-45.43974456762694,-102.40113010742061,-0.30762755490008165,0.12399370037570634,0.431621255275788,73139989,72670251,39.36959814159677,50.1663560549128,NaN,NaN,2.241466454286458,12.406797534080585
1997-08-22T09:30:00-04:00,91,92.73437,90.5625,92.5625,7172898,4505820.1,48.97129112266521,52.45885334239703,NaN,NaN,-92.17544566732528,-79.81916114847718,-0.2815513031942616,0.07968212628296101,0.3612334294772226,65967091,72757130.6,39.73276848302506,47.319214293988146,NaN,NaN,1.4255052980237541,10.83804150035818
1997-08-25T09:30:00-04:00,92.78125,93.40625,91.84375,92.21875,3888000,4560485.1,47.64444170442215,51.06934880526882,NaN,NaN,-57.404004002156626,-56.428565921161635,-0.2756784474115637,0.016635370212767953,0.2923138176243317,62079091,70938630.6,35.00620845179239,44.19892690325727,NaN,NaN,0.35630942313318825,9.340651203611753
1997-08-26T09:30:00-04:00,92,92.5625,90.70312,90.85937,4290000,4638130.1,42.71555342727122,49.10579705121148,NaN,NaN,-102.06592578636909,-60.48065760308882,-0.346963360550682,-0.14139038306402085,0.20557297748666115,57789091,67501570.6,28.182324225496643,40.92332843119867,NaN,NaN,-2.1793538268724446,7.694936199256867
1997-08-27T09:30:00-04:00,91,91.96875,90.40625,91.40625,5484301,4670355.1,45.17290781831486,47.74689506031115,NaN,NaN,-97.71884462888065,-78.96079293047171,-0.34042853600490774,-0.21996269251947353,0.12046584348543421,63273392,64449730.8,23.75448797570087,37.79582884721486,NaN,NaN,-3.449706674766105,6.102844360110728
1997-08-28T09:30:00-04:00,91.1875,91.9375,90,90.01562,4287898,4777815,40.424187345330935,46.961269546881056,NaN,NaN,-116.57878806876424,-93.18860163069917,-0.4083318301262583,-0.3899489441723887,0.018382885953869624,58985494,61618831.8,20.531987042073425,34.86262841512088,NaN,NaN,-6.088784825298803,4.361183047909367
1997-08-29T09:30:00-04:00,90.125,91.10937,89.71875,90.375,2652300,4556545.05,42.11763516280299,46.05140547313145,NaN,NaN,-116.74199556575483,-98.10191161038509,-0.4067196713439901,-0.490016703226118,-0.0832970318821279,61637794,60752972.4,19.653771797193983,31.913048350785413,NaN,NaN,-7.6800024637918325,2.64101368909491
1997-09-02T09:30:00-04:00,90.6875,93.35937,90.59375,93.3125,7294000,4804270.05,53.702010704659784,46.526951100907276,NaN,NaN,-13.3322757138997,-89.2875659527337,-0.19616449360366708,-0.32850264888671177,-0.13233815528304468,68931794,62123513,25.11387159937138,30.02242413248526,NaN,NaN,-5.122669019765383,1.5319161592577253
1997-09-03T09:30:00-04:00,93.29687,94,92.75,92.8125,2812500,4871545.05,51.80160472698231,46.960673626344395,NaN,NaN,36.660538164981766,-61.54227316246353,-0.08461165063476364,-0.23810271857649923,-0.1534910679417356,66119294,63789553.6,31.23175747315932,29.539894662025798,NaN,NaN,-3.7412473517548013,0.7786070862559358
1997-09-04T09:30:00-04:00,93.0625,93.71875,92.75,93.40625,2473700,4871320.05,53.88842064145307,47.40590469192576,NaN,NaN,56.99970850692117,-30.598562535303166,0.029034079400133084,-0.11719846869156925,-0.14623254809170233,68592994,64853474,34.889867877487305,29.71140387840605,NaN,NaN,-1.9553775112480978,0.3880378580410739
1997-09-05T09:30:00-04:00,93.96875,94.4375,92.59375,93.14062,3663300,4872390.05,52.78728934735675,48.59008685909227,NaN,NaN,77.76914284559207,8.271023647568095,0.08312429507137664,-0.04232717925248153,-0.12545147432385817,64929694,66042314,38.80701156360037,30.415584285306977,NaN,NaN,-0.8563800029082289,0.2102638779054592
1997-09-08T09:30:00-04:00,93.71875,94,93.3125,93.54687,803500,4554184.95,54.32448119995007,49.18272887079665,NaN,NaN,93.68257251088797,50.355937262896646,0.13973912451923934,0.049222431325190996,-0.09051669319404834,65733194,66861394,41.42184604197387,31.540481713193632,NaN,NaN,0.5030712529717598,0.2520935029149307
1997-09-09T09:30:00-04:00,93.21875,94.28125,92.90625,93.59375,1885200,4330650.05,54.508549007771535,49.47650714206519,NaN,NaN,92.23893193420136,71.47017879251686,0.1717158424839009,0.12412810991082779,-0.04758773257307311,67618394,66598714,40.81943230089043,32.549979054402016,NaN,NaN,1.660375984083465,0.4532767145104356
1997-09-10T09:30:00-04:00,93.125,93.5,91.65625,91.65625,3623700,4203795,46.21863124247835,48.811692278890106,NaN,NaN,-0.6866217534195155,64.00074680883661,0.05954372622963626,0.026841925213972218,-0.03270180101566404,63994694,66173794,39.810803848888604,32.73755263016078,NaN,NaN,0.23309159831082127,0.42182169791049073
1997-09-11T09:30:00-04:00,91.78125,91.90625,90.25,91.1875,7055898,4207474.85,44.457019497625936,48.48100163922037,NaN,NaN,-77.30927566794122,37.138949973864136,-0.04350135746071674,-0.08707849784155997,-0.043577140380843225,56938796,63842954.4,34.7399270914421,32.40686184086401,NaN,NaN,-1.4702821328890798,0.15152115065340926
1997-09-12T09:30:00-04:00,92,92.96875,90.9375,92.65625,6708000,4369739.85,50.78650756481889,48.61065995651706,NaN,NaN,-0.24273034683177958,21.53657533537936,-0.011678128359236456,-0.058174800829888795,-0.04649667247065234,63646796,63586374.8,34.223157906084,32.013318228225366,NaN,NaN,-1.0312518124673298,-0.017446415506696317
1997-09-15T09:30:00-04:00,92.65625,93.3125,92.1875,92.5,2060500,4227409.75,50.13200506552732,48.78834305373886,NaN,NaN,28.84002524730488,8.568065882662745,-0.0006673667750650703,-0.04733088093948368,-0.04666351416441861,61586296,62756995.2,32.53824395634818,31.837035049979345,NaN,NaN,-0.869284807865858,-0.139137614415148
1997-09-16T09:30:00-04:00,93.3125,95.28125,93.03125,94.8125,6979000,4294414.85,58.62964957577772,49.92506420720361,NaN,NaN,147.27841350620494,19.575962197063458,0.15427271967081166,0.14617738542409597,-0.008095334246715685,68565296,62946375.6,33.34521020708715,32.205812620092956,NaN,NaN,2.054943687139861,0.17430257152128187
1997-09-17T09:30:00-04:00,95.375,95.5,94.5,94.8125,2220000,4215274.85,58.62964957577772,50.88626004702239,NaN,NaN,159.0559637513331,51.524479298013986,0.24337273689513741,0.2961205868722061,0.05274784997706868,68565296,63860496,37.24718109097784,33.16957641404131,NaN,NaN,4.349119464271248,0.770704984771277
1997-09-18T09:30:00-04:00,95,96.375,94.96875,95.21875,5045398,4289634.75,60.01776234037984,52.28580111809731,NaN,NaN,176.1262548866578,102.21158540893379,0.31190593436110536,0.4426302679284504,0.13072433356734503,73610694,67194875.6,48.97971601187255,35.20155705474125,NaN,NaN,6.65419040327767,1.6112029017007616
1997-09-19T09:30:00-04:00,94.65625,95.35937,94.40625,95.03125,1566400,4098324.65,59.03324184142658,53.494058737999,NaN,NaN,121.37374604477058,126.53488068725426,0.3253529895829147,0.5374155705459884,0.21206258096307373,72044294,68874375.2,53.677569834029825,37.63182834308667,NaN,NaN,8.274974292108688,2.563170243187608
1997-09-22T09:30:00-04:00,95.5,96.20312,95.21875,95.5625,3259000,3902629.75,60.98599715974727,54.01434348479096,NaN,NaN,139.92014348256288,148.75090433430586,0.34869560178060854,0.6479320831888344,0.2992364814082259,75303294,71617774.8,60.13477642314129,40.133321544784515,NaN,NaN,10.208555945142841,3.655368200609784
1997-09-23T09:30:00-04:00,95.5625,95.70312,94.75,95.125,1872800,3801869.75,58.51240564386765,54.493686407425635,NaN,NaN,102.64866294857865,139.8249542227806,0.31439878944505883,0.6922349682145494,0.3778361787694906,73430494,72590814.4,62.15009746387878,42.34177440126448,NaN,NaN,11.179449039089615,4.730236891821188
1997-09-24T09:30:00-04:00,95.375,96.10937,94.28125,94.34375,2793100,3727024.75,54.27867026823099,54.52156138076692,NaN,NaN,81.47899059758078,124.30955959203013,0.2231186976739149,0.6567345508618843,0.43361585318796936,70637394,73005234,63.007834660161684,44.35020060002694,NaN,NaN,10.84965334472404,5.604439242235881
1997-09-25T09:30:00-04:00,94.25,94.75,93.625,93.6875,6327801,3769199.75,50.94414507049112,54.389908218133655,NaN,NaN,31.947646099258233,95.47383783455022,0.1083763188788825,0.5690862517865725,0.46070993290768997,64309593,71145013.8,56.78701939164513,45.6344868734587,NaN,NaN,9.622553285475782,6.178455534127296
1997-09-26T09:30:00-04:00,94.4375,94.8125,94.1875,94.46875,3995800,3754594.85,54.52573522358903,54.40428350553644,NaN,NaN,50.72794607516606,81.34467784062932,0.0764340984014441,0.5562525559094951,0.47981845750805097,68305393,70397233.6,54.45935926892537,46.565737818240954,NaN,NaN,9.56508474320024,6.662259706852002
1997-09-29T09:30:00-04:00,94.5,95.5625,94.15625,95.375,2065000,3725229.85,58.32663390004455,54.67700385498451,NaN,NaN,74.41599669836128,68.243848483789,0.10586687623719648,0.6121520528045465,0.5062851765673501,70370393,69410653.4,51.46225128744525,47.32593917442343,NaN,NaN,10.62240162593693,7.227994266721278
1997-09-30T09:30:00-04:00,95,95.6875,94.375,94.375,4137602,3567409.95,53.05678458975292,55.16544337978984,NaN,NaN,55.03973707891023,58.72206330985532,0.05033168545681632,0.5691997833883704,0.5188680979315541,66232791,67971112.8,47.366119897140656,47.86560460644144,NaN,NaN,9.973742720503274,7.620244045832991
1997-10-01T09:30:00-04:00,95.25,95.8125,94.78125,95.625,3567500,3605159.95,58.14717150137817,56.14331138005786,NaN,NaN,84.86899601516009,59.4000643933712,0.08792649201673564,0.6287762129524737,0.540849720935738,69800291,67803692.2,46.89858450504687,48.734080135984634,NaN,NaN,10.97941665479263,8.10012584711294
1997-10-02T09:30:00-04:00,95.53125,96.1875,95.3125,96.15625,2577500,3610349.95,60.12614421955643,56.81042828396768,NaN,NaN,104.51816820744905,73.91416881500936,0.13585324666938825,0.7106662792724734,0.5748130326030851,72377791,69417331.8,51.83344211857845,49.99195757973424,NaN,NaN,12.415983691964179,8.716676967805974
1997-10-03T09:30:00-04:00,97.46875,97.75,95.34375,96.64062,6499898,3752179.85,61.895262789813124,57.65066097855953,NaN,NaN,133.81095712019925,90.53077102401596,0.18444205744014275,0.8053656044032635,0.6209235469631208,78877689,71531791,57.41780944190484,51.76906940013115,NaN,NaN,14.140643026697674,9.49152926193336
1997-10-06T09:30:00-04:00,97.3125,97.60937,96.90625,97.28125,2272100,3825609.85,64.16016486489048,58.04569778492472,NaN,NaN,156.18090336392476,106.88375235712866,0.24045049380021521,0.9214866642133899,0.6810361704131747,81149789,73687670.2,62.22648584072259,53.83201765967653,NaN,NaN,16.278993751563583,10.46116704616625
1997-10-07T09:30:00-04:00,97.53125,98.5,97.20312,98.1875,1832800,3822989.85,67.136046773834,58.65329758478589,NaN,NaN,174.942915639265,130.8643880691996,0.31457656550383406,1.0742568772929673,0.7596803117891332,82982589,77037629.8,68.23010532591144,56.04508367645751,NaN,NaN,19.036802325543658,11.686257800363022
1997-10-08T09:30:00-04:00,98.35937,98.375,96.73437,97.5,4439398,3863774.75,62.87113219135762,58.857109716998586,NaN,NaN,141.95730515938635,142.28204989804485,0.29374622354314917,1.1268630912180697,0.8331168676749205,78543191,78786209.8,70.83570599201107,57.606225817895975,NaN,NaN,20.105162196590104,12.888958428395462
1997-10-09T09:30:00-04:00,96.78125,97.60937,96.21875,97.15625,3607800,3691369.85,60.791659323484694,58.98271096571703,NaN,NaN,102.0943606405516,141.79728838466536,0.2357588169303172,1.127815388837817,0.8920565719074999,74935391,79297729.8,71.57026499968458,58.8842754725856,NaN,NaN,20.385407208402196,13.959879682682137
1997-10-10T09:30:00-04:00,96.3125,96.98437,96.25,96.875,2858100,3498874.85,59.07016856806425,58.845866066311096,NaN,NaN,75.48768403808857,130.13263376824324,0.160973139675482,1.0932729965018524,0.9322998568263704,72077291,77937650.2,66.75577329083467,59.35720382027798,NaN,NaN,20.131572272266386,14.841550052622745
1997-10-13T09:30:00-04:00,97.34375,97.54687,96.71875,96.96875,1760300,3483864.85,59.482049414176004,58.91512633561884,NaN,NaN,88.55756910752173,116.60796691696264,0.10314375418278554,1.0612295495548523,0.9580857953720667,73837591,76475210.6,61.93154318342249,59.341592800245394,NaN,NaN,20.031900641468305,15.58302870817211
1997-10-14T09:30:00-04:00,97.46875,97.5,96.1875,97,2235700,3246699.85,59.62788936980628,59.29721341430279,NaN,NaN,67.75176816398252,95.16973742190615,0.05475006634647228,1.026523378305157,0.9717733119586848,76073291,75093351,57.68921303632814,58.961691255685864,NaN,NaN,19.986308812184042,16.212068723030956
1997-10-15T09:30:00-04:00,96.3125,97.0625,96.28125,96.78125,2601700,3265784.85,58.05269495920646,59.80496697778245,NaN,NaN,49.03952563835956,76.58618151770078,-0.001271834345925038,0.9701835190262784,0.9714553533722035,73471591,74079031,54.72587608521555,58.814466733798035,NaN,NaN,19.543086641926756,16.687928425730355
1997-10-16T09:30:00-04:00,97.3125,97.5,95,95.25,9488102,3487920.05,48.411775419364076,59.36825556319496,NaN,NaN,-5.655553318904716,55.03619872580951,-0.14289597546032573,0.7928353840467963,0.935731359507122,63983489,71888650.6,48.88604165173104,58.41637261828415,NaN,NaN,16.317249224227425,16.63497425408708
1997-10-17T09:30:00-04:00,95.01562,95.375,93,94.28125,8151301,3817165.1,43.49087562401534,58.30855854347859,NaN,NaN,-115.71674572023947,16.79531277414392,-0.29452664624983993,0.5675730516948221,0.862099697944662,55832188,68639630,41.76647950177661,57.72381749073639,NaN,NaN,11.947267221868671,15.965301820913021
1997-10-20T09:30:00-04:00,94.84375,95.75,94.15625,95.625,3636400,3836035.1,50.94010833369732,58.15736738233176,NaN,NaN,-49.47973597156815,-10.812148241674056,-0.2962308522786694,0.49181113259632525,0.7880419848749947,59468588,65765829.4,36.67825847513348,56.96039881773588,NaN,NaN,10.337526039152166,15.161333852090042
1997-10-21T09:30:00-04:00,96.21875,97.5,96.03125,97.48437,5225398,4003665,58.99503258308925,58.21792888816827,NaN,NaN,62.33871951029633,-11.894757972411293,-0.17029388360634878,0.5751746303670586,0.7454685139734074,64693986,63489968.4,33.22609620033593,55.98379251025653,NaN,NaN,11.646708063219224,14.659244453679925
1997-10-22T09:30:00-04:00,97.34375,97.39062,96.53125,96.84375,4485199,4088269.95,55.60746969445184,57.89516642208936,NaN,NaN,51.645440668464964,-11.373574966390205,-0.13011111061047187,0.5828296257103176,0.7129407363207895,60208787,60837407.6,29.715579838081354,54.403945204506726,NaN,NaN,11.567956716847823,14.217631919846767
1997-10-23T09:30:00-04:00,94.9375,95.75,94.28125,94.9375,8054102,4174585,46.96546337345825,56.82875217806402,NaN,NaN,-81.8833033666421,-26.619124975937677,-0.2262568538067744,0.43011966906232146,0.6563765228690959,52154685,58471646.8,26.977858028122967,52.229662960665166,NaN,NaN,8.403435713008006,13.387032461726944
1997-10-24T09:30:00-04:00,96.15625,96.15625,93.67187,94,6778699,4313729.95,43.393688209894385,55.34543241699287,NaN,NaN,-109.21575719197297,-25.318927270284373,-0.3404715041381795,0.23078714269637146,0.571258646834551,45375986,56380406.4,24.80255695250952,49.556525182935665,NaN,NaN,4.588340100100326,12.130076410066
1997-10-27T09:30:00-05:00,93.01562,93.9375,86.84375,87.1875,10840699,4752514.9,27.203539489850797,52.493110468136926,NaN,NaN,-343.2276860604693,-84.06851728806461,-0.8341768462083681,-0.4714624109259091,0.36271443528245895,34535287,51393746.2,20.547856962406243,46.15065029982816,NaN,NaN,-7.240094996917308,9.362909066211241
1997-10-28T09:30:00-05:00,84.375,92.875,84.375,92.21875,19548000,5523034.8,43.86201219508388,51.13531618268881,NaN,NaN,-242.7477557111897,-145.08581233236183,-0.7821170384536937,-0.6149318627846583,0.16718517566903549,54083287,49271606.4,19.050172585435845,42.451683627929924,NaN,NaN,-8.585388663076946,6.7988665334557865
1997-10-29T09:30:00-05:00,92.5,93.75,91.28125,91.96875,10184199,5853869.75,43.33140095835426,49.88815487089378,NaN,NaN,-117.14552637840868,-178.84400574173654,-0.7259657032644233,-0.7402719534114937,-0.014306250147070348,43899088,46009666.6,16.999161952972543,38.55374769602192,NaN,NaN,-9.69629096827296,4.442415461780252
1997-10-30T09:30:00-05:00,90.625,92.5625,89.75,89.9375,9772898,6213639.65,39.183752247264394,48.46769656226521,NaN,NaN,-144.64301506601836,-191.3959480816118,-0.7822140147112138,-0.9920737685360876,-0.20985975382487382,34126190,42403967.6,15.067983747921872,34.861762728671,NaN,NaN,-12.257099897214676,2.056770410495262
1997-10-31T09:30:00-05:00,91.8125,92.5,90.4375,92.0625,7072699,6242279.7,45.103757528402205,47.44067571328137,NaN,NaN,-99.74705770517288,-189.50220818425177,-0.6389386284871865,-1.008533039433857,-0.36959441094667045,41198889,41568548.2,14.652637384741908,31.484698028765248,NaN,NaN,-11.831600507033786,0.07271742227682654
1997-11-03T09:30:00-05:00,93.1875,94.375,92.875,94,5548500,6406099.7,49.89301518992512,46.74532755757558,NaN,NaN,-32.26515425802706,-127.30970182376333,-0.38862592806417895,-0.8553768210268942,-0.4667508929627152,46747389,44010968.6,21.468195013619066,28.8974824557146,NaN,NaN,-9.62740228719365,-1.3130139647903842
1997-11-04T09:30:00-05:00,93.875,94.4375,93.28125,94,3455700,6487244.7,49.89301518992512,46.16249328834119,NaN,NaN,-22.343374493147987,-83.22882558015499,-0.20710708468263261,-0.725634748816006,-0.5185276641333734,46747389,42543789,20.413616807811437,26.44660679304287,NaN,NaN,-8.018280640600981,-2.270909204191898
1997-11-05T09:30:00-05:00,94.1875,95.28125,93.84375,94.3125,4774898,6504019.7,50.69759907519424,46.325766406614775,NaN,NaN,0.5575469792836473,-59.68821090861653,-0.05780735696944217,-0.590786860345176,-0.5329795033757339,51522287,44068428.8,24.56076171922369,24.70908679786378,NaN,NaN,-6.513916681903383,-2.877053129579253
1997-11-06T09:30:00-05:00,94.03125,94.34375,93.5,93.95312,3679800,6507619.7,49.70905255463539,46.76992190165907,NaN,NaN,-13.174697883784077,-33.39454747216968,0.020725457491930888,-0.5070726815108202,-0.5277981390027511,47842487,46811688.2,31.47933171503101,23.974290527381953,NaN,NaN,-5.625531103459234,-3.269692840133536
1997-11-07T09:30:00-05:00,92.375,93.25,91.4375,92.9375,10606801,6895054.75,46.924403294189965,46.48308582740854,NaN,NaN,-55.055308675313285,-24.456197666197745,0.008859180592955207,-0.5167241632615571,-0.5255833438545123,37235686,46019047.6,30.605920798938016,23.540552121939417,NaN,NaN,-5.7292537188102575,-3.6210586799444964
1997-11-10T09:30:00-05:00,93.625,93.84375,92,92.375,4347898,7024434.65,45.40722729159825,45.51252830658775,NaN,NaN,-42.05410176741024,-26.413987168074378,-0.03014857764165535,-0.5632690659065815,-0.5331204882649262,32887788,43247127.4,27.710410198011274,23.1465745503448,NaN,NaN,-6.259877927835767,-3.998032858214678
1997-11-11T09:30:00-05:00,92.6875,93.0625,92.03125,92.40625,3212400,7073269.65,45.51262841574502,44.79146821525155,NaN,NaN,-44.01400925214648,-30.74811411987408,-0.04616278681704766,-0.5908239717862358,-0.5446611849691881,36100188,41117687.2,25.69897983603485,22.859674550198623,NaN,NaN,-6.660683736280289,-4.378411555081193
1997-11-12T09:30:00-05:00,91.625,92.71875,90.375,90.5,6775301,7281949.7,40.389941297792895,44.32178806698975,NaN,NaN,-82.87287525774097,-47.43419856727901,-0.17046710291177614,-0.7577450636089083,-0.5872779606971321,29324887,36678207.2,22.09767440756262,22.511090005872884,NaN,NaN,-8.523973845417485,-4.970634739414949
1997-11-13T09:30:00-05:00,91.46875,92.15625,90.09375,91.8125,8589602,7237024.7,44.981682061510355,44.435216199248025,NaN,NaN,-69.30376636332237,-58.66001226318666,-0.15032768802014174,-0.7751875707223093,-0.6248598827021675,37914489,34692607.6,20.700444119335586,22.21808194636046,NaN,NaN,-8.778720310544589,-5.514646963862041
1997-11-14T09:30:00-05:00,92.3125,93.39062,91.60937,93.0625,5827898,7120854.55,49.01012437066687,45.99282940502059,NaN,NaN,-15.553355317145574,-50.75962159155312,-0.0443554590731996,-0.6803042065436671,-0.6359487474704675,43742387,35993947.8,24.088218334703242,22.470964901524532,NaN,NaN,-7.794622162195646,-5.840357706481127
1997-11-17T09:30:00-05:00,94.375,95.3125,94.03125,94.78125,5149898,7196529.45,53.99777535671419,46.7168124879942,NaN,NaN,65.55375320577926,-29.23805059691522,0.1398755004914184,-0.46110437185619446,-0.6009798723476129,48892285,39194847.2,31.805413221659336,23.38205351839764,NaN,NaN,-5.395322668157012,-5.776781272434825
1997-11-18T09:30:00-05:00,94.8125,95.09375,93.89062,94.1875,3433600,7106939.55,52.1017674076889,47.34326723437523,NaN,NaN,63.56975122254642,-7.721298501976641,0.21560267281816248,-0.33147653132490973,-0.5470792041430722,45458685,41066546.6,35.9084003452769,24.732713403562236,NaN,NaN,-3.980573157133209,-5.520180113106022
1997-11-19T09:30:00-05:00,93.6875,95.0625,93.6875,94.65625,4387801,7102069.65,53.49021955616186,48.36515775643933,NaN,NaN,79.29496212916465,24.71226897540448,0.28666689556826974,-0.18874558468273506,-0.4754124802510048,49846486,45170866.4,43.881803639158164,26.7908433957934,NaN,NaN,-2.4096321054086998,-5.075816112006405
1997-11-20T09:30:00-05:00,95.3125,96.53125,95.28125,96.09375,4822699,6940499.5,57.55373714084685,49.25444201447109,NaN,NaN,143.0426953195746,67.18156131198387,0.41225315785706806,0.03990396707033028,-0.3723491907867378,54669185,48521805.6,49.41498082465985,29.273867927216113,NaN,NaN,0.1728845983772095,-4.326001724808745
1997-11-21T09:30:00-05:00,96.625,96.8125,95.65625,96.75,5436500,6873389.55,59.30188551133948,49.926504180286415,NaN,NaN,148.87777552745266,100.06778748090352,0.5146321806761097,0.2709410350583994,-0.24369114561771035,60105685,51794465.2,54.16789178612357,31.609560553823577,NaN,NaN,2.845800302543939,-3.301458578044076
1997-11-24T09:30:00-05:00,96,96.34375,94.625,95,4337199,6548214.55,53.02979658277355,50.15055999406129,NaN,NaN,93.09983981319422,105.5770048023865,0.4423642734445539,0.30926419618798207,-0.13310007725657186,55768486,53169705.4,56.037218980272215,34.154103566142204,NaN,NaN,3.358762793825449,-2.349998382062715
1997-11-25T09:30:00-05:00,95.625,95.8125,94.65625,95.25,4525000,5797064.55,53.78184014691898,50.370862927755915,NaN,NaN,82.7049945756145,109.40405347300012,0.39104654701976665,0.35570810651813645,-0.035338440501630194,60293486,56136665.6,59.84260618879157,36.67423531396849,NaN,NaN,3.9929150444807653,-1.4438678925565036
1997-11-26T09:30:00-05:00,95.875,95.98437,95.3125,95.53125,2681100,5421909.6,54.66132147091367,50.7245964217758,NaN,NaN,91.75954399008756,111.89696984518471,0.35665317588298895,0.410478029352106,0.05382485346911704,62974586,58762285.6,62.902869847438055,38.918773751997556,NaN,NaN,4.762328102659554,-0.5572684646684954
1997-11-28T09:30:00-05:00,95.75,96.25,95.59375,95.625,1564700,5011499.7,54.96892387503944,51.299205034693614,NaN,NaN,96.31402188606992,102.55123515848376,0.3218919234116521,0.4561897577336822,0.13429783432203007,64539286,60736305.8,65.05880401566239,41.37969398176358,NaN,NaN,5.48327902803952,0.30566689143264947
1997-12-01T09:30:00-05:00,96.21875,98.09375,96.03125,98.09375,4850898,4900409.65,62.23501309297187,52.50118973479173,NaN,NaN,158.61528379890711,104.49873681277465,0.43955562710310414,0.6837423682009103,0.24418674109780614,69390184,62593205.6,67.00152576294391,44.18620223640163,NaN,NaN,8.324872024792974,1.4512676247698386
1997-12-02T09:30:00-05:00,97.6875,97.98437,97.25,97.5,1974900,4721729.65,59.73838931517652,53.51731551332255,NaN,NaN,145.85200825343557,115.04917050082292,0.4501447829489963,0.8068677197840515,0.3567229368350552,67415284,64922565.2,69.3069242295344,47.30105540736588,NaN,NaN,9.986757757214715,2.6706233579762495
1997-12-03T09:30:00-05:00,97.625,98.53125,96.875,97.78125,3302500,4714069.65,60.54578298128687,54.95701849071498,NaN,NaN,132.27513944178543,124.96319947405712,0.4478810703619957,0.9165742747875498,0.4686932044255541,70717784,67007424.8,71.24341072640266,50.81146514442588,NaN,NaN,11.59068027989227,3.944917203964253
1997-12-04T09:30:00-05:00,98.5,98.71875,97.375,97.6875,2872500,4618949.75,60.11304367982996,56.03783003488066,NaN,NaN,121.79604098216103,130.9704988724718,0.4127276609091224,0.984602780561957,0.5718751196528347,67845284,67981564.4,72.12825587829286,54.48488027006569,NaN,NaN,12.806713362419542,5.21088808374358
1997-12-05T09:30:00-05:00,97.375,99,97.125,98.9375,3458800,4607899.75,63.82555461207166,57.096075052123865,NaN,NaN,121.67642064156348,136.04297862357052,0.44361672238133776,1.1263960226295069,0.6827793002481691,71304084,69334524,73.3545678906332,58.003905238346405,NaN,NaN,14.938298761652277,6.600518180587679
1997-12-08T09:30:00-05:00,98.96875,99,98.25,98.65625,2289200,4192019.7,62.41784582592998,57.69750865706785,NaN,NaN,120.53662510782165,128.42724688535344,0.415548779564462,1.2022152747037467,0.7866664951392847,69014884,69259464,73.16224442731907,60.95796461017924,NaN,NaN,16.35161038972593,7.993531353321715
1997-12-09T09:30:00-05:00,98.21875,98.59375,97.625,98.0625,1703000,4059774.8,59.43744855389545,58.2214858817969,NaN,NaN,92.13598338701195,117.68404191206874,0.33110895692017395,1.2005526912895021,0.8694437343693282,67311884,69238784,73.10537470952943,63.61489135048299,NaN,NaN,16.773284623931747,9.247781820551719
1997-12-10T09:30:00-05:00,97.5625,97.84375,96.46875,97.21875,3558400,4077074.8,55.38991093009282,58.35717812279196,NaN,NaN,53.0512322989636,101.83926048350436,0.19905372689438416,1.1182608929873084,0.9192071660929242,63753484,67845924,69.20358157544379,65.42358977450338,NaN,NaN,16.03223805552359,10.216989854119129
1997-12-11T09:30:00-05:00,96.3125,96.59375,95.3125,95.5625,5072801,3991949.8,48.41964811196036,57.70474319215721,NaN,NaN,-9.438585792720147,75.59233512852812,-0.008228900205420886,0.9089210408361481,0.917149941041569,58680683,66013003.8,64.33728642147959,66.4894687457048,NaN,NaN,13.284160277611939,10.655157057475245
1997-12-12T09:30:00-05:00,96.4375,96.5,94.90625,95.75,4478398,3786389.6,49.19903043640101,56.983110686804466,NaN,NaN,-27.36072169030673,45.78490666215408,-0.1341139315715485,0.7495075265771334,0.8836214581486819,63159081,64384003.2,60.28026414971763,66.9260667716758,NaN,NaN,11.238691277515883,10.738519088909621
1997-12-15T09:30:00-05:00,96.25,97.10937,95.875,96.71875,4674699,3728729.65,53.138833165337104,56.990899014130434,NaN,NaN,7.0098000737223405,23.07954165533422,-0.15221820286985843,0.6933487045613589,0.8455669074312173,67833780,64147782.4,59.692442500185734,67.18715416595533,NaN,NaN,10.560178376913598,10.713041844338761
1997-12-16T09:30:00-05:00,97.21875,97.8125,96.875,97.3125,2885800,3615524.75,55.42081003895795,57.107968292133215,NaN,NaN,45.6284686532422,13.778038708580272,-0.12540321385733733,0.6888128901095456,0.8142161039668829,70719580,64829321.6,60.87780459631877,67.26109690935014,NaN,NaN,10.627363787133664,10.70080212188089
1997-12-17T09:30:00-05:00,97.84375,97.875,96.70312,96.8125,2236300,3555659.75,53.076828586252525,56.99479022894314,NaN,NaN,27.074742857143526,8.582740820216259,-0.14135413925609852,0.6375234298967598,0.7788775691528583,68483280,65775280.8,62.52509926677169,67.2341132964454,NaN,NaN,10.026365570207453,10.6044540430704
1997-12-18T09:30:00-05:00,96.9375,96.9375,95.21875,95.875,4658301,3569184.75,48.90062495539077,56.56134030611109,NaN,NaN,-55.26119793966055,-0.5817816091718242,-0.21087179067119777,0.5152878308138611,0.7261596214850589,63824979,66804140,64.28646343654606,67.1789461122228,NaN,NaN,8.296448869187687,10.274739018230012
1997-12-19T09:30:00-05:00,94.53125,95.875,92.375,94.78125,8556000,3755849.8,44.50134765797873,55.29464991789729,NaN,NaN,-153.9972682926817,-25.909090929646815,-0.3198106885393648,0.3263962608108528,0.6462069493502176,55268979,65226119.6,59.65521149437221,66.65420937875341,NaN,NaN,5.461167379799765,9.58708592702569
1997-12-22T09:30:00-05:00,95.4375,95.90625,94.5625,95.39062,5136801,3740864.85,47.34361953453054,54.40930921927971,NaN,NaN,-84.42952533105633,-44.19695601060255,-0.3383292500772329,0.22329538675367644,0.5616246368309094,60405780,63740519.6,55.59465224822327,65.67476138008831,NaN,NaN,3.8802346546725217,8.771821459546667
1997-12-23T09:30:00-05:00,95.4375,95.625,93.53125,93.6875,4436500,3745829.9,41.02047980392887,53.0146447066113,NaN,NaN,-136.62756062495387,-80.64816186624176,-0.4460099115438164,0.004112247401138802,0.4501221589449552,55969280,60790459.6,48.53041738268088,64.05240471267962,NaN,NaN,0.45390218028819546,7.583547276795457
1997-12-24T09:30:00-05:00,94.4375,94.4375,93.25,93.40625,2019200,3620539.9,40.0687598222279,51.582910145354,NaN,NaN,-155.28246045276313,-117.1196025282231,-0.5121738832214915,-0.1900951950819092,0.3220786881395823,53950080,57883819.6,42.76459153996606,61.95500011708485,NaN,NaN,-2.6180891276459723,6.1261706475895386
1997-12-26T09:30:00-05:00,94.125,94.125,93.40625,93.78125,941800,3533574.9,42.0009624074176,50.02401070216443,NaN,NaN,-134.99102202421898,-133.06556734513478,-0.5057998835629733,-0.31017116631413444,0.19562871724883893,54891880,56097199.8,39.64657277157282,59.54728618000911,NaN,NaN,-4.613306982130738,4.591959557629499
1997-12-29T09:30:00-05:00,94.59375,95.71875,94.4375,95.625,2080000,3559339.9,50.45816828203583,49.1697480204577,NaN,NaN,-56.737577765886854,-113.6136292397758,-0.35940961037996555,-0.25363329572611804,0.10577631465384754,56971880,56437780,40.53662580125105,57.216884849575685,NaN,NaN,-3.8105119346699863,3.3916064873010017
1997-12-30T09:30:00-05:00,95.9375,97.25,95.84375,97.125,3616000,3497595,56.07041924704507,48.929245927111246,NaN,NaN,18.56982699765561,-93.01375877403343,-0.15405202427067127,-0.08678871568449154,0.06726330858617972,60587880,56474200,40.637442339041066,54.89774682311223,NaN,NaN,-1.2685057323464457,2.725876170208509
1997-12-31T09:30:00-05:00,96.875,97.625,96.6875,97.0625,4359500,3616825,55.786842740284484,48.95759819926779,NaN,NaN,39.853995028761275,-57.717447643290406,-0.021864036797309735,0.03993326258954255,0.061797299386852286,56228380,56526020,40.79126141179664,52.86829538285172,NaN,NaN,0.6520188539226702,2.429610839310532
1998-01-02T09:30:00-05:00,97.3125,97.65625,96.53125,97.5625,2360900,3569745,57.63287835347917,49.61568607366199,NaN,NaN,48.32064521537796,-16.996826509662185,0.09348041950802416,0.17864782377188249,0.08516740426385833,58589280,57453860,43.608796381819445,51.38768895144742,NaN,NaN,2.8023378902172293,2.4828575608686316
1998-01-05T09:30:00-05:00,97.84375,98.4375,96.78125,97.78125,4191801,3635710.05,58.45025024600663,50.276487488633826,NaN,NaN,71.45559565919194,24.29249702701999,0.17405935105953022,0.3027415930882711,0.12868224202874087,62781081,59031700.2,48.12923683485509,50.51975842895724,NaN,NaN,4.8066917641237445,2.814833875619362
1998-01-06T09:30:00-05:00,97.25,97.28125,96.1875,96.21875,3154900,3620515.05,50.89691370029322,50.11635038398783,NaN,NaN,19.10806142485135,39.46162486516763,0.11455191432832285,0.2718721349391444,0.15732022061082157,59626181,59562560.4,49.59329893000187,49.798391031086965,NaN,NaN,4.352718792262415,3.034531720854084
1998-01-07T09:30:00-05:00,96.09375,96.71875,95.21875,96.46875,4424199,3727265,51.96646513569817,49.869611462326425,NaN,NaN,2.288735242064138,36.205406514049336,0.08576896273156573,0.26453142402527874,0.178762461293713,64050380,60255060.4,51.51577784928698,49.1296748348704,NaN,NaN,4.293738663188994,3.2144184269019282
1998-01-08T09:30:00-05:00,96.3125,96.3125,95.375,95.625,3831000,3833665,48.15418031235134,49.517993728476334,NaN,NaN,-14.271780076592654,25.380251492978545,0.007756318453256722,0.18845785936028392,0.1807015409070272,60219380,61053260.4,53.70737991822244,48.49983773854546,NaN,NaN,3.116449675469032,3.200422890982943
1998-01-09T09:30:00-05:00,95.25,95.5,91.90625,92.3125,10258801,4168685.05,36.754363859852965,48.65040365022363,NaN,NaN,-158.61581571799124,-16.007040693695295,-0.25459052750592587,-0.13753661847538012,0.11705390903054573,49960579,59327520.2,48.59310259558868,47.37888339276278,NaN,NaN,-2.077110619930964,2.4464895322809563
1998-01-12T09:30:00-05:00,91.125,94.1875,90.90625,94,12097898,4519939.9,44.02437969991223,48.616334510361746,NaN,NaN,-142.21975741568073,-58.742111308669834,-0.29905324236008285,-0.25676264391955783,0.04229059844052502,62058477,59182999.4,48.17934042393283,46.559178316302834,NaN,NaN,-3.874944871179422,1.5434274746437595
1998-01-13T09:30:00-05:00,94.625,95.375,94.21875,95.3125,5224898,4557264.9,48.94049031233029,48.73039670877601,NaN,NaN,-33.861853427543174,-69.33609427914874,-0.2278696170709011,-0.24254642289810135,-0.01467680582720026,67283375,60714438.2,52.768776469277604,46.357330046378145,NaN,NaN,-3.605663573220994,0.8078430392345091
1998-01-14T09:30:00-05:00,95.6875,95.96875,94.71875,95.75,3770400,4512049.95,50.501056138355366,49.40758073266362,NaN,NaN,-4.104308963944107,-70.61470312035038,-0.14325376437469112,-0.19374401129556418,-0.05049024692087305,71053775,62115117.2,56.558318014531906,46.93075152008179,NaN,NaN,-2.8732381250128394,0.2819743014848879
1998-01-15T09:30:00-05:00,95.5,95.75,94.8125,94.95312,2875400,4511529.95,47.64465503480605,49.94871610499063,NaN,NaN,-16.023820483688716,-70.9651112017696,-0.13310329814162283,-0.2168693695979016,-0.08376607145627876,68178375,63706916.2,60.442671328629224,48.1934715049863,NaN,NaN,-3.2012444924525334,-0.21562838336331513
1998-01-16T09:30:00-05:00,96.25,96.6875,95.65625,96.3125,4374801,4618455,52.57275245772227,50.70384396572667,NaN,NaN,49.80187291016048,-29.281573476139254,-0.032247552598189455,-0.12407551220401558,-0.09182795960582613,72553176,68225435.6,68.93422091993477,50.28544637272643,NaN,NaN,-1.8571133290571382,-0.450126232748147
1998-01-20T09:30:00-05:00,96.6875,98.01562,96.5,97.875,5091699,4640124.9,57.522071214826056,51.20840846092597,NaN,NaN,113.60823507514722,21.884025022026336,0.13320962249611332,0.07468406851431553,-0.0585255539817978,77644875,71342715.2,73.20729860130538,52.61906585844459,NaN,NaN,0.9580788224007032,-0.248954082012597
1998-01-21T09:30:00-05:00,97.21875,97.6875,96.15625,96.9375,4699398,4447294.8,53.888375712432655,51.05254820845365,NaN,NaN,74.61680384069477,43.579756475673925,0.1706364123523962,0.15476996145869748,-0.015866450893698737,72945477,72475135.6,74.57543285564394,55.043208038201946,NaN,NaN,2.0744604204884554,0.0829622754875533
1998-01-22T09:30:00-05:00,96.15625,96.875,95.875,96.07812,4543398,4417624.65,50.72511007703198,50.690995875364194,NaN,NaN,34.77912488821056,51.35644324610487,0.13045078393063425,0.14719702901959408,0.016746245088959825,68402079,71944796.4,72.70304615232308,57.32262123395383,NaN,NaN,1.9772986126469438,0.3535817522246091
1998-01-23T09:30:00-05:00,96.5,96.78125,95,95.9375,6350301,4513314.7,50.20578313905745,50.16048907433407,NaN,NaN,10.26711409159938,56.614630161162474,0.08929805270158253,0.128368810965938,0.03907075826435546,62051778,70719477,68.42824950991641,59.09543931453219,NaN,NaN,1.7430880256316803,0.5520826484256192
1998-01-26T09:30:00-05:00,96.375,96.73437,95.40625,95.875,4362898,4630499.6,49.960952274040025,49.55411064776503,NaN,NaN,10.353161690130033,48.72488791715639,0.054478361913700375,0.10716871065648093,0.05269034874278055,57688880,67746617.8,59.31565770081141,59.89446937638621,NaN,NaN,1.4840278189785188,0.6852176727903191
1998-01-27T09:30:00-05:00,95.8125,97.5,95.65625,96.84375,7044199,4935619.55,53.72756650246027,49.756300133634106,NaN,NaN,49.24029025522934,35.851298953172815,0.09114120251620506,0.16661685188803688,0.07547564937183182,64733079,65164258.6,52.7449201637108,60.119585178794,NaN,NaN,2.348611824946328,0.9228454088126061
1998-01-28T09:30:00-05:00,97.40625,98.10937,97.1875,97.71875,4268602,5045049.65,56.884439860306394,50.1075840425347,NaN,NaN,111.24117209579101,43.17617260419207,0.16449534704117355,0.28109483317329875,0.1165994861321252,69001681,64375499.4,50.890558433071014,60.074926649064295,NaN,NaN,4.017246497334311,1.3649027071728497
1998-01-29T09:30:00-05:00,97.84375,99.5625,97.5625,98.25,8007699,5264634.6,58.72559836887129,50.86268533228612,NaN,NaN,149.23989638000478,66.06832690255092,0.23468930446086234,0.4099611167082031,0.17527181224734079,77009380,66096959.6,54.638863863089504,60.14146121655479,NaN,NaN,5.9534426274723025,2.0204084100727715
1998-01-30T09:30:00-05:00,98.78125,98.96875,98,98.3125,3649100,5229114.6,58.9477044000235,52.4479239422983,NaN,NaN,134.4506881283037,90.90504170989178,0.26877340027585117,0.5112385625921547,0.24246516231630358,80658480,69818300,61.48287803283506,61.06215946207239,NaN,NaN,7.6057092986882475,2.8183085370178396
1998-02-02T09:30:00-05:00,99.90625,100.5,99.75,99.9375,5756301,5398884.65,64.32325357173198,53.89784350457112,NaN,NaN,198.90795564650477,128.61600050116672,0.3775403005459595,0.714390537998753,0.33685023745279347,86414781,75563480.2,69.20726726327284,62.56415423631097,NaN,NaN,10.728935593827188,3.948398116562032
1998-02-03T09:30:00-05:00,100,100.8125,99.71875,100.6875,2763000,5327444.6,66.50336717883494,55.15233470932145,NaN,NaN,187.14801620652077,156.197545691425,0.4707142486073054,0.9252430482119252,0.4545287996046198,89177781,80452420.6,73.98786397549863,64.07980334389818,NaN,NaN,14.04216845267083,5.390365307434718
1998-02-04T09:30:00-05:00,100.28125,101.15625,99.9375,100.5625,3374000,5338399.6,65.78187181623102,56.24382154345542,NaN,NaN,158.42647262647398,165.63460579756162,0.4923171951611016,1.0699252935559969,0.5776080983948952,85803781,83812840.6,76.6690657985908,65.51628532847381,NaN,NaN,16.557620464680156,6.985687472755495
1998-02-05T09:30:00-05:00,101.3125,101.59375,100.03125,100.5,5076199,5370999.6,65.3998209784955,57.51204768229038,NaN,NaN,138.5478358237782,163.4961936863163,0.4707948758904722,1.1661016932579855,0.6953068173675133,80727582,84556481,77.22843740906221,66.71526861993333,NaN,NaN,18.539082792902878,8.636172518490834
1998-02-06T09:30:00-05:00,101,101.625,100.6875,101.625,5701199,5464509.55,68.90103061031371,58.678353264618345,NaN,NaN,136.63162048891357,163.93238015843826,0.49808115004574016,1.3179082549246885,0.8198271048789484,86428781,85710541.2,78.10573868457267,67.37037703169317,NaN,NaN,21.32875972399182,10.449399262133833
1998-02-09T09:30:00-05:00,101.71875,101.75,100.71875,101.28125,2322200,5067679.5,66.68071414826294,59.33254204557812,NaN,NaN,119.96860190198471,148.14450940953424,0.45966189197652474,1.3944044698496043,0.9347425778730796,84106581,85248901.2,76.83062199890013,67.62918584580709,NaN,NaN,23.07888429310631,12.253611409415615
1998-02-10T09:30:00-05:00,101.4375,102.46875,101.1875,102.25,3660400,4645804.6,69.6490631032929,60.45830543063956,NaN,NaN,127.27543990973636,136.1699941501774,0.4647867015583198,1.5157259548209794,1.0509392532626596,87766981,84966741.2,76.0137838099945,67.73192519968926,NaN,NaN,25.48590969879891,14.143939736470372
1998-02-11T09:30:00-05:00,102.09375,102.34375,101.70312,102.15625,4073200,4588219.7,69.008347731203,61.76425097736607,NaN,NaN,116.30744312605879,127.74618825009433,0.4280698274525738,1.5860265375783769,1.157956710125803,83693781,84544741.2,74.73404349148123,67.87699643820056,NaN,NaN,27.302554086899715,16.02374178653171
1998-02-12T09:30:00-05:00,101.71875,102.9375,100.875,102.59375,5024699,4650934.65,70.37783538185666,63.205111851851726,NaN,NaN,104.35360760765919,120.90734260687051,0.39997963200871633,1.6579312501366985,1.2579516181279822,88718480,86142920.8,76.35743023703337,68.44336649013749,NaN,NaN,29.239035328649198,17.911640863977063
1998-02-13T09:30:00-05:00,102.1875,102.51562,101.875,102,2101300,4612229.65,66.10830913495927,64.35849448477452,NaN,NaN,93.94009149478201,112.36903680804421,0.31204540578473305,1.6480083753588985,1.3359629695741655,86617180,86180600.6,76.39593732704469,69.66338646343986,NaN,NaN,29.7687223460115,19.60550964712484
1998-02-17T09:30:00-05:00,102.8125,103.09375,102.15625,102.5,3055500,4546264.6,67.87568424195615,65.36907432330996,NaN,NaN,98.38639047311386,108.05259452227003,0.2603011130828716,1.6613393609277551,1.4010382478448835,89672680,87293820.4,77.55885265498826,71.43581021281683,NaN,NaN,30.706396951197718,21.191350690563823
1998-02-18T09:30:00-05:00,102.3125,103.48437,102.28125,103.4375,3007400,4442049.65,70.93606757347479,66.37276201710769,NaN,NaN,103.54571459152561,103.3066494586279,0.26127943995398684,1.7276375477873671,1.4663581078333803,92680080,88276440.2,78.56281707465337,73.412400115787,NaN,NaN,32.4148376157243,22.794705965586747
1998-02-19T09:30:00-05:00,103.25,103.40625,102.75,102.89062,3387800,4376469.75,66.93043563154643,66.9588218215845,NaN,NaN,95.4691155986574,99.13898395314763,0.19992682534266826,1.7162666395117157,1.5163398141690474,89292280,89396140,79.67847324285455,75.20094364291307,NaN,NaN,32.74401384522912,24.216035662678514
1998-02-20T09:30:00-05:00,103.07812,103.71875,102.375,103.65625,3707000,4334649.85,69.52497127099487,67.71434088379674,NaN,NaN,98.15143424982993,97.89854928158177,0.18602823786079314,1.748875111495039,1.5628468736342458,92999280,90252300,80.51356291577191,76.56027827740856,NaN,NaN,33.77618656825791,25.581771506332714
1998-02-23T09:30:00-05:00,104.25,104.25,103.34375,104.0625,3227800,4178524.8,70.83261021829102,68.17929492997952,NaN,NaN,114.50530921686627,102.01159282599863,0.17924271416199855,1.786900266336744,1.6076575521747454,96227080,92174280,82.27453706240928,77.4936546916326,NaN,NaN,35.019660926386805,26.9300414234833
1998-02-24T09:30:00-05:00,103.90625,104.09375,102.9375,103.25,3386800,4129719.9,64.8401846851238,68.06049618042873,NaN,NaN,93.2330290856776,100.98092054851138,0.09908492122388934,1.731513703704607,1.6324287824807178,92840280,92807800,82.82547345764628,78.124912511786,NaN,NaN,34.35824747469291,27.991213716513244
1998-02-25T09:30:00-05:00,103.75,104.875,103.625,104.53125,3481800,3951599.95,69.25701420093839,68.30872063647925,NaN,NaN,124.97322946542211,105.26642352329068,0.11053321438387065,1.7705953004605561,1.6600620860766855,96322080,93536200,83.46195009256773,78.61011853278434,NaN,NaN,35.10934381249964,29.0080894445113
1998-02-26T09:30:00-05:00,104.4375,105.21875,104.1875,105.125,3187600,3897549.85,71.07067780239551,68.71378183818639,NaN,NaN,140.61495355691835,114.29559111494287,0.13467171773170872,1.8284017332413214,1.6937300155096127,99509680,95579680,85.12718672158049,79.17431491224995,NaN,NaN,36.29153629880463,30.04858185226749
1998-02-27T09:30:00-05:00,104.96875,105.53125,104.53125,105.125,3442900,3669309.9,71.07067780239551,68.8687566376208,NaN,NaN,140.6008252032845,122.7854693056338,0.12730013676484964,1.8528551864656748,1.7255550497008252,99509680,96881760,86.08840194045831,79.7445051448132,NaN,NaN,37.24011075055485,31.0759431234514
1998-03-02T09:30:00-05:00,105.25,105.75,104.625,104.90625,4252301,3699469.95,69.32323362494284,69.05750802881222,NaN,NaN,130.1256519647165,125.90953785520382,0.08631481913456973,1.8334485736190373,1.7471337544844676,95257379,96687819.8,85.20510246981262,80.34268232130695,NaN,NaN,37.54204091792304,31.99967137980449
1998-03-03T09:30:00-05:00,104.53125,105.625,104.53125,105.5,3349200,3579114.9,71.38016685991806,69.18115829714259,NaN,NaN,122.76781477046023,131.81649499216036,0.07806470356452877,1.8447146339401286,1.7666499303755998,98606579,97841079.6,86.1172849598735,81.06436097486973,NaN,NaN,38.380728538592415,32.91125097391705
1998-03-04T09:30:00-05:00,105.09375,105.40625,104.4375,104.8125,4404102,3661170,65.87248990613054,68.95716845249456,NaN,NaN,97.04191109829806,126.23023131873553,0.008820556133758872,1.7776756255427983,1.7688550694090395,94202477,97417159,84.06551024279757,81.73089431424947,NaN,NaN,37.52622236756325,33.570532601580794
1998-03-05T09:30:00-05:00,103.5,104.4375,103.15625,103.84375,7268000,3855870,58.96800859595938,68.14218082493046,NaN,NaN,34.45230592632261,104.99770179261641,-0.11299239796806892,1.6276145719489534,1.7406069699170224,86934477,94902118.4,72.95931608830942,81.48817187505492,NaN,NaN,34.672943082934715,33.728019813202785
1998-03-06T09:30:00-05:00,104.5625,105.9375,104.4375,105.9375,6896301,3946875.1,67.0151150206218,68.20695267390637,NaN,NaN,114.55532611365894,99.78860197469128,-0.06566969735132311,1.6585198482278685,1.7241895455791916,93830778,93766338,68.55459865028048,80.92807625528603,NaN,NaN,34.62624800863358,33.85633812683576
1998-03-09T09:30:00-05:00,105.53125,106.21875,105.25,105.5625,3362800,3829955.15,64.57249537096072,67.97101061169242,NaN,NaN,115.23256156241466,96.80998389423092,-0.0722169622484885,1.633918342768581,1.7061353050170696,90467978,92808457.8,64.99097477475551,80.03037069241226,NaN,NaN,33.7926319301811,33.84723724159938
1998-03-10T09:30:00-05:00,106.21875,106.84375,105.9375,106.5625,5481898,3987940.05,67.92943202561756,67.7562509297026,NaN,NaN,143.54517624825542,100.96545618978993,-0.02427177463612118,1.675795586721918,1.7000673613580393,95949876,92277117.2,63.03360052184514,78.92114093864026,NaN,NaN,34.18062930319591,33.894864678970315
1998-03-11T09:30:00-05:00,106.96875,107.3125,106.78125,107.0625,3439600,3976900.05,69.48630121926843,67.93881275739705,NaN,NaN,155.5555315518127,112.66818028049288,0.02346134892991225,1.7293940475204295,1.7059326985905172,99389476,93314517,65.23510505153746,77.88947178211761,NaN,NaN,34.992409934452795,34.051656858324954
1998-03-12T09:30:00-05:00,107.09375,107.59375,106.5,107.5,3191300,3932805.05,70.82107450261454,68.03139155965559,NaN,NaN,146.15541613910764,135.00880232304988,0.06451722849893615,1.7865792342141873,1.7220620057152511,102580776,96443776.8,70.87051356028616,77.20068254244005,NaN,NaN,36.070854820981545,34.34011371013304
1998-03-13T09:30:00-05:00,107.84375,108,106.875,107.09375,2879400,3825540.1,67.85295477763168,67.81855902817992,NaN,NaN,138.60977575624696,139.81969225156746,0.045242522181326184,1.7786151584419088,1.7333726362605826,99701376,97617896.4,72.66119916928534,76.51401555007406,NaN,NaN,36.06673243463787,34.58677352791944
1998-03-16T09:30:00-05:00,107.84375,108.375,107.53125,108.25,3223600,3881655.1,71.51241919494402,68.29514720745279,NaN,NaN,160.75861777483055,148.92490349405065,0.08877616823817824,1.8443428465583054,1.7555666783201271,102924976,100109296,76.02860567938606,76.02852499448404,NaN,NaN,37.20939300852082,34.961433453719636
1998-03-17T09:30:00-05:00,108.3125,108.5625,107.65625,108.5625,4581898,3957975,72.42602490610952,68.52150511496501,NaN,NaN,149.93997558140356,150.2038633606803,0.11534627440997403,1.8997495213325948,1.7844032469226208,107506874,102420695.6,78.65536965067508,75.68519782006315,NaN,NaN,38.41805164593596,35.45523605260768
1998-03-18T09:30:00-05:00,108.25,108.96875,108.03125,108.96875,1944100,3904810,73.6108563430717,68.70294643929903,NaN,NaN,145.05272589538845,148.10330222939544,0.13561112204101944,1.9539171494738952,1.8183060274328757,109450974,104432995.2,80.64396510258688,75.36496770442075,NaN,NaN,39.77617175423116,36.07251258141103
1998-03-19T09:30:00-05:00,108.96875,109.375,108.65625,109.25,2554800,3863160,74.43002135698994,68.9428995503415,NaN,NaN,141.525731951266,147.1773653918271,0.14257534581734577,1.9965252097045578,1.853949863887212,112005774,106317994.8,82.30686427689163,75.09485787130883,NaN,NaN,41.14058501556508,36.79652292914732
1998-03-20T09:30:00-05:00,109.5625,110.1875,108.875,109.875,3123300,3833975,76.19820730984691,69.43396909926321,NaN,NaN,143.0777148739075,148.07095321535922,0.16245028400341854,2.0570127188914853,1.8945624348880667,115129074,109403534.4,84.63396827482836,75.0540625716671,NaN,NaN,42.835478860795945,37.65923091938284
1998-03-23T09:30:00-05:00,109.71875,110.3125,109.40625,109.625,4453102,3895240.1,73.99406745922346,69.62067628492788,NaN,NaN,131.01191578687533,142.12161281776818,0.13316481785992007,2.061018457212967,1.9278536393530468,110675972,110953733.6,85.65480987394713,75.02102863695805,NaN,NaN,43.63129404488488,38.51238279445456
1998-03-24T09:30:00-05:00,110.0625,110.8125,109.9375,110.5625,3333600,3892580.1,76.71426416353478,70.39508873188532,NaN,NaN,139.24101331731347,139.98182036495018,0.15008172143222898,2.115455791143333,1.965374069711104,114009572,112254273.2,86.46709486130017,75.19257039542252,NaN,NaN,45.144502268480245,39.45982843360109
1998-03-25T09:30:00-05:00,111.40625,111.53125,109.1875,110.15625,4597602,3948370.2,73.14389798035043,71.40765225934183,NaN,NaN,120.35502958580018,135.0422811030325,0.1089735108580947,2.1015909582837224,1.9926174474256277,109411970,112246472.4,86.43547977211333,76.15515351569422,NaN,NaN,45.385890094255195,40.30640867083739
1998-03-26T09:30:00-05:00,109.875,110.75,109.625,110.09375,3333500,3955665.2,72.5842047085646,71.80544437990918,NaN,NaN,103.06966674398966,127.35106806157725,0.055340192459631954,2.0617926880001676,2.0064524955405356,106078470,111061011.6,81.55537792564058,77.08378060679138,NaN,NaN,45.42888092667652,41.03819042167155
1998-03-27T09:30:00-05:00,110.75,110.78125,109,109.625,2611300,3914085.2,68.35931263617707,72.07593132742463,NaN,NaN,80.89043076033624,114.913611238863,-0.02938413111486926,1.969722331646949,1.9991064627618182,103467170,108728630.8,72.8414786533583,77.64453088383443,NaN,NaN,44.28894872709409,41.50258446530334
1998-03-30T09:30:00-05:00,109.625,110.09375,108.96875,109.5625,3108700,3856905.15,67.79270829126922,72.06616534639974,NaN,NaN,64.90026793688749,101.69128166886543,-0.10316140705422372,1.8701547039440385,1.9733161109982622,100358470,106665130.4,66.11131662050778,77.86436774802462,NaN,NaN,43.18783676648281,41.743334794043264
1998-03-31T09:30:00-05:00,110.15625,111.1875,109.75,109.9375,5926500,3985770.15,69.42995535443521,72.0621406417688,NaN,NaN,86.53777190340249,91.15063338608323,-0.13805440526520596,1.8007481044167548,1.9388025096819608,106284970,105120210,61.52774522074283,77.59955633153928,NaN,NaN,42.65838089628107,41.87405566579152
1998-04-01T09:30:00-05:00,110.3125,111.07812,109.40625,110.82812,2929000,3912015.05,72.94731121187075,72.21401469242996,NaN,NaN,85.79134069408202,84.2378956077396,-0.1135260251527237,1.7968949782410562,1.9104210033937798,109213970,105080610,61.410216884781875,76.92382085471755,NaN,NaN,43.161408440750805,42.057963205071424
1998-04-02T09:30:00-05:00,110.9375,112.25,110.75,112.03125,3920900,3744660.05,76.82631444450243,72.85496895434929,NaN,NaN,131.59289441950648,89.94254114284294,-0.03283688761228021,1.8693748938784296,1.9022117814907098,113134870,106491890,64.04606680462248,76.30845425724162,NaN,NaN,44.82314099045401,42.45298860298322
1998-04-03T09:30:00-05:00,112.34375,112.8125,111.84375,112.59375,3787600,3589225,78.38667828385373,73.34598746069999,NaN,NaN,154.63354628689362,104.69116424815441,0.03801419868457012,1.9497295298464223,1.9117153311618522,116922470,109182950,68.46873727403991,75.76846365685977,NaN,NaN,46.71147124794798,43.06134326654961
1998-04-06T09:30:00-04:00,113.25,113.375,111.6875,111.6875,4550500,3648610,70.18698630061891,73.18605613173636,NaN,NaN,139.33666188915106,119.5784430386071,0.0051660182566297674,1.9181728539826395,1.9130068357260097,112371970,111585650,71.80370112368747,75.27905876207492,NaN,NaN,45.763908137986604,43.44742396246918
1998-04-07T09:30:00-04:00,111.75,111.9375,110.15625,110.9375,5583699,3653700.05,64.20151338125925,72.51396020589263,NaN,NaN,73.3401843989778,116.93892553772218,-0.08099716209776586,1.8117603831038025,1.8927575452015684,106788271,111686310.2,71.93761244936613,74.65717642970203,NaN,NaN,43.032721612635356,43.388180769635774
1998-04-08T09:30:00-04:00,111.21875,111.28125,109.75,110.3125,4854801,3724460.1,59.63732591156911,71.45733910264828,NaN,NaN,36.82721110389425,107.14609961968463,-0.18789851833711824,1.6578843972801707,1.845782915617289,101933470,110230210.2,66.98195669424308,73.56254017379855,NaN,NaN,39.27948127869865,42.8012236995019
1998-04-09T09:30:00-04:00,110.5625,111.28125,110.53125,111.1875,4481199,3788955.05,63.54475373160289,70.55352098991656,NaN,NaN,64.10588972888279,93.64869868155989,-0.20603946125799877,1.5882335890447905,1.7942730503027893,106414669,108886170,62.68913242824245,71.99505189904242,NaN,NaN,37.30622012230455,42.0162231884737
1998-04-13T09:30:00-04:00,111.375,111.375,110,110.875,4350199,3862495,61.263672696133106,69.64420707826726,NaN,NaN,41.61742333835278,71.04547409185173,-0.2429099886552062,1.4906355644837816,1.7335455531389878,102064470,105914570,54.38942933179111,69.76181043174556,NaN,NaN,34.993838688453735,41.01302540275656
1998-04-14T09:30:00-04:00,111.125,111.8125,110.90625,111.8125,3279100,3865270,65.28927307219186,68.82813628602847,NaN,NaN,92.38581909695617,61.655305533412744,-0.20926132200611924,1.4719689006313388,1.681230222637458,105343570,104508890,50.95290038133913,67.2250822546055,NaN,NaN,34.264029200715825,40.048883088179316
1998-04-15T09:30:00-04:00,111.96875,112.125,111.15625,112.125,3867200,3829535.1,66.5376121771307,68.35625872865563,NaN,NaN,104.12335066556116,67.81193878672941,-0.17258560042414928,1.4654982221072714,1.6380838225314207,109210770,104993389.8,52.076839472708976,64.7708936617909,NaN,NaN,34.055948621514766,39.192749592941524
1998-04-16T09:30:00-04:00,111.3125,111.5,110.5,110.8125,7177898,4091225,57.22837206644394,67.25941353993274,NaN,NaN,24.7087993061819,65.38825642718695,-0.239245527592999,1.339026913040172,1.578272440633171,102032872,105013270.2,52.12531823747843,62.66874654120789,NaN,NaN,30.805464875534966,37.99456606188345
1998-04-17T09:30:00-04:00,110.71875,112.4375,110.4375,112.28125,5688801,4247925.05,63.39953331809044,66.90514358864083,NaN,NaN,85.91989284612437,69.75105705063527,-0.18914164747750428,1.3418453812862907,1.530987028763795,107721673,105274671,52.80140378615543,61.23731262212197,NaN,NaN,30.06727298399631,36.86209562218529
1998-04-20T09:30:00-04:00,112,112.5625,111.875,112.25,3688300,4276175.05,63.190627465268626,66.57642352964078,NaN,NaN,119.03063666681182,85.23369971632708,-0.16377440688790346,1.3262690201539158,1.4900434270418192,104033373,105668451.6,53.858511973163075,60.36211229016878,NaN,NaN,29.43301416987841,35.80079827185573
1998-04-21T09:30:00-04:00,112.4375,113.15625,111.90625,112.78125,4573199,4282179.9,65.2848243912731,66.28034274655776,NaN,NaN,134.2454531065491,93.60562651824566,-0.11897069449497089,1.3413300589231056,1.4603007534180765,108606572,106321052,55.6320378863095,59.94099033770926,NaN,NaN,29.571487022573468,34.91089666481541
1998-04-22T09:30:00-04:00,112.875,113.4375,112.8125,113.09375,2386100,4234804.9,66.49246402542329,65.8192822332401,NaN,NaN,149.57680964470646,102.69631831407473,-0.07802221844307988,1.3627729803642268,1.4407951988073067,110992672,106677432.4,56.612789054962704,59.5983169212936,NaN,NaN,30.053531395213735,34.2169873405866
1998-04-23T09:30:00-04:00,112.625,113,111.75,112,5062000,4258024.8,58.78459620487092,64.53058807326641,NaN,NaN,73.76916730863934,112.5083919145662,-0.13120247794569084,1.276792101375193,1.407994579320884,105930672,107456992.4,58.76025245295263,59.220758753317185,NaN,NaN,28.03837254938189,33.33432808470021
1998-04-24T09:30:00-04:00,111.75,112.46875,110.34375,110.8125,11039699,4643334.75,51.768043114206705,62.629256989720204,NaN,NaN,-11.734348750268717,92.97754359528759,-0.24627687723400316,1.1001484827783798,1.346425360012383,94890973,104890852.4,49.98913130548595,57.900786898420485,NaN,NaN,23.949372803097997,31.993620187328467
1998-04-27T09:30:00-04:00,109.375,109.6875,107.625,108.71875,14510199,5238279.7,42.20313362558086,60.63041037007463,NaN,NaN,-201.92882100629123,28.78565206066699,-0.45138637710397833,0.78219238863241,1.2335787657363884,80380774,100160332.6,38.56185810644686,55.526369540046154,NaN,NaN,16.69729590924977,29.808431004745795
1998-04-28T09:30:00-04:00,109.78125,109.8125,108.125,108.5625,6511398,5408414.6,41.58562611266689,59.01498985088946,NaN,NaN,-179.77219907714243,-34.01787837607132,-0.5775004303320137,0.5117032278213713,1.089203658153385,73869376,93212893.4,28.32204201153077,52.41097165162934,NaN,NaN,10.960490991896004,27.115868145767255
1998-04-29T09:30:00-04:00,109.03125,109.96875,108.4375,109.3125,7703102,5497244.7,45.693132261829334,58.018976018765194,NaN,NaN,-137.67953595318036,-91.46914749564868,-0.5883395628053829,0.35377920464665635,0.9421187674520393,81572478,87328854.6,22.799950850648997,49.25511409137262,NaN,NaN,7.6041415471424605,24.328478631678
1998-04-30T09:30:00-04:00,110.5625,111.92187,110.40625,111.34375,8684500,5785019.7,54.93544008077559,57.4040250437061,NaN,NaN,-1.578812599552232,-106.538743477287,-0.44325107632209515,0.38805492204942027,0.8313059983715154,90256978,84194115.8,20.50606475667645,46.24203782911791,NaN,NaN,7.895260825946964,21.980876088002137
1998-05-01T09:30:00-04:00,111.75,112.59375,111.3125,112.59375,4008800,5789414.7,59.50295832883412,57.27825973175617,NaN,NaN,63.776975342609624,-91.43647865871132,-0.2568832482996951,0.5102019379968965,0.7670851862965916,94265778,84069076.8,20.417822586690292,43.81549449018214,NaN,NaN,9.791001058057134,20.239465369438566
1998-05-04T09:30:00-04:00,112.71875,113.3125,112.15625,112.3125,4537199,5826894.65,58.076648405839606,56.763072255588156,NaN,NaN,92.65069961054839,-32.52057453534341,-0.15154734705328776,0.5776510024799819,0.7291983495332697,89728579,85938637.8,25.57477187690546,42.00277102557974,NaN,NaN,10.77564025224261,18.887490352696286
1998-05-05T09:30:00-04:00,112,112.15625,111.125,111.53125,5146398,5856689.55,54.190823072238686,55.881158748095864,NaN,NaN,26.08530815599477,8.650926911284035,-0.1340859945134465,0.5615908563914616,0.695676850904908,84582181,88081198.8,31.086168654426103,40.50343739570239,NaN,NaN,10.30733752106098,17.66175423389124
1998-05-06T09:30:00-04:00,112.125,112.125,110.1875,110.21875,5526102,5853809.7,48.33921430077567,55.246218907690995,NaN,NaN,-28.52300749485729,30.482232602948653,-0.20621558444244525,0.43790737035185145,0.6441229547942967,79056079,87577919,30.514546036752222,38.95981080993623,NaN,NaN,7.940253712984366,16.27296844519026
1998-05-07T09:30:00-04:00,110.5,110.5625,109.34375,109.34375,6940398,5958089.55,44.86133019320492,53.92206154162774,NaN,NaN,-100.97336929616267,10.603321263626562,-0.30232765420307595,0.2662133870404517,0.5685410412435277,72115681,83949659.6,26.702426988994247,37.095598181567574,NaN,NaN,4.839807522105633,14.639659741892455
1998-05-08T09:30:00-04:00,110,111.375,110,111.125,7951000,6131579.6,52.37350444283636,53.1494098971683,NaN,NaN,-24.87107462227341,-7.12628872935004,-0.2382283887956136,0.2707555552490106,0.5089839440446242,80066681,81109840.2,24.158489719416266,34.97416802058566,NaN,NaN,4.742177024460055,13.225733639402112
1998-05-11T09:30:00-04:00,111.5625,112.21875,110.375,110.75,6336301,6230884.7,50.80422504482982,52.11508137242235,NaN,NaN,-6.939289591562292,-27.044286569772176,-0.2141358186459298,0.24131417073721195,0.45544998938314174,73730380,77910200.4,21.655190715805475,32.54725036554966,NaN,NaN,4.151763104431412,11.929452134406297
1998-05-12T09:30:00-04:00,110.8125,111.96875,110.34375,111.9375,6045199,6369189.65,55.36511975448417,51.32027106735527,NaN,NaN,14.694665296167475,-29.322415141737633,-0.11617848380266294,0.31022688462981307,0.426405368432476,79775579,76948880,20.952709228688178,30.000101806530047,NaN,NaN,5.170899525386341,10.963944618832018
1998-05-13T09:30:00-04:00,112.0625,112.5625,111.59375,112.21875,4441500,6397904.65,56.39619468690551,51.149670958929164,NaN,NaN,62.609798414798085,-11.09585395980656,-0.03462919437671952,0.38311887546157664,0.41774806983829615,84217079,77981080,23.810613812374157,27.503699046488727,NaN,NaN,6.305088431603573,10.298393734942241
1998-05-14T09:30:00-04:00,111.53125,112.6875,111.34375,111.65625,4187500,6248384.75,53.72323335291426,51.28932740455114,NaN,NaN,42.69821471426396,17.638462842278766,-0.02140632535462117,0.39099016314501966,0.41239648849964083,80029579,79563859.6,28.103130469947516,25.9404132725217,NaN,NaN,6.428049864273019,9.74548746770378
1998-05-15T09:30:00-04:00,112,112.21875,110.8125,111.03125,6716102,6299749.8,50.83993215994854,51.9062415855774,NaN,NaN,6.951066403481534,24.002891047429756,-0.05564211222588461,0.3428438482172851,0.3984859604431697,73313477,78213218.8,26.719712540603055,25.094545732104283,NaN,NaN,5.665963259476854,9.162698295099934
1998-05-18T09:30:00-04:00,110.71875,111.59375,109.82812,110.59375,4847199,6357694.75,48.86300457999653,52.426054333243805,NaN,NaN,-35.60808605505254,18.269131754731703,-0.10573673706958453,0.26631503910618903,0.37205177617577356,68466278,77160398.4,25.65937559405839,24.9043552737134,NaN,NaN,4.454280370694228,8.490067163041976
1998-05-19T09:30:00-04:00,111,111.6875,110.78125,111.34375,5918699,6424969.75,52.288156834679924,52.89712751701885,NaN,NaN,12.071662874487814,17.744531270395772,-0.08712086011032072,0.26315070103787264,0.35027156114819336,74384977,76082278,24.583520347359382,25.031753094906996,NaN,NaN,4.421226701469316,7.908804239960167
1998-05-20T09:30:00-04:00,112.09375,112.5,110.875,112.40625,5716602,6591494.85,56.7116749946658,53.02400143943958,NaN,NaN,68.78242947977505,18.979057483391166,-0.006272860790104584,0.3424304851605626,0.3487033459506672,80101579,75259178,23.764296215725295,25.264483913410487,NaN,NaN,5.731352359054341,7.597739685545049
1998-05-21T09:30:00-04:00,112.375,112.78125,111.3125,111.6875,6301500,6653469.85,53.12359064369106,52.56833231907221,NaN,NaN,70.99245442495649,24.63790542552967,-0.0043180750865641215,0.34330575209246206,0.3476238271790262,73800079,74013278,22.539889472992527,25.416060119574933,NaN,NaN,5.770977090709964,7.336773600568608
1998-05-22T09:30:00-04:00,111.75,112.0625,110.9375,111.25,4862199,6344594.85,51.00808554471579,52.063434971849084,NaN,NaN,29.34237315059083,29.11616677495153,-0.033955940643834004,0.30517890137423365,0.33913484201806765,68937880,73138158.6,21.694383129601277,25.138889494767493,NaN,NaN,5.18621036766022,7.029550281581695
1998-05-26T09:30:00-04:00,112.09375,112.09375,109.1875,109.46875,6899301,5964049.95,43.425713039942515,51.294498540970785,NaN,NaN,-78.14610924510055,20.608562136941927,-0.16751939537092425,0.12973559780441235,0.2972549931753366,62038579,71852618.8,20.479096343245146,24.38124147254029,NaN,NaN,2.2415683514574445,6.345552862992516
1998-05-27T09:30:00-04:00,109.3125,109.90625,107.57812,109.625,10202602,6148610.15,44.20915862198172,50.99949456391408,NaN,NaN,-190.81825878165878,-19.969422194287393,-0.23519124478203274,0.0032659371977956653,0.2384571819798284,72241181,71423859.6,20.075168967504013,23.635571681879696,NaN,NaN,0.11951478580817532,5.456118851966182
1998-05-28T09:30:00-04:00,109.875,110.375,109.0625,110.125,4907602,6008835.15,46.75037118313139,51.13442606319454,NaN,NaN,-125.51158221201212,-58.828224532644825,-0.23554267198655016,-0.05597115800335928,0.17957151398319088,77148783,70833300.4,19.50452842437177,23.121436070120946,NaN,NaN,-0.910199557970807,4.546644793403755
1998-05-29T09:30:00-04:00,110.625,110.8125,109.03125,109.03125,4772602,5813240.25,42.220044557518804,50.409178928529,NaN,NaN,-124.58851358287048,-97.94441813421022,-0.2948530926851046,-0.18899485187318987,0.10585824081191472,72376181,70548520.8,19.22079861709821,22.7687438485268,NaN,NaN,-3.1886286785761704,3.441605725978051
1998-06-01T09:30:00-04:00,108.96875,110.21875,108.5625,109.53125,6092199,5917410.2,44.85103019425045,49.98395072491619,NaN,NaN,-122.39035035901952,-128.29096283613228,-0.28562728647106245,-0.2511758672769133,0.03445141919414911,78468380,72454620.8,26.88708593154999,23.14245064965141,NaN,NaN,-4.309680968203865,2.3342790553806347
1998-06-02T09:30:00-04:00,110,110.34375,109.15625,109.625,6701102,6025605.35,45.35347662704767,49.26883335867073,NaN,NaN,-90.19907142350144,-130.70155527181245,-0.25920285656583864,-0.28955215151314917,-0.03034929494731055,85169482,77080801.4,41.41849279083888,24.60429233266217,NaN,NaN,-5.081321543762562,1.274907541217321
1998-06-03T09:30:00-04:00,109.875,110.1875,107.875,107.875,6445102,6090540.55,38.332862958450605,47.97859537806681,NaN,NaN,-149.9358569842428,-122.52507491232927,-0.3404569167259664,-0.45592044085476857,-0.11546352412880216,78724380,78377441.2,44.7340221329153,26.09882149841511,NaN,NaN,-7.975241929906734,-0.04654238322897264
1998-06-04T09:30:00-04:00,108.25,110.0625,108.0625,109.875,6566301,6142550.5,48.20152154296175,47.58418739164163,NaN,NaN,-86.76418623132722,-114.77559571619229,-0.24485008678368314,-0.4215261326084061,-0.17667604582472296,85290681,80005820.8,48.663539771891884,27.567422162839705,NaN,NaN,-7.315753695105892,-1.0850011420685324
1998-06-05T09:30:00-04:00,110.375,112,109.875,112,8463199,6218690.55,56.21846692943124,47.96836844660468,NaN,NaN,45.203407001326575,-80.81721159935287,-0.034866874445331486,-0.22025963888138733,-0.18539276443605585,93753880,84281360.6,57.2569719451664,29.748654977451373,NaN,NaN,-3.8410895689843545,-1.478728060199364
1998-06-08T09:30:00-04:00,111.9375,112.46875,111.65625,111.875,4159898,6029135.45,55.6726219009876,48.45476968381833,NaN,NaN,86.75774513967087,-38.9875924996148,0.09228729663849139,-0.07003364363794162,-0.162320940276433,89593982,86506481,60.923103488731755,32.267492684213764,NaN,NaN,-1.3678516380421186,-1.4628885713197575
1998-06-09T09:30:00-04:00,111.71875,112.42187,111.40625,112.21875,2725300,5848585.4,56.911612413090204,48.78501651084763,NaN,NaN,81.42676989683623,-4.6624242355472605,0.19056438606635528,0.0758845423065111,-0.11467984375984419,92319282,87936441,63.11275040331192,35.01958054535323,NaN,NaN,0.9980462939478012,-1.1113264477101061
1998-06-10T09:30:00-04:00,111.625,113.0625,111.25,111.5,6186898,5855670.35,53.541778009382455,48.55859529761311,NaN,NaN,73.00620915081458,39.925988991464216,0.19734943014197998,0.1320069439176308,-0.06534248622434918,86132384,89418041.8,65.2833693608539,37.985228627148125,NaN,NaN,1.929511197293143,-0.6769210698524992
1998-06-11T09:30:00-04:00,111.4375,111.875,109.375,109.40625,8056602,6036425.45,45.154185347864846,47.98935206219694,NaN,NaN,-31.079093011405337,51.06300763544859,0.05823426244380427,0.00745034183040616,-0.05078392061339811,78075782,87975062,61.48835089126301,40.767261585596025,NaN,NaN,-0.028885694082956687,-0.5843445875997074
1998-06-12T09:30:00-04:00,109.875,110.4375,108.25,110.4375,9779000,6316000.45,49.3618953869132,47.871767050925335,NaN,NaN,-58.226957011191104,30.376934832945057,0.03426178729678224,-0.007956686492420317,-0.04221847378920256,87854782,86795242.4,58.494262343338306,43.39582438657724,NaN,NaN,-0.25246948948671016,-0.5369338592978506
1998-06-15T09:30:00-04:00,108.8125,109.90625,107.5,107.53125,10234199,6491905.3,40.03920170826377,47.62987338437686,NaN,NaN,-133.22188961224214,-13.618992117437546,-0.16764494290970552,-0.25177465242633446,-0.08412970951662893,77620583,84400562.6,52.86728308679747,45.70926629683098,NaN,NaN,-3.8792982089555164,-1.0144144806775173
1998-06-16T09:30:00-04:00,108.40625,109.21875,107.75,109.1875,7471500,6623120.35,46.2674336224803,47.776893027269615,NaN,NaN,-96.59710466714154,-49.223767030233105,-0.17894294469157507,-0.30780839038109775,-0.12886544568952268,85092083,82955122.8,49.75596481805002,47.82932314329855,NaN,NaN,-4.568160143622955,-1.5220924325268657
1998-06-17T09:30:00-04:00,110.15625,111.78125,109.9375,111.46875,12057699,6930070.35,53.440965162378816,48.254792597215854,NaN,NaN,44.888185328306925,-54.847371794734634,-0.029884941225706424,-0.1662216222216557,-0.13633668099594928,97149782,85158602.4,54.1826731029255,50.30633347748096,NaN,NaN,-2.4416014632770247,-1.6534508654911741
1998-06-18T09:30:00-04:00,111.1875,111.4375,110.75,110.96875,3844600,6836470.25,51.80837489231281,48.93967333541542,NaN,NaN,49.25636381748671,-38.780280428956225,0.03444246920230104,-0.093283594493073,-0.12772606369537404,93305182,88204482.4,59.49509381710885,53.18306884891029,NaN,NaN,-1.3957894365428376,-1.616642089927126
1998-06-19T09:30:00-04:00,111.0625,111.23437,109.625,110.0625,3549100,6698850.25,48.89288668805642,49.228377370687284,NaN,NaN,7.6970858814825975,-25.595471850421482,0.016285808987672595,-0.10736880246078329,-0.12365461144845588,89756082,88584742.4,60.116828278643546,55.55662187370269,NaN,NaN,-1.5464027448372002,-1.6066078977714224
1998-06-22T09:30:00-04:00,110.25,111.0625,110.0625,110.59375,5438301,6727655.35,50.64623116009264,49.60643126590478,NaN,NaN,30.444275952117927,7.137761262450522,0.03908230649206909,-0.07480172833336951,-0.1138840348254386,95194383,92099502.4,65.40293874743543,57.26979658488816,NaN,NaN,-1.1001321423048929,-1.534254218419061
1998-06-23T09:30:00-04:00,111.09375,112.0625,111,111.90625,5004602,6632920.4,54.77438114524879,50.78082542210465,NaN,NaN,96.65992426798282,45.78916704947539,0.1361208931671566,0.05626708163350713,-0.07985381153364945,100198985,95120882.8,69.18402725459765,59.01622552215118,NaN,NaN,0.6136003546718677,-1.2274178508346427
1998-06-24T09:30:00-04:00,112.15625,113.6875,111.60937,113.40625,8291898,6537385.2,58.995638490078484,51.55183377547013,NaN,NaN,154.3066799833923,67.67286598049246,0.2862616248798392,0.2779732195661495,-0.008288405313689656,108490883,97389103,71.68579238343978,60.66067213726175,NaN,NaN,3.4558634366301124,-0.5583776669111064
1998-06-25T09:30:00-04:00,113.90625,114.4375,112.8125,113.21875,5854801,6584745.15,58.2635743534633,51.6979128771867,NaN,NaN,160.4320106563692,89.90799534826895,0.35347037125022573,0.4335495587490925,0.08007918749886679,102636082,99255283,73.58582356456381,61.82701868150441,NaN,NaN,5.477206627983212,0.303848660930939
1998-06-26T09:30:00-04:00,113.3125,113.84375,113.125,113.6875,4833102,6587770.15,59.61283930796737,51.979356977685256,NaN,NaN,141.36113856319238,116.64080588461093,0.40625047373023393,0.5878922796616592,0.1816418059314253,107469184,102797903.4,76.77234893740592,62.959107642124,NaN,NaN,7.537104928768295,1.3371709849077043
1998-06-29T09:30:00-04:00,114.25,114.6875,113.79687,114.09375,5953398,6580830.1,60.795749885459855,52.25679536856881,NaN,NaN,152.83810311594038,141.1195713173754,0.4423056305678033,0.7345238441411794,0.29221821357337613,113422582,106443543.2,79.51154621870367,64.13045020036627,NaN,NaN,9.583098898563891,2.515160686858588
1998-06-30T09:30:00-04:00,113.90625,114.1875,113.0625,113.3125,4284801,6460015.05,57.318886114182746,52.52658880462597,NaN,NaN,106.96266747745727,143.18011995927031,0.38919626480819847,0.7787135445836242,0.3895172797754257,109137781,108231302.4,80.71272809264758,65.23254725263725,NaN,NaN,10.343939219041175,3.633557620027529
1998-07-01T09:30:00-04:00,114.0625,114.9375,113.625,114.625,3489500,6312234.95,61.320951685803244,53.681357828764426,NaN,NaN,132.211109709009,138.76100590439364,0.41571556100516877,0.9091617310318867,0.4934461700267179,112627281,109058582,81.26023757266682,66.64482487273752,NaN,NaN,12.197415308983434,4.856965861306944
1998-07-02T09:30:00-04:00,114.71875,114.875,114.25,114.84375,3503900,6159114.9,61.9611423753178,54.581304042221895,NaN,NaN,128.94647669917293,132.46389911295438,0.4200063048705578,1.0184540511149152,0.5984477462443574,116131181,111757601.8,82.95978877404457,68.39236247493082,NaN,NaN,13.900308683563106,6.148871978772109
1998-07-06T09:30:00-04:00,114.78125,116,114.5625,116,3144400,5893174.95,65.23640840275748,56.381104520400015,NaN,NaN,143.99493110705416,132.99065762172674,0.4690114753913148,1.184712090483501,0.7157006150921861,119275581,114118881.2,84.30120194431309,70.6376423933248,NaN,NaN,16.35539936214166,7.606947319253473
1998-07-07T09:30:00-04:00,115.98437,116.125,115.28125,115.78125,4920699,5931215,64.11170644637477,57.65569543639248,NaN,NaN,128.91888738518975,128.2068144755766,0.45465559048839377,1.2840201032026783,0.8293645127142846,114354882,114305341.2,84.40559685676605,73.11261611037594,NaN,NaN,18.071008820466773,9.10181324799823
1998-07-08T09:30:00-04:00,115.875,116.9375,115.75,116.625,6875000,6138700,66.51005474153052,58.589201834903314,NaN,NaN,131.87982143757083,133.19024526759932,0.4681087985102812,1.414500510852136,0.9463917123418548,121229882,116723761.4,85.73096994900412,75.36606588509584,NaN,NaN,20.242857984346458,10.693391067476547
1998-07-09T09:30:00-04:00,116.28125,116.71875,115.625,115.84375,6942500,6176480.1,62.354866297678875,59.342522649572324,NaN,NaN,105.6810737180776,127.88423806941304,0.3935163494867271,1.4382871492002636,1.0447707997135365,114287382,117055781.6,85.90804527891177,77.25270527522461,NaN,NaN,20.950650594644085,12.158713857071909
1998-07-10T09:30:00-04:00,116.03125,116.9375,115.0625,116.46875,7849699,6166134.95,64.27759823494236,60.441430617207025,NaN,NaN,99.51924758486457,121.9987922465514,0.35649553417384494,1.4903902174308428,1.1338946832569978,122137081,118256961.6,86.55796097811654,79.14135761090127,NaN,NaN,22.09522339730759,13.57821521996272
1998-07-13T09:30:00-04:00,116.5625,116.84375,116.0625,116.5,6555102,6004940.05,64.3755726042389,61.42209786321747,NaN,NaN,101.00146705999566,113.40009943713969,0.3062603199742622,1.5167200832248255,1.2104597632505634,128692183,120140282,87.52910618639442,80.72179814225548,NaN,NaN,23.065369335304574,14.933522950725841
1998-07-14T09:30:00-04:00,116.9375,118.15625,116.9375,117.8125,6983602,5842410.2,68.30715213634568,62.388724362581534,NaN,NaN,129.6654240227281,113.54940676464734,0.33144434204310036,1.624765190804439,1.2933208487613386,135675785,124404462.6,89.3969695033949,82.16557973145528,NaN,NaN,25.06672982383033,16.381123932597912
1998-07-15T09:30:00-04:00,118.0625,118.28125,117.53125,117.59375,4977500,5717710.2,66.98036840447938,62.959062213610174,NaN,NaN,125.77140882841674,112.32772424281652,0.3041032658194933,1.6734499310357052,1.3693466652162118,130698285,126298143.2,90.10571109933754,83.48128821116227,NaN,NaN,26.372645564765907,17.808484165764767
1998-07-16T09:30:00-04:00,117.6875,118.59375,117.0625,118.40625,6315602,5430605.35,69.36087967643829,63.75172687953695,NaN,NaN,120.61491015904855,115.3144915310107,0.3103925929164584,1.7573374063617848,1.4469448134453264,137013887,130843444.2,91.56340322016618,84.7654010437053,NaN,NaN,28.185640968928176,19.290935137645253
1998-07-17T09:30:00-04:00,118.625,119,118.3125,118.5625,3539500,5415350.35,69.8116125907985,64.48021068545347,NaN,NaN,127.16163393874693,120.84296880178718,0.2948433189809756,1.8154989621715458,1.5206556431905702,140553387,134526705.4,92.52451744426297,85.89055593705223,NaN,NaN,29.821245777538714,20.795265229058604
1998-07-20T09:30:00-04:00,118.75,119.23437,117.9375,118.5625,2338400,5354815.35,69.81161259079849,65.12420087869194,NaN,NaN,116.5969365390801,123.96206269760407,0.2557776340998732,1.8403776858154117,1.5846000517155385,140553387,136898946.2,93.07194887872862,86.859156127054,NaN,NaN,31.185749528618885,22.279620128995788
1998-07-21T09:30:00-04:00,119,119,116.28125,116.5,5518602,5358830.4,56.979337182415094,65.09994738356569,NaN,NaN,64.53012549070868,110.9350029912002,0.07181330559055965,1.674366683703738,1.6025533781131784,135034785,136770746.2,92.6769678349363,87.71374468007464,NaN,NaN,28.746777968491227,23.203499820352278
1998-07-22T09:30:00-04:00,116.34375,116.98437,115.53125,116.5,10417301,5629465.35,56.979337182415094,64.7898320618951,NaN,NaN,21.165816983705263,90.01388462225789,-0.06186671693046142,1.5252199819501016,1.587086698880563,135034785,137638046.2,92.8965969478134,88.54491320687082,NaN,NaN,26.766797860931664,23.712542397577906
1998-07-23T09:30:00-04:00,116.3125,116.59375,113.90625,114.1875,15110898,5970415.35,45.98744552049068,63.64885371512173,NaN,NaN,-51.934759102484335,55.5039507699513,-0.3044591237666918,1.2065127941721983,1.51097191793889,119923887,134220046.2,82.40717860616078,88.50544105202198,NaN,NaN,21.279068892202357,23.3649033253814
1998-07-24T09:30:00-04:00,114.96875,115.09375,112.875,114.09375,11540500,6254700.3,45.603361603484394,62.24649322945937,NaN,NaN,-97.72616504899086,10.52639097240375,-0.4603092427526472,0.9355853644980812,1.3958946072507283,108383387,127786046.2,67.05769112080115,87.2737617074854,NaN,NaN,16.788644149204362,22.42543772878468
1998-07-27T09:30:00-04:00,113.625,115,112.84375,114.90625,9600000,6493045.2,49.537018850189014,61.2054441154461,NaN,NaN,-90.68875579788279,-30.93074749498884,-0.4947371597140804,0.777473157608128,1.2722103173222084,117983387,123272046.2,58.78477074970437,85.44370269983814,NaN,NaN,14.111265952594445,21.237698903614646
1998-07-28T09:30:00-04:00,114.4375,114.65625,111.875,112.96875,13693000,6880025.3,41.77847736867382,59.43890287452776,NaN,NaN,-137.3867062203527,-71.31411383720112,-0.6256261939254979,0.49017757491533587,1.1158037688408338,104290387,117123166.6,49.776284112708886,82.8755108543885,NaN,NaN,9.07252582305185,19.499817034962817
1998-07-29T09:30:00-04:00,113.71875,114.125,112.25,112.53125,7462398,7038905.15,40.24566037406543,57.85967387998395,NaN,NaN,-142.5387055146809,-104.05501833687836,-0.712961343835968,0.22460208904587375,0.9375634328818417,96827989,109481807.4,41.30500488714169,79.68957939783347,NaN,NaN,4.516649810753436,17.35936457436148
1998-07-30T09:30:00-04:00,113.625,114.59375,113.40625,114.21875,6821602,7205510.25,48.14796728440074,56.70755738351669,NaN,NaN,-87.84614774224816,-111.23729606483111,-0.6311819912403596,0.14858594383139234,0.7797679350717519,103649591,106226948.2,38.313915857037706,76.24357617489929,NaN,NaN,3.078601227942536,15.319255524873059
1998-07-31T09:30:00-04:00,114.34375,114.5,111.3125,111.78125,7680500,7414340.25,39.93306168866297,54.961663746689844,NaN,NaN,-143.72672619468125,-120.4374082939692,-0.7095012253781808,-0.10710859665097416,0.6023926287272067,95969091,103744089,36.16266218122108,72.57454446024404,NaN,NaN,-1.1822306675749408,12.961900354523344
1998-08-03T09:30:00-04:00,111.78125,112.42187,111.03125,111.3125,10486500,7781445.25,38.570181609238304,52.83759442332503,NaN,NaN,-153.5486608378685,-133.00938930196634,-0.7568034059345602,-0.3436116286909936,0.4131917772435666,85482591,97243929.8,31.2203572464516,68.41907215617667,NaN,NaN,-4.959976382201035,10.401632249277004
1998-08-04T09:30:00-04:00,112.21875,112.21875,107,107,15091602,8289990.4,28.823709950789308,50.11211881949003,NaN,NaN,-204.79142750770836,-146.4903335594375,-1.0257592769897868,-0.8690073189936669,0.15675195799611985,70390989,90464050.2,27.06540244576898,63.91619296663607,NaN,NaN,-12.533999076900379,7.12511348839452
1998-08-05T09:30:00-04:00,107.9375,108.875,105.59375,108.46875,21718400,9032160.4,34.86097762591338,47.6478401015954,NaN,NaN,-195.09491165633295,-157.00157478776788,-1.0482604940870248,-1.1535736596126611,-0.10531316552563635,92109389,89520330.2,26.536019347408896,59.27137983286769,NaN,NaN,-16.088396959359276,3.808897710143978
1998-08-06T09:30:00-04:00,108.125,109.5,107.5625,108.9375,13084398,9339255.3,36.70618194742033,45.283166484211236,NaN,NaN,-142.98726531536525,-168.02979830239127,-0.9765376238320586,-1.3259851953157096,-0.349447571483651,105193787,89829169.4,27.03896437091977,54.59384032762888,NaN,NaN,-18.09774363398414,0.6793775181256754
1998-08-07T09:30:00-04:00,109.6875,110.59375,108.46875,109.125,12083801,9550960.4,37.46921227731621,42.97299503324822,NaN,NaN,-110.67311233525545,-161.41907553050615,-0.8652397435945887,-1.430997250976887,-0.5657575073822982,117277588,94090868.8,33.77639004905569,50.358443268366536,NaN,NaN,-19.37997218307168,-2.1862438677596607
1998-08-10T09:30:00-04:00,108.75,109.65625,108.1875,108.5,6273000,9536855.3,35.91496751152451,41.46839719961317,NaN,NaN,-109.45581579941185,-152.60050652281478,-0.7848512280447062,-1.546821542438181,-0.7619703143934748,111004588,99195268.2,40.82477237735026,46.6547150213961,NaN,NaN,-20.905242027568743,-4.8603864620181
1998-08-11T09:30:00-04:00,106.78125,107.4375,105.5,106.875,14287102,9902030.3,32.177671514038565,39.696849651872,NaN,NaN,-137.8467385417962,-139.21156872963235,-0.7900790313978332,-1.7495691036407663,-0.9594900722429331,96717486,104460567.6,47.08149980408004,43.38220808255801,NaN,NaN,-23.432939910139204,-7.5136083831782585
1998-08-12T09:30:00-04:00,107.75,108.875,107.5,108.6875,11158398,10211075.2,39.71319795697277,39.24868911162072,NaN,NaN,-90.44251010378878,-118.28108841912353,-0.6275214653829799,-1.743891903971658,-1.1163704385886781,107875884,107613866.6,50.45975325164767,41.10024912866421,NaN,NaN,-23.075510927101096,-9.736737318024378
1998-08-13T09:30:00-04:00,108.8125,109.65625,107.375,107.375,9073898,10348990,36.54659372547984,38.60177712033468,NaN,NaN,-84.880275064551,-106.65969036896067,-0.5663207676912605,-1.8242713982027539,-1.2579506305114934,98801986,106335506.4,49.09150831780084,39.816950357021334,NaN,NaN,-23.82335727362383,-11.749111597395729
1998-08-14T09:30:00-04:00,108.34375,108.71875,105.78125,106.125,8628500,10603440,33.78371562400393,37.47654117560717,NaN,NaN,-100.44707491783109,-104.61448288547581,-0.5665774695848835,-1.9661724674925978,-1.3995949979077142,90173486,100914686,43.682444325871145,38.73821275531896,NaN,NaN,-25.347464672976294,-13.691733465335808
1998-08-17T09:30:00-04:00,106,108.9375,105.5,108.375,11290000,11051020,42.24712955204399,37.51001633156219,NaN,NaN,-77.19419546800455,-98.16215881919435,-0.3806878541516412,-1.8754548155972657,-1.4947669614456245,101463486,99006465.6,41.93098906079205,38.177834537324905,NaN,NaN,-23.758850165221403,-15.129892993890893
1998-08-18T09:30:00-04:00,109,110.59375,108.78125,110.375,7603898,11155284.8,48.54302086462336,38.10268493803061,NaN,NaN,-19.814073270319266,-74.55562576489896,-0.10295672540996414,-1.6234628682080796,-1.5205061427981155,109067384,101476445.2,45.00472805296106,38.44210047774057,NaN,NaN,-20.20689699143035,-15.855179279253672
1998-08-19T09:30:00-04:00,111.09375,111.09375,109.625,110.09375,6258602,10947349.85,47.75462148567859,38.074588809550455,NaN,NaN,-4.242841224293488,-57.315691988999916,0.07243037352925774,-1.4299681758865432,-1.502398549415801,102808782,100463024.8,43.97618825706517,38.846548506313965,NaN,NaN,-17.710175935695794,-16.120178801602545
1998-08-20T09:30:00-04:00,109.6875,110.40625,109.15625,109.4375,7402801,10561945,45.88211068604591,38.49952088079209,NaN,NaN,-15.334458410420453,-43.4065286581738,0.1503794283777551,-1.3144242639436072,-1.4648036923213623,95405981,99783823.8,43.26256567026094,39.35368446981681,NaN,NaN,-16.27137908867352,-16.141778842612684
1998-08-21T09:30:00-04:00,108.1875,108.71875,105.5,108.5625,16685398,10819189.9,43.436500829782226,38.84711511083095,NaN,NaN,-74.79332493465755,-38.27577866153909,0.14886712752290343,-1.278719782917733,-1.4275869104406365,78720583,97493243.2,40.854738115687375,40.04185453190508,NaN,NaN,-15.82383231208617,-16.096357909680325
1998-08-24T09:30:00-04:00,109.25,109.9375,108.3125,109.25,7201699,10699274.85,45.877517951545684,40.065244253742115,NaN,NaN,-16.03614112171873,-26.044167792281932,0.19700506706399068,-1.181330576610648,-1.3783356436746388,85922282,94385002.4,37.78182812993573,40.807313509345555,NaN,NaN,-14.72062321637721,-15.899824382065594
1998-08-25T09:30:00-04:00,110.375,111.25,108.64062,109.5,9688301,10499039.9,46.776986552272824,40.91638774848208,NaN,NaN,16.302820755955082,-18.82078898702706,0.24537010274723903,-1.07162301524059,-1.316993117987829,95610583,91693642.2,35.3055882588705,41.43371128873567,NaN,NaN,-13.561033103499408,-15.565711342270424
1998-08-26T09:30:00-04:00,108.28125,109.625,107.75,108.875,9339699,10592904.95,44.77364302738326,41.49263496847943,NaN,NaN,-22.479663686842606,-22.468153479536884,0.23494239886497992,-1.023315119406604,-1.2582575182715838,86270884,88386062.6,32.48753219333611,41.822894704622556,NaN,NaN,-13.139881428384111,-15.219164211715237
1998-08-27T09:30:00-04:00,107,107.5625,103.46875,103.75,24887808,11496215.25,32.487039211016906,41.136765463743764,NaN,NaN,-206.2281620070718,-60.646894198867116,-0.09950378613429534,-1.382637250939453,-1.2831334648051578,61383076,81581481.6,27.605720430938035,41.38213258904272,NaN,NaN,-16.992397832973317,-15.472483300466392
1998-08-28T09:30:00-04:00,104.96875,105.71875,102.15625,103.375,23735904,12298985.45,31.799415814464453,40.842797485382334,NaN,NaN,-227.68160334574551,-91.22454988108471,-0.31614556376275926,-1.678315419508607,-1.3621698557458477,37647172,73366799.4,23.094040419193803,40.11565173488869,NaN,NaN,-20.211231164473126,-16.149447281038782
1998-08-31T09:30:00-04:00,103.75,104.01562,95,96,22563104,12902815.65,21.95657363749696,40.11271906562937,NaN,NaN,-347.66716351089303,-157.5507543589196,-0.8935961881691465,-2.479165090957281,-1.5855689027881343,15084068,59199156.6,17.716262852293866,38.0181348097611,NaN,NaN,-27.67602602922372,-17.796101387922345
1998-09-01T09:30:00-04:00,96.0625,100.5625,93.625,100.0625,24748496,13385660.35,34.063721446958795,39.709185029199794,NaN,NaN,-249.67607037836646,-210.74653258578388,-0.9349726754004037,-2.754284747038639,-1.8193120716382354,39832564,48043552.8,14.794846008095874,35.47064143522169,NaN,NaN,-28.63222245364198,-19.34411868302515
1998-09-02T09:30:00-04:00,99.8125,101.75,98.78125,99.34375,13843199,12991900.3,33.08577298272692,39.46198354757458,NaN,NaN,-157.179107786031,-237.68642140562156,-0.9411764683755233,-2.9957826571076396,-2.0546061887321163,25989365,35987249,12.41258457818526,32.85071831096344,NaN,NaN,-29.69808024648289,-20.8232560492334
1998-09-03T09:30:00-04:00,97.625,99.375,96.75,98.5625,17311296,13203245.2,32.01003409380414,39.33529200970317,NaN,NaN,-156.60962959986108,-227.76271492417942,-0.9268529573569309,-3.2131723854282797,-2.286319428071349,8678069,25446247.6,10.77845054483555,30.500433040889465,NaN,NaN,-30.88593559981409,-22.260781699316357
1998-09-04T09:30:00-04:00,99.4375,99.8125,95.75,97.75,17783808,13488245.55,30.88533605625871,38.523735331432796,NaN,NaN,-136.62233466237376,-209.55086118750506,-0.9002960086125333,-3.4116894388370156,-2.5113934302244822,-9105739,16095665.4,9.574316836465755,28.189242167723304,NaN,NaN,-32.18912055939682,-23.679115822184993
1998-09-08T09:30:00-04:00,100.875,103,99.8125,103,14746500,13911920.55,44.46369786771731,38.23235511736807,NaN,NaN,-56.81466424084802,-151.38036133349607,-0.4785169936297433,-3.1095396722616613,-2.631022678631918,5640761,14207004,9.34717410281749,25.64227402842733,NaN,NaN,-28.291941958449463,-24.33809098450849
1998-09-09T09:30:00-04:00,102.75,103.125,100.4375,100.5,12109699,13803050.4,40.39402334936266,37.70659810763122,NaN,NaN,-59.866092741166305,-113.41836580605602,-0.3246270547390768,-3.036806497055764,-2.712179442316687,-6468938,4946703.6,8.306606405501455,23.09444675331564,NaN,NaN,-26.656218909243385,-24.669252116613475
1998-09-10T09:30:00-04:00,98.4375,99.34375,96.8125,98.5,19889296,14239595.3,37.44157141184805,37.10370244518852,NaN,NaN,-97.61826625775086,-101.5061975004,-0.31406324112495687,-3.1047584937228834,-2.7906952525979265,-26358234,-5522816.2,7.315097744788943,20.526770472924785,NaN,NaN,-26.408624556253297,-24.917733893704877
1998-09-11T09:30:00-04:00,98.1875,101.6875,97,101.6875,20379808,14804890.8,44.414741166738374,37.1735767549711,NaN,NaN,-61.31445001800106,-82.44716158402801,-0.06211729400209931,-2.8683418701005508,-2.8062245760984514,-5978426,-8454115.2,7.060968190321773,18.1129297639701,NaN,NaN,-23.678919939868784,-24.740760471728294
1998-09-14T09:30:00-04:00,102.875,104.45312,102.09375,103.4375,10686801,14907805.85,47.85157207906707,37.314580621222625,NaN,NaN,-9.64672757032948,-57.05204016561913,0.23631856132605567,-2.5108263744408816,-2.7471449357669373,4708375,-5691292.4,10.226599357034118,16.144699137334268,NaN,NaN,-20.31280154550909,-24.108194910839835
1998-09-15T09:30:00-04:00,102.875,104.3125,102.28125,104.0625,8337898,14760200.75,49.06289366187253,37.47785970047975,NaN,NaN,-3.0613282457099014,-46.3013729665915,0.4759154001814614,-2.1522506855401105,-2.628166085721572,13046273,-4210190,11.95788752625731,14.477006227861896,NaN,NaN,-17.295467886380713,-23.13494819305996
1998-09-16T09:30:00-04:00,104.75,105.25,103.15625,105,11024898,14931250.75,50.90506845713253,37.91581865974755,NaN,NaN,17.952481434653162,-30.73765813142763,0.6849313336833442,-1.7720019186173914,-2.4569332523007357,24071171,1897831.8,18.903697744944793,13.506732338691092,NaN,NaN,-14.286660306988837,-21.87090706647837
1998-09-17T09:30:00-04:00,102.25,103.03125,101.78125,102,12945199,15265580.6,45.26373680183643,38.82843991623465,NaN,NaN,-15.397049515682154,-14.293414783013882,0.610979639204714,-1.693208703294843,-2.304188342499557,11125972,9394673,26.561731937037536,13.43216173198391,NaN,NaN,-13.481427784080577,-20.67241002613583
1998-09-18T09:30:00-04:00,102.375,102.40625,101.09375,102.09375,7019199,15246400.5,45.46711938136213,39.80470445672735,NaN,NaN,-17.263729487034304,-5.483270676820536,0.5595893387754698,-1.60470166903022,-2.16429100780569,18145171,14219392.4,31.072857890011107,14.002077265613712,NaN,NaN,-12.786560545107925,-19.545860100274698
1998-09-21T09:30:00-04:00,99.625,103.40625,98.9375,102.03125,8834602,14853860.7,45.34615083589139,41.47538854232695,NaN,NaN,-21.04431424587971,-7.762788011930581,0.5137871202486188,-1.5220571074949163,-2.035844227743535,9310569,15139831.2,31.931898520003728,15.017479813307274,NaN,NaN,-12.262203233656965,-18.50533769075788
1998-09-22T09:30:00-04:00,103.5,103.65625,102.15625,102.875,7270102,14857280.85,47.3814684655974,42.426656186515416,NaN,NaN,22.225208717429084,-2.705480619302783,0.5305521642380739,-1.3726540224459427,-1.9032061866840166,16580671,15846710.8,32.62636078748035,16.291159440406165,NaN,NaN,-11.252609712975557,-17.469233693931834
1998-09-23T09:30:00-04:00,103.875,107,103.78125,107,13688500,15057290.8,56.00706646106978,44.063891434968475,NaN,NaN,116.82152496260447,17.06832808628748,0.7938467786343266,-0.9108977133911083,-1.7047444920254349,30269171,17086310.8,33.89994492181715,17.82597089352273,NaN,NaN,-7.623387182646881,-16.062684192319697
1998-09-24T09:30:00-04:00,106.3125,106.8125,103.25,104.375,11129500,15146780.85,50.350600447092525,45.37393188877479,NaN,NaN,97.9363118053344,39.73500035049079,0.7652804447733115,-0.7481439360587956,-1.513424380832107,19139671,18689050.6,35.595150378498715,19.598592310212954,NaN,NaN,-6.256555511739245,-14.66180866652249
1998-09-25T09:30:00-04:00,103.125,105.42187,102.625,104.25,10247398,14414760.35,50.09116525958098,46.74577683186924,NaN,NaN,78.3949656359915,58.866739375095946,0.7130787478656553,-0.622075946000038,-1.3351546938656933,8892273,16838471,34.49511279897064,21.37864916467759,NaN,NaN,-5.248824930973781,-13.317096704301246
1998-09-28T09:30:00-04:00,105.3125,106.3125,104.25,105.1875,8847801,13670355.2,52.0852314366616,47.29017208679384,NaN,NaN,108.96139131703374,84.86788048767865,0.7149803796034264,-0.4414292193614102,-1.1564095989648366,17740074,18524372,36.42275909304787,23.31261952112262,NaN,NaN,-3.8293194799114563,-11.961699957959848
1998-09-29T09:30:00-04:00,105.375,105.9375,103.375,104.9375,10618102,13073105.1,51.49438391369256,48.08305498424597,NaN,NaN,86.01411268843519,97.62566128187987,0.6732801822082548,-0.31480937120451813,-0.9880895534127729,7121972,16632632.2,35.172024872996175,25.23157798308653,NaN,NaN,-2.8278159958842095,-10.656859391949043
1998-09-30T09:30:00-04:00,103.5,104.3125,101.375,101.75,7908398,12231100.2,44.55456833601428,48.59112619311498,NaN,NaN,8.382114968759836,75.93777928311093,0.41743826708390874,-0.46629171955788706,-0.8837299866417958,-786426,10421512.8,31.363866918070244,26.949347209749476,NaN,NaN,-3.9769869697300204,-9.702591903060611
1998-10-01T09:30:00-04:00,100.03125,101.54687,98.09375,98.8125,13335602,12205720.35,39.29833561600604,48.22566865377696,NaN,NaN,-93.40236026709898,37.67004486862426,0.05579111755556543,-0.813991089697339,-0.8697822072529044,-14122028,3769173,27.88186766322022,28.43655431495651,NaN,NaN,-6.66300721316304,-9.26836551878953
1998-10-02T09:30:00-04:00,98.875,100.875,97.21875,100.71875,14351801,12057745.6,43.921756317756916,47.94496752796909,NaN,NaN,-95.29765575565325,2.9315205902953068,-0.04422491206280976,-0.9250633473314167,-0.880838435268607,229773,2036673,27.039914585686034,29.637505402717363,NaN,NaN,-7.495519105964981,-9.015101745528879
1998-10-05T09:30:00-04:00,99.59375,99.96875,96.34375,98.6875,12807199,11808915.15,40.39138964853842,47.32557438415951,NaN,NaN,-143.67150867431792,-47.59505940797502,-0.22619387257912593,-1.1635807759925143,-0.9373869034133884,-12577426,-4026827,24.27683773282874,30.517430417472465,NaN,NaN,-9.320571575692496,-9.05874029269511
1998-10-06T09:30:00-04:00,100.75,101.28125,97.53125,98.59375,12621000,11702640.15,40.23066226335152,46.56311679888944,NaN,NaN,-101.3896990554318,-85.07582175674841,-0.32582796365380373,-1.344671857980643,-1.0188438943268392,-25198426,-10490906.6,21.727825544439185,30.719153831722064,NaN,NaN,-10.819917400075393,-9.310337022320864
1998-10-07T09:30:00-04:00,98.625,100.03125,95.75,97.125,14348500,11814580.2,37.6996202924767,46.02282276250661,NaN,NaN,-131.78046438220778,-113.10833762694195,-0.45563982987417506,-1.588393681669558,-1.132753851795383,-39546926,-18243006.6,19.133252228294054,30.188548138240385,NaN,NaN,-12.850371790921262,-9.816056274978063
1998-10-08T09:30:00-04:00,94.5625,96.75,92.21875,96.59375,20625008,11851365.8,36.79784101622724,45.403588593568394,NaN,NaN,-186.9277267386096,-131.81341092124407,-0.5366940332162149,-1.8036213933156517,-1.2669273600994369,-60171934,-27452987.8,16.597451356216496,29.154590528683627,NaN,NaN,-14.786108738130752,-10.526063769714161
1998-10-09T09:30:00-04:00,97,98.78125,94.0625,98.53125,12708500,11467800.4,42.22566415057519,45.18069668747438,NaN,NaN,-119.1604323678787,-136.58596624368914,-0.4241657909704888,-1.7971345988125478,-1.372968807842059,-47463434,-36991629.2,14.45995341258093,27.906594449582002,NaN,NaN,-14.91419450511481,-11.15293958905711
1998-10-12T09:30:00-04:00,100.625,101.4375,99.6875,99.96875,9508500,11408885.35,45.93551675897508,45.07741442271565,NaN,NaN,-30.613282996555835,-113.97432110813675,-0.22714481081945714,-1.6568998213663804,-1.4297550105469232,-37954934,-42067130.8,13.466183253336155,26.538010340000273,NaN,NaN,-13.939635982543807,-11.551039073840924
1998-10-13T09:30:00-04:00,99.5625,100.40625,98.75,99.625,6256801,11304830.5,45.18826508189183,44.30464289563151,NaN,NaN,-45.451145895661135,-102.78661047618262,-0.10065108949167167,-1.5555688724115129,-1.4549177829198412,-44211735,-45869792.6,12.75869577730586,25.027921115392324,NaN,NaN,-13.345168812693403,-11.807343322248421
1998-10-14T09:30:00-04:00,98.9375,101.8125,98.84375,100.5625,8176898,11162430.5,47.68766444636062,44.11443318129351,NaN,NaN,-19.824034057046713,-80.3953244111504,0.057002288411756474,-1.3836649224051456,-1.440667210816902,-36034837,-45167374.8,13.661042666933966,23.46119913599484,NaN,NaN,-12.141639099491528,-11.85509986185458
1998-10-15T09:30:00-04:00,100.125,107.25,99.9375,105.96875,20541104,11542225.75,59.232457880685025,44.767382654229515,NaN,NaN,82.16010773311484,-26.57775751680551,0.510976750253898,-0.8019462729995297,-1.3129230232534277,-15493733,-36231734.6,24.37676552592916,22.738460045063306,NaN,NaN,-7.138135472509869,-11.181247806233907
1998-10-16T09:30:00-04:00,106.125,106.75,105,106,16573898,12019960.7,59.28838712417646,45.28189377476629,NaN,NaN,108.26717479521045,18.907763915812318,0.7826968729747326,-0.3345519320350121,-1.1172488050097447,1080165,-26523014.8,33.966372461147,22.563003857070388,NaN,NaN,-3.1940032231586293,-10.040212865794581
1998-10-19T09:30:00-04:00,105.6875,106.8125,105.5,106.375,7915898,11974025.5,59.997599650903496,45.88926632742422,NaN,NaN,101.28740802597923,45.28790212031934,0.9460928863988958,0.06536730298887505,-0.8807255834100207,8996063,-17132815.4,41.67062345390154,23.0271894699922,NaN,NaN,0.2253582875216101,-8.573702701035126
1998-10-20T09:30:00-04:00,107.5625,108.79687,106.09375,107,14611602,12341100.5,61.210447417833976,47.07897197612563,NaN,NaN,111.93579719251112,76.76529073795379,1.0468260365712196,0.42780696230400395,-0.6190190742672157,23607665,-3568935.4,50.630775515922046,24.40339722698161,NaN,NaN,3.426327577380954,-6.8594126612614
1998-10-21T09:30:00-04:00,106.875,107.625,105.875,106.625,9178398,12115595.4,60.03431629171558,48.56011345296202,NaN,NaN,97.72903919675058,100.27590538871326,1.0367991277468842,0.6769798354163896,-0.35981929233049464,14429267,6523885.4,56.04181945828031,26.41482235520019,NaN,NaN,5.77872170326852,-5.053964894899983
1998-10-22T09:30:00-04:00,106.78125,108.46875,106.15625,108.21875,8277500,11972995.4,63.26492756093937,49.941768541760766,NaN,NaN,108.74716136815914,105.5933161157221,1.0811535375575962,0.9916226296165007,-0.08953090794109558,22706767,14163985.4,59.647340866217796,28.74392423238103,NaN,NaN,8.777443849801477,-3.078049359942632
1998-10-23T09:30:00-04:00,107.96875,108,106.78125,106.84375,6237199,11772485.45,58.845387570511875,51.25991125047316,NaN,NaN,93.42923156710123,102.62572747010026,0.9653451158274259,1.1171504868431867,0.1518053710157609,16469568,17241866,61.03394415947723,31.369431834284494,NaN,NaN,10.145142110575502,-1.18902200701147
1998-10-26T09:30:00-05:00,107.71875,108.46875,106.78125,107.625,5838602,11622025.5,60.532431680201206,52.71003763739099,NaN,NaN,95.81972560715721,101.53219098633585,0.8906272238071614,1.2650894007747127,0.37446217696755124,22308170,19904287.4,62.24257088887304,34.26334221602977,NaN,NaN,11.776643468311473,0.6632159180346646
1998-10-27T09:30:00-05:00,108.4375,108.96875,106.28125,107,10089699,11595605.35,58.46753936106344,54.19346042800432,NaN,NaN,86.44580569327367,96.43419268648836,0.753807405776368,1.3167214341880111,0.5629140284116432,12218471,17626448.6,60.51320543616406,37.219053159449054,NaN,NaN,12.593296311114907,2.3675131170461277
1998-10-28T09:30:00-05:00,106.5625,107.53125,106.03125,106.8125,5650602,11482715.55,57.83020119025904,55.6957718690066,NaN,NaN,67.86841585613585,90.46206801836543,0.6114377729445186,1.3272112445922915,0.7157734716477728,6567869,16054169,59.28869463179141,40.26842767913298,NaN,NaN,13.107746098873049,3.9018321144499737
1998-10-29T09:30:00-05:00,107.09375,109.4375,106.625,109.40625,9625602,11297215.55,63.72155729317973,57.23119280776406,NaN,NaN,86.77792117900603,86.0682199805348,0.6491521622480654,1.5272136744578546,0.8780615122097892,16193471,14751509.8,58.23721996684139,43.395375290151584,NaN,NaN,15.282797165172024,5.527684264553123
1998-10-30T09:30:00-05:00,110.125,110.90625,109.5,110,9872801,11073265.55,64.9294181535619,58.58790005023455,NaN,NaN,103.30816461918728,88.04400659095201,0.668647800488356,1.7138712628202342,1.0452234623318781,26066272,16670850.6,59.38028199029575,46.67495377136298,NaN,NaN,17.449984117238657,7.230869957793914
1998-11-02T09:30:00-05:00,110.8125,111.875,110.1875,111.875,6501398,10757975.5,68.49647297352621,60.25277204249415,NaN,NaN,113.95899100975527,91.67185967147161,0.7559446831220253,1.9901543162344097,1.2342096331123844,32567670,18722750.6,60.62116832510206,50.09370181049128,NaN,NaN,20.442039911122805,9.118179951126612
1998-11-03T09:30:00-05:00,111.59375,111.8125,110.75,111.0625,6866000,10470225.5,65.39261187642671,61.517411144641734,NaN,NaN,105.04292629884493,95.39128379258587,0.7079289030194682,2.1191207618867196,1.4111918588672514,25701670,21419390.4,62.253193106904746,53.56456969906062,NaN,NaN,22.069650853496967,10.968390080036663
1998-11-04T09:30:00-05:00,112.46875,113.09375,111.09375,112.25,8233602,10164480.6,67.6965851410177,62.121991663236926,NaN,NaN,117.25806685259636,105.26921399187798,0.7036406483570803,2.2907426693136017,1.5871020209565214,33935272,26892871,65.38869603078663,56.49399330655044,NaN,NaN,24.141344144445625,12.850240660666515
1998-11-05T09:30:00-05:00,111.53125,113.9375,111.125,113.78125,6841500,9475305.2,70.43029702348375,62.9178423703303,NaN,NaN,134.20243517072225,114.75411679022122,0.7473183394609124,2.521249945282662,1.7739316058217496,40776772,31809531.2,67.96305651498199,58.922327881824366,NaN,NaN,26.7640348057675,14.837925538538084
1998-11-06T09:30:00-05:00,113.46875,114.5625,113.3125,114.125,5224801,9101120.25,71.0231363046464,63.705380702740506,NaN,NaN,151.9712593356552,124.48673573351479,0.7412837339285216,2.7005362732324016,1.95925253930388,46001573,35796591.4,69.91711756247535,60.93993460386535,NaN,NaN,29.092902860501912,16.874350870247202
1998-11-09T09:30:00-05:00,113.9375,114.25,112.5,113.3125,6188699,8935130.2,67.57456949820278,64.15996085133828,NaN,NaN,121.01536843188613,125.89801121794099,0.6289280585804216,2.7454126125294067,2.116484553948985,39812874,37245632.2,70.61852939185708,62.36763130928928,NaN,NaN,30.1034230828302,18.76421832918763
1998-11-10T09:30:00-05:00,113,113.9375,112.25,113,14015199,9323050.1,66.24231969425642,64.60338966580548,NaN,NaN,101.87489282978474,125.26440452412893,0.486297644258213,2.7243566092717515,2.2380589650135385,25797675,37264833.2,70.62830200282922,63.40952291961421,NaN,NaN,30.581441612289296,20.45239308391644
1998-11-11T09:30:00-05:00,113.8125,114,111.89062,112.25,10922398,9460325.1,63.030514791818874,64.5866458965826,NaN,NaN,83.81685570898753,118.57616229540717,0.30313993345114154,2.6169838818274656,2.313843948376324,14875277,33452834.2,65.93915273559803,63.858938053141365,NaN,NaN,30.112010773556058,21.83233846815067
1998-11-12T09:30:00-05:00,112.3125,113.125,111.6875,112.125,5457398,8706139.8,62.48672032005006,64.84674109297818,NaN,NaN,66.49271136089808,105.03421753344234,0.1433770508646428,2.4930652619571276,2.349688211092485,9417879,27181055.6,58.99880641416045,63.71357107133302,NaN,NaN,29.574546925447542,22.938368247764508
1998-11-13T09:30:00-05:00,112.21875,113.21875,112.125,113.21875,5524602,8153675,65.30715824401307,65.1877929903933,NaN,NaN,73.43876027942369,89.32771772219604,0.0841036201511538,2.454817736281427,2.3707141161302734,14942481,20969237.2,53.04376436947296,63.056513462804446,NaN,NaN,29.842059686198862,23.92460988182656
1998-11-16T09:30:00-05:00,114.21875,114.35937,112.89062,114.0625,6023699,8059065.05,67.34672824969371,65.82202076815261,NaN,NaN,89.49395096216546,83.0234342282519,0.0747761371330169,2.4641842875465443,2.3894081504135274,20966180,17199898.4,49.761552332559845,62.28853824111843,NaN,NaN,30.62518307859033,24.881834624221383
1998-11-17T09:30:00-05:00,113.65625,115.625,113,114.0625,9058898,7781429.85,67.34672824969371,66.50177270096937,NaN,NaN,93.94057418786197,81.43657049986737,0.04322618480093965,2.443440881414702,2.4002146966137623,20966180,16233599.4,48.9257552069251,61.54832828219941,NaN,NaN,31.27729665375625,25.795472057012077
1998-11-18T09:30:00-05:00,114.3125,115,113.5,114.75,4567699,7550894.9,69.06531973716291,66.88347001839675,NaN,NaN,93.87619332941979,83.44843802395381,0.043177642514442116,2.454186749756815,2.4110091072423727,25533879,18365319.8,50.88558920065684,61.02321179890051,NaN,NaN,32.29813145678297,26.72442339983649
1998-11-19T09:30:00-05:00,115.28125,115.90625,114.625,115.75,5249301,7399484.95,71.42144412123491,67.34718615894482,NaN,NaN,114.85775453133196,93.12144665804058,0.08272072778944928,2.514410016979184,2.431689289189735,30783180,22638380,54.64273177705198,60.68481535509739,NaN,NaN,33.84500709001521,27.741649641290593
1998-11-20T09:30:00-05:00,116.35937,116.75,115.84375,116.625,5562000,7365725,73.33518812414219,67.6928086697031,NaN,NaN,137.3421974618491,105.90213409452568,0.13684041908224964,2.6027398130425468,2.465899393960297,36345180,26918919.8,58.10054347276356,60.5047707227875,NaN,NaN,35.73317975979394,28.883296801076785
1998-11-23T09:30:00-05:00,117.46875,119.625,117.15625,119.375,7151301,7431359.95,78.26206004369342,68.612054967365,NaN,NaN,195.88617640323938,127.18057918274046,0.31660563364813665,2.8616564360204677,2.545050802372331,43496481,31424980,61.4336282886849,60.44623037862895,NaN,NaN,39.112503185944085,30.34461199891497
1998-11-24T09:30:00-05:00,119,119.65625,118.45312,118.625,5323699,7193059.95,74.23353433475498,69.0789799097748,NaN,NaN,184.4113516410183,145.2747346733717,0.3416160068042009,2.9720708108775824,2.6304548040733815,38172782,34866300.4,63.80192572569648,60.33288964255107,NaN,NaN,40.692336812234345,31.82285840081774
1998-11-25T09:30:00-05:00,118.9375,119.1875,118.21875,118.625,4393500,7130204.85,74.23353433475498,69.35063971772276,NaN,NaN,158.0342546887254,158.10634694523287,0.31540259425747674,3.0247080468952277,2.709305452637751,38172782,37394081,65.47884343270032,60.15544585095953,NaN,NaN,41.96157203260572,33.27124606250174
1998-11-27T09:30:00-05:00,119.46875,119.71875,119.01562,119.5,4557898,6876819.65,75.91127501116517,69.6997924824741,NaN,NaN,155.83741745784002,166.30227953053446,0.3135788451319619,3.1012790090527034,2.7877001639207415,42730680,39783581,67.03355811929801,59.949477319304,NaN,NaN,43.53895876639443,34.73806216305784
1998-11-30T09:30:00-05:00,119.01562,119.375,116.125,116.125,8705398,6818449.5,59.750507323022404,69.14093089853263,NaN,NaN,76.7650341026726,154.18684685869917,0.05519788763171318,2.856697523460383,2.80149963582867,34025282,39319601.4,66.40815033527907,59.648735958119865,NaN,NaN,39.638564069048215,35.438133863913606
1998-12-01T09:30:00-05:00,116.125,118.03125,115.21875,117.625,8950602,6940909.7,63.47251790228381,68.94308791339174,NaN,NaN,60.64086989126106,127.13778555630351,-0.03945809703247427,2.752177014538077,2.7916351115705513,42975884,39215482,66.25875681973433,59.3366255878988,NaN,NaN,37.597271786922754,35.7465821386292
1998-12-02T09:30:00-05:00,117.21875,117.90625,116,117.28125,7495500,6972384.7,62.05627091796761,68.8734990652595,NaN,NaN,56.27307075459298,101.51012937901842,-0.144106302154269,2.611502233877715,2.755608536031984,35480384,38677002.4,65.4388429061113,59.30088917150688,NaN,NaN,35.52838032930109,35.71541045158233
1998-12-03T09:30:00-05:00,117.25,118.3125,115.09375,115.34375,12145301,7167969.65,54.65409103385329,68.31402554481687,NaN,NaN,26.269325790268788,75.1571435993271,-0.35091255993905746,2.3169678361081623,2.6678803960472197,23335083,35709462.6,60.96176658768773,59.44110061247312,NaN,NaN,31.236342509078153,35.07554360265316
1998-12-04T09:30:00-05:00,116.625,118.5,116.5,118.375,10007199,7326254.6,62.24237184154537,68.09511223035489,NaN,NaN,68.34996651870574,57.65965341150023,-0.29301456243798274,2.301612192999741,2.594626755437724,33342282,33831783,58.246345495710514,59.81271355006152,NaN,NaN,30.056311650684854,34.35851046665769
1998-12-07T09:30:00-05:00,118.0625,119.46875,118,118.9375,4290000,7279514.55,63.46419789745585,67.81778863376647,NaN,NaN,91.10758279182099,60.5281631493299,-0.2291221926895739,2.3082240145757567,2.5373462072653306,37632282,34553183,59.00192888381752,60.47274044657992,NaN,NaN,29.550410559951274,33.67163905141392
1998-12-08T09:30:00-05:00,118.53125,119.75,117.5,118.40625,10102602,7475209.7,61.441966342048055,67.39601992607749,NaN,NaN,76.7644705605291,63.75288328318351,-0.23410036412293556,2.244720752111661,2.4788211162345966,27529680,31463942.2,54.457243053091496,60.867846721306094,NaN,NaN,28.49519584627254,32.93214716496515
1998-12-09T09:30:00-05:00,118.6875,118.96875,117.875,118.625,5327898,7040844.65,61.979192591635915,66.88986798711127,NaN,NaN,69.246985308948,66.34766619405451,-0.2335874826056381,2.186836762977549,2.4204242455831873,32857578,30939381,53.700849363700016,61.06893673295205,NaN,NaN,27.816912080444094,32.201399295747855
1998-12-10T09:30:00-05:00,118.84375,118.84375,116.71875,116.89062,5966602,6793054.85,55.38969642024307,65.74474315132615,NaN,NaN,29.829332710059766,67.05966757801271,-0.3537716021843118,1.9782097428527976,2.3319813450371094,26890976,31650559.6,54.62111512517303,61.06739268638926,NaN,NaN,25.141534069247324,31.192847120533493
1998-12-11T09:30:00-05:00,116.4375,117.34375,115.5625,117.125,8198199,6930094.9,56.069422887275934,64.5114742058357,NaN,NaN,-9.988566210048065,51.39196103226194,-0.41685803275763833,1.8109088040900616,2.2277668368477,35089175,31999938.2,55.09334477652303,60.85259277951493,NaN,NaN,23.191650446873336,30.049819024296326
1998-12-14T09:30:00-05:00,116.15625,116.40625,113.75,113.75,9521398,7129934.7,45.35313793084597,62.16083691206087,NaN,NaN,-110.92534144386691,10.98537618512437,-0.6702417387442612,1.3899646634173735,2.0602064021616346,25567777,29587037.2,51.13557553992408,60.11701758317487,NaN,NaN,17.700000804006898,28.285559278540692
1998-12-15T09:30:00-05:00,114.6875,116.75,114.53125,116.6875,9631500,7310324.75,53.65555643100658,60.69098134750742,NaN,NaN,-57.20964220689398,-15.80944636836025,-0.62524067837697,1.278655554190422,1.903896232567392,35199277,31120956.6,53.426133787907446,59.375889587618516,NaN,NaN,15.793627873591703,26.500997649262263
1998-12-16T09:30:00-05:00,117.125,117.125,115.75,116.53125,7260000,7220379.85,53.19262396376298,59.18805917815085,NaN,NaN,-41.96334895748302,-38.05151322164646,-0.5915877045344484,1.1644116018993316,1.75599930643378,27939277,30137296.4,51.75083170258057,58.39531732118139,NaN,NaN,14.184792626870838,24.74153978892063
1998-12-17T09:30:00-05:00,117.21875,118.59375,117.03125,118.39062,6914699,7337729.85,57.85279826317016,57.898167981865484,NaN,NaN,37.306455980273235,-36.556088567603766,-0.43683112838572336,1.2099603959516259,1.6467915243373492,34853976,31729896.4,54.252081221808936,57.48235468564645,NaN,NaN,14.382958168266397,23.26174241454145
1998-12-18T09:30:00-05:00,118.3125,119.125,117.875,118.5,4802398,7315384.7,58.116967817198514,57.78148658859235,NaN,NaN,61.13628065875883,-22.33111919384239,-0.3249664029237951,1.2405835206826055,1.5655499236064006,39656374,32643336.2,55.671492331437754,56.71545054251492,NaN,NaN,14.620517440304287,22.027281703936143
1998-12-21T09:30:00-05:00,119.25,121.34375,119,120.15625,8580699,7466319.65,62.00080543614679,57.676364269582564,NaN,NaN,148.43467857165086,29.54088480926116,-0.14639129847968446,1.3825608005067949,1.5289520989864793,48237073,37177195.4,61.97744787074997,56.40964276044462,NaN,NaN,16.064802384792916,21.17549894405854
1998-12-22T09:30:00-05:00,120.40625,121.21875,119.1875,120.6875,5461102,7381809.7,63.18020786023149,57.75664547974427,NaN,NaN,145.25725058681869,70.03426336800369,-0.006825839354405172,1.5204197997934727,1.527245639147878,53698175,40876975,66.202610744901,56.464197606072446,NaN,NaN,17.599158529870483,20.6645931706031
1998-12-23T09:30:00-05:00,121.1875,123.21875,120.8125,123.21875,7791000,7505174.75,68.23855527926092,58.726964354416246,NaN,NaN,219.46870937172372,122.32067503384505,0.22862376294305053,1.8130253428266911,1.5844015798836406,61489175,47586954.6,72.22975894550228,57.269054203059206,NaN,NaN,20.640923506293262,20.66121178998741
1998-12-24T09:30:00-05:00,123.15625,123.25,122.5,122.6875,1507100,7360854.75,66.18349022614096,59.00847281045879,NaN,NaN,195.82856623598045,154.0250970849865,0.3158663561386723,1.979234525056981,1.6633681689183086,59982075,52612574.4,75.72193338407462,58.5173104807995,NaN,NaN,22.454076083107825,20.917335260433184
1998-12-28T09:30:00-05:00,123.25,123.3125,122,122.375,4203602,7343139.95,64.94448317611113,59.114207473219885,NaN,NaN,160.7642653735843,173.95069402795156,0.31888245702057416,2.0619712401940262,1.743088783173452,55778473,55836994.2,77.66278336787872,59.85022865823244,NaN,NaN,23.556610626973576,21.294374598510384
1998-12-29T09:30:00-05:00,122.71875,124.48437,122.125,124.3125,3935800,7104660.05,68.83946463633775,59.6426002085263,NaN,NaN,165.3446771174654,177.33269373711448,0.41181186123335145,2.2578536097151414,1.84604174848179,59714273,58132434.2,78.95273265397687,61.59990648686711,NaN,NaN,25.74508470502586,21.930190328012596
1998-12-30T09:30:00-05:00,123.9375,124.75,123.03125,123.3125,6810699,6997664.9,64.83537301429067,59.84661309585878,NaN,NaN,138.45259559918546,175.97176273958786,0.36782267913925315,2.3058200974058565,1.9379974182666033,52903574,57973514,78.61424512695106,63.37943475567075,NaN,NaN,26.363123463307513,22.563466490197584
1998-12-31T09:30:00-05:00,123.3125,123.9375,122.46875,123.3125,6790500,6962414.9,64.83537301429067,60.521304281147884,NaN,NaN,107.40995491236315,153.56001184771574,0.30330088684490963,2.3171235268227406,2.013822639977831,52903574,56256393.8,74.87881395776482,64.82641324371302,NaN,NaN,26.858884042873765,23.177097569151325
1999-01-04T09:30:00-05:00,123.375,125.21875,121.71875,123.03125,9450398,6827669.75,63.62817670588952,61.06121526819171,NaN,NaN,96.75020761285492,133.7443401230906,0.21065198920778183,2.2771376264875585,2.0664856372797766,43453176,52950614,68.16373988104417,65.76001289403597,NaN,NaN,26.937220422863028,23.714257976824424
1999-01-05T09:30:00-05:00,122.9375,124.875,122.9375,124.4375,8031000,6728859.8,66.94247024437968,62.60331043344414,NaN,NaN,103.41601912970869,122.2746908743155,0.21244256436195252,2.332038842732217,2.1195962783702647,51484176,52091754.6,66.49528098569456,66.857134711591,NaN,NaN,27.952459577212572,24.319715348308446
1999-01-06T09:30:00-05:00,125.8125,127.75,125.75,127.4375,7737699,6901244.75,72.66500347519536,63.96112807945763,NaN,NaN,150.54456173907053,119.31466779863656,0.3745573086892269,2.587792914231798,2.2132356055425713,59221875,51993275,66.29490248468551,67.77633247564658,NaN,NaN,30.749140489567296,25.238204654202566
1999-01-07T09:30:00-05:00,126.375,127.21875,125.78125,126.8125,5504898,6671359.55,69.9483222948653,65.15796367453636,NaN,NaN,123.51782697802265,116.32771407440399,0.3964690902686643,2.708821968378402,2.3123528781097376,53716977,52155955.6,66.4746273162198,68.8280321623351,NaN,NaN,32.19602551393336,26.232179062735536
1999-01-08T09:30:00-05:00,128.1875,128.29687,126.1875,127.75,6221898,6716059.55,71.65987798142946,66.14418365441203,NaN,NaN,124.46181956523132,119.73808700497761,0.4281671856435403,2.847561860164163,2.4193946745206225,59938875,53563015.8,68.06096584587785,69.8143810640543,NaN,NaN,33.93000732336214,27.33186881425362
1999-01-11T09:30:00-05:00,127.6875,127.6875,125.21875,126.53125,7578301,6796644.5,66.3680084019287,66.73354369617847,NaN,NaN,97.03309286048642,119.79466405450391,0.3257547691425846,2.826588135948853,2.5008333668062686,52360574,55344495.4,69.99669341837249,70.83760971312107,NaN,NaN,33.79973577408972,28.255849808515922
1999-01-12T09:30:00-05:00,126.21875,126.21875,123.75,124.25,7768801,6775174.6,57.768612543667224,66.4312442038585,NaN,NaN,57.35481083083166,110.58242239472852,0.07610438123313701,2.5959638433476897,2.5198594621145527,44591773,53966014.8,66.63152577959552,71.17004384946719,NaN,NaN,30.90202924090557,28.633875441714444
1999-01-13T09:30:00-05:00,120.40625,125.125,120.375,123.375,10810602,6839634.8,54.83381932192042,65.83507359397913,NaN,NaN,11.296012445311083,82.73271253597662,-0.1631746963552696,2.3158910916704656,2.479065788025735,33781171,48877874,55.9409279760944,70.43706650883814,NaN,NaN,27.593074053908744,28.48518952917077
1999-01-14T09:30:00-05:00,123.625,123.90625,120.90625,121.21875,11400699,6928094.75,48.31930567548295,64.41227005085214,NaN,NaN,-24.516208292582142,53.12590548185566,-0.4648043065495582,1.8980604048387875,2.3628647113883456,22380472,42610573,46.12437819898549,68.57239645551552,NaN,NaN,22.534626051980148,27.635109032429252
1999-01-15T09:30:00-05:00,122.375,124.40625,122.0625,124.375,7812699,6955729.7,56.47133630306686,63.718544770632555,NaN,NaN,15.371785935322437,31.307898755873886,-0.4496113779987736,1.8008504888898784,2.250461866888652,30193171,36661432.2,39.10881910429794,65.95717400696005,NaN,NaN,20.828876534991007,26.662790104223788
1999-01-19T09:30:00-05:00,125.29687,125.625,123.5,125.1875,6535102,6936749.85,58.29507038019445,63.24358671378136,NaN,NaN,49.58747025618283,21.818774235013176,-0.3851845527500437,1.7689811759510974,2.154165728701141,36728273,33534972,36.009066945400654,62.98190854821161,NaN,NaN,20.09158036682385,25.724045856023796
1999-01-20T09:30:00-05:00,126.09375,127.9375,125.03125,126.1875,6534398,7023349.85,60.48920495391675,62.64713959360843,NaN,NaN,102.06627573122458,30.76106721509176,-0.2804325100335716,1.8036250911591765,2.084057601192748,43262671,33269151.6,35.74962283342704,59.89597213245805,NaN,NaN,20.206876811806623,24.935878849707056
1999-01-21T09:30:00-05:00,125.57812,125.84375,122.59375,122.84375,6937500,6941189.9,50.85477379691586,61.648525363795954,NaN,NaN,-15.048582452826405,25.492148235464263,-0.43246549220331865,1.5434757359385998,1.9759412281419184,36325171,33777951.6,36.68988408312426,56.90137491504185,NaN,NaN,16.94595470270179,23.79446111442059
1999-01-22T09:30:00-05:00,122.125,123.84375,121.78125,122.5625,7522301,7044249.85,50.13150068214177,60.598248768642456,NaN,NaN,-71.10277494253108,16.174834905474473,-0.5410492612940729,1.2996296515243273,1.8406789128184002,28802870,35062431.2,39.1123992777977,54.34663100932992,NaN,NaN,14.188307414729866,22.4221534430362
1999-01-25T09:30:00-05:00,123.28125,124,121.90625,123.8125,5700301,6939714.9,53.30982535138375,59.86122367189205,NaN,NaN,-49.613346386017156,3.1778084412065537,-0.5177538063458393,1.193486654886101,1.7112404612319403,34503171,35924431.2,40.7508752545475,52.38856925029444,NaN,NaN,12.924929141812635,21.06540711428998
1999-01-26T09:30:00-05:00,124.125,126.0625,123.625,126.0625,6047000,7166709.9,58.44391843090877,59.25418425664412,NaN,NaN,42.85460422279101,1.8312352345281895,-0.34802246546427296,1.2762123794015992,1.624234844865872,40550171,36688810.8,42.23530686267189,50.65571395579282,NaN,NaN,13.526089530008065,19.988361745106847
1999-01-27T09:30:00-05:00,126.375,126.625,124.15625,124.59375,7399398,7326499.7,54.25028640917678,57.93884732335708,NaN,NaN,31.398501878952228,-12.302319535926278,-0.331934269296418,1.2093170082453497,1.5412512775417677,33150773,34666431.2,39.42116504025993,48.736161281190995,NaN,NaN,12.661355457541076,18.94164656116888
1999-01-28T09:30:00-05:00,125.25,126.96875,125.1875,126.6875,5961699,7427794.65,58.78987554600395,57.14181541272412,NaN,NaN,80.2410492249526,6.755606799629521,-0.1848830168068214,1.3101475065332409,1.4950305233400623,39112472,35223891.4,40.596119452535675,46.88769643378498,NaN,NaN,13.430623662365203,18.154357575625497
1999-01-29T09:30:00-05:00,127.34375,128.29687,125.40625,127.65625,6456801,7410099.75,60.73140978148731,56.36121054129968,NaN,NaN,107.24191428937162,42.42454464601006,-0.03482881343853661,1.4514945065418914,1.486323319980428,45569273,38577172,47.226747609561045,45.39953798833378,NaN,NaN,14.678672822806204,17.657831182365598
1999-02-01T09:30:00-05:00,128.6875,128.6875,126.90625,126.90625,9426801,7541914.8,58.436022322957804,55.79464010708747,NaN,NaN,110.64671661683833,74.47655724658117,-0.0003657357053381549,1.4858661503487554,1.4862318860540935,36142472,38905032.2,47.839779074545575,43.816901249489,NaN,NaN,14.98794970734825,17.276419543077406
1999-02-02T09:30:00-05:00,127.07812,127.21875,124.76562,126.125,9194500,7529119.9,56.05916707972434,55.67253685966297,NaN,NaN,40.55519827672662,74.01667605736829,-0.04215301603893051,1.4335406160054305,1.475693632044361,26947972,36184592.4,43.34092238197482,42.153286721087525,NaN,NaN,14.531815353375729,16.884333230262882
1999-02-03T09:30:00-05:00,125.6875,127.9375,125.65625,127.40625,10290699,7642104.85,59.00419892383378,55.9704211169425,NaN,NaN,76.59102660461863,83.05518100250156,0.0021780215655842206,1.4784161590013412,1.476238137435757,37238671,37002172,45.0144660561059,41.37282515537406,NaN,NaN,15.026633005051055,16.61894748380405
1999-02-04T09:30:00-05:00,127.375,127.5,124.78125,125.5,7761102,7643275,53.28235766134424,56.32492483021831,NaN,NaN,31.751839276963963,73.35733901290384,-0.10526132135067856,1.3446614857474088,1.4499228070980874,29477569,35075191.4,41.87500969816081,41.06929883388658,NaN,NaN,13.701397151104375,16.202154579132667
1999-02-05T09:30:00-05:00,125.65625,125.65625,123.21875,124.0625,7516102,7743835.2,49.392559235958686,55.81929789685343,NaN,NaN,-38.86934024215971,44.135088106597564,-0.2720408088476436,1.109871796038533,1.3819126048861765,21961467,30353630.2,35.366426111529506,40.801985048688834,NaN,NaN,11.374840158828157,15.51253823337488
1999-02-08T09:30:00-05:00,125.09375,125.09375,123.34375,124.3125,8528398,7859160.2,50.07517614615061,55.23216259442172,NaN,NaN,-36.15334252205665,14.77507627881857,-0.3589583493096782,0.9332146682490787,1.292173017558757,30489865,29223108.8,34.00361850527348,40.6587387315369,NaN,NaN,9.694954888476474,14.681454898389394
1999-02-09T09:30:00-05:00,124.375,124.5,121.51562,121.53125,8985699,7929530.1,43.108711845587685,53.99069880096965,NaN,NaN,-110.50652879851788,-15.437269136230327,-0.5838927622171843,0.5623070647872765,1.1461998270044609,21504166,28134347.6,32.696881360323616,40.44068576917237,NaN,NaN,5.961857193299552,13.43579808337656
1999-02-10T09:30:00-05:00,122.125,123,121.32812,122.3125,6936699,7887925,45.40627441888715,53.6015202739676,NaN,NaN,-109.04434871794929,-52.56434420074392,-0.6548608062663975,0.327623819171464,0.9824846254378615,28440865,26374786.4,30.647093931349403,40.00905790118845,NaN,NaN,3.5948742411201535,12.029951820197073
1999-02-11T09:30:00-05:00,123.0625,126.09375,122.5,125.125,9181801,7806484.95,52.7968718267471,53.79190392715369,NaN,NaN,-7.467636722120519,-60.40823940056081,-0.4944832611294363,0.3643805490260661,0.8588638101555024,37622666,28003805.8,34.726933387198116,39.695810337574194,NaN,NaN,3.8514669259423715,10.861596835303544
1999-02-12T09:30:00-05:00,124.8125,125.5,122.625,123.625,10676602,7770280.1,48.98788953077638,53.48319422568174,NaN,NaN,-45.9606571408099,-61.826502780290845,-0.4715966863647205,0.26936795219960175,0.7409646385643223,26946064,29000725.2,37.163125103438624,39.43954246963785,NaN,NaN,2.84673267888672,9.716616241529712
1999-02-16T09:30:00-05:00,124.75,125.625,122.875,122.875,6915500,7725420.15,47.15602790067581,52.67691633066511,NaN,NaN,-53.046237660043396,-65.2050818078882,-0.48714842814836246,0.1320291033788692,0.6191775315272317,20030564,26908865,34.272569033193435,38.870775481817965,NaN,NaN,1.4643730197072984,8.53772435269794
1999-02-17T09:30:00-05:00,123.1875,125.35937,122.25,122.75,7858102,7791570.15,46.841637384318844,52.147727114603825,NaN,NaN,-64.01515999168531,-55.906808046521675,-0.48498096437444077,0.012951326059180701,0.49793229043362147,12172462,25042524.2,31.88938137178701,38.3327909340699,NaN,NaN,0.2637760088158615,7.355731732143357
1999-02-18T09:30:00-05:00,123.1875,124.375,122.21875,123.71875,9048898,7917295.15,49.64366689313797,51.49442649654197,NaN,NaN,-59.503224455611786,-45.99858319405418,-0.40091512834777404,-0.003211620001096094,0.39770350834667795,21221360,23598623.2,30.143037570516015,37.58614222821135,NaN,NaN,0.05552561965266718,6.312845144644687
1999-02-19T09:30:00-05:00,124,125.75,123.375,124.25,5312199,7836030.1,51.16391292883483,50.81103386420965,NaN,NaN,-10.172687413112428,-46.539593332252565,-0.2969303105108547,0.026540620208109544,0.32347093071896427,26533559,21380801.8,27.63932261425927,36.18704044283265,NaN,NaN,0.3107068841436025,5.4553968217159605
1999-02-22T09:30:00-05:00,124.4375,127.71875,124.28125,127.5625,10695801,7994705.1,59.395373923341275,50.87955897852275,NaN,NaN,84.93302688458726,-20.360856527173134,-0.0077420750145014705,0.31379333695083744,0.3215354119653389,37229360,23437461,33.181907916301796,35.14004964581524,NaN,NaN,3.145178344256218,5.125365610650283
1999-02-23T09:30:00-05:00,127.59375,128.5,126.59375,127.5,7770699,8098225,59.192646436675574,51.1033789325907,NaN,NaN,120.35523022257912,14.31943704935137,0.16700137988913483,0.5302871368267574,0.3632857569376226,29458661,25323080.4,37.87996050337278,34.74998094020081,NaN,NaN,5.346629759358625,5.1569747747514745
1999-02-24T09:30:00-05:00,127.84375,128.84375,125,125.25,7271000,8159425,52.27524082626514,50.62273906847866,NaN,NaN,58.42629755048104,38.80772855778464,0.12087095329836084,0.5143744485605737,0.39350349526221284,22187661,27326120.2,42.50459254074577,34.570704260532224,NaN,NaN,5.19950449027598,5.163050448397833
1999-02-25T09:30:00-05:00,124.53125,125.28125,122.6875,124.0625,11633000,8371105.1,49.01928685399291,50.318234010810706,NaN,NaN,-47.517196401260854,41.204934168654816,0.006250068467883563,0.40131608084706727,0.3950660123791837,10554661,25192780.4,39.16070897824984,34.37682563768144,NaN,NaN,4.0800522613052035,5.008336421670315
1999-02-26T09:30:00-05:00,124.75,124.84375,122.8125,123.5625,9621301,8554085.2,47.67288494638221,50.19540013298381,NaN,NaN,-54.7789534050188,32.28368097027355,-0.10143029381737978,0.26827814510745895,0.36970843892483873,933360,20072740.6,32.54346603793907,34.17518563242498,NaN,NaN,2.765667671723692,4.68795517167794
1999-03-01T09:30:00-05:00,123.65625,124.3125,122.375,123.90625,7607199,8611605.1,48.71579944560551,50.09830179723059,NaN,NaN,-59.94228497896027,3.308618597564042,-0.14503835450420288,0.18841049579458513,0.333448850298788,8540559,14334980.4,27.0310373288967,33.677144119826636,NaN,NaN,1.9768389148810774,4.300652849278388
1999-03-02T09:30:00-05:00,124.5,125.3125,122.3125,122.8125,9651500,8622840.05,45.601495191230185,50.276357750490774,NaN,NaN,-59.263069673361315,-32.61504138162404,-0.2376084512255215,0.036438286266886166,0.27404673749240765,-1110941,8221060,22.631944558329693,32.95822006254136,NaN,NaN,0.40689423571408584,3.7444016187692024
1999-03-03T09:30:00-05:00,123.09375,123.5625,121.78125,123.46875,7881398,8557184.95,47.7594143741456,50.44443917586637,NaN,NaN,-84.0356007958779,-61.10742105089584,-0.24379185674151443,-0.030693083434485402,0.21309877330702903,6770457,5137619.2,20.7939744952333,32.25442581710449,NaN,NaN,-0.3203152499666576,3.163727780378365
1999-03-04T09:30:00-05:00,124.0625,125.48437,123.26562,125.03125,8256398,8455469.9,52.58247264735957,50.42912494876727,NaN,NaN,20.93670256834934,-47.41664125697379,-0.1371152046732998,0.0417047674654043,0.1788199721387041,15026855,6032058,22.753694293926372,31.39919445329937,NaN,NaN,0.42892188024525574,2.7730412232164925
1999-03-05T09:30:00-05:00,127.5,128.125,126.5625,127.54687,10703102,8602569.9,59.12547254451837,51.15323802117741,NaN,NaN,185.6099649835681,0.6611424207435845,0.09584618367470657,0.2986277017320873,0.20278151805738073,25729957,10991377.4,32.69691068653559,31.080179137806294,NaN,NaN,3.165697105183162,2.8291349206403025
1999-03-08T09:30:00-05:00,128.28125,128.79687,127.25,128.375,4802199,8466874.75,61.03175403152797,52.14436131623828,NaN,NaN,179.88837252301974,48.62727392113958,0.28783805489739306,0.562579086679122,0.274741031781729,30532156,15389696.8,40.06536515295553,31.49395028921787,NaN,NaN,6.018990080264008,3.2848285148722605
1999-03-09T09:30:00-05:00,128.125,129.9375,127.75,128.0625,7893398,8435124.75,59.89655421765137,53.07685537576202,NaN,NaN,159.38727037518692,92.35734193084923,0.37063811232525334,0.7380386721882957,0.3674005598630423,22638758,20139636.6,46.83483413472089,32.56148262942743,NaN,NaN,8.019265284839703,3.9611766248676092
1999-03-10T09:30:00-05:00,128.46875,129.25,127.78125,129.1875,3960100,8183844.8,62.59395474874523,54.001875936876836,NaN,NaN,137.4472038099047,136.65390285200573,0.47155147294001887,0.9568399010380659,0.48528842809804706,26598858,24105316.8,51.73615283552046,34.10384800549918,NaN,NaN,10.537180191524056,4.90060570581853
1999-03-11T09:30:00-05:00,129.6875,131.1875,128.875,130.625,6583699,8166194.8,65.76280648987336,55.044654048379584,NaN,NaN,160.62573950968877,164.59171024027364,0.5973961147156255,1.232033571492579,0.6346374567769535,33182557,27736457.2,55.75804239521018,36.112327989852815,NaN,NaN,13.690306565133673,6.156277257149265
1999-03-12T09:30:00-05:00,131,131.03125,129.21875,129.375,5286500,7971429.75,60.92918810451577,55.15421220417777,NaN,NaN,126.76568651055146,152.8228545456703,0.5593986583571594,1.3338857797234027,0.7744871213662433,27896057,28169677.2,56.22671277370383,37.75838547966725,NaN,NaN,14.957995161241122,7.413665529162387
1999-03-15T09:30:00-05:00,129.9375,131.25,129.5,131.21875,5394398,7707319.55,65.01392381511235,55.570017731208964,NaN,NaN,131.04681764402653,143.05454356987167,0.6168609532260849,1.5455633128988495,0.9287023596727646,33290455,28721337,56.853508717718306,39.11363892354907,NaN,NaN,17.346280506803282,8.832610525968228
1999-03-16T09:30:00-05:00,131.125,131.65625,130.46875,130.71875,4547500,7588919.55,63.08769084522484,56.34233558970608,NaN,NaN,123.81565103484168,135.94021970180262,0.5801647018894678,1.6539082370345994,1.0737435351451317,28742955,29942176.4,58.27734747091165,40.24026427570378,NaN,NaN,18.723511307289186,10.245596351871221
1999-03-17T09:30:00-05:00,130.6875,130.9375,129.625,130.15625,4524102,7422219.55,60.90159933487925,57.19107219548368,NaN,NaN,93.83499809765394,127.21777855935247,0.4810644593786795,1.675074109368481,1.1940096499898014,24218853,29466175.4,57.48087149505872,41.5488473126187,NaN,NaN,19.232598772751498,11.529453840568403
1999-03-18T09:30:00-05:00,129.78125,132.375,129.75,132.25,3506300,7145089.65,65.67011328440489,58.47658850534244,NaN,NaN,114.67631750818036,118.02789415905079,0.5164648289373477,1.8395906861614861,1.3231258572241384,27725153,28374694.6,55.6042620219908,43.19604702576525,NaN,NaN,21.154705334182925,12.90448976822762
1999-03-19T09:30:00-05:00,132.3125,132.625,129.6875,129.6875,5526699,7155814.65,56.57564502072161,59.03800604642216,NaN,NaN,85.73692867629197,109.82214259219889,0.3359837055964614,1.7431054892197153,1.407121783623254,22198454,27235174,53.63549810139315,45.096365652372135,NaN,NaN,19.9094699893688,13.905201228390645
1999-03-22T09:30:00-05:00,130.0625,130.59375,129.42187,129.9375,4603801,6851214.65,57.19841859987394,59.86635771846814,NaN,NaN,61.3419968120641,95.8811784258064,0.20837476820169032,1.6675902438753667,1.4592154756736764,26802255,25937534,51.4034942989313,47.15147634812939,NaN,NaN,19.11304321529471,14.649178655091225
1999-03-23T09:30:00-05:00,129.3125,129.53125,125.70312,126.1875,9713801,6948369.75,46.43966776099571,59.77209010324315,NaN,NaN,-12.952939020281946,68.52746041478167,-0.13515101950177066,1.290276701296463,1.4254277207982338,17088454,23606633.8,47.57379604699004,49.06432074468345,NaN,NaN,14.62911883701637,14.646312966794817
1999-03-24T09:30:00-05:00,126.84375,127.17187,125.625,126.90625,6280898,6898864.65,48.4414187852096,59.47630054166101,NaN,NaN,-28.30877692413921,44.09870541042306,-0.31050789483649144,1.0372928522526195,1.347800747089111,23369352,23436733.6,47.29718969749569,50.81742755922411,NaN,NaN,11.72710645709013,14.229283465408432
1999-03-25T09:30:00-05:00,128.0625,129.5,127.75,129.5,6639602,6649194.75,54.980311640268596,59.18021761992888,NaN,NaN,28.78356837166931,26.920155583120856,-0.25090142674342886,1.0341739636598248,1.2850753904032537,30008954,23893493.8,48.169673416971236,51.92262489711237,NaN,NaN,11.423848750956616,13.8285070776296
1999-03-26T09:30:00-05:00,128.625,129.125,127.71875,128.5625,6159699,6476114.65,52.39381946892223,58.56322229402848,NaN,NaN,10.684536698445594,11.909677187551576,-0.27193342679111376,0.9451586069143616,1.2170920337054754,23849255,24223654,48.82910196463295,52.54860609794647,NaN,NaN,10.32839174710176,13.32849060183991
1999-03-29T09:30:00-05:00,129.15625,131.4375,129.15625,131.15625,5863898,6388949.6,58.246305684220154,58.44534739878339,NaN,NaN,73.3482336344504,14.310924552028832,-0.1164296076042024,1.0715550242002223,1.1879846318044247,29713153,24805833.6,50.03623708602047,52.777277737325015,NaN,NaN,11.37389936884557,13.049263282840718
1999-03-30T09:30:00-05:00,129.9375,131.21875,129.5625,130.46875,5401398,6176444.5,56.271629784425144,57.993752758474805,NaN,NaN,62.79559804966515,29.46063196601825,-0.06756466692254337,1.1035287981512454,1.1710934650737888,24311755,26250493.8,52.99923394926722,52.867497816878355,NaN,NaN,11.562206207927924,12.836826557853176
1999-03-31T09:30:00-05:00,131.15625,131.60937,128.3125,128.375,7413602,6153054.7,50.64088862285655,56.91361576797361,NaN,NaN,13.500720907886418,37.822531532423376,-0.1776900864863311,0.9489808569658749,1.126670943452206,16898153,24956254,50.13099016197335,52.4655655145043,NaN,NaN,9.861880094749113,12.411834205981167
1999-04-01T09:30:00-05:00,129.6875,129.6875,128.125,129.34375,7683602,6124414.9,52.985030036525885,56.346175905974334,NaN,NaN,-18.982955707777606,28.26922671653399,-0.18584804013798495,0.8943608932797247,1.0802089334177096,24581755,23870814.2,47.79482768709645,51.86328800831806,NaN,NaN,9.230140742191649,11.95730656829695
1999-04-05T09:30:00-04:00,130.9375,132.59375,130.25,132.40625,5791102,5878814.9,59.52858726451096,55.954366152359945,NaN,NaN,127.39783123386587,51.61188562361805,0.004374710711680496,1.0856773218073101,1.0813026110956296,30372857,25175534.6,50.764906168794205,51.42838782625205,NaN,NaN,10.882393643624075,11.803747579057967
1999-04-06T09:30:00-04:00,132.1875,132.98437,131.15625,132.09375,5381301,5907770,58.631840381004864,55.63609111920137,NaN,NaN,133.68917764266158,63.68007442526029,0.09357226670690055,1.1982679444792552,1.1046956777723547,24991556,24231215.2,48.609345229083935,50.73781623755007,NaN,NaN,11.892317538713092,11.816400430437271
1999-04-07T09:30:00-04:00,132.6875,133.375,131.375,133.15625,6248602,5825530.2,60.79434297371278,55.628429950546625,NaN,NaN,149.98188693076042,81.11733220147934,0.20230932209913166,1.3575823303962693,1.1552730082971376,31240158,25616895.8,51.8408474714017,50.33495737871742,NaN,NaN,13.399286259104684,12.042526977389759
1999-04-08T09:30:00-04:00,133.1875,134.9375,132.28125,134.84375,5909102,5922980.3,64.01205389055468,55.50999713670018,NaN,NaN,198.35355345693728,118.08789871128951,0.35701811706529063,1.601545654628751,1.2445275375634604,37149260,29667117.2,59.79816208543096,50.634521668963146,NaN,NaN,15.696497434356166,12.56452275695639
1999-04-09T09:30:00-04:00,134.4375,135.5,133.59375,134.875,4365801,5812085.4,64.07086183656146,56.04536976640303,NaN,NaN,189.78178543128402,159.84084693910182,0.4259192948953425,1.7769266561826385,1.351007361287296,41515061,33053778.4,65.00497186721118,51.44662693795015,NaN,NaN,17.542566092042367,13.275671804825814
1999-04-12T09:30:00-04:00,133.46875,136.40625,133.21875,136.3125,8213199,5958420.35,66.76154346367532,56.728450113817416,NaN,NaN,180.37798641602592,170.43687797553383,0.5261988405945361,2.008755912030466,1.48255707143593,49728260,36924859,69.81704964512656,52.76188089124981,NaN,NaN,19.93893884606534,14.22756709643146
1999-04-13T09:30:00-04:00,136.25,136.46875,134.5,135.4375,10071398,6192270.35,63.63752441666453,57.95686844636519,NaN,NaN,153.428251414733,174.3846927299481,0.4921112587093184,2.097696144822578,1.6055848861132596,39656862,39857920.2,72.86198428754616,54.56818005128953,NaN,NaN,21.04766611172366,15.201866955758918
1999-04-14T09:30:00-04:00,136.0625,136.0625,132.6875,133.15625,11551699,6542480.3,56.24758771797195,58.51445194156249,NaN,NaN,89.42858870886356,162.27403308556876,0.28472668090146547,1.9614932372400915,1.676766556338626,28105163,39230921.2,71.20820804265013,56.276109933086275,NaN,NaN,19.781731580701685,15.856133330750742
1999-04-15T09:30:00-04:00,133.4375,133.5625,131,132.65625,11150000,6873775.2,54.74697247008987,58.497784857978296,NaN,NaN,36.276799980517836,129.85868239028486,0.09262060960061946,1.7925423183394003,1.6999217087387808,16955163,35192101.8,61.521524487245784,57.229813580963025,NaN,NaN,18.301477759752593,16.205468249179578
1999-04-16T09:30:00-04:00,132.90625,132.90625,131.1875,131.53125,6476199,7022270.15,51.42276529695695,58.428423845695065,NaN,NaN,18.783111619349974,95.65894762789806,-0.11993581310824442,1.5500019423534752,1.6699377554617196,10478964,28984882.4,50.21549423992445,57.32884160062671,NaN,NaN,16.057760552067162,16.18436714959209
1999-04-19T09:30:00-04:00,132.6875,134.53125,128.375,129.5,12487199,7370295.15,45.99261760883202,57.55316041173877,NaN,NaN,-14.786861232666622,56.62597809815954,-0.391728960835396,1.1802765544174747,1.5720055152528707,-2008235,18637583.4,37.758519198381585,56.45186175150964,NaN,NaN,12.395888159265454,15.643155865259715
1999-04-20T09:30:00-04:00,129.8125,131.1875,129,131.125,9049602,7592585.2,50.496307500431556,57.14063739145352,NaN,NaN,-27.13558337021213,20.513211141170522,-0.45217653140353087,1.0067848509984572,1.458961382401988,7041367,12114484.4,32.31595562969291,54.9744847286829,NaN,NaN,10.624454905686946,14.926198585320748
1999-04-21T09:30:00-04:00,131.0625,135.625,130.40625,134.875,5772199,7395505.1,58.994394376504104,57.73731637385691,NaN,NaN,67.23867455831252,16.07522831106033,-0.240344889725026,1.1585302702457057,1.3988751599707316,12813566,9056165,30.1236095161281,53.54538611112253,NaN,NaN,11.855785481581789,14.487568141929469
1999-04-22T09:30:00-04:00,135.125,136.375,134.39062,136.15625,6897398,7426330.1,61.43059898596389,58.34057129881677,NaN,NaN,124.71849362914138,33.76356704078505,-0.02596054035663231,1.3664244845249414,1.3923850248815737,19710964,9607325.2,31.03168391314044,52.3480186986971,NaN,NaN,13.664222265355914,14.36994730241896
1999-04-23T09:30:00-04:00,135.875,136.75,135,135.8125,4593102,7324005.1,60.39388957148515,58.40237860645778,NaN,NaN,118.03193972844845,53.61333266260475,0.07514088050941403,1.4863111255183412,1.4111702450089272,15117862,10535104.8,32.61905947513037,51.051886792006826,NaN,NaN,14.773017751964229,14.427528795211142
1999-04-26T09:30:00-04:00,136.5,136.8125,135.46875,136.59375,3606500,7196345.15,61.964934023092674,58.640456723749764,NaN,NaN,118.7936447659265,80.32943386232338,0.17156246343001125,1.6256233242964413,1.45406086086643,18724362,14681624.2,39.338968929088765,50.389717056292895,NaN,NaN,16.161434380760774,14.675229593146804
1999-04-27T09:30:00-04:00,137.125,137.5,135.84375,137.25,5147199,7160510.2,63.2824735849237,58.818180338836264,NaN,NaN,121.96283858126768,110.14911825261933,0.25162800234923344,1.7685958638029717,1.5169678614537383,23871561,18047663,44.20362804193895,49.844201382759834,NaN,NaN,17.698108589006278,15.107069449698157
1999-04-28T09:30:00-04:00,136.4375,137.25,135,135.375,5544301,7167655.35,57.187177686741514,58.33068918142104,NaN,NaN,81.7625539905998,113.05389413907679,0.15513274925051346,1.71088379801688,1.5557510487663666,18327260,19150401.8,45.738845416181434,48.839964477813446,NaN,NaN,17.215731147864116,15.408306835150437
1999-04-29T09:30:00-04:00,135.5625,136.0625,133.8125,134.34375,9824301,7288190.3,54.1007103367638,57.618535502864056,NaN,NaN,38.93953301547541,95.8981020163436,0.006523627814693622,1.5639055835347335,1.55738195572004,8502959,16908800.8,43.14037277279763,47.278207399641055,NaN,NaN,15.887673448278287,15.476787779882986
1999-04-30T09:30:00-04:00,135.09375,135.625,131.5,133.25,10991898,7453605.1,50.95929593525335,56.4898035365482,NaN,NaN,-18.016831814159644,68.68834770782198,-0.17096259362685418,1.3436787136864723,1.5146413073133265,-2488939,13387440.6,39.357694342172934,45.10253916371579,NaN,NaN,13.828161167288894,15.241269692369544
1999-05-03T09:30:00-04:00,133.4375,135.84375,133.09375,135.6875,10709699,7699534.95,56.9576182648405,56.01266738284649,NaN,NaN,36.580615490532224,52.245741852743116,-0.13149851721034378,1.3502681608003968,1.4817666780107406,8220760,11286720.2,37.25881692339777,42.55945578056234,NaN,NaN,13.837431832625697,15.040721426691851
1999-05-04T09:30:00-04:00,135.125,135.8125,133.125,133.75,10509301,7955934.95,51.559261740298,55.677786955869784,NaN,NaN,3.624194055792534,28.5780129476481,-0.2370255367013081,1.1854847571341054,1.4225102938354135,-2288541,6054699.8,32.59638292754096,39.801468272340244,NaN,NaN,12.12770398940199,14.624576078507586
1999-05-05T09:30:00-04:00,133.9375,135.0625,131.84375,134.8125,10032301,8145119.9,54.1269330616522,55.63349842669566,NaN,NaN,-15.367412372608461,9.152019675006413,-0.23590504482947217,1.1276289877985732,1.3635340326280454,7743760,3937999.8,30.91110059087508,37.615009422599485,NaN,NaN,11.511687752164494,14.179877746172858
1999-05-06T09:30:00-04:00,134.4375,135.125,132.375,133.98437,13507199,8525024.75,51.82129465303717,55.66196480927282,NaN,NaN,-18.61975509893538,-2.359837947875745,-0.2881166114042286,1.0033882683727597,1.2915048797769884,-5763439,1084720.2,28.753071905120763,36.08197925582779,NaN,NaN,10.304792098991697,13.626294082289835
1999-05-07T09:30:00-04:00,134.5,135.125,133.4375,135,8680699,8740769.65,54.38745488672611,56.26159604340811,NaN,NaN,15.8957198121891,4.4226723773940035,-0.2526975305264567,0.9756329666189174,1.2283304971453741,2917260,2165960,30.726725090679707,35.5797082481348,NaN,NaN,10.055445133809556,13.116172803935509
1999-05-10T09:30:00-04:00,134.84375,135.71875,133.53125,134.32812,5580102,8609114.8,52.399102434626975,56.39750996727921,NaN,NaN,18.586428844796416,0.8238350482468448,-0.27132698134145894,0.8891717704685504,1.1604987518100094,-2662842,-10760.4,28.985893740878595,35.34184668464806,NaN,NaN,9.27034564839009,12.566768924571878
1999-05-11T09:30:00-04:00,135.3125,136.875,134.71875,135.6875,7000602,8455575,55.91112648741983,56.17727654663033,NaN,NaN,79.7527289726594,16.049542031620216,-0.19260774125144664,0.9197390752457011,1.1123468164971477,4337760,1314499.8,31.5293714187665,35.44225824912223,NaN,NaN,9.621201187714789,12.145973533592294
1999-05-12T09:30:00-04:00,135.75,137.21875,131.5,136.75,13865801,8571280.1,58.48909320578145,55.96716899090301,NaN,NaN,45.440268877457434,28.211078281633398,-0.07550601633398335,1.0179642960796684,1.0934703124136518,18203561,3406460,35.45903784067464,35.758497815374675,NaN,NaN,10.67629761667703,11.936019831175827
1999-05-13T09:30:00-04:00,137.25,138,136.8125,137.34375,4485699,8238065.05,59.90016859610609,55.93190320694737,NaN,NaN,141.30849792458784,60.19672888633804,0.029772004129465568,1.1306853175754839,1.1009133134460183,22689260,9096999.8,44.74830965634177,36.624872828318345,NaN,NaN,11.962716793032314,11.93983368286961
1999-05-14T09:30:00-04:00,134.5625,135.875,133.5,133.78125,8370102,8332760.2,49.112736722338475,55.01388911403636,NaN,NaN,-12.040730343583805,54.60943885518346,-0.14318971375386447,0.9219261712536877,1.0651158850075522,14319158,11377379.4,47.979476049073526,37.24205190831726,NaN,NaN,9.757446192406801,11.628064041374923
1999-05-17T09:30:00-04:00,133.625,134.48437,132.375,134.1875,6268102,8021805.35,50.21382457293573,54.08041418460864,NaN,NaN,-65.28480054980263,37.83519297626365,-0.22787705857804919,0.7802695617849906,1.0081466203630398,20587260,16027399.8,53.899842119501606,37.934638628143155,NaN,NaN,8.319264746897796,11.15537842787819
1999-05-18T09:30:00-04:00,134.53125,134.98437,132.625,133.9375,8218602,7980255.35,49.50394608971643,53.531611927678284,NaN,NaN,-75.84122213503103,6.716402754725562,-0.29415724994170545,0.640450057935908,0.9346073078776135,12368658,17633579.4,55.77221755343971,38.65130806651875,NaN,NaN,6.944979053992325,10.553892803037353
1999-05-19T09:30:00-04:00,134.46875,135,133.25,134.90625,5052398,7944265.3,52.31701601382921,53.40420519032581,NaN,NaN,-41.946716746642196,-10.760994370094366,-0.26697745531574857,0.6008854887329278,0.8678629440486764,17421056,17477078.4,55.535533409797964,39.53667668344735,NaN,NaN,6.580999202989338,9.986336574459065
1999-05-20T09:30:00-04:00,135.125,135.59375,130.0625,134.09375,4675398,7833165.3,49.810665712931154,53.32216017444566,NaN,NaN,-113.65321752765418,-61.75333746054277,-0.2957102798896316,0.49822509418663685,0.7939353740762685,12745658,15488358,52.48730955069698,40.47450634119906,NaN,NaN,5.557723300243174,9.353677535285366
1999-05-21T09:30:00-04:00,134.125,134.6875,132.59375,133.34375,6414602,7924240.3,47.54634211339966,52.64992616362845,NaN,NaN,-86.31422104909484,-76.60803560164497,-0.3533192412951497,0.3522863224573314,0.7056055637524811,6331056,13890737.6,50.107913263401244,41.392298936913605,NaN,NaN,4.048227360048745,8.595756081680134
1999-05-24T09:30:00-04:00,133.84375,133.84375,130.39062,131.125,7952000,8141515.3,41.5314840029255,51.93365632524471,NaN,NaN,-196.63567292881635,-102.87821007744772,-0.5189341566039357,0.0569378679975614,0.5758720246014971,-1620944,9449096.8,44.11967232661886,42.215391036847734,NaN,NaN,0.8497214714503212,7.489179708790161
1999-05-25T09:30:00-04:00,131.375,132.34375,128.4375,129,15406398,8654475.25,36.73792432527852,50.69158427264659,NaN,NaN,-277.5539149345319,-143.22074863734787,-0.7363976419747152,-0.34462502786689697,0.3917726141078183,-17027342,3569896.8,37.697714441460846,42.70014916903243,NaN,NaN,-3.5142288272156277,5.917264203646477
1999-05-26T09:30:00-04:00,129.3125,131,128.09375,130.4375,12575898,9006055.1,41.644683259647785,49.96468345883306,NaN,NaN,-232.35723176700833,-181.3028516414211,-0.7459301848077273,-0.5406401169018409,0.20529006790588644,-4451444,-804603.2,33.760095291227515,43.05779369661148,NaN,NaN,-5.673691580821681,4.261413377293883
1999-05-27T09:30:00-04:00,129.84375,130.28125,128,128.5625,14515398,9240609.95,37.55323773403155,48.76223937649774,NaN,NaN,-216.93325696068413,-201.9588595280271,-0.8343318151213974,-0.8376247009958604,-0.003292885874462942,-18966842,-7147103.2,29.02613475005478,42.936322957995415,NaN,NaN,-8.85377909024415,2.3878144533598786
1999-05-28T09:30:00-04:00,129,130.75,128.59375,130.20312,8748000,9128415.05,42.84458210600533,48.07977363873905,NaN,NaN,-141.14493423436983,-212.9250021650821,-0.7412726357367054,-0.9298836805453448,-0.1886110448086393,-10218842,-10457082.8,26.905745814019326,42.787740963219754,NaN,NaN,-9.832872548699497,0.6420020244942537
1999-06-01T09:30:00-04:00,130.125,130.15625,128.375,129.75,6705301,8928195.15,41.791330304538555,47.07121676853324,NaN,NaN,-130.05884685694994,-199.60963695070882,-0.6712837374302232,-1.0277157165964184,-0.3564319791661951,-16924143,-13517722.6,25.08123349002173,42.32715968259514,NaN,NaN,-10.941827416586762,-1.012830752803034
1999-06-02T09:30:00-04:00,129.75,130.1875,128.01562,129.875,6981898,8751825,42.213362119291794,45.908664548069694,NaN,NaN,-111.74044994926146,-166.44694395365474,-0.5809995188277247,-1.082681377700851,-0.5016818588731263,-9942245,-12100703.2,27.531423445555035,41.76090151151516,NaN,NaN,-11.71075425441867,-2.541105538748125
1999-06-03T09:30:00-04:00,130.6875,130.875,129.78125,130.59375,6076602,8554040.05,44.69629113134956,44.822673300587084,NaN,NaN,-69.01317553523864,-133.7781327073008,-0.44351148125686035,-1.0560712104442018,-0.6125597291873415,-3865643,-11983543,27.74184247445038,40.54615385566577,NaN,NaN,-11.646430284584678,-3.8418662167247755
1999-06-04T09:30:00-04:00,131.46875,133.35937,130.9375,133.21875,9787199,8368040.05,52.691222420133954,45.07827942185819,NaN,NaN,-3.7113850726006126,-91.1337583296841,-0.16098108053289284,-0.8137860798534575,-0.6528049993205647,5921556,-7005863.4,36.215690265804994,39.705883442575164,NaN,NaN,-9.091459276874826,-4.5918080824604965
1999-06-07T09:30:00-04:00,133.4375,134.1875,132.90625,133.5625,5299102,8198960.2,53.63644756284935,45.3227524925663,NaN,NaN,30.771775344811896,-56.750416413847745,0.052431215874241155,-0.5872659794777633,-0.6396971953520044,11220658,-2717963.4,42.47404278427274,38.88975491863025,NaN,NaN,-6.735359736394872,-4.898029747308264
1999-06-08T09:30:00-04:00,133.375,133.79687,131.59375,132.25,4895699,8164740.05,49.564470713018956,45.327075679945054,NaN,NaN,2.270160504077284,-30.284614941642303,0.10551669126630658,-0.5078013312691212,-0.6133180225354278,6324959,1931857,48.38793752075609,38.362306344867136,NaN,NaN,-5.906565790214212,-5.042106324866257
1999-06-09T09:30:00-04:00,132.40625,133.09375,131.8125,132.125,7409699,8185194.9,49.18152022492381,45.103111695023244,NaN,NaN,1.2952859460272317,-7.677467762584567,0.1308725748533821,-0.4497273039687002,-0.5805998788220823,-1084740,3703358,50.4767930457516,38.00096774743525,NaN,NaN,-5.341014175944115,-5.084807446448808
1999-06-10T09:30:00-04:00,131.4375,131.46875,129.59375,130.90625,7040699,7843939.8,45.49100512709528,44.79456451032068,NaN,NaN,-51.31086744816785,-4.137006145170409,0.06742003532085428,-0.4963248346710145,-0.5637448699918688,-8125439,2851398.8,49.440454335699236,37.78333523207827,NaN,NaN,-5.905889983318808,-5.202104951715951
1999-06-11T09:30:00-04:00,131.21875,131.73437,129.09375,129.8125,12824301,8260869.9,42.41496318660378,44.42803744412097,NaN,NaN,-59.66682292078411,-15.328093714807107,-0.04054607226628071,-0.6144274603247197,-0.573881388058439,-20949740,-2522860.4,43.38882463017169,37.30340032970473,NaN,NaN,-7.286357951478208,-5.4998553802534165
1999-06-14T09:30:00-04:00,130.6875,130.75,129.54687,129.9375,6823500,8183539.8,42.8902476600755,44.52509199106026,NaN,NaN,-58.26307814380686,-33.135064412530866,-0.09288246969557556,-0.6899844751779085,-0.5971020054823329,-14126240,-7592240,38.59048467657274,36.90845835470143,NaN,NaN,-8.288380748281329,-5.898216147114547
1999-06-15T09:30:00-04:00,130.46875,131.65625,130.07812,130.8125,5700898,8155179.6,46.23545235610628,45.2034868504051,NaN,NaN,-22.30946336451006,-38.05098918624834,-0.05953273628960676,-0.6715179258443413,-0.6119851895547346,-8425342,-10542300.2,36.08926458098312,36.79356907895302,NaN,NaN,-8.228894961407917,-6.231170263442171
1999-06-16T09:30:00-04:00,132.375,133.875,132.375,133.3125,7865801,8137539.55,54.44573492975977,46.11784768398452,NaN,NaN,81.86733458024307,-21.93657945940516,0.12961454662668448,-0.449967006271379,-0.5795815528980635,-559541,-10437260.4,36.247708351140126,36.97125572608964,NaN,NaN,-5.65781044501157,-6.149261717952085
1999-06-17T09:30:00-04:00,132.875,135.5625,132.625,134.5625,8162801,8293059.7,57.90693972921263,47.57168354078318,NaN,NaN,129.71888252757347,14.269370535743104,0.32642980461224697,-0.17154429713275476,-0.49797410174500173,7603260,-7291520.6,40.96773443086649,37.824227131861896,NaN,NaN,-2.384654660377724,-5.611460709727177
1999-06-18T09:30:00-04:00,134.0625,134.6875,133.375,134.3125,2875100,8203044.8,56.97455770034725,48.58096751180759,NaN,NaN,118.43742655380348,49.89022043066062,0.4212633244912701,0.02860505386908585,-0.3926582706221842,4728160,-2155940.6,47.76676379718276,39.314299844945005,NaN,NaN,0.0022758733854164642,-4.809498340711092
1999-06-21T09:30:00-04:00,134.46875,135.25,133.65625,134.625,4646398,8114634.6,57.88734707840556,49.730682995655236,NaN,NaN,128.50990257606946,87.24481657463589,0.4821426283908118,0.21002001486633048,-0.2721226135244813,9374558,2544219,53.091705953263315,41.31504787803368,NaN,NaN,2.238037856188445,-3.8027074554397293
1999-06-22T09:30:00-04:00,134,135.1875,133.5,133.6875,5862398,8010154.5,54.17418778283888,50.5850276859086,NaN,NaN,99.6387545907444,111.63446016568678,0.4376777134585786,0.2749745282987419,-0.16270318515983667,3512160,4931719.4,55.56949722748289,43.31776743388567,NaN,NaN,3.130505275134436,-2.8122484939291343
1999-06-23T09:30:00-04:00,133,133.625,132.125,133.03125,9629199,7721294.55,51.67541574718207,51.0835365870395,NaN,NaN,48.071411765958466,104.87527560282986,0.3464671692414373,0.2703807763919599,-0.07608639284947735,-6117039,3820219.8,54.135823364205265,45.203051783153875,NaN,NaN,3.1906723622445705,-1.9546883716186052
1999-06-24T09:30:00-04:00,132.875,132.9375,130.65625,132.03125,9176898,7551344.55,48.03923332611068,50.75125165175213,NaN,NaN,3.591988704023619,79.64989683811989,0.2080117869488517,0.18392834083658727,-0.02408344611226442,-15293937,-759219.6,48.57528379040799,46.085879892054095,NaN,NaN,2.2062361652570273,-1.3602705806363722
1999-06-25T09:30:00-04:00,132.59375,133.01562,131.25,131.70312,4087000,7029924.65,46.87370825978219,50.26819884439019,NaN,NaN,2.2746325248539434,56.41733803232999,0.08960538821191324,0.08792328915262715,-0.0016820990592861032,-19380937,-5581039,43.50790187845917,46.15972697021027,NaN,NaN,1.058288110698268,-1.014762196159995
1999-06-28T09:30:00-04:00,132.6875,133.625,132.5,133.3125,5028898,6843969.55,52.90853857916073,50.507060834828884,NaN,NaN,49.3461808914835,40.584593695412785,0.1134154960517025,0.14008727100534202,0.02667177495363952,-14352039,-10326358.4,39.17645836197955,45.501764173154804,NaN,NaN,1.7652881725702996,-0.6176121434842388
1999-06-29T09:30:00-04:00,133,135.1875,132.78125,134.5625,6956199,6856514.45,56.994683843205166,51.06514395042041,NaN,NaN,92.02966789724005,39.062776356711915,0.20192270094500048,0.2790751511348901,0.07715245018988964,-7395840,-12507958.4,37.33615885582575,44.56314744530295,NaN,NaN,3.607913425787115,-0.013965633588331139
1999-06-30T09:30:00-04:00,134.625,137.5,133.84375,137,16856096,7350224.35,63.62318839839471,52.36029989837037,NaN,NaN,171.92566260407062,63.83362652433434,0.40166435205191753,0.5792328902547865,0.177568538202869,9460256,-9392499.4,41.55816426361614,44.00012672586845,NaN,NaN,7.476058240772507,1.0560377770346456
1999-07-01T09:30:00-04:00,137,138.5,136.0625,138.03125,9939500,7543369.25,66.01015642040386,54.04567084364181,NaN,NaN,208.62781983088558,104.84079274970672,0.5699957476175149,0.8900632227247627,0.32006747510724776,19399756,-2453760.8,49.6885600894496,44.45010783010258,NaN,NaN,11.460563240567645,2.5423985575393595
1999-07-02T09:30:00-04:00,138.125,139.5,137.90625,139.40625,3772800,7242649.3,68.93693393798193,55.906148434920844,NaN,NaN,217.41993896895013,147.86985403852597,0.7304537799477798,1.2331347000419726,0.5026809200941927,23172556,6056937.8,57.49870923285879,45.80069529840873,NaN,NaN,15.796553161754542,4.435849215284385
1999-07-06T09:30:00-04:00,139.25,140.75,138.59375,139.375,11221102,7538749.3,68.79195323810686,57.517327069349456,NaN,NaN,193.08219991081967,176.6170578423932,0.786157023871749,1.485377199933879,0.6992201760621299,11951454,11317636.4,61.479317552179275,47.61427051063703,NaN,NaN,19.174755048668207,6.541407191482074
1999-07-07T09:30:00-04:00,139.0625,139.71875,138.51562,139.5625,3230700,7455499.35,69.21036007459912,58.5719431511237,NaN,NaN,155.01946966556292,189.21501819605777,0.7854502428479326,1.6810329796220458,0.8955827367741132,15182154,15833235.2,64.54860307588399,49.63576299097578,NaN,NaN,22.04727570239304,8.756531264469356
1999-07-08T09:30:00-04:00,139.0625,140.625,138.75,139.67187,7101500,7440089.4,69.46750391014359,59.39769773547591,NaN,NaN,141.40152735236083,183.11019114571582,0.7426475276019828,1.8238921462765916,1.0812446186746087,22283654,18397914.8,66.19605647102395,51.437785993844166,NaN,NaN,24.48372150685248,11.003272727666944
1999-07-09T09:30:00-04:00,140,140.59375,139.5625,140.5,2934700,7234789.45,71.41423647269225,60.42910336207198,NaN,NaN,130.65435746743807,167.51549867302634,0.7198806254887653,1.9810954005355654,1.2612147750468001,25218354,19561634.4,66.94663371998615,52.80777670261584,NaN,NaN,27.154761495124436,13.310628265875158
1999-07-12T09:30:00-04:00,140.9375,140.9375,139.5,139.875,4436301,6815389.45,67.89577410500564,61.143991006829125,NaN,NaN,110.5879602519714,146.14910292963057,0.6164891461325133,2.0318262077124416,1.4153370615799283,20782053,19083533.8,66.29535520179627,53.75089450608248,NaN,NaN,28.483096397030614,15.47812371318308
1999-07-13T09:30:00-04:00,139.375,139.92187,138.65625,139.375,6477602,6798094.55,65.13117784899475,61.92663315441168,NaN,NaN,82.1445014701463,123.96156324149588,0.47455580042234646,2.0085318121078615,1.533976011685515,14304451,19554133.2,66.63937932388518,54.541600370111205,NaN,NaN,28.86251532094682,17.39017965714933
1999-07-14T09:30:00-04:00,140,140.21875,138.75,140.15625,4382500,6732174.65,67.36706469357429,63.047465222011134,NaN,NaN,82.0517692130254,109.36802315098839,0.3965903131818853,2.0297139031628717,1.6331235899809864,18686951,20255092.6,67.17679009801344,55.47309799395465,NaN,NaN,29.805373408437504,19.16377876447621
1999-07-15T09:30:00-04:00,140.78125,141.375,140.3125,141.04687,3348600,6506314.6,69.74853947457335,64.59812994690132,NaN,NaN,98.53352765859495,100.79442321223522,0.3688815483859087,2.094225525463372,1.7253439770774635,22035551,20205472,67.09439292620871,56.79589150365471,NaN,NaN,31.299296052777976,20.89742409137646
1999-07-16T09:30:00-04:00,141.25,142.15625,140.75,141.8125,2281500,6212249.55,71.6630350291004,66.36879614470976,NaN,NaN,102.08037526529321,95.07962677180625,0.36530793735437994,2.1819788987704385,1.8166709614160585,24317051,20025211.4,66.77396988481354,58.45775350410859,NaN,NaN,33.13539176675296,22.64570518785882
1999-07-19T09:30:00-04:00,142.1875,142.25,140.5625,140.875,4287000,6282844.55,66.14315147177332,67.31412563703923,NaN,NaN,86.57889321897052,90.27781336520607,0.2675267192609734,2.1510793604922753,1.883552641231302,20030051,19874811,66.48865925760467,60.40862499665324,NaN,NaN,33.14949741126442,24.14624693405962
1999-07-20T09:30:00-04:00,140.125,140.40625,137.53125,137.98437,7060102,6403529.75,52.671611658578264,67.00533476670874,NaN,NaN,25.42710788599944,78.93433464837672,-0.009430090046417039,1.8717650286732805,1.8811951187196976,12969949,19607910.6,65.95012751383175,62.45247990079651,NaN,NaN,28.658717428158493,24.790885576073745
1999-07-21T09:30:00-04:00,138.09375,138.90625,137.3125,137.82812,4793699,6350094.8,52.05444510731663,66.17899596020317,NaN,NaN,6.769230141467704,63.877826834065175,-0.20964891845290667,1.6191339706535643,1.828782889106471,8176250,17505770.4,61.71057095768009,63.89193752180108,NaN,NaN,24.922463904717237,24.809682480165673
1999-07-22T09:30:00-04:00,137.4375,138,135.46875,136.01562,7804102,6258839.95,45.40784784457582,64.70740249050117,NaN,NaN,-39.4905952117202,36.27300226000214,-0.4564942386666704,1.258165090773133,1.7146593294398034,372148,13173089.8,54.00478850990595,64.20023955183368,NaN,NaN,19.38745923519048,24.03507915945493
1999-07-23T09:30:00-04:00,136.65625,137,135.125,135.75,4603000,6030145.05,44.51088346235513,62.96268459938496,NaN,NaN,-66.98319885898829,2.4602874351458413,-0.6198653905463565,0.9398275912568579,1.5596929818032144,-4230852,7463509.2,45.87521903505863,63.369990251990814,NaN,NaN,14.694485171316943,22.700708589720932
1999-07-26T09:30:00-04:00,134.875,136.125,134.625,134.75,4333398,6042464.95,41.210417876532006,60.99257493070104,NaN,NaN,-105.6272123930922,-35.9809336872667,-0.7678059824815402,0.599935503701289,1.3677414861828292,-8564250,1744649,39.46672071186764,61.79766190625427,NaN,NaN,9.667029701423399,20.838754462821285
1999-07-27T09:30:00-04:00,136,137.20312,135.375,135.875,5908500,6086445.05,46.056444217968725,59.33872379808459,NaN,NaN,-85.20052768807984,-58.106460802082566,-0.7609571873358558,0.4165450020130095,1.1775021893488653,-2655750,-1380490.8,36.46864622192812,59.79195070240028,NaN,NaN,6.873898134367272,18.843774987327855
1999-07-28T09:30:00-04:00,136.25,137.3125,135.59375,136.3125,3955500,5936410.1,47.85653938636477,57.79508347495753,NaN,NaN,-86.2947104187523,-76.71924891412657,-0.6995886968141756,0.30301631833114584,1.0026050151453214,1299750,-2755790.8,35.2013352620049,57.578042044613206,NaN,NaN,5.132415152842955,16.885009296687155
1999-07-29T09:30:00-04:00,134.9375,135.25,133.3125,134.40625,7760602,5481635.4,41.377551518891245,55.649605978257455,NaN,NaN,-156.39948162431563,-100.10102619664565,-0.7552435005529567,0.05855063945412553,0.8137941400070823,-6460852,-4122390.8,33.939233885630145,55.220370627873486,NaN,NaN,1.4675131592433646,14.6825098484809
1999-07-30T09:30:00-04:00,134.8125,135.34375,132.5625,132.75,5994301,5284375.45,36.725311791364454,53.42314438442594,NaN,NaN,-156.79132411728986,-118.06265124830597,-0.8636529525768362,-0.2657720507139629,0.5978809018628732,-12455153,-5767251,32.43199852719104,52.80155943683026,NaN,NaN,-3.263963889146089,12.118727885962759
1999-08-02T09:30:00-04:00,132.75,134.75,132.5,133.0625,6065500,5399010.45,38.13858447461571,51.49510200054171,NaN,NaN,-135.3730664271869,-124.01182205512491,-0.871835528086212,-0.4919135082448918,0.37992201984132024,-6389653,-5332331.6,33.27577430319094,50.41844479249496,NaN,NaN,-6.578299789199211,9.447723932368191
1999-08-03T09:30:00-04:00,133.71875,133.84375,131.375,132.4375,5445398,5110225.25,36.38805482786412,49.28231558156242,NaN,NaN,-137.3293903853948,-134.4375945945879,-0.8746108652907111,-0.7133415617720686,0.16126930351864244,-11835051,-7168191.8,31.48825755956028,47.86926389689116,NaN,NaN,-9.850525332782208,6.690831180203849
1999-08-04T09:30:00-04:00,132.71875,133.875,130.4375,130.625,6497898,5273585.15,31.82591602912754,46.57355676403058,NaN,NaN,-139.22233921459758,-145.02312035375695,-0.9476416232248925,-1.0232827255124732,-0.07564110228758072,-18332949,-11094731.6,28.021180768223857,45.07832017132081,NaN,NaN,-14.242805866725819,3.70031160207104
1999-08-05T09:30:00-04:00,130.875,131.9375,128.84375,131.8125,10322000,5434610.15,37.36651265764999,44.12380516606983,NaN,NaN,-139.66227591911252,-141.67567921271632,-0.867265866389729,-1.159723435274742,-0.292457568885013,-8010949,-11404751,27.76127388965878,42.29169902880976,NaN,NaN,-16.157932323699796,0.8634196126752061
1999-08-06T09:30:00-04:00,131.21875,132,129.5,130.375,7537699,5664760.1,33.78683700895206,41.812639847296886,NaN,NaN,-130.95579805467077,-136.50857400019248,-0.8604960012451894,-1.3680775704414998,-0.5075815691963104,-15548648,-12023450,27.21868155719858,39.486700621637894,NaN,NaN,-18.95864337682412,-1.9683036715389832
1999-08-09T09:30:00-04:00,130.59375,131.79687,129.75,130.09375,5565898,5721239.95,33.118340660019086,40.41597763311408,NaN,NaN,-118.01826741747284,-133.03761419824968,-0.8244653523103305,-1.5381632595842234,-0.7136979072738929,-21114546,-14968428.6,24.739996711168715,36.5431198500191,NaN,NaN,-21.393942309499018,-4.743394905533274
1999-08-10T09:30:00-04:00,129.875,130.15625,127,128.65625,9793301,5887024.9,29.865780234346616,38.83107299933051,NaN,NaN,-140.42252409949333,-133.6562409410694,-0.8438934476053108,-1.7685647167805314,-0.9246712691752206,-30907847,-18782987.8,21.951527392552393,33.7031881667957,NaN,NaN,-24.532445694434713,-7.570402161090622
1999-08-11T09:30:00-04:00,129.6875,130.53125,128.625,130.21875,8003398,6068069.8,37.097200989721735,38.23745536684093,NaN,NaN,-103.86971984466946,-126.58571706708378,-0.7036871611882249,-1.8042802206605018,-1.1005930594722768,-22904449,-19697287.8,21.330936775446986,31.369341614334342,NaN,NaN,-24.887102702159964,-10.044216524100527
1999-08-12T09:30:00-04:00,130.6875,131.8125,129.90625,130.14062,7036801,6252479.85,36.892362009656814,37.693275263076764,NaN,NaN,-79.71873555724602,-114.59700899471048,-0.573872310567308,-1.817933447681412,-1.244061137114104,-29941250,-24083348,18.61251918738509,29.42200591092909,NaN,NaN,-25.228419692270794,-12.213388405267708
1999-08-13T09:30:00-04:00,131.625,133.25,131.125,133.15625,5857699,6431289.8,48.672855409938606,38.22630651546295,NaN,NaN,-32.43310112459205,-94.89246960869474,-0.25863121287554636,-1.5673501532085368,-1.3087189403329904,-24083551,-25790328.6,17.66878103594736,27.86501021979193,NaN,NaN,-21.512135867946846,-13.541780899936155
1999-08-16T09:30:00-04:00,133.125,133.96875,132.25,133.75,3927000,6413289.8,50.6271065976581,38.552782399726475,NaN,NaN,-3.921034574027902,-72.07302304000575,0.0023367541277561354,-1.3057979976732952,-1.3081347518010513,-20156551,-25598729.6,18.170322139551132,26.557987071050714,NaN,NaN,-17.907270301053646,-14.165422242952939
1999-08-17T09:30:00-04:00,134.4375,134.84375,133.125,134.625,4808000,6300684.7,53.440501447992425,38.95163683269988,NaN,NaN,29.87183496806206,-38.014151226494675,0.23355039421476453,-1.0161967590325958,-1.2497471532473603,-15348551,-22486870.4,26.049722659147122,25.904300456560872,NaN,NaN,-14.034512902576104,-14.146720908613391
1999-08-18T09:30:00-04:00,134.20312,134.375,133.25,133.65625,4355500,6278774.75,50.04069797083863,39.570433007838986,NaN,NaN,25.116547071452274,-12.216897843270337,0.3157978712973244,-0.8549998141257049,-1.1707976854230293,-19704051,-21846790.8,27.594105575144155,25.451077005811875,NaN,NaN,-11.862429889584778,-13.820393620180733
1999-08-19T09:30:00-04:00,132.375,133.23437,131.6875,132.5625,6448102,6210974.75,46.44784156631181,40.26489942033522,NaN,NaN,-12.280749972097055,1.270699273759456,0.2916677195014503,-0.8062130360462163,-1.0978807555476666,-26152153,-21088971.4,29.47209263753622,25.239655156550818,NaN,NaN,-11.148475243204798,-13.438690994898456
1999-08-20T09:30:00-04:00,133.0625,134.125,132.6875,133.90625,3663700,6164009.75,51.09370421660521,41.19026511619162,NaN,NaN,34.314038924173225,14.620127283512506,0.3570178590565345,-0.6516084317269986,-1.008626290783533,-22488453,-20769951.8,30.291762759023342,25.026511474824563,NaN,NaN,-9.061598025818407,-12.813391999315591
1999-08-23T09:30:00-04:00,134.8125,136.54687,134.65625,136.46875,5637801,6229229.9,58.48939188899152,42.7689320491293,NaN,NaN,122.12616455756508,39.8295671098311,0.5519908112673031,-0.3186377766994042,-0.8706285879667073,-16850652,-20108772,32.0542552039698,25.066939877996674,NaN,NaN,-4.648923313698145,-11.64703932994167
1999-08-24T09:30:00-04:00,136.0625,137.96875,135.375,136.96875,9279500,6397779.9,59.76782530575997,44.764782711745895,NaN,NaN,152.33273593016855,64.3217473022524,0.6851059965680186,-0.014246092256684051,-0.6993520888247027,-7571152,-18553292.2,36.144691673911254,25.647190656974345,NaN,NaN,-0.7365758313766319,-10.088401687289522
1999-08-25T09:30:00-04:00,137.1875,138.78125,136.15625,138.375,6005301,6500269.95,63.20053978070893,46.61007036339296,NaN,NaN,180.79678555794578,95.45779499955111,0.8287450766635681,0.33657925700475744,-0.4921658196588107,-1565851,-14925652.2,44.531526539135484,26.845065846222685,NaN,NaN,3.6924358642884116,-8.119710608492674
1999-08-26T09:30:00-04:00,138.28125,138.42187,136.5,136.71875,4322301,6328354.9,57.02881489024877,48.27021164062843,NaN,NaN,143.62577557056198,126.6391001080829,0.7741200590946751,0.4754842542095332,-0.29863580488514185,-5888152,-10872852,52.10066221912011,28.622350179217076,NaN,NaN,5.448666105497142,-6.181371077922701
1999-08-27T09:30:00-04:00,136.875,137.0625,135.0625,135.0625,6247398,6341009.75,51.60209066566139,49.59047949817432,NaN,NaN,84.77760611299898,136.73181354584807,0.5963261036050349,0.44677182462115184,-0.1495542789838831,-12135550,-8802271.4,55.44577382168844,30.81561997282563,NaN,NaN,5.129856255879207,-4.565481458808143
1999-08-30T09:30:00-04:00,135.34375,135.5,132,132.5625,4652000,6270334.75,44.68940541815886,50.649309868446615,NaN,NaN,8.460420578780038,113.99866475009105,0.2954471952822344,0.21975471511890987,-0.07569248016332451,-16787550,-8789651,55.466188222359634,33.20952431781186,NaN,NaN,2.4369043116597435,-3.5651406344555876
1999-08-31T09:30:00-04:00,132.9375,133.75,130.875,132.0625,11453699,6570749.8,43.436133458030085,51.102090759040074,NaN,NaN,-27.101815430052973,78.11175447804675,0.06015553634294849,-0.0004980597346389004,-0.06065359607758739,-28241249,-12923670.4,47.748434129566355,35.096488414534676,NaN,NaN,-0.08672552843349718,-3.068224190738146
1999-09-01T09:30:00-04:00,132.9375,133.73437,132.3125,133.6875,6863898,6589049.8,48.491871480470174,51.93062714981245,NaN,NaN,2.9517232550368204,42.54274201746496,0.013782501220715768,-0.043425469551692686,-0.057207970772408454,-21377351,-16885970.4,41.75192321770407,36.74930298812888,NaN,NaN,-0.5542297208650698,-2.709082123613421
1999-09-02T09:30:00-04:00,132.125,132.67187,130.65625,132.10937,10896301,6617764.85,44.34636504033685,51.62159212341233,NaN,NaN,-47.31534293888418,4.35451831557573,-0.11619673593846881,-0.20245389069549447,-0.08625715475702565,-32273652,-22163070.4,35.37926093475309,38.01433726661501,NaN,NaN,-2.3182367617912725,-2.6532470719245427
1999-09-03T09:30:00-04:00,134.875,136.5,134.6875,135.96875,9160801,6698919.95,54.57394955743042,51.90350947768178,NaN,NaN,77.27844422194094,2.854685937364131,0.05550902662981015,-0.01687087146976296,-0.07237989809957311,-23112851,-24358530.6,33.114718740319844,39.081794166669916,NaN,NaN,-0.23289697668610565,-2.307482772604766
1999-09-07T09:30:00-04:00,136.0625,136.625,135.21875,135.46875,4560801,6648665.1,53.20965811131188,51.88702066791888,NaN,NaN,70.6849273964618,15.29958730090048,0.1289720390199619,0.08883515067537928,-0.04013688834458263,-27673652,-26535751,30.995883486269662,39.43509136860724,NaN,NaN,0.9075758320794238,-1.8481886862213106
1999-09-08T09:30:00-04:00,134.84375,136.0625,134.03125,134.8125,6159602,6466980.15,51.393660318803164,51.98366083563064,NaN,NaN,35.092901000923945,27.73853058709587,0.12674188303869185,0.11829046545378219,-0.008451417584909665,-33833254,-27654152,29.9362554730114,39.60238778988347,NaN,NaN,1.2275925038782889,-1.4087913733499393
1999-09-09T09:30:00-04:00,134.75,135.25,133.6875,134.75,6177801,6375700.3,51.21438841811058,52.32412846790197,NaN,NaN,12.011347018103875,29.55045533970928,0.11478849150729638,0.1350341967992108,0.02024570529191443,-40011055,-31380892.8,26.665047891016997,39.40188459370353,NaN,NaN,1.4256869957466263,-1.00386589205043
1999-09-10T09:30:00-04:00,136.25,136.35937,134.9375,135.875,2934500,6170585.25,54.304227655076474,52.55345157064992,NaN,NaN,53.70137251313257,49.753798430112624,0.17288923043157517,0.23635724333138342,0.06346801289980823,-37076555,-32341473.4,25.880056042671796,39.08676268539269,NaN,NaN,2.5202955535520175,-0.500414256964366
1999-09-13T09:30:00-04:00,135.125,135.46875,134.5,134.95312,2320500,5993725.3,51.42971138376574,52.0491886774195,NaN,NaN,15.239465872415861,37.34600276020761,0.14083165516695675,0.23950758185850418,0.09867592669154743,-39397055,-35598314.2,23.368196365133343,38.466329911190094,NaN,NaN,2.5914536369921146,-0.05871884354201168
1999-09-14T09:30:00-04:00,134.0625,134.5625,133.375,134.0625,3736000,5984175.3,48.7451972436414,51.26185810155389,NaN,NaN,-33.60037441181004,16.48894239855324,0.05561906263504365,0.168199754985352,0.11258069235030835,-43133055,-38690194.8,21.2587046335248,37.40304512259106,NaN,NaN,1.8654757825803625,0.21616610304689887
1999-09-15T09:30:00-04:00,135.4375,135.4375,131.875,131.9375,6984500,6093000.3,42.980526417313605,49.81757143273994,NaN,NaN,-72.67836559140565,-5.065310919912678,-0.13734509498609832,-0.05910067638231453,0.07824441860378377,-50117555,-41947055,19.28396412550839,35.59964780733198,NaN,NaN,-0.5673477399109456,0.1042355540529211
1999-09-16T09:30:00-04:00,132.5,132.8125,130.3125,132.45312,15377602,6644105.4,44.689768820891786,48.93621099921444,NaN,NaN,-117.57310383240612,-30.982201090014676,-0.2188991094260895,-0.19537946817882812,0.023519641247261386,-34739953,-40892834.6,21.81565130330955,33.436432741916946,NaN,NaN,-2.0558627765184565,-0.20434992174298994
1999-09-17T09:30:00-04:00,132.625,133.9375,132.15625,133.75,8542301,6748815.35,48.843478889628365,48.73916730092636,NaN,NaN,-58.4832150499793,-53.41911860263705,-0.17599110491142905,-0.19646923989202492,-0.020478134980595877,-26197652,-38717054,26.91096374997204,31.398232022508633,NaN,NaN,-2.1004464595399264,-0.4752208557139808
1999-09-20T09:30:00-04:00,133.9375,134,133.09375,133.5625,2803900,6705825.35,48.278964759266714,48.995564396719786,NaN,NaN,-46.1755074609419,-65.70211326930861,-0.1516505711349825,-0.21004134889932402,-0.05839077776434151,-29001552,-36637953.4,31.50460880680903,29.68669063568359,NaN,NaN,-2.2973735518979916,-0.7355283837402681
1999-09-21T09:30:00-04:00,132.25,132.46875,130.15625,130.75,9335199,6890695.25,40.68338024549523,48.79893916725301,NaN,NaN,-135.27441038201044,-86.03692046334868,-0.3073994645009432,-0.4426401083905205,-0.1352406438895773,-38336751,-35678692.6,33.578841721194365,28.674576892228448,NaN,NaN,-4.85743343680368,-1.3243719627493267
1999-09-22T09:30:00-04:00,131.25,131.84375,129.75,130.60156,13009102,7077175.35,40.322804031443795,48.215434349465404,NaN,NaN,-136.66664305126477,-98.8345759553205,-0.39714559650448994,-0.6316726395201897,-0.23452704301569977,-51345853,-35924352.2,33.300722151380654,28.070919673205346,NaN,NaN,-7.0154034563470375,-2.1373764618347137
1999-09-23T09:30:00-04:00,131.8125,131.8125,127.625,127.875,12204199,7387120.25,34.30796746877779,47.498405951496906,NaN,NaN,-184.59405850453297,-112.23876688974588,-0.6044422561268473,-0.9900798631742589,-0.38563760704741157,-63550052,-41686372,27.53913844070837,27.510910923630725,NaN,NaN,-10.939146538137706,-3.3947721870208554
1999-09-24T09:30:00-04:00,127.75,128.375,126.3125,127.75,13792898,7860650.1,34.05714812837074,46.032920135135505,NaN,NaN,-214.73925747535995,-143.489975374822,-0.7071473480403504,-1.2695717920978495,-0.5624244440574991,-77342950,-51915431.6,20.69404643478228,26.62372004466376,NaN,NaN,-14.131639715435822,-4.92861040536585
1999-09-27T09:30:00-04:00,128.75,129.75,128.28125,128.59375,6970301,7896795.25,37.384773623662525,44.90257124316055,NaN,NaN,-137.0144254592967,-161.65775897449296,-0.6754774072883145,-1.4067712031678923,-0.7312937958795778,-70372649,-60189651,17.01080760698727,25.624786053286442,NaN,NaN,-15.834365754795304,-6.486575455284344
1999-09-28T09:30:00-04:00,127.9375,128.8125,125.5625,128.34375,11063398,8217365.15,36.79234626307146,43.85962023917972,NaN,NaN,-151.82639848079572,-164.96815659425002,-0.6295050101191823,-1.5181750585285556,-0.8886700484093734,-81436047,-68809510.2,14.179412263517719,24.499297252608326,NaN,NaN,-17.3992156151918,-8.045524049556837
1999-09-29T09:30:00-04:00,128.4375,129.125,126.75,126.8125,7580301,8023695.25,33.31048048094145,42.580769672239065,NaN,NaN,-129.5169848204264,-163.53822494808236,-0.657309671890363,-1.7103071382723272,-1.0529974663819641,-89016348,-76343609.2,12.258801235318117,23.47027963434412,NaN,NaN,-19.810486477200204,-9.726232967791603
1999-09-30T09:30:00-04:00,127.4375,129.4375,126.96875,128.75,7498898,8055445.25,40.92804558930949,41.62532809611285,NaN,NaN,-94.44980430880946,-145.50937410893764,-0.5070331355212967,-1.686788885783585,-1.1797557502622884,-81517450,-79937088.8,11.461381977642134,22.44037434398486,NaN,NaN,-19.6349947485058,-11.141770365036487
1999-10-01T09:30:00-04:00,127.9375,128.5625,126.625,128.46875,11127102,8066985.3,40.21003874954314,40.82392290795409,NaN,NaN,-94.89902311553452,-121.54132723697255,-0.3934563090380263,-1.6715761365598212,-1.2781198275217949,-92644552,-82997409.2,10.81610522815275,21.543796405629102,NaN,NaN,-19.701225426845028,-12.364549659580565
1999-10-04T09:30:00-04:00,129.1875,130.875,128.75,130.75,6341602,7926025.35,48.15480495493102,40.78175203018906,NaN,NaN,-35.42106965184279,-101.2226560754818,-0.1444065045916294,-1.4586279582613315,-1.314221453669702,-86302950,-86183469.4,10.1739077590926,20.752025200312517,NaN,NaN,-17.26785389555504,-13.065021693291204
1999-10-05T09:30:00-04:00,130.71875,131.96875,128.6875,130.625,11976000,8296785.3,47.780157966939036,41.12458285516231,NaN,NaN,-22.6513720692037,-75.38765079316339,0.023267413683117466,-1.2851371865658052,-1.3084046002489227,-98278950,-89552050,9.52966024391435,20.055289208770084,NaN,NaN,-15.428164348814905,-13.402613501223161
1999-10-06T09:30:00-04:00,130.75,132.8125,130.6875,132.625,10308199,8504215.15,53.953043376187125,41.78624532339769,NaN,NaN,26.753380009730247,-44.133577827132065,0.26670626362462335,-0.9750217707181434,-1.2417280343427668,-87970751,-89342930.6,9.911049581957386,19.204960514387786,NaN,NaN,-11.848170067854632,-13.180550153599086
1999-10-07T09:30:00-04:00,132.85937,133,131.5,131.875,6535602,8522105.2,51.49476158598006,41.97562265885138,NaN,NaN,34.52147618172422,-18.33932172902533,0.3687651851241722,-0.7807715529375514,-1.1495367380617236,-94506353,-91940711.2,9.381937486148772,17.952887209828983,NaN,NaN,-9.61815384341768,-12.671636395001743
1999-10-08T09:30:00-04:00,131.75,133.875,131.23437,133.875,9674301,8859095.25,57.107222186392256,42.606212475074635,NaN,NaN,69.63883876327274,14.568250646736137,0.5515178941994212,-0.4601393703124472,-1.0116572645118684,-84832052,-90378211.2,12.410808633325857,16.589044340294468,NaN,NaN,-5.8519332608996715,-11.697393090130019
1999-10-11T09:30:00-04:00,133.59375,134.125,133.3125,133.65625,4282000,8957170.25,56.33936690886752,43.724497236744085,NaN,NaN,97.69685537586659,41.191835652278016,0.632415244597485,-0.22113820876501222,-0.8535534533624972,-89114052,-90940431.6,12.252119024316087,15.065707004803164,NaN,NaN,-3.0608119821087914,-10.46359578898413
1999-10-12T09:30:00-04:00,133.125,133.3125,131.1875,131.59375,8686102,9204675.35,49.571511412550315,44.38511919253741,NaN,NaN,47.172190276552136,55.15654812142917,0.5261256367277978,-0.19589640745275005,-0.7220220441805478,-97800154,-90844672.4,12.457436663897283,13.576900898554351,NaN,NaN,-2.680518315382992,-9.351727578469681
1999-10-13T09:30:00-04:00,130.6875,131.3125,128.1875,128.1875,10469301,9378915.4,40.84492384063991,44.85204464767042,NaN,NaN,-46.20756132296041,40.56435985489104,0.22112861420431484,-0.4456112764251543,-0.6667398906294691,-108269455,-94904413.2,11.255061546871332,12.413752548994564,NaN,NaN,-5.35390841584582,-8.7806105552377
1999-10-14T09:30:00-04:00,128.48437,129.1875,126.75,128.15625,10562199,9138145.25,40.7740062681212,45.331820229081174,NaN,NaN,-80.57107478779473,17.545849660987255,0.022454700225657542,-0.6386715153473972,-0.6611262155730547,-118831654,-99769473.4,10.008394950575621,11.650491728694087,NaN,NaN,-7.432293854616318,-8.58799388372036
1999-10-15T09:30:00-04:00,126,126.75,124.5,124.875,14238699,9422965.15,34.08253467644225,45.095946018565435,NaN,NaN,-153.9143725602404,-27.164792603715377,-0.3066217204855157,-1.0444033661799494,-0.7377816456944337,-133070353,-109417133.6,8.093812578684933,11.013563512386778,NaN,NaN,-11.662012989130004,-9.027139470207452
1999-10-18T09:30:00-04:00,124.9375,125.9375,123.4375,125.78125,9758801,9770710.2,37.150385605551776,45.12152025731403,NaN,NaN,-149.01282839630113,-76.50672935814892,-0.4322458561929403,-1.2780889659356092,-0.8458431097426689,-123311552,-116256633.6,7.062365709236644,10.505203044223846,NaN,NaN,-14.01644553945331,-9.739897480099717
1999-10-19T09:30:00-04:00,127.1875,128.25,125.9375,127,14392898,10023595.15,41.11918252450301,45.679284688996994,NaN,NaN,-74.75937095929596,-100.89304160531853,-0.40283642072429715,-1.3493886356480402,-0.9465522149237431,-108918654,-118480333.6,6.760702684457257,10.112481719162355,NaN,NaN,-14.656468538456801,-10.442264774150729
1999-10-20T09:30:00-04:00,127.75,129.46875,127.125,128.25,9759398,9861109.95,44.95827326286327,45.96715809425084,NaN,NaN,-30.535652066704476,-97.75865975406735,-0.2748841898633816,-1.29015745225297,-1.0152732623895884,-99159256,-116658293.8,10.147343565003055,10.018621832545277,NaN,NaN,-13.95221055118585,-10.94368559944146
1999-10-21T09:30:00-04:00,127.21875,129,126.625,129,9105398,9706169.9,47.1834303254622,46.465257492530775,NaN,NaN,-30.932105024320254,-87.83086580137247,-0.12315702655131089,-1.169219545578727,-1.0460625190274162,-90053858,-110902734.6,20.028742418038647,10.676667346108555,NaN,NaN,-12.686108388458944,-11.192603140729672
1999-10-22T09:30:00-04:00,129.75,131.21875,129.5625,130.09375,8309602,9432005.1,50.33659463741243,46.621099612708015,NaN,NaN,34.939252235103744,-50.06014084230362,0.0577360369190163,-0.9738924728786458,-1.031628509797662,-81744256,-100637515.2,33.97509624140561,12.376752237702338,NaN,NaN,-10.655065411725447,-11.115812036586211
1999-10-25T09:30:00-04:00,129.3125,130.46875,128.75,129.4375,8114301,9489205.1,48.466954280100985,46.67015649221958,NaN,NaN,8.68191856912611,-18.52119144921817,0.13561450448458368,-0.8621103791919325,-0.9977248836765161,-89858557,-93946916.2,41.1756417593007,14.637179488801362,NaN,NaN,-9.531559752330262,-10.889490281692504
1999-10-26T09:30:00-04:00,130.1875,130.6875,127.8125,127.8125,6256301,9248850.25,44.09905827089358,45.96630041327005,NaN,NaN,-20.466197901159262,-7.662556837590827,0.0827104463924836,-0.8943368256859117,-0.9770472720783953,-96114858,-91386157,43.70614577700394,17.051114931304685,NaN,NaN,-9.874917039151324,-10.744551247043765
1999-10-27T09:30:00-04:00,128.375,130.3125,128.25,130.125,5433301,9141500.25,50.88285375590543,45.92259271112186,NaN,NaN,3.8645999007743415,-0.7825064440950668,0.20170129048584695,-0.7249206589710866,-0.9266219494569335,-90681557,-89690617.2,45.38152577998941,19.622514095150446,NaN,NaN,-8.01848396553519,-10.35511306397111
1999-10-28T09:30:00-04:00,132.4375,134.85937,132.1875,134.5625,10509699,9292040.3,60.73082383699262,46.18142140045045,NaN,NaN,137.77854952748808,32.9596244662666,0.5573476500125168,-0.2299373869412875,-0.7872850369538044,-80171858,-87714217.2,47.34856969960851,22.11806845702778,NaN,NaN,-2.7156838587223864,-9.263766034649864
1999-10-29T09:30:00-04:00,135.84375,137.6875,135.71875,137,10988602,9285115.3,64.8945236130261,46.79250402217606,NaN,NaN,194.64912128267676,64.9015982757812,0.9137758963198963,0.354934833446066,-0.5588410628738303,-69183256,-85202017.2,49.82228341279987,24.80165162763376,NaN,NaN,3.18732685716126,-7.485038478676846
1999-11-01T09:30:00-05:00,136.5,137,135.5625,135.5625,4006500,9168360.2,60.80021438779099,47.594554234693256,NaN,NaN,143.76951097279286,91.91911675651455,1.0026335290735506,0.694450848468108,-0.3081826806054426,-73189756,-81868257,52.97941116708283,27.6960783778613,NaN,NaN,6.459567301209844,-5.492951938693033
1999-11-02T09:30:00-05:00,135.96875,137.25,134.59375,134.59375,6516898,8895405.1,58.138127790131904,48.829783088228396,NaN,NaN,110.9814330559037,118.20864294792713,0.9467543463065695,0.8752602522777693,-0.07149409402880025,-79706654,-78586616.2,55.919555150736294,30.88639934956594,NaN,NaN,8.166535181749227,-3.5415966357727102
1999-11-03T09:30:00-05:00,136,136.375,135.125,135.5,7221301,8741060.2,59.90664954274436,50.1964004649872,NaN,NaN,103.87545026096562,138.2108130199654,0.9205864856801156,1.0792390130713443,0.15865252739122868,-72485353,-74947375.4,58.982598302506005,34.38455673184668,NaN,NaN,10.106304297811436,-1.5918965024035465
1999-11-04T09:30:00-05:00,136.75,137.35937,135.76562,136.53125,7910000,8809780.1,61.88017737203675,52.18194637181538,NaN,NaN,109.62864553752327,132.58083222197246,0.9202918738226208,1.3090173696695047,0.3887254958468839,-64575353,-71828074.4,61.45493226443402,38.196065280828755,NaN,NaN,12.31351005216895,0.394590148249667
1999-11-05T09:30:00-05:00,138.625,139.10937,136.78125,137.875,7431500,8697640.05,64.34311547912046,54.124284219927425,NaN,NaN,122.28738054174174,118.10848407378543,0.9540750456924234,1.581319302962413,0.6272442572699897,-57143853,-69420193.8,63.29416401315064,42.2126223025369,NaN,NaN,14.92721261401594,2.4706790719305625
1999-11-08T09:30:00-05:00,137,138.375,136.75,138,4649199,8716000,64.57242404804843,55.79951575732353,NaN,NaN,107.8880150540954,110.93218489004596,0.9274942347162236,1.7866120506652692,0.8591178159490456,-52494654,-65281173.4,66.27329033399185,46.4635214203608,NaN,NaN,17.089761864825725,4.559119470915586
1999-11-09T09:30:00-05:00,138.5,138.6875,136.28125,136.70312,4533699,8508379.85,60.243671275671524,56.891329901095546,NaN,NaN,88.15880055711031,106.36765839028729,0.7716168519681355,1.8236388809092148,1.0520220289410793,-57028353,-60745513.2,69.22131731793067,50.68309097414135,NaN,NaN,17.681806447563055,6.433789039008081
1999-11-10T09:30:00-05:00,136.25,138.39062,136.07812,137.71875,6405602,8305194.9,62.37111209185899,57.976164312981034,NaN,NaN,81.34078209939149,101.86072475797245,0.6886905477703995,1.9128852136540786,1.224194665883679,-50622751,-56372992.8,71.78202141715136,54.37975375979225,NaN,NaN,18.79745898190815,8.200027602279519
1999-11-11T09:30:00-05:00,138.1875,138.5,137.46875,138.5,4794102,8016790.05,63.9683674271969,58.94986236939421,NaN,NaN,84.660957914758,96.8671872334194,0.6393084510943088,2.023330229751565,1.3840217786572562,-45828649,-52623652,73.79526747122014,57.22405170477901,NaN,NaN,20.191580700126526,9.913106616257663
1999-11-12T09:30:00-05:00,139.25,139.98437,137.125,139.75,11802898,7895000,66.42412224762586,60.23251722421742,NaN,NaN,90.64267077007794,90.53824527908662,0.6419973215769919,2.186518430628496,1.544521109051504,-34025751,-48000031.6,76.0632899420307,59.71602657497401,NaN,NaN,22.103370252157728,11.654572849957672
1999-11-15T09:30:00-05:00,139.84375,140.25,139.40625,140.07812,2187500,7516434.95,67.05879222755692,61.872498221121944,NaN,NaN,101.34233903142022,89.22911007455158,0.6168868407798622,2.3156296600263317,1.6987428192464695,-31838251,-43868751,77.90354269871447,62.15869778366761,NaN,NaN,23.865288992763524,13.398960870358508
1999-11-16T09:30:00-05:00,140.5625,143,140.09375,141.25,7544801,7174030.1,69.2914157650527,63.187395507489605,NaN,NaN,122.49228633041618,96.09580722921277,0.6281093801892379,2.483879544483017,1.855770164293779,-24293450,-37321770.4,80.46646221623196,64.66476467197064,NaN,NaN,26.030316400172055,15.203440231760442
1999-11-17T09:30:00-05:00,142.25,142.9375,141.3125,141.5625,9458102,7158965.3,69.87770987407984,63.8407445101387,NaN,NaN,127.52305788169095,105.33226238567265,0.6052412364537485,2.6123217098609643,2.007080473407216,-14835348,-30164289.8,82.81342149383222,67.19796837155806,NaN,NaN,28.00027322556467,17.03155923087533
1999-11-18T09:30:00-05:00,142.4375,143,141.625,142.625,4491000,6928245.4,71.84587431646544,64.33726956038437,NaN,NaN,131.776864889448,114.75544378061068,0.6086882795094071,2.7679408227939746,2.1592525432845675,-10344348,-23067429.6,84.76767778688222,69.69406796970681,NaN,NaN,30.27004930026514,18.922772097931016
1999-11-19T09:30:00-05:00,142.40625,142.96875,142,142.49609,4832102,6754370.4,71.2377033867687,65.08280448888277,NaN,NaN,125.43190411893349,121.71329045038178,0.5510281455799704,2.8480377252595304,2.29700957967956,-15176450,-19297569.4,85.69799829934372,72.03110990772544,NaN,NaN,32.00402439791663,20.79152242650039
1999-11-22T09:30:00-05:00,142.4375,143,141.5,142.46875,4155398,6556425.25,71.1002385988626,66.00866954664926,NaN,NaN,114.28727887818437,124.3022784197346,0.46331591196707844,2.876154469638408,2.4128385576713294,-19331848,-16796288.8,86.29604388733065,74.20085910319646,NaN,NaN,33.42546381452451,22.596371196218122
1999-11-23T09:30:00-05:00,142.84375,142.84375,140.375,141.21875,5917898,6539505.1,64.93102248296341,66.36755332809346,NaN,NaN,86.18342950624562,117.04050705490049,0.28228232917625107,2.765691469141643,2.483409139965392,-25249746,-16987548,85.9999154647046,76.13066747192492,NaN,NaN,33.08636588027204,24.094941865368682
1999-11-24T09:30:00-05:00,140.75,142.4375,140,142.0625,4458102,6490745.15,67.01171146298238,66.73409147744673,NaN,NaN,77.34999188612493,107.00589385578728,0.18522166729956968,2.714936224089854,2.5297145567902843,-20791644,-18178807.2,84.06495189992032,77.74566887445967,NaN,NaN,33.335197844892136,25.414978433872033
1999-11-26T09:30:00-05:00,142.46875,142.875,141.25,141.375,1693400,6049930.2,63.6955421079607,66.6878362366496,NaN,NaN,77.83852138802484,96.21822515550265,0.04773873033973164,2.5893879697149487,2.541649239375217,-22485044,-20606946.4,80.10850457559216,78.94669320034835,NaN,NaN,32.658661146539814,26.449790249967432
1999-11-29T09:30:00-05:00,140.875,141.92187,140.4375,140.9375,7348602,5867930.2,61.606242368495536,66.47596611668153,NaN,NaN,50.648559210158886,81.26155617374772,-0.09202741306602258,2.426614973042689,2.5186423861087115,-29833646,-23538385.6,75.48929383798045,79.60497916491897,NaN,NaN,31.521239913440542,27.17428305903502
1999-11-30T09:30:00-05:00,140.75,142.3125,139,139.39062,7681898,6051700.1,54.76607708963305,66.08470938910736,NaN,NaN,20.357314969240655,62.475563391958985,-0.29648614464550915,2.148034705301825,2.444520849947334,-37515544,-27175124.8,70.08972066772183,79.66700797561835,NaN,NaN,28.533434074458906,27.36844748980986
1999-12-01T09:30:00-05:00,139.3125,140.5,139,140.40625,6980199,6074865.15,58.05873758913101,65.7766826389125,NaN,NaN,5.566297532218749,46.352136997153615,-0.36656571902112445,1.9863137011709284,2.352879420192053,-30535345,-28232244.6,68.55472140544319,79.43648654621062,NaN,NaN,26.834674545047754,27.2921942119867
1999-12-02T09:30:00-05:00,140.625,141.375,140.375,141.25,6698301,6048715.15,60.62314306935178,65.53773804192357,NaN,NaN,36.37570318877024,38.157279257682674,-0.35887885656319396,1.9042808494880603,2.2631597060512543,-23837044,-28841324.6,67.63561853362094,78.99651162209638,NaN,NaN,26.090984076207587,27.120592764018255
1999-12-03T09:30:00-05:00,143.03125,145.34375,143.03125,143.84375,10044898,6155460.05,67.25187744585531,65.59686341322568,NaN,NaN,145.28247835784248,51.64607065164621,-0.1903535869274262,2.0252177223919716,2.215571309319398,-13792146,-27102745,68.91664914330744,78.48603727933043,NaN,NaN,27.473205356519287,27.170965991518404
1999-12-06T09:30:00-05:00,143.53125,143.71875,142.25,142.78125,3138800,5940825.05,62.60277953129068,65.27857679206379,NaN,NaN,91.79546084755707,59.875450979125844,-0.1627517717436464,2.0121315946398397,2.174883366383486,-16930946,-24522205,70.76624761982279,77.97623048798103,NaN,NaN,27.166650577241924,27.170349503764623
1999-12-07T09:30:00-05:00,143.28125,143.3125,141.375,141.625,10714000,6244065.1,57.91104758355517,64.46569335052826,NaN,NaN,53.86291583077081,66.57657115143188,-0.23053694220493792,1.886712188627314,2.117249130832252,-27644946,-22548085.4,72.13239280927047,77.3809398160552,NaN,NaN,25.421305114828503,26.920486019630893
1999-12-08T09:30:00-05:00,141.34375,142.0625,140.5,140.71875,4611199,6247940.1,54.465621058137366,63.36482986367522,NaN,NaN,-1.2449212093308781,65.21432740312196,-0.33807556039178266,1.6946546803425235,2.032730240734306,-32256145,-22892245.4,71.50502751881113,76.57319738926799,NaN,NaN,22.885632496851088,26.34407837351949
1999-12-09T09:30:00-05:00,141.8125,142.21875,139.375,141.40625,6474699,6251394.95,56.576279544129335,62.27414452279408,NaN,NaN,-19.295975265011712,54.079991712365555,-0.3624135730990219,1.5797132743605289,1.9421268474595508,-25781446,-23281125.8,70.75617748112145,75.5723759388565,NaN,NaN,21.419348962742287,25.64054560055132
1999-12-10T09:30:00-05:00,142.28125,142.8125,140.875,141.875,5127301,6268054.9,58.005579578431536,61.328992822198565,NaN,NaN,28.77406907832904,30.77830985646286,-0.3464613194307753,1.5090501981710815,1.8555115176018568,-20654145,-24653525.6,68.0477253456151,74.3116421564473,NaN,NaN,20.62654772144617,24.924260189250585
1999-12-13T09:30:00-05:00,141.4375,142.71875,141.28125,142.125,4210801,5888450.05,58.784759272553615,60.449315727462206,NaN,NaN,35.447450668205526,19.50870782059256,-0.3192626093788722,1.4564332558782667,1.7756958652571389,-16443344,-24556005.2,68.14104815346016,73.01485674688514,NaN,NaN,20.192417506755543,24.248282663179864
1999-12-14T09:30:00-05:00,141.625,142.48437,140.625,140.75,5739000,6066025.05,52.96406586835423,59.594533112132986,NaN,NaN,-40.19776128752569,0.6965723969332629,-0.3894166793071614,1.288925016123187,1.6783416954303485,-22182344,-23463484.8,69.22546505953362,71.81668171794435,NaN,NaN,18.0900990137899,23.36854214183844
1999-12-15T09:30:00-05:00,140.375,142.20312,140.03125,141.48437,6879000,6032735,55.49850294560734,58.77216107517762,NaN,NaN,-43.05413517442504,-7.665270396085566,-0.3814093685104474,1.2015799847922892,1.5829893533027366,-15303344,-20072924.6,72.36880305764488,70.98124251492469,NaN,NaN,17.03834479556393,22.464228235227797
1999-12-16T09:30:00-05:00,142.1875,142.65625,141.15625,142.125,5854801,5852569.95,57.64266401485001,58.33981263995543,NaN,NaN,26.67038481059988,1.5280016190367527,-0.3299447336805321,1.1705584362020716,1.5005031698826037,-9448543,-16806344,75.0164514461232,70.61752443424832,NaN,NaN,16.762941519435334,21.649758704400302
1999-12-17T09:30:00-05:00,143,143.3125,142.0625,142.6875,4775398,5866789.85,59.48836967527788,58.188536019011316,NaN,NaN,90.50245637037968,13.87367907744688,-0.258173814538996,1.1777859017088588,1.4359597162478548,-4673145,-13610144,77.30766250798423,70.74740791067715,NaN,NaN,17.053893263352883,20.993206498536384
1999-12-20T09:30:00-05:00,142.5625,143.1875,141.09375,141.65625,4608699,5855619.7,54.77589122887758,58.18923702895736,NaN,NaN,28.27148910097504,12.438486764000782,-0.27855863132911374,1.0877614270864626,1.3663200584155764,-9281844,-12177844,78.26942305738831,71.33167236708191,NaN,NaN,15.947400869114858,20.27237712290474
1999-12-21T09:30:00-05:00,141.59375,144.0625,141.34375,143.8125,7981301,6046914.85,61.62167477189607,58.44373254201201,NaN,NaN,123.01668795445951,45.08137661239782,-0.15158257738126646,1.1768418366889932,1.3284244140702597,-1300543,-8001483.8,80.82179686306159,72.20789204262609,NaN,NaN,17.073665624641947,19.815418337438626
1999-12-22T09:30:00-05:00,143.625,144.1875,142.96875,144.1875,5377500,6019894.95,62.679745219923625,58.59063269562427,NaN,NaN,159.6620204921796,85.62460774571875,-0.0522296053946012,1.263137407327008,1.3153670127216093,4076957,-4125423.6,82.83668709229833,73.29368265396019,NaN,NaN,18.31079088617729,19.600471558687005
1999-12-23T09:30:00-05:00,145.01562,146.48437,145,146.48437,5721699,6083074.8,68.42223001342776,58.67422930759374,NaN,NaN,256.9000677923815,131.67054434207506,0.1473698023991683,1.4995792657205698,1.3522094633214015,9798656,-275983.8,84.57044544669861,74.41181096134527,NaN,NaN,21.345850615075005,19.849811423885292
1999-12-27T09:30:00-05:00,146.5,146.78125,145.0625,146.28125,2691000,6132954.8,67.43405137329552,59.019320153451226,NaN,NaN,198.53926389343798,153.27790584668674,0.23945899632469692,1.6515332087272725,1.4120742124025756,7107656,2080176.4,85.53369128672959,75.46662836612431,NaN,NaN,23.44826523258632,20.363876253699726
1999-12-28T09:30:00-05:00,145.875,146.5,145.48437,146.1875,4084500,5969749.7,66.95341762734475,59.66520372800762,NaN,NaN,163.08858815563568,180.24132565761886,0.265769365702349,1.7442859195305118,1.4785165538281628,3023156,4541176.4,86.4828939668467,76.49166416309404,NaN,NaN,24.999175583812345,21.026061872287244
1999-12-29T09:30:00-05:00,146.3125,146.8125,145.3125,146.8125,3001000,5735704.8,68.56214107752221,60.672098015106535,NaN,NaN,148.57703662079393,185.35339539088574,0.2947348128872662,1.8469350699372455,1.5522002570499793,6024156,6006116.2,87.02850616175073,77.60048406616116,NaN,NaN,26.77997178762045,21.84804900304913
1999-12-30T09:30:00-05:00,147.125,147.5625,146.1875,146.64062,3641300,5568759.85,67.5877067773584,61.45862853176576,NaN,NaN,143.30119945867324,182.08123118418447,0.2723192145995166,1.892599275299375,1.6202800606998584,2382856,5667296,86.16223964766647,78.70091707805724,NaN,NaN,27.983288504675013,22.724511788995684
1999-12-31T09:30:00-05:00,146.84375,147.5,146.25,146.875,3172700,5392479.8,68.25036085278923,62.19039862279131,NaN,NaN,124.75275505166276,155.6517686360407,0.24417992865601001,1.9255049715198709,1.6813250428638609,5555556,4818676,83.90940512918579,79.83389420545515,NaN,NaN,29.174307994082938,23.645911246865293
2000-01-03T09:30:00-05:00,148.25,148.25,143.875,145.4375,8164301,5298449.95,60.13057693983976,62.28652845616888,NaN,NaN,79.55977678822047,131.8558712149972,0.10667624280980603,1.8146703463761185,1.7079941035663124,-2608745,2875395.8,78.82672650245476,80.59715694466904,NaN,NaN,27.946492560345593,24.260280005933907
2000-01-04T09:30:00-05:00,143.53125,144.0625,139.64062,139.75,8089801,5546000,39.903017125157945,61.353596403083436,NaN,NaN,-76.8497714288723,83.86819929809562,-0.3636349676895452,1.253450393954381,1.6170853616439262,-10698546,131055.4,72.17750065631242,80.80801663015325,NaN,NaN,18.744682958616945,23.472337570602914
2000-01-05T09:30:00-05:00,139.9375,141.53125,137.25,140,12177898,5619194.9,40.84499969449905,60.30691759943284,NaN,NaN,-118.56179304142246,30.440433365652336,-0.6381428197169807,0.8194068369977003,1.457549656714681,1479352,-777905.4,70.06927508992874,80.64376463245924,NaN,NaN,12.191301523013953,21.86076099237592
2000-01-06T09:30:00-05:00,139.625,141.5,137.75,137.75,6227199,5699994.9,35.458165018090384,58.722310528235724,NaN,NaN,-128.92930740916447,-24.005668007915204,-0.9336244677646548,0.2905190720088626,1.2241435397735174,-4747847,-2204046,66.77376262810147,80.05500114545768,NaN,NaN,4.611886841053017,19.396636113615504
2000-01-07T09:30:00-05:00,140.3125,145.75,140.0625,145.75,8066602,5779590.05,57.114911508182324,58.552777802014624,NaN,NaN,15.142235466719365,-45.927771924903894,-0.5705034754310043,0.511014195484762,1.0815176709157663,3318755,-2651406.2,65.72943938170451,79.22798520786627,NaN,NaN,6.754607003963424,17.590631955093777
2000-01-10T09:30:00-05:00,146.25,146.90625,145.03125,146.25,5741602,5810305.1,58.06207200058638,58.78750499999382,NaN,NaN,75.84231429709483,-46.671264423129024,-0.29095069561788667,0.7178293013934081,1.0087799970112947,9060357,-317585.8,68.49746069477787,78.52998789625124,NaN,NaN,8.62313678838035,16.30956121699186
2000-01-11T09:30:00-05:00,145.8125,146.09375,143.5,144.3125,7433699,5971450,53.16228404479933,58.183262805201196,NaN,NaN,28.72056184733131,-25.5571977678883,-0.23332389115117225,0.7171251330723294,0.9504490242235016,1626658,2147455,71.1481747306783,77.8390148867953,NaN,NaN,8.121592435985802,15.13985139113385
2000-01-12T09:30:00-05:00,144.59375,144.59375,142.875,143.0625,6911699,6030084.95,50.2178882618194,57.293130165336606,NaN,NaN,-10.317747841030345,-3.9083887278098772,-0.2734104447057457,0.6086859683413195,0.8820964130470652,-5285041,794576.4,67.77745996586201,76.76335580633555,NaN,NaN,6.642185996236265,13.925899191862767
2000-01-13T09:30:00-05:00,144.46875,145.75,143.28125,145,5158301,5944050,54.43078206968647,56.29374102649795,NaN,NaN,23.484559951343748,26.57438474429178,-0.16859847354098711,0.6713483211208313,0.8399467946618184,-126740,1718797.8,68.86273685265357,75.64137662104663,NaN,NaN,7.002391789940362,12.936826705873852
2000-01-14T09:30:00-05:00,146.53125,147.46875,145.96875,146.96875,7437301,6023175,58.29310513386316,55.64081629510992,NaN,NaN,87.70362443916545,41.08666253878099,0.023917241064368988,0.8698433459922796,0.8459261049279106,7310561,2517159,69.80869253083907,74.5181624241973,NaN,NaN,8.683983008835195,12.3292776062969
2000-01-18T09:30:00-05:00,145.34375,146.625,145.1875,145.8125,6488500,6108830.1,55.327172020803985,54.810370180357005,NaN,NaN,51.281375560325316,36.1744747914271,0.06182725941714695,0.9232101791993443,0.8613829197821974,822061,869499.8,65.39323394596215,73.01175813699125,NaN,NaN,8.993679248258886,11.852763555148613
2000-01-19T09:30:00-05:00,145.3125,146.46875,145,146.25,6152898,6186040.05,56.23454656304287,53.92982771503706,NaN,NaN,48.16805773300195,40.06397396856123,0.10241460164233196,0.9894011718351123,0.8869865701927804,6974959,1939160,66.85877504059926,71.57106305690901,NaN,NaN,9.528645349232349,11.520746668589146
2000-01-20T09:30:00-05:00,146.96875,146.96875,143.8125,144.75,5800102,6076980.1,52.3113761396052,52.838661240911826,NaN,NaN,18.391993611895334,45.80592225914636,0.01867223581526356,0.9103268649618599,0.8916546291465963,1174857,3231139.6,68.58904031581027,70.31583453320499,NaN,NaN,8.725186578628675,11.121380941451935
2000-01-21T09:30:00-05:00,145.5,145.5,144.0625,144.4375,6244801,6120345.15,51.50520263098309,51.64257851078281,NaN,NaN,-2.978198526251883,40.513370563627234,-0.06286675117683793,0.813071190175549,0.8759379413523869,-5069944,2242498.8,65.7597854014655,69.01943312408211,NaN,NaN,7.840519403595862,10.652686436043926
2000-01-24T09:30:00-05:00,145.65625,145.84375,139.40625,140.34375,7896898,6229105.1,42.30704149664915,50.3694688362692,NaN,NaN,-97.62712797347648,3.447220081098847,-0.37991754983476955,0.40104100405892495,0.7809585538936945,-12966842,-1812981.8,55.623789865751895,67.36208050717478,NaN,NaN,3.924902659329611,9.69157446794188
2000-01-25T09:30:00-05:00,140.51562,141.9375,139,141.9375,9942500,6591680.1,46.32586153671134,50.82824343709444,NaN,NaN,-110.5609410206047,-28.921243235087154,-0.4641333907471541,0.2007918154597519,0.664925206206906,-3024342,-2582262.4,53.925820234515975,66.05838904847502,NaN,NaN,2.0269097598656716,8.596622366788136
2000-01-26T09:30:00-05:00,141,141.54687,140.09375,140.8125,5158102,6645360.2,43.996123096357124,51.053323680084304,NaN,NaN,-99.71617740615802,-58.49809026291915,-0.5704444769888625,-0.04813039002917208,0.5223140869596904,-8182444,-5613743,47.741145370997735,64.46352263997996,NaN,NaN,-0.26131585441562866,7.331202620901884
2000-01-27T09:30:00-05:00,141.84375,142.21875,138.125,140.25,10919898,7041305.1,42.83614775696528,51.5803224471468,NaN,NaN,-103.63699217074729,-82.90388741944767,-0.6478338378858848,-0.28747821039766563,0.36035562748821914,-19102342,-9669182.8,40.97144772104161,62.62050014661854,NaN,NaN,-2.4585769142860996,5.9326626873036
2000-01-28T09:30:00-05:00,139.4375,140.0625,135.53125,135.875,11916199,7455050.05,35.08748438293962,50.00693479534375,NaN,NaN,-161.274695853139,-114.56318688482511,-0.9448670424106703,-0.8207281755251188,0.12413886688555154,-31018541,-14858902.2,34.27370973478659,60.37366231469583,NaN,NaN,-7.1543901443615905,4.06308371135143
2000-01-31T09:30:00-05:00,135.8125,139.67187,135,139.625,10768602,7834845.15,44.37545351069343,49.02931918892283,NaN,NaN,-118.99459362034109,-118.83668001419804,-0.8433257198725921,-0.9300182829551886,-0.08669256308259654,-20249939,-16315521.6,32.65991324251783,57.81383749667725,NaN,NaN,-7.9564386778424065,2.346009084323739
2000-02-01T09:30:00-05:00,139.75,141.6875,138.53125,140.9375,8419801,7847620.15,47.22187374814841,48.605004167733476,NaN,NaN,-54.781230998027944,-107.68073800968268,-0.6509220150124835,-0.9003450818482008,-0.2494230668357174,-11830138,-18076680.8,30.77323428624524,54.92991317921774,NaN,NaN,-7.616082471893748,0.9228531477212409
2000-02-02T09:30:00-05:00,141.28125,142.25,140.375,141.0625,6205898,7753425,47.497428872377725,48.41068563991622,NaN,NaN,-33.273073847346886,-94.39211729792046,-0.4859535421938859,-0.8568649945780749,-0.37091145238418893,-5624240,-17565040,32.00217028806924,52.37453534508968,NaN,NaN,-7.265233672368662,-0.24687354086303093
2000-02-03T09:30:00-05:00,140.875,143.25,140,143.1875,7997500,7544405.1,52.078033041523696,48.24263213790459,NaN,NaN,-13.66004245080408,-76.39672735393181,-0.21808594719647323,-0.6435188863797805,-0.42543293918330727,2373260,-13269919.6,41.405971496486146,50.41333781964915,NaN,NaN,-5.496764942789838,-0.9968580268525747
2000-02-04T09:30:00-05:00,143.1875,144,142.125,142.59375,4925398,7479315.05,50.74582550724547,47.703540736003326,NaN,NaN,1.7541899971475896,-43.790950183874486,-0.07277244938100197,-0.5163985009095597,-0.4436260515285578,-2552138,-7576639,51.06623458018107,49.07459082317359,NaN,NaN,-4.476238424921711,-1.4939123694338798
2000-02-07T09:30:00-05:00,142.5625,142.78125,141.4375,142.375,5845801,7368275,50.235953598000506,47.339882277231645,NaN,NaN,-16.69741082183714,-23.33151362417369,0.012206427977710876,-0.4283680165564192,-0.4405744445341301,-8397939,-5206239,54.43456617001699,48.291828839177505,NaN,NaN,-3.79855864107178,-1.823147551096437
2000-02-08T09:30:00-05:00,143.96875,144.5625,143.625,144.3125,4936500,7328019.9,54.5881482247135,47.2222823959224,NaN,NaN,46.15631677820243,-3.144004068927623,0.1924930176262321,-0.19995817250133996,-0.39245119012757207,-3461439,-3532499.2,56.70096039303024,47.56627065006543,NaN,NaN,-1.9119455082513424,-1.8358329735471377
2000-02-09T09:30:00-05:00,144.46875,144.46875,141.26562,141.28125,8511500,7381909.95,47.577488854260984,46.884147589826384,NaN,NaN,-6.9353170569793665,2.123547289145881,0.10553296636343129,-0.26053498217328297,-0.36606794853671426,-11972939,-4802239,54.48683114652204,46.558969995116264,NaN,NaN,-2.3913347719191766,-1.9151903733145719
2000-02-10T09:30:00-05:00,141.625,142.5625,140.875,141.5625,6690602,7370855.1,48.241684609019096,46.6510391596861,NaN,NaN,-25.876379355707606,-0.31972009183481875,0.06678196800565178,-0.2825904885296495,-0.3493724565353013,-5282337,-6333358.4,51.85716662236036,45.56592579660876,NaN,NaN,-2.5787994301016735,-2.0099916671413007
2000-02-11T09:30:00-05:00,141.84375,141.9375,138.03125,138.6875,9849199,7605400,42.33662232798757,46.653152076210276,NaN,NaN,-87.59305094325285,-18.189168279914906,-0.14129784962712333,-0.5259947685692055,-0.38469691894208213,-15131536,-8849238,47.77686798264026,45.00543137638649,NaN,NaN,-4.591796873508898,-2.3788209823366717
2000-02-14T09:30:00-05:00,139.78125,139.78125,138.3125,139.5,8528801,7659975,44.4076562186321,46.516137410633185,NaN,NaN,-92.22540881500801,-33.29476787854908,-0.20895212115264117,-0.6458870703828836,-0.43693494923024245,-6602735,-8490197.2,48.400839030469,44.61078986181171,NaN,NaN,-5.615799513228359,-2.8412464867497698
2000-02-15T09:30:00-05:00,139.25,141.21875,137.79687,141.09375,11078301,7889465.05,48.32799797164576,46.82555704458237,NaN,NaN,-56.36956535110125,-53.79994430440981,-0.13471003815796462,-0.6053224969276982,-0.4706124587697336,4475566,-6902796.2,51.17826361769989,44.856298308004725,NaN,NaN,-5.303943665093609,-3.1930603693703183
2000-02-16T09:30:00-05:00,140.375,140.9375,138.79687,139.1875,8845398,8024090.05,44.3036732096381,46.93038029120186,NaN,NaN,-65.16254484726363,-65.44538986246667,-0.19847675374484386,-0.7187084009507885,-0.5202316472059446,-4369832,-5382174.8,53.746658976982424,45.76881339771478,NaN,NaN,-6.2646271940288765,-3.6318556300358265
2000-02-17T09:30:00-05:00,140.4375,140.4375,138.21875,138.28125,7584199,8113294.9,42.4921025283235,47.4592815873007,NaN,NaN,-85.59881289901088,-77.38987657112732,-0.2811319215202063,-0.8716465491062024,-0.5905146275859962,-11954031,-6716513.6,51.201242476795365,46.97792287928684,NaN,NaN,-7.600204570099948,-4.198762621473558
2000-02-18T09:30:00-05:00,138.875,138.875,134.625,135.3125,9650898,8283599.75,37.13522304501729,46.94212226832383,NaN,NaN,-182.80586137001757,-96.43243865648027,-0.5022762598288467,-1.2183599523720545,-0.7160836925432078,-21604929,-8011192.2,48.786940953530014,48.12985343007342,NaN,NaN,-10.493299197693927,-5.097982132362183
2000-02-22T09:30:00-05:00,135.1875,136.34375,133.53125,134.96875,16415398,8709524.75,36.560485755183,46.18059455454058,NaN,NaN,-198.86884389111265,-117.76112567170121,-0.6299640188912691,-1.5035387161572942,-0.8735746972660251,-38020327,-14294710.6,39.14057355283073,48.72752052054381,NaN,NaN,-12.989053256725455,-6.225278007271221
2000-02-23T09:30:00-05:00,135.625,137.46875,134.5,136.5625,12119000,8818349.75,41.11118689234742,45.72443441310985,NaN,NaN,-129.94249122442582,-132.4757108463661,-0.5672988622385082,-1.5826982750641605,-1.0153994128256523,-25901327,-20370089.2,32.458084743010346,48.76008583875389,NaN,NaN,-13.765216598673433,-7.302412091757251
2000-02-24T09:30:00-05:00,136.6875,137.03125,133.09375,133.8125,17375008,9429195.05,36.27578609841401,44.59570248860201,NaN,NaN,-154.6294481387355,-150.3690915046605,-0.6645241851734618,-1.8460546442924795,-1.1815304591190177,-43276335,-28151389.8,26.271402135311675,47.67904517009857,NaN,NaN,-15.973882464715198,-8.541193573608385
2000-02-25T09:30:00-05:00,135.1875,136.71875,133.125,133.32812,10559898,9411195.05,35.48411528108984,43.50558032959089,NaN,NaN,-137.1581320078854,-160.6809553264354,-0.7107678904991412,-2.069990322242944,-1.3592224317438029,-53836233,-36527830.2,21.516885704680803,45.568377393277125,NaN,NaN,-17.996279743429653,-9.891920169297137
2000-02-28T09:30:00-05:00,133.375,136.6875,132.71875,136.125,13397801,9485275.15,43.19316287839034,43.00252384961874,NaN,NaN,-107.55422123169174,-145.63062729877024,-0.5116108027637889,-1.998735935198539,-1.48712513243475,-40438432,-40294530.8,19.78306949529322,43.09327048793972,NaN,NaN,-17.377254780058845,-10.961253685120237
2000-02-29T09:30:00-05:00,136.0625,137.4375,135.75,137.4375,8242500,9358970.05,46.42820844558278,42.41967100825226,NaN,NaN,-58.90297458892696,-117.6374534383331,-0.26264499508165917,-1.8154313762868242,-1.552786381205165,-32195932,-39129651.8,21.87955917734699,40.60602754396234,NaN,NaN,-15.85589010461187,-11.660487459333327
2000-03-01T09:30:00-05:00,137.625,139,137.21875,138.4375,6866000,9281280,48.81969547535095,42.50840005261582,NaN,NaN,-21.285369405290663,-95.90602907450607,-0.014855644598959383,-1.5713559369538643,-1.556500292354905,-25329932,-39015372.8,22.094670937898982,38.29230181477497,NaN,NaN,-13.869523005881268,-11.976063965983032
2000-03-02T09:30:00-05:00,138.6875,139.125,137.34375,138.53125,7600199,9350995.05,49.04933028186675,42.5660890292478,NaN,NaN,-14.928992359506791,-67.96593791866033,0.16140589928238036,-1.3547429182519295,-1.5161488175343099,-17729733,-33906052.4,31.21433423324477,36.817813786981006,NaN,NaN,-12.199388800271315,-12.007967513738501
2000-03-03T09:30:00-05:00,140.4375,141.71875,139.71875,141.125,12770301,9589635.1,55.05739513594292,43.47471565838747,NaN,NaN,55.293719953194206,-29.475567526444387,0.44277156117186256,-0.9626843660694817,-1.4054559272413443,-4959432,-24130692.2,44.58103840971312,36.58954024605764,NaN,NaN,-8.86264507999685,-11.558635737489695
2000-03-06T09:30:00-05:00,140.8125,141.34375,138.75,139.8125,11966898,9941710.1,51.733031487446524,43.99795674901707,NaN,NaN,37.14310511795499,-0.5361022565150364,0.5249678798536217,-0.749246077424317,-1.2742139572779387,-16926330,-19428271.8,49.64979039197372,36.678751057593686,NaN,NaN,-7.02325338501548,-10.910723972850521
2000-03-07T09:30:00-05:00,140,140.15625,135.21875,137.04687,20061808,10652510.45,45.49893468812473,43.79588080019414,NaN,NaN,-29.516276584612655,5.341237344347813,0.3840879761042306,-0.7941039871476505,-1.1781919632518811,-36988138,-20386713,48.67265134895023,36.49977875268299,NaN,NaN,-7.329281707858678,-10.399089363565972
2000-03-08T09:30:00-05:00,136.46875,137.84375,135.03125,136.875,11808398,10996105.35,45.13492826046804,43.855256160967706,NaN,NaN,-49.29774302247896,-0.26123737908984596,0.2754256647003026,-0.8339098823765028,-1.1093355470768054,-48796536,-25080033.8,44.09609772909029,35.81045294926212,NaN,NaN,-7.681878528670007,-10.010916387152262
2000-03-09T09:30:00-05:00,137.25,140.875,136.125,140.875,5500898,10845575.25,54.298817993302706,44.69859297989479,NaN,NaN,49.15215968063206,12.554993028937918,0.45826422028804537,-0.5365052717167487,-0.994769492004794,-43295638,-30193214.8,39.714811142623695,34.98999356824986,NaN,NaN,-5.021410143797854,-9.298129780958774
2000-03-10T09:30:00-05:00,140.1875,142,139.53125,140.1875,7924500,10907270.15,52.6704653869184,45.808253147173446,NaN,NaN,99.43697956943568,21.383644952186213,0.514035396784972,-0.3522252460235791,-0.8662606428085511,-51220138,-39445356,33.2727359951533,33.88183607122295,NaN,NaN,-3.3898615896594397,-8.454091467916012
2000-03-13T09:30:00-05:00,136.6875,140.46875,136.5,138.59375,10540398,10941830.1,49.00184567867885,46.696921713137435,NaN,NaN,26.812393906209643,19.317502709837147,0.42823323605980135,-0.33096909773379934,-0.7592023337936007,-61760536,-48412197.2,28.455277135368505,33.11860061283279,NaN,NaN,-3.1503455877567372,-7.696413485036116
2000-03-14T09:30:00-05:00,139.28125,140.09375,136.15625,136.625,8263699,10928575,44.846394985901185,46.963722291248416,NaN,NaN,-4.055137064069935,24.40973061394569,0.2332858872424295,-0.4675949747405639,-0.7008808619829934,-70024235,-55019416.6,25.522878028684474,32.62322870466666,NaN,NaN,-4.251643303932979,-7.204303459164239
2000-03-15T09:30:00-05:00,136.875,140.4375,136.0625,139.8125,10300801,10889700,51.950920425092136,48.083374743154,NaN,NaN,44.66551655987972,43.20238253041744,0.30867603451667824,-0.3150358188371456,-0.6237118533538238,-59723434,-57204796.2,24.619173281265248,32.505212357949056,NaN,NaN,-2.890503427386833,-6.588046311767467
2000-03-16T09:30:00-05:00,141.625,146.84375,140.875,146.34375,25601392,11727499.7,62.585720941500306,50.0192037188976,NaN,NaN,237.3230928667816,80.83656916764735,0.7622431892060366,0.329092133153722,-0.43315105605231463,-34122042,-55370077,26.957472663576908,32.89382571215592,NaN,NaN,2.426259352746335,-5.300288359694067
2000-03-17T09:30:00-05:00,145.8125,148,145.4375,146.9375,10272898,11861934.65,63.379251203544314,51.461067170694314,NaN,NaN,245.75061687915408,110.09929662959102,1.0484129405725109,0.8773651196633239,-0.1710478209091869,-23849144,-49895878.2,33.57791996680423,33.87917217440671,NaN,NaN,6.719200756299408,-3.583218485980713
2000-03-20T09:30:00-05:00,146.875,147.34375,144.78125,146.78125,12502102,12004494.85,63.000571794771176,52.64480740992205,NaN,NaN,186.38884172671084,142.0145861936913,1.1644069582961658,1.2844608769610204,0.1200539186648546,-36351246,-44814020.2,39.09665253116283,35.10896455682212,NaN,NaN,9.896078427159244,-1.6576046412464334
2000-03-21T09:30:00-05:00,145.53125,149.75,144.5,149.1875,13612801,11864365,66.33630825617168,53.89599403712352,NaN,NaN,180.84500687209828,178.99461498092492,1.3285363694836947,1.780724380519473,0.4521880110357783,-22738445,-35356862.2,47.790280303440696,36.94436522578939,NaN,NaN,13.681003716028947,0.533625124078621
2000-03-22T09:30:00-05:00,149.5625,150.84375,148.6875,150.09375,8259801,11671405.05,67.52386142154356,55.21560340424329,NaN,NaN,180.67596154260664,206.19670397747032,1.4154776789635959,2.221535109740273,0.8060574307766772,-14478644,-26307904.2,54.4850623244286,38.60656008944538,NaN,NaN,17.10713872751703,2.9012699245698217
2000-03-23T09:30:00-05:00,149.15625,153.46875,149.15625,152.5,11653898,11385349.55,70.49961157806572,56.31861886439492,NaN,NaN,173.29492665041786,193.39107073419754,1.5419817103429851,2.7335345687054087,1.1915528583624235,-2824746,-20048445,58.45369086835252,39.597463836491045,NaN,NaN,20.996935033671114,5.48636494015572
2000-03-24T09:30:00-05:00,152.875,155.75,151.71875,153.5625,11462898,11430499.55,71.7313269930734,57.747068543368265,NaN,NaN,165.68471997813205,177.37789135399314,1.5973818650050853,3.18828018961878,1.5908983246136947,8638152,-13550985.8,62.14361216472407,40.48987967740179,NaN,NaN,24.560555885070634,8.21124936085785
2000-03-27T09:30:00-05:00,153.375,153.78125,151.8125,151.9375,8798602,11200539.6,67.11584744736481,59.29113374045685,NaN,NaN,127.17768786114014,165.53566058087898,1.4301605917025273,3.378599064241854,1.9484384725393267,-160450,-6312826.6,65.78881747386151,41.7124629720383,NaN,NaN,26.156841128359005,10.77490532764373
2000-03-28T09:30:00-05:00,151.25,152.98437,150.59375,151.0625,6334301,11105129.65,64.70170409117978,60.68876058550769,NaN,NaN,100.69107594381839,149.504874395223,1.1767741582950717,3.419406170408166,2.2426320121130945,-6494751,-3064087.8,67.31029375875218,43.37061983129987,NaN,NaN,26.757050680073856,13.05806894941946
2000-03-29T09:30:00-05:00,151.5625,152.48437,149.65625,151.21875,6747500,11099204.65,64.94419451040713,61.44914462244372,NaN,NaN,85.38461157931587,130.44660440256487,0.9457938668391281,3.4248743456620048,2.4790804788228766,252749,-117809.2,68.67106893439961,45.43892395928386,NaN,NaN,27.31297676374608,15.09448435146612
2000-03-30T09:30:00-05:00,150.15625,151.92187,147.125,148.6875,9491898,11193789.6,57.99361917204124,61.829369892809645,NaN,NaN,56.449963793573474,107.07761183119598,0.56730005258735,3.1882055445570643,2.6209054919697143,-9239149,-1400689.8,67.35629626327153,47.87346397843516,NaN,NaN,25.756779877763876,16.617669426651513
2000-03-31T09:30:00-05:00,149.625,152.3125,148.4375,150.375,9249102,11017729.65,60.9909790856915,62.685736564739116,NaN,NaN,64.18667397608823,86.77800263078721,0.38412666889133273,3.1010638280838805,2.7169371591925477,9953,-3126329.6,65.53859470350434,50.52227237615915,NaN,NaN,25.293209411934725,17.85703228169197
2000-04-03T09:30:00-04:00,150.125,151.25,148.6875,151.25,8508199,10844794.7,62.48573084874912,63.945689126371114,NaN,NaN,59.148442711566936,73.17215360087258,0.2802512443040137,3.0672512145725648,2.786999970268551,8518152,-1390609.2,66.51735959443928,53.45044963085593,NaN,NaN,25.334050998735453,18.925177812698184
2000-04-04T09:30:00-04:00,151.75,153,141.39062,145.75,21056400,10894524.3,49.61610285992382,63.7789164431448,NaN,NaN,7.136140085245106,54.4611664291579,-0.17595279048019652,2.567058982168305,2.7430117726485017,-12538248,-2599308.6,65.13012305398401,56.34408890033584,NaN,NaN,21.066869116981852,19.231133713310136
2000-04-05T09:30:00-04:00,147.875,150.8125,147.625,149.1875,8227898,10715499.3,55.75033028905505,63.29067425368443,NaN,NaN,37.399462535752505,44.86413662044525,-0.25830320068008694,2.420132771798393,2.67843597247848,-4310350,-3511928.4,64.04407082542197,58.99313162618191,NaN,NaN,19.46974543126699,19.265221101589688
2000-04-06T09:30:00-04:00,150.25,151.6875,149,150.48437,6378500,10759379.4,57.83601284947576,62.89472865696525,NaN,NaN,51.047716486464424,43.783687159023444,-0.23803373761285052,2.3808938004624167,2.6189275380752672,2068150,-1250468.6,65.5759160030636,61.27870277162901,NaN,NaN,18.87929833054918,19.21008927715533
2000-04-07T09:30:00-04:00,151.5625,152.125,150.5,151.4375,6023602,10664334.5,59.35241133534869,62.6341457670065,NaN,NaN,62.98342009373935,43.543036382553666,-0.17590084153014107,2.399051486162591,2.574952327692732,8091752,365891.2,66.66893424408605,63.24815146540924,NaN,NaN,18.88370305975951,19.163462674670214
2000-04-10T09:30:00-04:00,151.75,153.10937,150.3125,150.84375,9624199,10618524.55,57.95413733589169,62.03541927270079,NaN,NaN,60.539548858291205,43.821257611898524,-0.18910321995254353,2.338573302752053,2.5276765227045965,-1532447,-1644228.6,63.94954689479691,64.40238479336325,NaN,NaN,18.46391971387227,19.063527965984793
2000-04-11T09:30:00-04:00,150,151.625,148.375,150.40625,9006398,10655659.5,56.89059806280804,61.27590046136254,NaN,NaN,25.78159119227421,47.55034783330435,-0.23842968399375275,2.2296394177124057,2.4680691017061585,-10538845,-1244348,64.2618474351697,65.10072658698762,NaN,NaN,17.813170590586576,18.884905483785047
2000-04-12T09:30:00-04:00,150.375,151.15625,146.15625,146.28125,10779699,10679604.4,47.95482769355787,59.665558755326266,NaN,NaN,-64.13552454969265,27.24335041621532,-0.5425964561562484,1.789823531510848,2.3324199876670964,-21318544,-4645986.8,59.53696260025072,65.17810313926606,NaN,NaN,14.36655666580203,18.239427081216046
2000-04-13T09:30:00-04:00,147.46875,148.15625,141.125,144.25,12226801,10010874.85,44.267587230331806,57.703863057987576,NaN,NaN,-182.8088400421225,-19.52796088950207,-0.8556923508656853,1.26280454908499,2.1184968999506752,-33545345,-11768685.8,51.0697104200745,64.38711015750538,NaN,NaN,10.277334033077757,17.10198521719629
2000-04-14T09:30:00-04:00,142.625,142.8125,133.5,138.375,29603808,10977420.35,35.71418260777523,55.460886998016896,NaN,NaN,-306.59925985592537,-93.44449687943502,-1.4013206917773382,0.3668460352290026,1.7681667270063408,-63149153,-26016866.8,39.09264565079737,62.480240741572224,NaN,NaN,3.3744844709998376,15.140913682025369
2000-04-17T09:30:00-04:00,135.1875,140.75,134.6875,140.75,23918192,11548224.85,40.70224463871393,53.74663989426933,NaN,NaN,-230.96597581381326,-151.7456018138559,-1.5344035060174366,-0.14983765551545503,1.3845658505019816,-39230961,-33556569.6,34.48389881924288,60.13549824589298,NaN,NaN,-0.5015152651481907,12.90628097528629
2000-04-18T09:30:00-04:00,140.5625,144.46875,139.78125,144.46875,10955699,11415369.75,47.56300881856463,52.50512663056629,NaN,NaN,-116.27337108162386,-180.1565942686355,-1.3126821537203082,-0.25628684164840365,1.0563953120719045,-28275262,-37103853,32.5401772832879,57.55472027081358,NaN,NaN,-1.3442414913848313,10.87049205147613
2000-04-19T09:30:00-04:00,144.5,145.125,142.53125,143.125,6553699,11330064.65,45.51381220885276,51.613711847481405,NaN,NaN,-88.22303743493087,-184.97409684568316,-1.2002844781214592,-0.4439602855799194,0.7563241925415397,-34828961,-39805936.4,31.102059747301496,54.96513194824429,NaN,NaN,-2.6984713754891803,8.9320687047668
2000-04-20T09:30:00-04:00,143.5625,143.9375,142.375,143.8125,8537602,11174249.85,46.77724052210613,50.598444807225306,NaN,NaN,-80.90505160319655,-164.59333915789796,-1.0299355162609334,-0.531095202784627,0.49884031347630636,-26291359,-38355139.2,32.818839611487604,52.62800658452881,NaN,NaN,-3.3623089152217704,7.175729044768433
2000-04-24T09:30:00-04:00,141.5,143.3125,140.5,142.25,12893102,11245760.05,44.265024954367846,49.29696581476951,NaN,NaN,-91.87060320092397,-121.64760782689768,-0.9734360971572404,-0.7179548079702442,0.2554812891869962,-39184461,-33562200.8,38.289586832780934,50.61173710155322,NaN,NaN,-4.691604347962942,5.480395702949665
2000-04-25T09:30:00-04:00,144.625,148.15625,144.4375,148.15625,14102000,11510929.95,54.26402800042731,49.628960467662615,NaN,NaN,-1.5901607322072921,-75.7724448105765,-0.5124003243221924,-0.38501911621574436,0.12738120810644807,-25082461,-30732500.8,41.32737773388165,48.9115410072602,NaN,NaN,-2.4758279307694186,4.343792326704082
2000-04-26T09:30:00-04:00,147.96875,148.75,146,146.48437,7711102,11579770,51.45022229920998,49.321809896959394,NaN,NaN,5.835267917218741,-51.350717010807976,-0.30442794789683403,-0.25315372676459447,0.05127422113223956,-32793563,-31636161,40.63936608508307,47.239776382950275,NaN,NaN,-1.6303247523704354,3.490347029693437
2000-04-27T09:30:00-04:00,143,147.34375,143,146,15595301,12022160.05,50.63108606341811,48.80717226938385,NaN,NaN,-21.067674252179472,-37.9196443742577,-0.189495094485864,-0.18559464697509043,0.0039004475107735637,-48388864,-34348141.6,38.564401701516374,45.31038250426833,NaN,NaN,-1.2191105687292587,2.817567372775909
2000-04-28T09:30:00-04:00,147,147.85937,145.0625,145.09375,8743398,11984735.05,49.05736216162739,48.07181161411804,NaN,NaN,-6.802141946967051,-23.099062443011803,-0.16539408007865894,-0.20284215258755012,-0.03744807250889118,-57132262,-40516322.2,34.277635799549415,42.99671832965857,NaN,NaN,-1.3555154638207911,2.2214126818335234
2000-05-01T09:30:00-04:00,146.5625,148.48437,145.84375,147.0625,7328301,11888695,52.51066466708468,47.68299213777468,NaN,NaN,20.805410201242097,-0.5638597625785906,-0.01563536761410915,-0.05699228202652762,-0.04135691441241847,-49803961,-42640222.2,32.920656195585025,40.78036899400058,NaN,NaN,-0.4316198407594456,1.8424080357488135
2000-05-02T09:30:00-04:00,145.5,147.125,144.125,144.125,9411898,11933879.95,47.352790325117695,47.00172015651108,NaN,NaN,-17.852361862283345,-3.816299988593807,-0.10803722051319914,-0.1764034400539174,-0.06836621954071825,-59215859,-49466901.8,28.95314352803851,38.258318714919774,NaN,NaN,-1.2104251252177591,1.406289012753589
2000-05-03T09:30:00-04:00,144,144,139.78125,141.625,12180699,11490094.9,43.441873288412985,46.679366270429306,NaN,NaN,-83.32911937430819,-21.649177446899195,-0.31921029993719896,-0.4673790944622169,-0.148168794525018,-71396558,-57187500.8,25.24727127493766,35.80905504882599,NaN,NaN,-3.0961030127339932,0.7630901519696487
2000-05-04T09:30:00-04:00,142,142.35937,140.75,141.8125,5963602,11376880.1,43.816662009461595,46.647157326081434,NaN,NaN,-78.58670929594797,-33.15298445565289,-0.42151932504248346,-0.6750679508281223,-0.25354862578563886,-65432956,-60596319.2,23.798870905243504,33.86113794062377,NaN,NaN,-4.494557997422024,0.011997559199409702
2000-05-05T09:30:00-04:00,141.0625,144,140.9375,143.53125,7862398,11451075,47.2663174512249,47.472309814899276,NaN,NaN,-47.184111157041464,-41.22937829766777,-0.3515497362671808,-0.6929857961196149,-0.3414360598524341,-57570558,-60683978.4,23.76112069092278,32.76602901491844,NaN,NaN,-4.678730734410856,-0.658106482744914
2000-05-08T09:30:00-04:00,142.75,143.375,141.84375,142.45312,5064102,11403100,45.38391183096398,47.80671461434571,NaN,NaN,-47.15575889765223,-54.821612117446634,-0.35495626598395225,-0.7851313923323744,-0.43017512634842214,-62634660,-63250118.2,22.629488485378516,31.919285419642414,NaN,NaN,-5.37166786108107,-1.3314723939357933
2000-05-09T09:30:00-04:00,143.0625,143.40625,140.26562,141.3125,5619801,11202880.1,43.4140043751844,47.51035715410426,NaN,NaN,-63.24355698346271,-63.899851141682504,-0.4073538980046759,-0.9393674988542671,-0.5320136008495912,-68254461,-65057838.6,21.840384409801942,31.155014500107708,NaN,NaN,-6.514597753785166,-2.0719188739142753
2000-05-10T09:30:00-04:00,140.5,140.96875,137.75,138.125,10293898,11267255.1,38.39811758566849,47.00209325244824,NaN,NaN,-130.09570708891746,-73.25316868460436,-0.6174100911629611,-1.3037762148032925,-0.6863661236403314,-78548359,-66488198.8,21.210149972683,30.44844951620638,NaN,NaN,-9.04712145288683,-3.0683763851960686
2000-05-11T09:30:00-04:00,140.125,141.5,139.125,141.28125,7091102,11082825.25,45.15520009168312,46.88623322170374,NaN,NaN,-74.4870764700162,-72.43324211941801,-0.5090216160113029,-1.3226431436544601,-0.8136215276431572,-71457257,-67693059,20.66909761597367,29.5806108022411,NaN,NaN,-9.201996803081881,-3.94460787346547
2000-05-12T09:30:00-04:00,141.8125,143.46875,141.625,142.8125,5960801,10769525.25,48.127947833907626,47.16215628452802,NaN,NaN,-10.416133770487503,-65.07964664210722,-0.3092636355086653,-1.2002010720289888,-0.8909374365203235,-65496456,-69278238.6,19.94811640500913,28.27050577168597,NaN,NaN,-8.421382972340737,-4.584147173304794
2000-05-15T09:30:00-04:00,142.75,145.60937,142,145.28125,4441301,9511399.9,52.58975217492308,47.04256515413486,NaN,NaN,35.1016914510386,-48.628156572369065,-0.002174728383870339,-0.8936558470001614,-0.8914811186162911,-61055155,-68962337.6,20.542945362019154,26.785903459410072,NaN,NaN,-6.359909687624038,-4.837827532493257
2000-05-16T09:30:00-04:00,146.5625,147.71875,145.3125,146.5625,8192000,8725090.3,54.76444758973387,47.27929553202943,NaN,NaN,99.40749392311736,-16.09794639105305,0.28031049711268596,-0.5410929972254337,-0.8214034943381197,-52863155,-65884076.4,26.290500673707953,25.76098450145471,NaN,NaN,-3.988566528434422,-4.716504531913424
2000-05-17T09:30:00-04:00,145.6875,146.1875,144.46875,145.15625,5906898,8472650.25,51.94795871283645,47.37335786413074,NaN,NaN,50.29879528477049,19.98095408368454,0.3604174134780853,-0.37088172749051296,-0.7312991409685983,-58770053,-61928415.2,32.997664870830164,25.363360442119976,NaN,NaN,-2.8303332184161696,-4.4470514871281015
2000-05-18T09:30:00-04:00,145.625,146.3125,143.8125,143.8125,4325301,8361230.35,49.33687045292985,47.39332274208091,NaN,NaN,27.047049350939545,40.28777924787569,0.3126453292714897,-0.3404924793792361,-0.6531378086507258,-63095354,-60256034.6,35.6631483714972,25.462325625830527,NaN,NaN,-2.61740830831195,-4.185673890154366
2000-05-19T09:30:00-04:00,142.5625,143.23437,140.40625,141.125,6518398,8260270.15,44.51741788179356,46.82237654313155,NaN,NaN,-68.01816102183703,28.767373797605778,0.10075788882601255,-0.5271904476182101,-0.6279483364442227,-69613752,-61079493.8,34.926379486358485,25.605591575171495,NaN,NaN,-3.8874489374069245,-4.14307032547616
2000-05-22T09:30:00-04:00,141.25,141.46875,137,140.0625,10839398,8157584.95,42.73985761883454,46.4928813498256,NaN,NaN,-122.50736848654415,-2.754438189910766,-0.09941233161781393,-0.7522137509664901,-0.6528014193486762,-80453150,-64959092.8,31.612754398766256,25.79556378022347,NaN,NaN,-5.468976406118911,-4.332485479853696
2000-05-23T09:30:00-04:00,140.4375,140.8125,137.5625,138,7979199,7851444.9,39.44710429320039,46.20754070731042,NaN,NaN,-129.79295248686765,-48.59452747190777,-0.3453362548484511,-1.0844717379092401,-0.739135483060789,-88432349,-72072931.6,26.624649627158504,25.893947948239248,NaN,NaN,-7.823596225730856,-4.831215586407575
2000-05-24T09:30:00-04:00,138,140.6875,136.5,140.25,11084500,8020114.8,44.47289502872922,46.25441449440096,NaN,NaN,-111.07819530507003,-80.86992558987588,-0.3310452077707764,-1.1529419927742595,-0.8218967850034831,-77347849,-75788490.8,24.454283415353203,25.940763127532794,NaN,NaN,-8.345698949063749,-5.3332846382156
2000-05-25T09:30:00-04:00,140.6875,141.8125,137.71875,137.84375,8278898,7654294.65,40.59264469819573,45.77772358347031,NaN,NaN,-101.67824743981066,-106.61498494802592,-0.4508020969671337,-1.3853994062124002,-0.9345973092452665,-85626747,-80294769.4,22.101169705041215,25.822195199969826,NaN,NaN,-9.992581733560977,-5.9988985089792255
2000-05-26T09:30:00-04:00,138.8125,139.6875,137.32812,138,4814000,7457824.75,40.95291360230717,45.461223709994826,NaN,NaN,-114.16570296746693,-115.8444933371519,-0.4837395489597691,-1.539271745444978,-1.055532196485209,-80812747,-82534568.4,21.01857254745758,25.707129775832616,NaN,NaN,-11.211311492848756,-6.743528935246301
2000-05-30T09:30:00-04:00,140,142.9375,139.46875,142.71875,5362602,7359539.8,50.68034573447425,45.98024809280124,NaN,NaN,-4.54560163845744,-92.25213996753456,-0.16826299257450694,-1.2658609372033425,-1.0975979446288355,-75450145,-81533967.4,22.83700538975131,25.77831698868614,NaN,NaN,-9.237824332705497,-7.0998568491690435
2000-05-31T09:30:00-04:00,142.5625,144,142.09375,142.8125,6056500,7191769.9,50.85357475967931,46.86992360523059,NaN,NaN,45.96101836836501,-57.10134579648801,0.054281722214504224,-1.0297457918607051,-1.0840275140752094,-69393645,-77726226.6,29.489957434536592,26.369731807389968,NaN,NaN,-7.623878829450878,-7.174717132066449
2000-06-01T09:30:00-04:00,143.6875,145.4375,143,145.3125,8961602,7030815.05,55.3566653187951,47.59859969288143,NaN,NaN,92.84957885307037,-16.315790964859936,0.3603499319292436,-0.6335900991636549,-0.9939400310928985,-60432043,-74343065.4,34.86360335087787,27.38362507416884,NaN,NaN,-4.826093314049984,-6.839199443778383
2000-06-02T09:30:00-04:00,148.9375,149.09375,147.48437,147.84375,8962199,7180744.9,59.41174033018326,48.40458487118684,NaN,NaN,176.15737283950617,39.25133309100344,0.7038974404456164,-0.114068230535878,-0.8179656709814944,-51469844,-67511684.8,44.12371215053153,29.110453341706155,NaN,NaN,-1.1286633526684158,-6.023408573619816
2000-06-05T09:30:00-04:00,147.46875,148.21875,146.875,147.125,6998102,7137530.1,57.80611738430423,48.777182386142634,NaN,NaN,133.9635988795519,88.8771934604072,0.8439151872163855,0.23692831303898743,-0.606986874177398,-58467946,-63042724.6,49.21055706598571,31.158139891989485,NaN,NaN,1.4011000239054894,-4.962764488259058
2000-06-06T09:30:00-04:00,146.625,147.78125,145.90625,146.46875,4858898,7127269.9,56.309774166762004,48.88756285593036,NaN,NaN,101.37287924159484,110.06088963641764,0.8510896112681081,0.4568751399077371,-0.394214471360371,-63326844,-60618064.4,51.77572464331081,32.9785130326754,NaN,NaN,3.0549140300300697,-3.8173818427891826
2000-06-07T09:30:00-04:00,146.625,148,146,147.48437,4919500,7092254.85,58.11671833202286,49.32818854301511,NaN,NaN,98.990974609319,120.66688088460846,0.8793793513034303,0.7050097177689167,-0.17436963353451346,-58407344,-58420804.2,54.041035549955275,34.481610938327194,NaN,NaN,4.966061096941796,-2.562604279970471
2000-06-08T09:30:00-04:00,147.5,147.75,146.0625,146.90625,5723102,6863715.05,56.679709323871705,49.85267703379667,NaN,NaN,83.91444092119156,118.87985329823269,0.8157077204518737,0.8452650170303286,0.02955729657845499,-64130446,-59160484.8,53.13613779125048,35.72968161116671,NaN,NaN,6.171455546509835,-1.314881447616142
2000-06-09T09:30:00-04:00,147.5,147.96875,145.625,146.59375,3085300,6663424.95,55.8754499124915,50.66396503598937,NaN,NaN,72.50418016780638,98.14921476389273,0.7128263409854453,0.9205902228102616,0.20776388182481634,-67215746,-62309665.2,49.34753310694144,36.75976401263693,NaN,NaN,6.967354348717264,-0.1317049052827981
2000-06-12T09:30:00-04:00,146.96875,146.96875,144.875,144.875,3436800,6537224.9,51.54344121076759,51.29279243541316,NaN,NaN,41.91916510364073,79.7403280087105,0.49939399745673063,0.8320063786457297,0.33261238118899905,-70652546,-64746585.2,46.57985333271667,37.8288425079191,NaN,NaN,6.492507594447079,0.8146111661071843
2000-06-13T09:30:00-04:00,144.8125,147.75,144.625,147.59375,6551500,6642734.85,57.19656110172109,52.560610778878925,NaN,NaN,62.17255234170147,71.90026262873182,0.5099115907634958,0.9700018696433688,0.46009027887987297,-64101046,-64901425.6,46.401774345787686,39.241494273535466,NaN,NaN,7.689429415049237,1.796728058813192
2000-06-14T09:30:00-04:00,148.25,148.875,147.1875,147.84375,6407102,6553489.95,57.685417279049716,53.50436236818752,NaN,NaN,88.20506328840044,69.7430803645481,0.5015332670171134,1.0870068626512648,0.5854735956341514,-57693944,-64758745.6,46.604348460336915,40.823641776748595,NaN,NaN,8.810640384794139,2.7987155339533274
2000-06-15T09:30:00-04:00,148.125,148.75,146.84375,148.15625,5776199,6546955,58.326126552677714,54.77103964350766,NaN,NaN,81.32989473747271,69.22617112780435,0.48459606233522323,1.1912186735531805,0.7066226112179572,-51917745,-62316205.4,50.08250873078623,42.82230885001609,NaN,NaN,9.920914811437838,3.8161725735939713
2000-06-16T09:30:00-04:00,148.3125,148.3125,145.875,146.59375,5526199,6606999.9,53.92919623684615,55.69791697454617,NaN,NaN,56.30645697251358,65.98662648874578,0.3424195810449492,1.1346470875241437,0.7922275064791945,-57443944,-60361845,52.73544542448442,45.08779976980372,NaN,NaN,9.69978956575717,4.656689286760143
2000-06-19T09:30:00-04:00,146.46875,149.15625,146.25,148.46875,5090500,6535605,58.0190230456178,56.22210821105642,NaN,NaN,71.81908751223402,71.96661097046444,0.34779144943294016,1.2269668182703697,0.8791753688374295,-52353444,-56702024.6,57.31086849887072,47.55021856331225,NaN,NaN,10.658022225742052,5.514022563757559
2000-06-20T09:30:00-04:00,148.1875,148.875,147,147.9375,5662301,6276750.15,56.488906022716215,56.62463187270191,NaN,NaN,67.05550949678846,72.94320240148184,0.29100822206971233,1.24293564642457,0.9519274243548577,-58015745,-55484964.4,58.741239941771745,49.63959588525762,NaN,NaN,11.039090551544268,6.303317990584231
2000-06-21T09:30:00-04:00,146.9375,148.4375,146.89062,147.84375,3112700,6033425.2,56.20719543624191,56.68538402394811,NaN,NaN,59.18004492496165,67.13819872879408,0.22550101675938583,1.2338036953040898,1.008302678544704,-61128445,-56171864.6,57.5688149511145,51.261396713845954,NaN,NaN,11.281297286964296,7.0144578900670975
2000-06-22T09:30:00-04:00,147.5625,147.6875,145,145.625,7486500,5853525.2,49.868652788029856,56.00373491379429,NaN,NaN,11.375446850442684,53.14730915138807,0.021833288987344712,1.035594289778885,1.0137610007915403,-68614945,-59511304.6,52.12216925938019,51.83271507876371,NaN,NaN,9.713729029620897,7.400068052860497
2000-06-23T09:30:00-04:00,145.8125,146.125,143.875,144.375,4469898,5663075.2,46.675134517726896,55.20866470903877,NaN,NaN,-44.90350640862668,32.90531647516002,-0.1959805794734908,0.7687852764496768,0.9647658559231675,-73084843,-62639484.4,47.58090018150041,51.71631101558619,NaN,NaN,7.4366552014156175,7.405294788368372
2000-06-26T09:30:00-04:00,145.375,146.25,144.875,146.23437,5194801,5682115.25,51.63648716304089,54.87485849448726,NaN,NaN,-30.21919726869753,12.497659518973709,-0.21236340322855563,0.699311601887473,0.9116750051160286,-67890042,-65746804,43.52427229047542,51.12692156181224,NaN,NaN,6.8527122501775946,7.326354425769689
2000-06-27T09:30:00-04:00,145.98437,146.71875,145.01562,145.15625,4076600,5617815.15,48.80126327507427,54.20946884756237,NaN,NaN,-59.59541642298786,-12.832525664981551,-0.28861406597236894,0.5509074226505675,0.8395214886229364,-71966642,-68536983.4,40.2092293766571,50.13893540657665,NaN,NaN,5.526373114326178,7.069214238420616
2000-06-28T09:30:00-04:00,145.625,146.98437,145.3125,145.5625,5320102,5580995.25,49.917176512552174,53.726430789610966,NaN,NaN,-59.01362007888457,-36.471258665750796,-0.30300470914427335,0.46076560219259477,0.7637703113368681,-66646540,-69640602.4,38.945690050128455,49.125331996496506,NaN,NaN,4.737192537278003,6.7360682811145285
2000-06-29T09:30:00-04:00,144.75,145.75,143.51562,144.1875,6339199,5449875.1,46.24338263398009,53.03842598400301,NaN,NaN,-169.3500492964982,-72.61635789513898,-0.3908529138332921,0.2752041690452529,0.666057082878545,-72985739,-70514761.2,37.92899616618365,48.3097222150138,NaN,NaN,2.991307920088201,6.201102515253624
2000-06-30T09:30:00-04:00,143.9375,145.59375,143.89062,145.28125,7396602,5371595.25,49.43157317021923,52.88757826682098,NaN,NaN,-118.168892094691,-87.26943503235184,-0.36169705651779493,0.2139357622313014,0.5756328187490963,-65589137,-69015620,40.78400043312063,47.89573272218552,NaN,NaN,2.3939893470322366,5.657229205507711
2000-07-03T09:30:00-04:00,145.4375,147.4375,145.1875,147.28125,1431900,5093285.15,54.719878608140796,52.710672374422394,NaN,NaN,8.283903019513877,-79.56881497470957,-0.2020745795111314,0.32303959436018204,0.5251141738713134,-64157237,-68269059,42.209547401448404,47.596287940447,NaN,NaN,3.4362453247839104,5.3399457939757395
2000-07-05T09:30:00-04:00,146.375,146.65625,144.375,144.625,2714800,4986080.25,47.60007007098677,51.99029043098932,NaN,NaN,-85.63266257376722,-84.77626420486544,-0.2657362551576151,0.19294385492429456,0.4586801100819097,-66872037,-67250138,44.18450222696467,47.423441780920406,NaN,NaN,2.1263842448183974,4.880865572667548
2000-07-06T09:30:00-04:00,144.9375,146.46875,144.21875,145.75,5382898,5009250.15,50.53558520342799,51.43382319175719,NaN,NaN,-60.83685464829306,-85.14091111874714,-0.22409465373194354,0.17856179291698027,0.4026564466489238,-61489139,-66218657.8,46.18931872217666,47.14535678030543,NaN,NaN,1.9510070019195118,4.462314348274972
2000-07-07T09:30:00-04:00,146.6875,148.78125,146.25,148.09375,3021300,4874160.05,56.05854064691287,51.58591922104767,NaN,NaN,85.93508964530739,-34.083883330386016,-0.04034538503382612,0.3522247153566411,0.39257010039046725,-58467839,-63315077.8,51.473265954810834,47.05520110390018,NaN,NaN,3.583312124183574,4.3367426019762005
2000-07-10T09:30:00-04:00,147.875,148.90625,147.53125,147.84375,2814500,4860620.05,55.34863765454436,51.395177407399565,NaN,NaN,100.09652506670918,9.569200101894022,0.057406665897694165,0.46432843276258495,0.4069217668648908,-61282339,-62453718.2,52.949283790988304,46.74365933905143,NaN,NaN,4.667605325232907,4.384008705298587
2000-07-11T09:30:00-04:00,147.46875,149.125,147.15625,148.15625,5420699,4959815,56.09705792256388,51.36718825738869,NaN,NaN,93.1460334894494,26.541626195881122,0.1318995972322849,0.5717962634052469,0.439896666172962,-55861640,-60794598.8,55.741717822472005,46.52940775910145,NaN,NaN,5.769462944925499,4.581930739531003
2000-07-12T09:30:00-04:00,149.28125,150.125,148.6875,149.125,5800699,4922274.95,58.423565370157824,51.52550039552553,NaN,NaN,139.21236634490106,71.51063197961477,0.2294888364709956,0.7267577117617066,0.49726887529071095,-50060941,-57432379.6,60.81686798458609,46.76141154720657,NaN,NaN,7.38226201938002,4.98197806522372
2000-07-13T09:30:00-04:00,149.98437,150.375,149.1875,149.78125,5354102,4869624.95,59.971053296232256,52.2471004318257,NaN,NaN,148.71592065846784,113.42118704096697,0.3159725334525235,0.8922345421063653,0.5762620086538418,-44706839,-54075919.6,65.11723375445143,47.68963043971166,NaN,NaN,9.181414093147856,5.581897497784311
2000-07-14T09:30:00-04:00,150.4375,151.25,149.67187,151.25,5335199,4847574.95,63.26643934903567,53.43219363406204,NaN,NaN,170.5216795457868,130.33850502106284,0.44209355992749133,1.128878958563206,0.6867853986357146,-39371640,-50256679.8,69.25243887821279,49.23759748947683,NaN,NaN,11.726486822219195,6.45969597270358
2000-07-17T09:30:00-04:00,150.98437,151.98437,150.6875,151,3933000,4767915,62.32589885210732,54.19572304042392,NaN,NaN,160.42565219997627,142.40433044771626,0.4757527936773205,1.2814763907323652,0.8057235970550447,-43304640,-46661140,72.55140676037891,51.310964237327084,NaN,NaN,13.570594015627524,7.475538550264143
2000-07-18T09:30:00-04:00,150.625,150.625,149.34375,149.76562,4245602,4725670.1,57.760014067681475,54.83563381132444,NaN,NaN,98.73537430858042,143.52219861154248,0.38578912561672873,1.2879600040759556,0.9021708784592268,-47550242,-44998860.4,73.94331691381151,53.72054191855239,NaN,NaN,13.903109545927908,8.39376297821611
2000-07-19T09:30:00-04:00,149.46875,149.90625,148.25,148.6875,8294199,4857265,54.03655197669693,55.12987491590621,NaN,NaN,59.03245118591107,127.48621557974448,0.23214991850634603,1.1923582765921594,0.9602083580858134,-55844441,-46155560.4,71.23628294509163,56.02701283962119,NaN,NaN,13.128241854730643,9.070117103432471
2000-07-20T09:30:00-04:00,149,150.625,148.8125,150.625,4283000,4915780,59.134921148426166,56.05069909550951,NaN,NaN,88.41241589601398,115.4255146272537,0.23857484497164716,1.2584269143003723,1.0198520693287252,-51561441,-47526480.8,68.05619851276869,58.178955864377265,NaN,NaN,13.944780229720283,9.766497550045015
2000-07-21T09:30:00-04:00,149.75,149.75,147.6875,147.6875,5370398,4809974.9,50.06729414338772,56.09610773645011,NaN,NaN,28.5195474722725,87.02508821255084,0.03333319270108959,1.0615185602050872,1.0281853675039976,-56931839,-51038520.6,60.59350893570801,59.59392075741921,NaN,NaN,11.747176653418048,10.049451707669734
2000-07-24T09:30:00-04:00,148.125,148.85937,146.5625,146.84375,5625301,4867745.05,47.80004859818916,55.601834164310716,NaN,NaN,-10.072010528429903,52.92555566686961,-0.16027560337079483,0.8278408632905041,0.9881164666612989,-62557140,-54889020.6,53.647723402278515,60.410933328907085,NaN,NaN,9.233063376357146,9.932824803196507
2000-07-25T09:30:00-04:00,147.75,147.84375,146.78125,147.3125,4488801,4832445.05,49.17699475016541,55.714471641394894,NaN,NaN,-17.869599716757936,29.604560861801946,-0.25231787324860533,0.6727191251005422,0.9250369983491475,-58068339,-56992640,50.25821255495349,60.844769780906276,NaN,NaN,7.603920826150119,9.600124235047023
2000-07-26T09:30:00-04:00,146.96875,147.15625,145.64062,145.875,11773301,5217280.1,45.23619654768036,55.33594388027007,NaN,NaN,-63.12928554640423,5.172213515338884,-0.3969525424795547,0.42884632024970415,0.8257988627292588,-69841640,-59792079.8,46.08532189539163,60.83734143613592,NaN,NaN,4.989779363467303,8.941503539107062
2000-07-27T09:30:00-04:00,145.9375,146.625,144.6875,145.375,7640000,5333275,43.91790737818201,54.46875578964644,NaN,NaN,-87.89239553262483,-30.08874877038888,-0.5062353254137985,0.1930047059620108,0.6992400313758093,-77481640,-64976119.6,39.53848050718662,59.984856761305615,NaN,NaN,2.4486706849930706,8.01395598851935
2000-07-28T09:30:00-04:00,145.71875,145.90625,141.51562,142.09375,6217102,5327170.15,36.41744446272771,53.116527704516685,NaN,NaN,-173.46078669442306,-70.484815603728,-0.7639705116198464,-0.2557231081489988,0.5082474034708476,-83698742,-70329500.2,34.144231253248435,58.64163872289562,NaN,NaN,-2.4143791384584876,6.524193827522516
2000-07-31T09:30:00-04:00,142.9375,144.125,142.0625,142.90625,5235000,5219090.05,39.187009221708244,51.908667083027,NaN,NaN,-165.37480015145766,-101.54537352833356,-0.8382470792626697,-0.5395614456074895,0.2986856336551802,-78463742,-73510820.6,31.402416682169388,56.90311721287401,NaN,NaN,-5.502509561139752,4.806093343427906
2000-08-01T09:30:00-04:00,143.625,144.71875,143.125,143.875,3939600,5344475.05,42.408135235129755,50.76470778766784,NaN,NaN,-119.20090488344502,-121.81163456167096,-0.7817595939369862,-0.6785138587660526,0.1032457351709336,-74524142,-76801981.2,28.823737124006698,54.61789357997548,NaN,NaN,-7.070279734085672,3.1094686180688242
2000-08-02T09:30:00-04:00,143.875,145.40625,143.625,144.59375,7432898,5580379.95,44.74655017582096,49.677243279067035,NaN,NaN,-95.09671585390451,-128.205120623171,-0.6604455285593789,-0.72231117552829,-0.06186564696891114,-67091244,-76251902,29.860449105494055,52.099551819335666,NaN,NaN,-7.6619099387950955,1.5707002528025502
2000-08-03T09:30:00-04:00,142.875,145.8125,142.625,145.59375,4544801,5538475.1,47.91522762167359,48.58072815568403,NaN,NaN,-87.37943751073772,-128.1025290187936,-0.48540489557113936,-0.6686217664328353,-0.18321687086169597,-62546443,-73264862.6,35.365808414137774,49.67907821475889,NaN,NaN,-7.214573540882453,0.31566113941897833
2000-08-04T09:30:00-04:00,146.3125,146.71875,145.40625,146.375,3679600,5571390.1,50.31262170730785,47.72263693105549,NaN,NaN,-36.24300483364682,-100.65897264663836,-0.29871918809912146,-0.5566158559855978,-0.25789666788647636,-58866843,-68298482.8,43.33028721158001,47.59185538984468,NaN,NaN,-6.132392442269554,-0.6054893722508119
2000-08-07T09:30:00-04:00,146.71875,148.4375,146.375,148.125,4134500,5637390.1,55.27831116467261,47.54537243798343,NaN,NaN,10.731531301967713,-65.43770635595328,-0.05201674353471131,-0.32291759730486547,-0.27090085377015416,-54732343,-63552203,49.70835293043693,45.86078653388936,NaN,NaN,-3.6576086213381314,-1.0415064078347147
2000-08-08T09:30:00-04:00,147.5,148.8125,147.5,148.6875,3591700,5545940.15,56.77368856774679,47.74088219448699,NaN,NaN,31.979613292974065,-35.20160272066946,0.14370556021818565,-0.09126890349742212,-0.23497446371560776,-51140643,-58875503.2,55.073828575258965,44.70632550747274,NaN,NaN,-1.166861995081083,-1.0594143488699101
2000-08-09T09:30:00-04:00,149.14062,149.21875,147.375,147.4375,5350898,5523450.1,52.56720072075344,47.271759306796085,NaN,NaN,24.489607546682098,-11.284338040552147,0.18121736307149824,-0.00845275987623495,-0.1896701229477332,-56491541,-56755562.6,57.297811188470675,43.93786927002289,NaN,NaN,-0.25133798004714614,-0.9439748676095153
2000-08-10T09:30:00-04:00,147.53125,147.85937,146.28125,146.71875,4188398,5465164.9,50.26120776724161,47.285610279928505,NaN,NaN,-5.233451349352264,5.144859191724953,0.15108956119301087,-0.0008081714564696085,-0.15189773264948048,-60679939,-56382261.8,57.694951603801904,43.73082946060102,NaN,NaN,-0.15132031514110528,-0.830738502971171
2000-08-11T09:30:00-04:00,146.625,148,145.5625,147.32812,5080898,5452449.85,52.17665829674033,47.59822525839645,NaN,NaN,1.6036322915780195,12.71418661676992,0.16455906662109204,0.05380110062688459,-0.11075796599420745,-55599041,-55728701.4,58.423986450109986,44.0719911068747,NaN,NaN,0.4795614696767151,-0.6435527925929017
2000-08-14T09:30:00-04:00,147.78125,149.5625,147.0625,149.28125,2917200,5401659.85,57.787768293413095,48.213280511485564,NaN,NaN,72.15909013864287,24.999698384104956,0.2900289864488149,0.25177826706681117,-0.03825071938200372,-52681841,-55318601,58.9025723256145,44.68944537620763,NaN,NaN,2.746877227140015,-0.15920564691677075
2000-08-15T09:30:00-04:00,149.34375,149.8125,148.5625,149.15625,5547602,5466759.85,57.324203507943736,49.076709580075814,NaN,NaN,96.44487562189008,37.89275084988816,0.34583881925070536,0.394047804681378,0.04820898543067263,-58229443,-56736361,56.48196662712827,45.432062857045956,NaN,NaN,4.4554302192384245,0.5000280482482571
2000-08-16T09:30:00-04:00,149.3125,149.9375,147.84375,148.625,5136898,5308894.8,55.29406059082173,49.88929195240722,NaN,NaN,82.0956232318186,49.413953986915466,0.32834725283708244,0.45864305147702567,0.13029579863994323,-63366341,-58111321,54.15751482459092,46.47627959400341,NaN,NaN,5.331381071898019,1.1902213373410802
2000-08-17T09:30:00-04:00,148.6875,150.4375,148.34375,150.1875,5612801,5375384.85,59.803126883886236,51.55969783963282,NaN,NaN,117.96988164190222,74.05462058516636,0.39869859010533915,0.6286690362716172,0.22997044616627804,-57753540,-57526041.2,55.00634376138048,47.966430487441414,NaN,NaN,7.437265085827836,2.082656158553474
2000-08-18T09:30:00-04:00,150.375,150.375,149.21875,149.6875,4620801,5337905,57.79430646803803,52.88879050008495,NaN,NaN,115.50724496426095,96.83534311970294,0.3878875778926377,0.7148299185320752,0.3269423406394375,-62374341,-58881101.2,52.57893197265665,49.47903872247622,NaN,NaN,8.631056478996527,3.018141918616767
2000-08-21T09:30:00-04:00,150.03125,150.71875,149.40625,150.5625,2359900,5174634.95,60.307078113817276,54.16728641999121,NaN,NaN,120.40319364402635,106.48416382077964,0.41363752202351795,0.843989243168835,0.430351721145317,-60014441,-60347621.2,50.00690903463809,50.99212243037846,NaN,NaN,10.37804251513084,4.069556289547349
2000-08-22T09:30:00-04:00,150.5625,151.3125,150.09375,150.3125,3017900,5101089.9,59.2221945798825,55.20126102028131,NaN,NaN,116.8243869345566,110.56006608331295,0.388215675288186,0.9156213152555495,0.5274056399673634,-63032341,-61308200.8,48.338931577395044,52.312014035514245,NaN,NaN,11.535412236603912,5.1361071391268585
2000-08-23T09:30:00-04:00,149.8125,151.28125,149.28125,150.84375,5477500,4786299.85,60.83455280629387,56.124069962039904,NaN,NaN,100.9157067014384,114.3240827772369,0.3810257244193217,1.0036877954915155,0.6226620710721938,-57554841,-60145900.8,50.490799637719185,53.39237055148435,NaN,NaN,12.96567667186936,6.254617072375787
2000-08-24T09:30:00-04:00,151.15625,151.54687,150.5,151.3125,4522398,4630419.75,62.252792191058596,56.97693928230782,NaN,NaN,110.35095200654035,112.80029685016453,0.3807830430862663,1.0986408749300267,0.7178578318437604,-53032443,-59201681.4,52.231535597227804,54.02817400760204,NaN,NaN,14.57335166461907,7.443007728410541
2000-08-25T09:30:00-04:00,151.15625,151.625,150.9375,151.25,2820400,4460584.65,61.93077696996433,57.452115411257225,NaN,NaN,108.70504949122738,111.43985775555782,0.3501364819809838,1.15552843431999,0.8053919523390063,-55852843,-57897381.8,54.60583844350284,54.37799440139246,NaN,NaN,15.83982751878903,8.642553412750326
2000-08-28T09:30:00-04:00,151.25,152.90625,151.25,151.76562,5497398,4473704.55,63.60345423612063,57.93995581614107,NaN,NaN,125.26210666866886,112.41164036048633,0.3381361373681683,1.2280621240492167,0.8899259866810484,-50355445,-55965582.6,57.94033267310024,54.58274469409541,NaN,NaN,17.38152733999,9.890978259498851
2000-08-29T09:30:00-04:00,151.4375,151.875,150.90625,151.79687,3528200,4453134.55,63.70753239223443,58.73569379267542,NaN,NaN,102.85001926820283,109.61676682721557,0.306769915431506,1.273388380970431,0.9666184655389249,-46827245,-52724563.4,62.86841309753719,54.98064483045731,NaN,NaN,18.713455234124158,11.151332113016752
2000-08-30T09:30:00-04:00,151.3125,151.5,150.34375,150.34375,3948600,4278919.65,55.727492460007774,59.126142699301575,NaN,NaN,66.42060327505683,102.71774614193926,0.16948158962028703,1.1784704525642837,1.0089888629439967,-50775845,-51368764.2,64.73013253884832,55.48315775438925,NaN,NaN,17.81833013965167,12.103760402536025
2000-08-31T09:30:00-04:00,151.0625,153.09375,150.90625,152.34375,4820801,4292719.65,62.660154055768636,59.874963824946455,NaN,NaN,117.03962899758821,104.05548154014882,0.1929839905066253,1.2502188510772783,1.057234860570653,-45955044,-49953284.4,66.61226698006959,56.06803493510064,NaN,NaN,19.018665092283417,13.091603929642796
2000-09-01T09:30:00-04:00,153.25,153.59375,152,152.375,3152900,4266384.65,62.75828371203271,60.230000640562146,NaN,NaN,131.19374106654257,108.55321985521186,0.18995399397055568,1.2946773530338476,1.1047233590632919,-42802144,-47343144.6,69.81141508703922,56.84723798948813,NaN,NaN,20.019717677527037,14.08133446505483
2000-09-05T09:30:00-04:00,151.875,152.20312,150.8125,151.28125,3450400,4232179.65,57.10199267450769,60.21412843817386,NaN,NaN,67.85972781071723,97.07274408362153,0.09822502680248779,1.2275046425664016,1.1292796157639138,-46252544,-46522564.4,70.75997993985818,57.86709608325456,NaN,NaN,19.25053183442217,14.819791232107308
2000-09-06T09:30:00-04:00,151.1875,151.78125,149.53125,149.78125,4164102,4260799.75,50.39393432890567,59.86411941946556,NaN,NaN,12.49201857742451,79.00114394546587,-0.07043995337011832,1.0412296740512659,1.1116696274213842,-50416646,-47240444.6,68.72548000870314,58.90766502497685,NaN,NaN,16.47574818706466,15.05635651138693
2000-09-07T09:30:00-04:00,150.25,151.07812,149.82812,150.84375,4078800,4197194.85,54.47365747096848,59.48344303282858,NaN,NaN,18.8317465324292,69.48337259694033,-0.1147919285943595,0.9681797166784349,1.0829716452727944,-46337846,-46352844.8,69.87865251258893,59.969972792920316,NaN,NaN,15.349468359435905,15.098229632536784
2000-09-08T09:30:00-04:00,150.28125,150.5,149.32812,149.8125,3476100,4161579.95,50.1615775580329,58.938248110685365,NaN,NaN,-34.05580259885164,39.26428627765236,-0.21225851642363014,0.8176484997432567,1.0299070161668868,-49813946,-47124625.2,67.54644414117178,61.03908080495711,NaN,NaN,13.029336921213758,14.80267353091921
2000-09-11T09:30:00-04:00,149.75,151.1875,148.6875,149.59375,3933800,4104225.05,49.27061987999553,58.14992966541238,NaN,NaN,-55.552169207885726,1.9151042227667006,-0.2855713228965092,0.6729428625462504,0.9585141854427596,-53747746,-49313745.6,61.29724492549348,61.845533368589635,NaN,NaN,10.88550030961196,14.243077356446745
2000-09-12T09:30:00-04:00,149.75,150.25,148.4375,148.46875,4742500,4195490.05,44.857829585823396,57.123903594408155,NaN,NaN,-119.89231930031451,-35.63530519943966,-0.3970857117174721,0.46215704579591943,0.8592427575133915,-58490246,-51761286,55.153414922937706,62.332282178985544,NaN,NaN,7.657664139566293,13.302304039749538
2000-09-13T09:30:00-04:00,148,149.34375,147.65625,148.89062,4555102,4145865.05,46.78264613157396,56.12019597478531,NaN,NaN,-146.49030590882458,-67.43177009668946,-0.4270756754469679,0.3253981632046816,0.7524738386516495,-53935144,-52464985.6,53.49329410307948,62.54674606936842,NaN,NaN,5.55327044777615,12.195299240896198
2000-09-14T09:30:00-04:00,149.875,149.9375,148.15625,148.46875,3391400,4058590.15,45.08772876598387,54.8941200158514,NaN,NaN,-129.8330302312258,-97.16472544942046,-0.45726770928157223,0.18088920204968417,0.6381569113312564,-57326544,-54662725.2,48.57562504582663,62.28560960141119,NaN,NaN,3.3019704885250976,10.924823704843183
2000-09-15T09:30:00-04:00,148.1875,148.25,146.03125,146.09375,4075700,3981735.1,36.967726608455806,53.11104499002936,NaN,NaN,-236.69613512178765,-137.69279195400767,-0.6096056685667394,-0.12385017437716783,0.48575549418957154,-61402244,-56980384.8,43.983556137563404,61.52687515098694,NaN,NaN,-1.5014524422934885,9.149641398109372
2000-09-18T09:30:00-04:00,146.375,146.96875,144.20312,144.65625,5104301,4005910.1,33.084031450760406,50.93108621964649,NaN,NaN,-253.47670269841737,-177.277698652114,-0.7692980455539635,-0.47586706275288293,0.2934309828010806,-66506545,-59532144.6,39.55037544039859,60.21330677722254,NaN,NaN,-6.936373034132863,6.851639336360481
2000-09-19T09:30:00-04:00,145.125,146.3125,144.70312,145.96875,6547801,4215305.15,39.34923015822784,49.191207488646015,NaN,NaN,-183.465165527411,-189.99226789753328,-0.7479767294398671,-0.6415399289987533,0.10643680044111381,-59958744,-59825844.2,39.06236193547089,58.51287455136066,NaN,NaN,-9.438402967982418,4.524490435740068
2000-09-20T09:30:00-04:00,145.6875,146.03125,143.15625,144.89062,6498500,4389335.15,36.3394169839135,47.80634495463928,NaN,NaN,-177.914393258427,-196.27708536745376,-0.7651768673162657,-0.8500342837042183,-0.08485741638795263,-66457244,-62330264.2,35.08667699675321,56.395484869782436,NaN,NaN,-12.511216473332972,2.090818020158205
2000-09-21T09:30:00-04:00,144.46875,145.5625,143.75,145.1875,5346602,4382790.25,37.75139334963101,46.027147761343734,NaN,NaN,-143.02743816169624,-198.91596695354787,-0.7161259278340896,-0.9800148261805646,-0.263888898346475,-61110642,-63087083.8,33.961777395733606,54.06330704232987,NaN,NaN,-14.508837573194313,-0.28056135032072627
2000-09-22T09:30:00-04:00,142.625,145.3125,142.42187,145.28125,7587398,4536040.25,38.21740628387343,44.27422794504664,NaN,NaN,-135.1373837862856,-178.60421668644744,-0.639452514065048,-1.063204540927785,-0.42375202686273705,-53523244,-61511283.8,38.39082478746987,51.8189791637892,NaN,NaN,-15.968565685692413,-2.5217048268023956
2000-09-25T09:30:00-04:00,145.9375,146.0625,143.71875,144.15625,9715398,4880790.15,34.84616912300058,42.68452626279613,NaN,NaN,-109.34968442708458,-149.7788130321809,-0.6258055517461054,-1.2060089665453688,-0.5802034147992634,-63238642,-60857703.2,40.18276704396253,49.63489252836808,NaN,NaN,-18.25769330031687,-4.769703180161606
2000-09-26T09:30:00-04:00,144.375,145,142.40625,142.40625,5281199,4869980.2,30.35978011759302,41.253515247702374,NaN,NaN,-125.21248071139091,-138.12827606897685,-0.690837446932273,-1.4437502234646047,-0.7529127765323317,-68519841,-62569922.6,37.135484948767136,47.378464309801224,NaN,NaN,-21.747963479056647,-7.195168937146612
2000-09-27T09:30:00-04:00,143.5625,143.96875,142.125,143.15625,6049301,4996035.25,34.265857031541145,39.81010093060042,NaN,NaN,-113.44539976597203,-125.23447737048589,-0.6406559285063355,-1.553732687165251,-0.9130767586589156,-62470540,-61772581.8,39.438714187585404,45.2041830008724,NaN,NaN,-23.408648599370512,-9.511380317464312
2000-09-28T09:30:00-04:00,143.1875,146.32812,142.89062,146.125,6842801,5140745.3,46.95004628457746,39.58070583963932,NaN,NaN,-58.43550026196262,-108.31608979053917,-0.3778358465521263,-1.3853715668490736,-1.0075357202969473,-55627739,-60676001.2,42.555869964589526,43.41914198825939,NaN,NaN,-20.4931673029093,-11.080207029670738
2000-09-29T09:30:00-04:00,145.46875,145.96875,143.625,143.625,8311699,5315290.2,39.957695515187886,38.915496956438766,NaN,NaN,-68.86612937345477,-95.061838907973,-0.3436571801377759,-1.4371071954691672,-1.0934500153313913,-63939438,-62759240,38.501492622888705,41.79087396664476,NaN,NaN,-20.51890239016492,-12.428592081169906
2000-10-02T09:30:00-04:00,144.28125,144.90625,143.14062,143.84375,5517801,5433535.25,40.788664425059004,38.62484230209846,NaN,NaN,-74.50660753393706,-88.09322352934352,-0.28029068790202194,-1.4438133752089186,-1.1635226873068967,-58421637,-61795839,41.287290090942776,40.80043647864512,NaN,NaN,-20.253412667893155,-13.546423593558941
2000-10-03T09:30:00-04:00,144.53125,145.75,142.28125,142.5,9347199,5728375.2,37.36748111029405,37.95233051486418,NaN,NaN,-81.0352774705637,-79.25778288117807,-0.30102786867511044,-1.5398075231507846,-1.2387796544756742,-67768836,-61645638,41.730466789474605,39.96023452767334,NaN,NaN,-21.18675082692728,-14.637898912611561
2000-10-04T09:30:00-04:00,142.875,144.25,141.75,143.6875,6149000,5827620.1,41.99750626408375,37.73160033615703,NaN,NaN,-84.41636102807163,-73.45197513359798,-0.21116796010569816,-1.5027396046077968,-1.2915716445020986,-61619836,-61475497.2,42.26211698509864,39.50926966619277,NaN,NaN,-20.399654689003064,-15.46100688066749
2000-10-05T09:30:00-04:00,143.40625,144.84375,143.3125,144.1875,4566898,5852025,43.87869472073446,38.22524091560551,NaN,NaN,-53.9414099223903,-72.55315706568352,-0.10009189283042619,-1.4166865105401314,-1.3165946177097052,-57052938,-61760537,41.57769094723705,39.33742215259803,NaN,NaN,-19.168550863341302,-15.990656021049464
2000-10-06T09:30:00-04:00,143.875,144.64062,139.75,141.0625,10014898,6178964.9,36.01638036206319,38.43469440926999,NaN,NaN,-132.47435590983395,-85.27480237295933,-0.21265164096344535,-1.5824091689140118,-1.3697575279505665,-67067836,-62386216.6,40.04465953103605,39.37272815907214,NaN,NaN,-20.77179927534519,-16.673676485948853
2000-10-09T09:30:00-04:00,141.3125,141.3125,139.375,140,4508000,6207674.9,33.7988852013421,38.03824119806387,NaN,NaN,-189.3559756289932,-108.24467599197055,-0.3273728099266593,-1.7789735403588907,-1.4516007304322314,-71575836,-65017056.4,34.31530561236133,39.033652707421446,NaN,NaN,-22.813283853663126,-17.55076325276518
2000-10-10T09:30:00-04:00,140.09375,141.25,137.6875,137.6875,6104699,6275784.85,29.53644477774904,37.55231461190927,NaN,NaN,-220.41252383466446,-136.12012526479072,-0.5164607732653406,-2.097176697013907,-1.5807159237485666,-77680535,-66999396.2,30.74574731417529,38.72358630152303,NaN,NaN,-26.06807905811212,-18.767522653529028
2000-10-11T09:30:00-04:00,137.625,138.625,135.125,136.53125,10366000,6566329.75,27.658271452302174,36.831377333528636,NaN,NaN,-247.62600203225492,-168.7620534656274,-0.6672818067423723,-2.414818182176532,-1.7475363754341597,-88046535,-72284736,23.67461416966512,37.98878892823242,NaN,NaN,-29.325090383878464,-20.27574661500752
2000-10-12T09:30:00-04:00,137.28125,137.59375,132.78125,133.125,12336801,7013599.8,23.015232984308028,35.7455078121311,NaN,NaN,-249.47178237432237,-207.8681279560138,-0.9282804555158626,-2.907886944828988,-1.9796064893131253,-100383336,-80950815.6,16.837016509419186,36.44923119408595,NaN,NaN,-33.93814072321108,-22.227517201893743
2000-10-13T09:30:00-04:00,132.9375,137.65625,132.875,137.5625,11776801,7398654.85,37.69028206043968,35.9486587362339,NaN,NaN,-161.93230337130746,-213.7597174483085,-0.7419687791137806,-2.907067463205351,-2.1650986840915705,-88606535,-85258555.4,14.582452026575737,34.6206372642726,NaN,NaN,-32.17123053253555,-23.648047677699715
2000-10-16T09:30:00-04:00,137.40625,138.23437,136.6875,138.1875,5659000,7426389.8,39.44124923689339,36.5973351018982,NaN,NaN,-101.93776363230462,-196.27607504897077,-0.5266721690475755,-2.82343889540104,-2.2967667263534643,-82947535,-87532895.2,13.550756303082764,32.93601378958086,NaN,NaN,-30.215881958229847,-24.58630971777545
2000-10-17T09:30:00-04:00,138.4375,138.5625,134.40625,134.75,7831699,7490584.7,33.813222469191444,36.56500406173037,NaN,NaN,-121.9737925870162,-176.58832879944111,-0.5625534350037724,-2.99995852010818,-2.4374050851044076,-90779234,-90152635,12.45745956989947,31.00878131688901,NaN,NaN,-30.68374662283146,-25.45737213278345
2000-10-18T09:30:00-04:00,132.625,136.125,130.15625,134.25,10897301,7710524.75,33.07395165591093,35.57385444539705,NaN,NaN,-144.90341467444583,-156.04381132787927,-0.5652406117387114,-3.1439558497777966,-2.578715238039085,-101676535,-92878635,11.42454194336004,28.785115029658332,NaN,NaN,-31.294096133938098,-26.291189847234115
2000-10-19T09:30:00-04:00,136.84375,139.45312,136.4375,139.28125,8767301,7881559.7,45.89312515675706,35.99781370550914,NaN,NaN,-44.53197520106703,-115.05584989322821,-0.1927017594992968,-2.819592437413206,-2.6268906779139094,-92909234,-91383814.6,15.55917087494791,27.146377761948276,NaN,NaN,-26.90768445297969,-26.37926050519777
2000-10-20T09:30:00-04:00,138.375,141.1875,138.375,139.90625,7373500,7870864.8,47.2449416881843,36.45897636716094,NaN,NaN,-12.662517654092202,-85.20189274978517,0.11473502123228929,-2.483471901373548,-2.5982069226058373,-85535734,-90769654.4,17.267904991578305,25.430707397707955,NaN,NaN,-23.134468460325834,-25.91571878450178
2000-10-23T09:30:00-04:00,139.9375,141.03125,138.9375,140.53125,5290000,7649594.9,48.62718144446186,37.26324067674436,NaN,NaN,-1.171175685051321,-65.0485751603345,0.36498923639642067,-2.1419703771103116,-2.5069596135067322,-80245734,-90229294.2,18.82435127858048,23.794556289786946,NaN,NaN,-19.748579112485125,-25.034698831356543
2000-10-24T09:30:00-04:00,140.96875,141.9375,139,139.59375,5750699,7673069.9,46.65261737814847,37.59574861346327,NaN,NaN,2.554289977229915,-40.14295864748527,0.4657368037743099,-1.9247886087888446,-2.3905254125631545,-85996433,-89272734,21.634933275749475,22.32118602483343,NaN,NaN,-17.65787704508949,-23.98086714760411
2000-10-25T09:30:00-04:00,138.75,139.5625,136.125,136.3125,9136102,7827409.95,40.46004339537791,37.35155923308066,NaN,NaN,-56.21623287568402,-22.405522287732932,0.3168609888281173,-1.9944491765280077,-2.311310165356125,-95132535,-87963934,25.43883126417434,21.1684103331861,NaN,NaN,-17.884100991026834,-23.109900553807353
2000-10-26T09:30:00-04:00,137.125,137.65625,134.03125,136.6875,9345801,7952559.95,41.41711097548018,37.73732570546758,NaN,NaN,-75.86801554116748,-28.672730355753014,0.2519415331202417,-1.9963832489558229,-2.2483247820760646,-85786734,-86539434,29.452677576652377,20.411840193587263,NaN,NaN,-17.760143281742984,-22.345649514941016
2000-10-27T09:30:00-04:00,137.875,139.28125,136.625,139.28125,9762898,8025119.9,47.68139932979777,38.72893385750013,NaN,NaN,-16.352142019884322,-29.41065522891144,0.3840686978994512,-1.7682389097017506,-2.1523076076012018,-76023836,-84637054.4,34.522140124014996,20.426614087276814,NaN,NaN,-15.623277698496855,-21.38531068402042
2000-10-30T09:30:00-05:00,138.4375,141.09375,138.15625,140.53125,10154102,8256934.95,50.432248368724956,40.22149125685555,NaN,NaN,31.086602763625827,-22.959099539176016,0.5461441866584322,-1.4696273742781614,-2.0157715609365936,-65869734,-81761854.4,41.37850380197121,21.18609669354795,NaN,NaN,-13.00200662183921,-20.187695817994534
2000-10-31T09:30:00-05:00,141.01562,143.6875,140.0625,142.95312,7752398,8177194.9,55.33259558047429,42.198228694582134,NaN,NaN,100.77093635676205,-3.315770263269589,0.7920356723776831,-1.0257269704644898,-1.817762642842173,-58117336,-76186035,51.89785857770926,23.20204272269396,NaN,NaN,-9.161811272300891,-18.612569454324014
2000-11-01T09:30:00-05:00,142.25,143.25,141.21875,142.46875,6753602,8207425,54.17895805561335,44.42420905681822,NaN,NaN,106.49391701372558,29.226259714612333,0.8902967064049707,-0.7048917598359594,-1.5951884662409301,-64870938,-70133715.6,60.23839421989068,26.30214113058478,NaN,NaN,-6.442502283942179,-16.87398842998375
2000-11-02T09:30:00-05:00,143.15625,143.90625,142.51562,142.70312,11395102,8548835.2,54.67141690010233,45.63714725965127,NaN,NaN,132.84340993360468,70.96854480956677,0.9347139690264181,-0.42679600495790737,-1.3615099739843255,-53475836,-63671536,66.8480707604958,30.035399611579066,NaN,NaN,-4.104777496702436,-15.049815439514992
2000-11-03T09:30:00-05:00,143.46875,143.75,142.375,142.78125,5187102,8307445.4,54.84563976949955,46.73746086912314,NaN,NaN,125.5957362502152,99.35812046358667,0.930953298551719,-0.1978183507946767,-1.1287716493463957,-48288734,-58124515.6,71.26387593590687,34.15776529963794,NaN,NaN,-2.1482104745804818,-13.20672901595292
2000-11-06T09:30:00-05:00,143.15625,144.29687,143.03125,143.78125,4042500,8284170.4,57.11749187454945,48.40205154093443,NaN,NaN,131.89903762187123,119.52060743523575,0.9539025323982102,0.06360651615136703,-0.8902960162468432,-44246234,-53799815.6,74.15435231043266,38.56468620967602,NaN,NaN,0.16202573901785944,-11.296906908099952
2000-11-07T09:30:00-05:00,143.14062,144,142.5625,143.75,5231301,8240500.5,57.020942501258574,50.112550887030686,NaN,NaN,108.27944167471915,121.02230849882717,0.9244038774184389,0.2652088305262055,-0.6591950468922334,-49477535,-52071855.4,75.22658618469558,43.12197508405712,NaN,NaN,2.0522431661737004,-9.389885468918003
2000-11-08T09:30:00-05:00,144.0625,144.0625,140.5625,140.5625,6123301,8028365.55,48.09134109103807,50.269566310907905,NaN,NaN,59.46004254367015,111.6155336048161,0.6600468651962137,0.1658635346030337,-0.49418333059318,-55600836,-50217835,76.35981704637409,47.46487838201614,NaN,NaN,1.279981776435394,-7.8656187195818035
2000-11-09T09:30:00-05:00,140,141.21875,137.25,140.03125,10635301,7943290.55,46.77654249144465,50.2361092254265,NaN,NaN,-3.4001502436484983,84.36682156936544,0.4303545052230156,0.04375980093558951,-0.3865947042874261,-66236137,-52769895.2,71.51067921367587,51.339362255023104,NaN,NaN,0.26398216454463624,-6.704247164706598
2000-11-10T09:30:00-05:00,139,139.46875,136.53125,136.625,8569500,7782925.5,39.34837904864051,49.57333762572498,NaN,NaN,-62.83460918027197,46.68075248326802,0.049973482327022256,-0.3241278513786483,-0.37410133370567056,-74805637,-58073275.8,62.61239038625625,54.4670793341428,NaN,NaN,-3.0206626759127393,-6.178020809164618
2000-11-13T09:30:00-05:00,135.625,136.98437,133.01562,135.5625,17285296,8364240.3,37.355656613078786,48.909268999648575,NaN,NaN,-120.52410683648633,-3.803876408403491,-0.25545732349656597,-0.693422988076378,-0.43796566457981206,-92090933,-67642215.6,50.421236863113656,56.523243876097396,NaN,NaN,-6.366261590393458,-6.204912349340167
2000-11-14T09:30:00-05:00,137.46875,139.625,137,139.125,7668898,8356100.25,47.04015794014241,49.379277181417464,NaN,NaN,-32.82061339327224,-32.02388742200177,-0.20216066367377838,-0.6906664941720351,-0.4885058304982567,-84422035,-74631115.6,43.72482331101968,57.82938616515777,NaN,NaN,-6.273627019018613,-6.214728730722802
2000-11-15T09:30:00-05:00,139.0625,140.10937,137.75,139.5625,8837699,8253120.15,48.10126700526194,49.856716897830445,NaN,NaN,-28.322417513095015,-49.58037943335479,-0.12578391145094525,-0.6457357198119382,-0.519951808360993,-75584336,-78627815.6,40.418914817149826,58.6126888251933,NaN,NaN,-5.869855918673025,-6.165461186144262
2000-11-16T09:30:00-05:00,139.5625,139.875,137.3125,137.375,6684102,8148960.2,43.41713434227851,49.55212654157907,NaN,NaN,-59.64275350943122,-60.828900086511354,-0.20617948054929802,-0.7776761590476156,-0.5714966784983175,-82268438,-81834275.8,37.94049568921282,58.85685707985029,NaN,NaN,-7.0122960436447554,-6.286437594358619
2000-11-17T09:30:00-05:00,137.3125,139,135.75,136.64062,6551102,8107840.3,41.9405303081591,48.94557525153865,NaN,NaN,-84.90338341081656,-65.24265493262027,-0.287417786498977,-0.9307689116220388,-0.6433511251230618,-88819540,-84637056.4,35.87002216889496,58.463394106059134,NaN,NaN,-8.394892457235471,-6.587645431912454
2000-11-20T09:30:00-05:00,135.75,136.375,134.3125,134.6875,5458500,8116265.3,38.217801770739165,47.723089979414716,NaN,NaN,-128.11370396745104,-66.76057435881322,-0.44204771366979645,-1.1959107672103073,-0.7538630535405109,-94278040,-85074477.8,35.544013794957706,57.295262335862596,NaN,NaN,-10.752203436887896,-7.1825822897660885
2000-11-21T09:30:00-05:00,134.875,136.1875,133.51562,135.375,7684301,8212945.4,40.22896215834852,46.72666170103866,NaN,NaN,-115.41001130577705,-83.27845394131417,-0.46504641530720137,-1.3351710726745125,-0.8701246573673111,-86593739,-85508818.6,35.20189382651421,55.50694087919284,NaN,NaN,-12.079938379965965,-7.88220458836607
2000-11-22T09:30:00-05:00,134.34375,134.875,132.125,132.14062,5736898,8042985.2,34.53352251961368,45.2882406738609,NaN,NaN,-150.87380711974325,-107.78873186264381,-0.6535608694809996,-1.6870757442185607,-1.033514874737561,-92330637,-88858078.8,32.59643061155046,53.06039515426818,NaN,NaN,-15.128360275093172,-8.917369686469941
2000-11-24T09:30:00-05:00,133.625,134.96875,133.625,134.84375,3411600,7746275.15,41.93265747562467,44.36588479572697,NaN,NaN,-109.8593117307227,-117.83204350690212,-0.555527537061131,-1.727924296063975,-1.172396759002844,-88919037,-90188198.6,31.596244239936468,50.226992890270296,NaN,NaN,-15.325281697531018,-9.832785688050095
2000-11-27T09:30:00-05:00,136.46875,136.6875,135.3125,136.03125,5992000,7557730.25,44.87994809637491,43.49177452585736,NaN,NaN,-67.16029618927453,-114.2834260625937,-0.37848847881865,-1.6455073575261565,-1.2670188787075065,-82927037,-89009698,33.54197197606128,47.32610858067234,NaN,NaN,-14.535466576609334,-10.504597243558557
2000-11-28T09:30:00-05:00,135.125,136.59375,133.64062,133.6875,5336102,7316830.25,40.50964281305105,42.31239597669968,NaN,NaN,-88.51837885404413,-106.36436103991232,-0.3857043157546376,-1.7491492734008034,-1.3634449576461658,-88263139,-87806717.8,35.55704560414556,44.49256996777591,NaN,NaN,-15.284814373078392,-11.187485404918533
2000-11-29T09:30:00-05:00,134.375,135.90625,133.26562,133.4375,6914102,7274915.45,40.061516728718075,41.73883709367682,NaN,NaN,-89.4210110545087,-101.16656098965865,-0.37353195350837076,-1.8303598995316293,-1.4568279460232585,-95177241,-89523418.2,33.97393926732374,41.465007269272306,NaN,NaN,-16.014515211004248,-11.877061091502206
2000-11-30T09:30:00-05:00,132.5,133.5,129.75,132.28125,11201602,7497315.45,37.96946367839897,41.10976003560213,NaN,NaN,-127.51445999863671,-96.49469156543735,-0.40682894192429586,-1.9653641234286283,-1.5585351815043325,-106378843,-92333059.4,31.501863900274856,38.607234746886526,NaN,NaN,-17.255503632027132,-12.64541002586291
2000-12-01T09:30:00-05:00,133.1875,134.0625,131,132.21875,7587199,7306920.3,37.854390391783994,41.003046560112374,NaN,NaN,-105.85522172469008,-95.69387356423083,-0.3961519400419149,-2.053725106556726,-1.6575731665148112,-113966042,-97342460.4,27.640183391871517,36.10921996157333,NaN,NaN,-18.289037124230916,-13.451642468486911
2000-12-04T09:30:00-05:00,131.875,133.875,131.5,133.34375,6996398,7397385.1,41.302768361047555,41.284983113538715,NaN,NaN,-87.8842328435732,-99.83866089509056,-0.2817862128517481,-2.0098059325794964,-1.7280197197277483,-106969644,-102150981.8,24.531511822771975,34.259953887263215,NaN,NaN,-18.197226298613618,-14.129583015647869
2000-12-05T09:30:00-05:00,134.875,138.25,134.40625,137.71875,8883398,7639430,52.37116236546805,41.665769143919114,NaN,NaN,11.899304555073572,-79.75512421326701,0.09962401336316096,-1.6034897030237971,-1.703113716386958,-98086246,-104115603.2,23.374778045684735,32.80637922545357,NaN,NaN,-14.534894444679027,-14.187484648366606
2000-12-06T09:30:00-05:00,137.78125,138.34375,135.03125,135.51562,12888000,8022264.95,47.51245022631254,41.62371080256558,NaN,NaN,9.740953771469549,-59.922731248071365,0.20839045157920788,-1.4426256519129481,-1.651016103492156,-110974246,-107275004.2,21.610058820631465,31.462889511416545,NaN,NaN,-12.986464541647672,-14.01591034740676
2000-12-07T09:30:00-05:00,134.875,135.875,133.65625,133.65625,6529102,8042555,43.817669963930875,41.652320489826465,NaN,NaN,-44.05307942688271,-43.23045513372056,0.16203032516795202,-1.448478197032216,-1.610508522200168,-117503348,-109499905.2,20.43976568563248,30.212837368303664,NaN,NaN,-12.886507892268892,-13.854567139529921
2000-12-08T09:30:00-05:00,137.0625,139.125,133.875,133.96875,10276102,8024595.05,44.59746366014802,41.84210144353996,NaN,NaN,9.123780165408016,-20.23465475570095,0.15910451741146203,-1.4116278754358405,-1.5707323928473025,-107227246,-108152146,23.154597291213875,29.304592734183583,NaN,NaN,-12.56838765899789,-13.670827213739631
2000-12-11T09:30:00-05:00,137.375,139.5625,136.71875,138.625,6405602,7916400.15,54.68894838132102,43.01861191572438,NaN,NaN,111.9048901369456,19.723169840402807,0.4604012206317276,-0.9952308670576429,-1.4556320876893705,-100821644,-106922546,25.647351836935144,28.597688308610543,NaN,NaN,-8.828859140846717,-12.979117489040643
2000-12-12T09:30:00-05:00,138.1875,138.8125,137.375,138.03125,5022898,7303280.25,53.354359967647255,43.956140330674295,NaN,NaN,90.90035901715902,35.523380732819895,0.6004921463566266,-0.7050169047435872,-1.3055090511002139,-105844542,-108474205.2,24.564457761717733,27.837871446839365,NaN,NaN,-6.310900294982541,-12.026515032746628
2000-12-13T09:30:00-05:00,139.25,139.40625,136.03125,136.14062,6070500,7223360.35,49.234303381004224,45.0061961064879,NaN,NaN,63.38334494494147,46.25185896751428,0.5480661210860698,-0.6204263997426267,-1.1684925208286965,-111915042,-108662364.4,24.42975504312018,27.254537477665775,NaN,NaN,-5.512480735920844,-11.09593870462866
2000-12-14T09:30:00-05:00,135.875,136.5,134.03125,134.40625,7778398,7170395.3,45.74456656966275,45.27847532749062,NaN,NaN,-15.216411722866816,52.01919250831746,0.38644545407508146,-0.6854357032348446,-1.071881157309926,-119693440,-109100382.8,24.09846367892723,26.71898172330797,NaN,NaN,-5.956718053622257,-10.361764325913459
2000-12-15T09:30:00-05:00,133.125,133.125,130.5625,130.96875,9065301,7289455.25,39.73331005379501,44.9108583244492,NaN,NaN,-147.8444980163281,20.62553687197024,0.055285558365660625,-1.0027742093528502,-1.0580597677185108,-128758741,-113406681.8,21.07286636555861,25.828331322557784,NaN,NaN,-8.369284365771112,-10.07712433160741
2000-12-18T09:30:00-05:00,132.0625,133.46875,131.76562,132.71875,7235398,7323670.05,43.7834493799648,45.144701650657325,NaN,NaN,-90.66715160869518,-19.888871477157913,-0.033850168338898534,-1.100372478142134,-1.0665223098032355,-121523343,-117547021.6,18.648579475258714,24.62058374192301,NaN,NaN,-9.024083639956611,-9.926689947085867
2000-12-19T09:30:00-05:00,132.46875,134.96875,130.01562,130.01562,9616699,7531580,39.38101312769265,45.09609425058409,NaN,NaN,-116.00153452707666,-61.269250186005046,-0.25072839451039286,-1.3799328029412266,-1.1292044084308337,-131140042,-122606121.6,16.1966520357403,23.35077751109562,NaN,NaN,-11.055498712942443,-10.087948342208236
2000-12-20T09:30:00-05:00,128.625,128.9375,126.09375,126.25,9994199,7647074.9,34.219149190899955,44.828214644334146,NaN,NaN,-231.4009918031722,-120.22611753562781,-0.6035381984755106,-1.8836271565252218,-1.2800889580497112,-141134241,-128449961.4,13.91993621835445,22.094925533815594,NaN,NaN,-14.628291334076913,-10.736568769618048
2000-12-21T09:30:00-05:00,126,128.85937,125.53125,127.125,14331500,8076805,36.30824858814754,44.717775944074404,NaN,NaN,-187.19284766088145,-154.6214047232307,-0.725523296351928,-2.186993078489621,-1.4614697821376932,-126802741,-129871821.6,13.42544834012645,21.079587315833802,NaN,NaN,-16.74838034083201,-11.595398994077184
2000-12-22T09:30:00-05:00,129,131.10937,128.84375,130.9375,10182898,8415369.9,44.56865668098011,44.95105368121244,NaN,NaN,-88.27287761266173,-142.70708064249746,-0.50731927805305,-2.0956188797040056,-1.5882996016509556,-116619843,-127444042,18.733865570369474,20.66546972637648,NaN,NaN,-15.763621372942918,-12.190859333915146
2000-12-26T09:30:00-05:00,130.84375,132.34375,130.28125,132.34375,4665301,8349034.95,47.28443635182294,44.58771610880922,NaN,NaN,-47.68869173419178,-134.11138866759677,-0.23973489780458146,-1.8879682239066824,-1.648233326102101,-111954542,-125530281.8,22.75464382935148,20.621174425209823,NaN,NaN,-14.074478349975106,-12.459947764780855
2000-12-27T09:30:00-05:00,132,133.73437,131.25,133.3125,4854102,8324934.95,49.133306872613744,44.703491583545016,NaN,NaN,-16.596253356162265,-114.2303324334139,0.017399097687723408,-1.6264844539924468,-1.6438835516801702,-107100440,-120722361.4,31.874067903179096,21.354317931106078,NaN,NaN,-12.132212383659015,-12.413128424620592
2000-12-28T09:30:00-05:00,132.8125,133.875,132.59375,133.71875,8358699,8397164.8,49.92643346397707,45.139831833548314,NaN,NaN,1.0745438043428603,-67.7352253119109,0.2185665135744057,-1.3706754097121632,-1.5892419232865689,-98741741,-112243861.4,44.350789353752454,23.062248193114648,NaN,NaN,-10.336739904382089,-12.116501493157948
2000-12-29T09:30:00-05:00,134.0625,134.28125,131.1875,131.1875,8774602,8275814.8,45.19763242429685,45.182701030987516,NaN,NaN,-31.17731291222804,-36.532118362180185,0.1861470885026537,-1.3565580626582516,-1.5427051511609053,-107516343,-108386581.8,48.933000935870076,24.90356273916152,NaN,NaN,-10.21588985607945,-11.844985545003876
2001-01-02T09:30:00-05:00,132,132.15625,127.5625,128.8125,8737398,8333324.75,41.24982577491037,44.22276370195818,NaN,NaN,-95.24569217599357,-37.926681274846544,0.018566679783228013,-1.5194968014318704,-1.5380634812150984,-116253741,-108313361.4,49.01881564025418,26.572953010827167,NaN,NaN,-11.342667113532107,-11.773225769079337
2001-01-03T09:30:00-05:00,128.3125,136,127.65625,135,19431600,8955084.85,52.81346550199603,44.18412838298309,NaN,NaN,-8.762260223739547,-30.14139497275611,0.3214512561752665,-1.1362494109960153,-1.4577006671712818,-96822141,-105286881.2,52.56689519960166,28.57312711353316,NaN,NaN,-8.363254743254773,-11.2860870511044
2001-01-04T09:30:00-05:00,134.9375,135.46875,133,133.54687,9219000,8971864.95,50.30905512450248,44.26089636466154,NaN,NaN,24.947983494519903,-21.832547602619677,0.41499665169542443,-0.9389548525520013,-1.3539515042474257,-106041141,-105075021.4,52.81445935790875,30.60060599316092,NaN,NaN,-6.837941598731913,-10.650637700765472
2001-01-05T09:30:00-05:00,133.46875,133.625,129.1875,129.1875,12911398,8973034.85,43.62553125884574,44.10953669960319,NaN,NaN,-60.392252271695675,-34.125906817827385,0.1860131914014853,-1.1214350149955692,-1.3074482063970545,-118952539,-109117181,47.69920813614308,32.28637345439062,NaN,NaN,-7.85203078837555,-10.250836713281197
2001-01-08T09:30:00-05:00,129.875,130.1875,127.6875,130.1875,6625301,8977844.8,45.416874042741696,44.515505555956516,NaN,NaN,-87.59174285510993,-45.40879280640376,0.10847709531606098,-1.1718518372519782,-1.2803289325680391,-112327238,-110079360,46.54362437947754,34.10571331252769,NaN,NaN,-8.054463833054228,-9.937069158963059
2001-01-09T09:30:00-05:00,131.04687,131.5,129.42187,129.84375,5702398,8749159.6,44.88883989601779,44.59446202138888,NaN,NaN,-57.11482318880763,-37.78261900896657,0.043927616374775935,-1.2254194120995692,-1.269347028474345,-118029636,-110434539,46.09964385582298,36.066503625425135,NaN,NaN,-8.377760374748659,-9.714310761218144
2001-01-10T09:30:00-05:00,129,132.125,128.8125,132.125,8746102,8866184.6,49.11682842744084,45.28987739994232,NaN,NaN,-28.725215490946812,-41.77521006240802,0.15832293541390263,-1.0714433592069668,-1.2297662946208694,-109283534,-112926817.6,43.00003747826951,37.981031157034366,NaN,NaN,-7.338362948487926,-9.374889645113827
2001-01-11T09:30:00-05:00,131.09375,133.48437,131.09375,132.25,7245301,8977304.75,49.34614138510777,46.37037684238574,NaN,NaN,24.230662373209125,-41.91867428667018,0.24091290783494212,-0.9286251598271917,-1.1695380676621339,-102038233,-112126236,44.295698540480366,40.15072846575765,NaN,NaN,-6.441007409354764,-8.95576361143396
2001-01-12T09:30:00-05:00,132.6875,133.71875,131.28125,132,7244000,9035979.75,48.87176060341907,47.267770557762276,NaN,NaN,40.069336233408116,-21.826356585649428,0.2747576891596757,-0.8260909562125391,-1.1008486453722148,-109282233,-110192174.8,47.40599896251729,42.577910653071285,NaN,NaN,-5.839004973209078,-8.510512377401835
2001-01-16T09:30:00-05:00,132,133.1875,131.51562,132.84375,8542199,9074169.8,50.59790727312005,47.6984313143437,NaN,NaN,56.556207093536564,7.003233404079874,0.3454500711428561,-0.6690360564436446,-1.0144861275865007,-100740034,-107874734,50.940740892694016,44.87840174752303,NaN,NaN,-4.857120354951218,-7.988599231337461
2001-01-17T09:30:00-05:00,134.84375,135.04687,132.64062,133.45312,7851398,9013474.65,51.86193741730903,48.02539567616414,NaN,NaN,99.96426982546048,38.4190520069335,0.41978706924982667,-0.48975229102421736,-0.909539360274044,-92888636,-102846534,57.599337720606854,47.36730845404127,NaN,NaN,-3.6883308860000166,-7.37427518200354
2001-01-18T09:30:00-05:00,133.4375,135.70312,132.9375,134.78125,8106898,9057049.65,54.589131778997896,48.41509745519158,NaN,NaN,122.80869885594696,68.72583487631225,0.5374243782589971,-0.2377588874502976,-0.7751832657092947,-84781738,-97946174.8,62.88619163567529,49.58246014921957,NaN,NaN,-1.9312633840225575,-6.596702068006257
2001-01-19T09:30:00-05:00,136.1875,136.1875,133.875,134.01562,7782500,8965339.7,52.73438589923902,48.61566548628172,NaN,NaN,116.90109660366284,87.25992172240299,0.5411909704878269,-0.0986945525995111,-0.639885523087338,-92564238,-96051375.8,64.7180711454069,51.0372659914806,NaN,NaN,-0.913926672862266,-5.784877011557116
2001-01-22T09:30:00-05:00,134.25,135.78125,133.5625,134.90625,7050898,8818174.65,54.66405976888372,49.29183886803792,NaN,NaN,114.3055553594193,102.10716554760522,0.5778533126737284,0.08243111775482248,-0.49542219491890593,-85513340,-91297597.2,68.86958744982908,52.46130788533482,NaN,NaN,0.47502164700388255,-4.89060577461983
2001-01-23T09:30:00-05:00,134.46875,136.65625,134.15625,135.96875,8463102,8524754.75,56.92347264020251,50.41138507270164,NaN,NaN,144.94984838946502,119.78589380679091,0.6428634703701309,0.30815714304375774,-0.3347063273263732,-77050238,-86559638,72.3603764611496,54.1285622296845,NaN,NaN,2.2867933756169747,-3.8652630388717153
2001-01-24T09:30:00-05:00,136.25,137.3125,135.84375,136.375,6199898,8325604.75,57.78967778217032,50.766828806999804,NaN,NaN,162.72143380689417,132.33732660307766,0.6788879919822082,0.5139036626513871,-0.1649843293308211,-70850340,-82151978.8,75.15185371581023,55.74177355227082,NaN,NaN,4.0551435043293695,-2.7337763898429888
2001-01-25T09:30:00-05:00,136.25,137.25,135.65625,136.03125,10818301,8633254.75,56.74980911223888,51.226882663266686,NaN,NaN,133.05205738228713,134.38599830834568,0.6454458425692339,0.6418229738807213,-0.0036228686885126093,-81668641,-81529359.4,75.52784136042303,57.36415798102184,NaN,NaN,5.309445247317042,-1.5847447273915558
2001-01-26T09:30:00-05:00,135.15625,136.125,134.45312,135.875,7136801,8747389.7,56.25430644358099,52.12893803360492,NaN,NaN,88.62447767062743,128.7306745217386,0.5807111326139103,0.7222660470788753,0.141554914464965,-88805442,-80777600.2,76.00004655929553,59.385646439818444,NaN,NaN,6.261861993514027,-0.46380091011932967
2001-01-29T09:30:00-05:00,135.5,136.89999,135.37,136.60001,6705898,8664749.65,58.08315939739162,53.0336727017942,NaN,NaN,104.72993120733882,126.8155496913225,0.5546727486920846,0.8348958503300707,0.28022310163798614,-82099544,-80094841,76.44459847805706,61.52143030400269,NaN,NaN,7.555489442984915,0.681811997466991
2001-01-30T09:30:00-05:00,136.3,137.92,135.78999,137.8,7069102,8579474.65,60.99010295454074,54.18376292026012,NaN,NaN,119.07858268511612,121.64129655045272,0.5833013499343112,1.0093497890558751,0.426048439121564,-75030442,-79690881.8,76.71936357520048,63.70855314110109,NaN,NaN,9.46566414568296,1.9366480186407007
2001-01-31T09:30:00-05:00,137.39999,138.7,136.60001,137.02,9706898,8627949.65,58.166382050827075,54.83015960764486,NaN,NaN,118.64162741656557,112.82533527238702,0.5170056018696597,1.0723054414586386,0.5552998395889789,-84737340,-82468281.8,70.62000187156565,65.68140774062223,NaN,NaN,10.431903501164857,3.15025594471558
2001-02-01T09:30:00-05:00,137.10001,137.95,136.25,137.92999,8239602,8068349.75,60.46602087209022,55.62443671385789,NaN,NaN,104.31805596055675,107.07853498804093,0.5013612966408719,1.1820014603900688,0.6806401637491969,-76497738,-81434101.2,71.52770637417547,67.62655115731475,NaN,NaN,11.881411582602235,4.397563892985102
2001-02-02T09:30:00-05:00,137.39999,137.99001,134.75,134.8,8276500,8021224.75,50.236709376499775,55.721933054792224,NaN,NaN,50.95246303799836,99.54413206151513,0.2593196455510387,1.0047897206879952,0.7454700751369565,-84774238,-80627860.4,72.24756447609907,69.40094869399915,NaN,NaN,10.314753941474136,5.2428767570549635
2001-02-05T09:30:00-05:00,134.8,135.94,134.75,135.78999,4352898,7593299.75,52.94805649843213,55.88980085660023,NaN,NaN,35.56628277881973,85.71140237581132,0.15040120407429125,0.9334715802298206,0.7830703761555293,-80421340,-80292219.6,72.55861088682624,70.94508226500861,NaN,NaN,9.755078954447582,5.8874770709681945
2001-02-06T09:30:00-05:00,135.3,136.7,135.22,135.39,7106699,7617369.65,51.7218790203076,55.87979668538584,NaN,NaN,39.696198572037865,69.83492555319566,0.0415834249188769,0.8350496573041255,0.7934662323852486,-87528039,-82791739,66.57451491216099,71.58616635011961,NaN,NaN,8.94238886917837,6.323893042141076
2001-02-07T09:30:00-05:00,134.72,135.39999,133.67999,134.69,5748699,7619684.7,49.558870163569736,55.520492284283826,NaN,NaN,-18.08209384710244,42.49018130046206,-0.08070756760628739,0.6925817728773893,0.7732893404836767,-93276738,-84499618.6,62.76547243963872,71.57754355040272,NaN,NaN,7.643533066941338,6.512413045683971
2001-02-08T09:30:00-05:00,134.8,135.39999,133.10001,133.12,5943301,7479544.65,45.01213258690064,54.968902761973936,NaN,NaN,-64.65520046098978,8.695530016152748,-0.2603700319969716,0.44782680048746215,0.7081968324844338,-99220039,-89044078.8,53.924436489074694,70.806569646379,NaN,NaN,5.162312815184576,6.319541584184058
2001-02-09T09:30:00-05:00,133.35001,133.35001,131.25999,131.84,9913000,7612929.6,41.65662966059938,54.0398006113822,NaN,NaN,-152.50793258777705,-31.99654910900233,-0.44747306174382495,0.14885550530465252,0.5963285670484775,-109133039,-93915839,46.38187382852759,69.20030438771461,NaN,NaN,2.006993682433884,5.703463312505462
2001-02-12T09:30:00-05:00,131.7,133.5,131.7,133.35001,5804398,7540949.5,46.70412754506785,53.30984739030116,NaN,NaN,-120.51685179092613,-63.21317602295151,-0.4503596418657169,0.03337901471633131,0.48373865658204823,-103328641,-98497299.2,40.62682638795599,66.93362223962934,NaN,NaN,0.729817073087633,4.992942421160057
2001-02-13T09:30:00-05:00,133.7,134.17,132,132.25999,6587602,7443219.65,43.76098658339286,52.3077980189599,NaN,NaN,-124.98489541546702,-96.14939482045249,-0.5025329806621472,-0.14442756924563582,0.3581054114165114,-109916243,-102974940,35.93398365631599,64.13234580680833,NaN,NaN,-1.2410771391429232,4.102368198259631
2001-02-14T09:30:00-05:00,132.64999,132.64999,130.66,132.06,8400102,7470654.85,43.22280694351486,51.34158357833677,NaN,NaN,-160.57266158029483,-124.64750836709095,-0.5249182826779999,-0.2980424419309884,0.22687584074701145,-118316345,-107982861.4,31.54515430921279,60.99072530315045,NaN,NaN,-3.008669341963653,3.0865056925134478
2001-02-15T09:30:00-05:00,132.84,133.52,132.5,133.34,5928602,7361740.05,47.65954722865256,50.72767220584188,NaN,NaN,-87.23018439136571,-129.16250515316614,-0.43181364658856736,-0.31289121748869775,0.1189224290998696,-112387743,-110616402.2,29.50437088778392,57.66960561232819,NaN,NaN,-3.278736224742603,2.177185418619726
2001-02-16T09:30:00-05:00,131,131.28999,129.3,130.39999,6434898,7294359.95,39.939555464803554,49.4317004963713,NaN,NaN,-177.1796722860691,-134.09685309282457,-0.5395298424182228,-0.5554898739229088,-0.015960031504686098,-118822641,-112554322.6,28.06551327985555,54.213956669599504,NaN,NaN,-5.996824006503562,1.0094697864592566
2001-02-20T09:30:00-05:00,131.03999,131.14,128.10001,128.39,5760000,7229815.05,35.6838776707761,47.62411297610239,NaN,NaN,-177.49570811285292,-145.4926243572099,-0.7068885828205485,-0.8995707600303717,-0.19268217720982322,-124582641,-116805122.6,25.166359359561554,50.5315992256253,NaN,NaN,-9.757286334613088,-0.5286382308367925
2001-02-21T09:30:00-05:00,127.89999,128.84,125.5,125.62,10910801,7352200,30.811422835866793,45.67018731789094,NaN,NaN,-208.20599870812092,-162.1368450157407,-0.9497478135827877,-1.3798669441883078,-0.43011913060552015,-135493442,-121920562.4,22.19502869809584,47.072672570377456,NaN,NaN,-14.767409567250207,-2.5627484217529943
2001-02-22T09:30:00-05:00,126.35001,126.53999,123.02,125.81,21281600,8106285.1,31.502314877801425,43.60135117544174,NaN,NaN,-204.01567140559496,-170.82544698080073,-1.0361332545509514,-1.7252856987942096,-0.689152444243258,-114211842,-121099661.8,23.750843548328092,43.660039511388355,NaN,NaN,-18.433808455377644,-4.830042712270801
2001-02-23T09:30:00-05:00,125.08,125.53999,121.8,124.96001,20173008,8574020.45,30.056352590143376,42.159897119273424,NaN,NaN,-189.6247907312392,-191.30436824877543,-1.0839236628349491,-2.0440570227869443,-0.9601333599519952,-134384850,-125499083.2,21.29339136947931,40.02045571805837,NaN,NaN,-21.892342307238348,-7.267514082980451
2001-02-26T09:30:00-05:00,125.8,127.62,124.5,127.62,11502602,8792310.5,39.42653016221171,41.1940738095434,NaN,NaN,-116.41946818105275,-179.15232742777215,-0.8785489952408292,-2.0583196040030316,-1.1797706087622024,-122882248,-126311004.6,20.864335640063757,36.328007486146774,NaN,NaN,-21.8866564821763,-9.355962997151286
2001-02-27T09:30:00-05:00,126.8,127.84,125.50999,126.44,11415000,9027765.6,37.05497743439965,40.14643798197854,NaN,NaN,-101.36688010134095,-163.92656182546975,-0.7683182421605541,-2.140168411462895,-1.3718501693023408,-134297248,-128253926,19.834391485692137,32.98942724139899,NaN,NaN,-22.643238783677603,-11.25414525236933
2001-02-28T09:30:00-05:00,126.75,126.84,123.27,123.95,14831102,9415865.6,32.59893188860946,38.93501381948138,NaN,NaN,-118.62560320236024,-146.0104827243176,-0.8053503165902445,-2.3785380650401464,-1.573187748449902,-149128350,-130980907.6,18.457222825589596,29.82455226896692,NaN,NaN,-24.790895227961972,-13.187966677453993
2001-03-01T09:30:00-05:00,124.05,124.60001,121.75,124.60001,14672000,9664120.7,34.80305421448669,38.205793935737525,NaN,NaN,-120.11690329944673,-129.23072910308798,-0.7305189369726761,-2.486336419665747,-1.755817482693071,-134456350,-135029809.2,16.612837091368718,27.15943802627363,NaN,NaN,-25.79625180862175,-14.989150267620815
2001-03-02T09:30:00-05:00,122.5,125.64999,122.3,123.61,12564301,9880355.65,33.03131806894068,37.589700250619046,NaN,NaN,-103.9325630335836,-112.09228356355686,-0.6924937406741525,-2.6214346585357617,-1.9289409178616093,-147020651,-137556969.4,15.567210923644822,24.958390675924868,NaN,NaN,-27.174475317936185,-16.72991098909444
2001-03-05T09:30:00-05:00,124.14999,124.78,123.81,124.74001,5293199,9731190.6,36.975171347822645,36.894774807958676,NaN,NaN,-84.58021994214515,-105.72443391577534,-0.542658233690577,-2.6072637099748306,-2.0646054762842536,-141727452,-141326010.2,14.137978970378626,23.066330146097915,NaN,NaN,-27.10657715840259,-18.212291870424174
2001-03-06T09:30:00-05:00,126.35001,127.75,125.49001,126.08,6917000,9859395.7,41.383489338396316,36.72495357617321,NaN,NaN,-44.66152801319471,-94.38336349814608,-0.31595955403130604,-2.459554918823386,-2.14359536479208,-134810452,-141428651,14.100013803068805,21.50676087086597,NaN,NaN,-25.68372303734136,-19.27963917998377
2001-03-07T09:30:00-05:00,126.89999,127.03999,125.75999,126.98,6371699,9822645.7,44.206239928240514,36.795198789367895,NaN,NaN,-36.33363439103312,-77.92496973588068,-0.08032744438301931,-2.2440046702708543,-2.163677225887835,-128438753,-137290731.6,23.069049770695443,20.901324832400444,NaN,NaN,-23.64089425386219,-19.90267561910926
2001-03-08T09:30:00-05:00,126.60001,127.24001,126.14,127.12,6055000,9837960.75,44.652737294341875,36.58042665120285,NaN,NaN,-26.510903034646738,-59.20376968292068,0.1002333995546314,-2.038385476444546,-2.1386188759991773,-122383753,-134876212.2,27.805880352431956,20.780004079875305,NaN,NaN,-21.855816742526482,-20.181695779597433
2001-03-09T09:30:00-05:00,126.10001,126.10001,123.11,123.36,10020301,10041810.75,36.25996965102422,36.31759909307575,NaN,NaN,-78.23585053569562,-54.064427183343085,-0.012305997830919235,-2.1540013732878265,-2.1416953754569072,-132404054,-131952892.8,33.17102926417944,21.1446837930413,NaN,NaN,-22.817741857968848,-20.55827379079335
2001-03-12T09:30:00-05:00,122.34,122.5,117.75,118.08,13972898,10244805.65,28.23453571255206,35.785503238916895,NaN,NaN,-177.05357245597972,-72.55909768611,-0.39963024815361736,-2.641233185648929,-2.2416029374953115,-146376952,-132882792.8,32.347525327555275,21.65762421932657,NaN,NaN,-26.718975964972618,-21.438374101390387
2001-03-13T09:30:00-05:00,119.39999,120.44,117.53,120.02,12887199,10598945.7,34.01348362398332,36.014221866639495,NaN,NaN,-167.0016960114423,-97.02713128575951,-0.47720577266923403,-2.8381101533318542,-2.36090438066262,-133489753,-132618653,32.85742764793095,22.419224144314793,NaN,NaN,-27.739004309906473,-22.338464131178398
2001-03-14T09:30:00-05:00,117.05,119.28999,115.75,117.64999,19883392,11263735.2,30.7552265725878,35.960858416267094,NaN,NaN,-183.81151161451513,-126.52270673045591,-0.6305372802424563,-3.1490759809656907,-2.5185387007232345,-153373145,-137605531.4,28.491310851247647,22.75782895166619,NaN,NaN,-29.74442842928699,-23.396459030908197
2001-03-15T09:30:00-05:00,118.45,118.86,117.36,117.67999,10370301,11362245.15,30.8455312485613,36.017228320439806,NaN,NaN,-157.2137944404584,-152.66328501161826,-0.6687131260183428,-3.354430108246163,-2.68571698222782,-143002844,-141729349.6,25.47651925013568,23.056623800284502,NaN,NaN,-31.230870492987865,-24.51566066834815
2001-03-16T09:30:00-05:00,117.13,117.39999,114.81,115.00999,58515392,13991584.65,27.418334756537234,35.15950007717735,NaN,NaN,-181.4906759819719,-173.3142501008735,-0.803493952824121,-3.6900844232579715,-2.8865904704338505,-201518236,-155552186,18.434953340272358,22.883096493156547,NaN,NaN,-33.66378713004206,-25.822535877161567
2001-03-19T09:30:00-05:00,115.75999,117.69,114.82001,117.35001,10067801,14173229.8,34.30734105791309,34.963240335999735,NaN,NaN,-134.47382394596872,-164.79830039887128,-0.6702003792056597,-3.7243409444409252,-3.0541405652352656,-191450435,-164566882.6,15.438122267915276,22.56907726331534,NaN,NaN,-33.35140822664114,-26.898089069944362
2001-03-20T09:30:00-05:00,117.89999,118.46001,114.11,114.2,15086898,14639574.7,30.15774715995262,34.78886999823853,NaN,NaN,-130.00846208405804,-157.39965361339446,-0.7247038009087925,-3.9600203163712564,-3.235316515462464,-206537333,-179176398.6,12.026084263041838,22.10971022313336,NaN,NaN,-34.52921909161576,-27.988250501611706
2001-03-21T09:30:00-05:00,114.17999,115.25999,111.89999,112.25999,19004704,15044269.85,27.918092788775766,34.29708703925918,NaN,NaN,-146.40289185251754,-149.91792966099493,-0.8151864618446618,-4.254299592768291,-3.439113130923629,-225542037,-193610177,9.736523437577759,21.618544962148288,NaN,NaN,-36.25293448052212,-29.16891964145605
2001-03-22T09:30:00-05:00,112.02,112.60001,108.03999,111.12,28625600,15411469.85,26.66493876327607,33.84234566028314,NaN,NaN,-157.91087425653205,-150.05734562420966,-0.8705635800469174,-4.527317605982276,-3.6567540259353586,-254167637,-215843135.6,7.399626123384536,21.035146047843984,NaN,NaN,-38.03978662144921,-30.436186352883645
2001-03-23T09:30:00-05:00,113.25,114.66,111.5,114.48,12861699,15045904.4,35.81041257588605,33.75914860514481,NaN,NaN,-100.67129868210617,-133.89347016423653,-0.6118712246299292,-4.42159305672277,-3.809721832092841,-241305938,-223800676,6.77303358192907,20.50907852009758,NaN,NaN,-36.45708286351266,-31.296314425830648
2001-03-26T09:30:00-05:00,115.7,116.27,114.77,115.94,9943801,14967964.35,39.349776492306,33.61388340185264,NaN,NaN,-64.44748575553758,-119.88820252615031,-0.28974627138883857,-4.171904671328889,-3.8821583999400504,-231362137,-231783016.4,6.205384169505393,19.945176403414482,NaN,NaN,-34.00291745638667,-31.682972001624364
2001-03-27T09:30:00-05:00,115.62,118.64999,115.28,118.31,12881199,15041274.3,44.68198805208244,33.64786541069849,NaN,NaN,-34.60089413598531,-100.80668893653578,0.11398514737584042,-3.7396769657202498,-3.85366211309609,-218480938,-234171737.4,6.042187596106231,18.728971962372395,NaN,NaN,-30.162597785894995,-31.465775685091597
2001-03-28T09:30:00-05:00,116.89999,116.95,114.89999,115.03999,10953301,14847384.25,39.51936577846634,33.28119601670738,NaN,NaN,-57.02616730586733,-82.93134402720572,0.1875095923286021,-3.6192751226853375,-3.8067847150139396,-229434239,-234950177.8,5.986930103647879,17.170475516030677,NaN,NaN,-28.611455682445637,-31.058015684713602
2001-03-29T09:30:00-05:00,114.7,116.5,109.34,115.48,12061398,14716854.15,40.515323980596854,33.58514989739114,NaN,NaN,-79.65231844737743,-67.27963286537481,0.2865498671969986,-3.4485973810176915,-3.73514724821469,-217372841,-227591218.6,13.994469068126591,15.800721216312615,NaN,NaN,-27.081005242369464,-30.489871335807297
2001-03-30T09:30:00-05:00,115.55,116.69,114.5,116.69,9183602,14547819.2,43.281361581579596,34.65992317375025,NaN,NaN,-40.38441709059805,-55.22225654707317,0.4448769729203854,-3.1790510320642085,-3.623928004984594,-208189239,-220967878.8,20.553377806967646,14.958282107699217,NaN,NaN,-24.96550252587233,-29.700675791530873
2001-04-02T09:30:00-04:00,116.3,117.38,113.8,114.2,10561000,14811209.25,39.23786561223749,35.033093315768404,NaN,NaN,-50.85699955304915,-52.5041593065755,0.3949248264057377,-3.1302719719774217,-3.5251967983831594,-218750239,-218445499.2,22.96285854454004,14.251527171742723,NaN,NaN,-24.414585487908557,-28.945520033870544
2001-04-03T09:30:00-04:00,113.98,114.14999,110.06,110.39,12836000,15107159.25,34.00322864845714,35.26509346404479,NaN,NaN,-114.65530930020385,-68.51504233941921,0.13190642388647955,-3.36031376852506,-3.4922201924115397,-231586239,-221066559.4,22.20910341314213,13.802798069020898,NaN,NaN,-25.66925005462547,-28.47748146540696
2001-04-04T09:30:00-04:00,110.578,112.10001,109.3,110.85001,14884500,15532799.3,35.12851235344924,35.571020685822496,NaN,NaN,-128.9251549484257,-82.89483986793087,0.02133150041630838,-3.465555816891154,-3.4868873173074624,-216701739,-218520059.4,24.792073142627274,13.753909061341727,NaN,NaN,-26.30574367978739,-28.16723321031845
2001-04-05T09:30:00-04:00,113.3,115.49001,112.5,115.05,21517600,16305929.3,44.442721224652104,36.78704829068785,NaN,NaN,-39.15239330024156,-74.79485483850371,0.25072988401826635,-3.1734749622846294,-3.424204846302896,-195184139,-214082319,29.203749958734022,14.523108819803273,NaN,NaN,-23.76711962591109,-27.538645555403114
2001-04-06T09:30:00-04:00,113.991,114.39999,112.06,113.3,14937801,16551804.3,41.752726479998906,37.31886153512255,NaN,NaN,-62.30148768107757,-79.17826895659961,0.3009055821227178,-3.0480728686494984,-3.3489784507722162,-210121940,-214468859.2,29.043936625239454,15.494952702469288,NaN,NaN,-22.568897681584705,-26.828681573429055
2001-04-09T09:30:00-04:00,114,114.99001,112.78,114.56,9034301,16304874.45,44.36383633813961,38.33358219070733,NaN,NaN,-27.233777759689836,-74.45362459792774,0.42752302347425486,-2.8145746714293978,-3.2420976949036526,-201087639,-210936339.2,32.670176354003615,16.969530708966555,NaN,NaN,-20.77037289573285,-25.96320890518674
2001-04-10T09:30:00-04:00,115.45,117.75,115.17,116.64999,17873296,16554179.3,48.48870704652544,39.802911780546594,NaN,NaN,67.35337771661179,-38.05188719456457,0.647408784411883,-2.432836714388799,-3.0802454988006818,-183214343,-201261960,41.489300374310865,19.237586204447492,NaN,NaN,-17.95271722187287,-24.818852950427615
2001-04-11T09:30:00-04:00,118.78,118.99001,116.14,116.73,12722301,16196124.75,48.64567641943469,41.372964470272215,NaN,NaN,97.42107965763496,7.217359726647558,0.7844787427288704,-2.0996470703895938,-2.884125813118464,-170492042,-192020020.6,48.43756126284265,22.168867285837358,NaN,NaN,-15.66734266310884,-23.511494337953504
2001-04-12T09:30:00-04:00,116.3,118.94,115.96001,118.85001,9233199,16139269.65,52.75392339785593,42.58321524327006,NaN,NaN,121.65827356306393,39.379493099308654,0.9908559751092225,-1.6455558442319358,-2.6364118193411583,-161258843,-185234961.4,52.86320158313707,25.461022143066504,NaN,NaN,-12.455163253180588,-21.93201846870023
2001-04-16T09:30:00-04:00,118.28999,118.89,116.91,117.60001,7348699,13580935,50.203734546941796,43.35849796145833,NaN,NaN,107.58145152114213,73.35608093975259,1.0125305021848896,-1.3707486916100464,-2.383279193794936,-168607542,-176932081.8,57.65307788338848,29.135857408343867,NaN,NaN,-10.506532446950594,-20.299806179878853
2001-04-17T09:30:00-04:00,117.31,119.66,117.02,119.25999,10924699,13623779.9,53.42376156435857,43.982910355192345,NaN,NaN,128.21429367357976,104.4456952264065,1.1007011008646277,-1.0074028177141514,-2.108103918578779,-157682843,-168251122.6,62.0008049364213,33.13290150408066,NaN,NaN,-7.8909149891001045,-18.527107438339034
2001-04-18T09:30:00-04:00,121.06,126,120.69,124,32491008,14493985.4,61.14920976398063,45.52789921130051,NaN,NaN,237.4909973564008,138.47321915436433,1.4199796991355371,-0.3331292946593578,-1.753108993794895,-125191835,-156646621,66.89398099851905,37.4834051394286,NaN,NaN,-2.9271272765999132,-16.298538843804874
2001-04-19T09:30:00-04:00,124.25,125.84,123.58,125.64999,13810398,14234270.1,63.423511190468204,47.16419829771989,NaN,NaN,226.12864552597543,164.21473232803243,1.666940924023412,0.33056716123437013,-1.336373762789042,-111381437,-144824500,70.99211455494734,41.55466553134436,NaN,NaN,1.8922785519280034,-13.699850644414463
2001-04-20T09:30:00-04:00,124.89999,125.39999,123.66,124.5,7626699,13184325.05,60.754066339450404,48.41224863756781,NaN,NaN,180.28134183921782,175.9393459832632,1.673141426912961,0.7550530208521593,-0.9180884060608017,-119008136,-136374358.6,73.5157153434879,45.337689641095814,NaN,NaN,5.019044714951339,-11.025722735933634
2001-04-23T09:30:00-04:00,123.64999,123.89,121.91,122.24001,8451801,12963830.15,55.78489019890716,49.59417896518706,NaN,NaN,119.8720761613735,178.39747091130943,1.4534616983656503,0.8987387168962613,-0.554722981469389,-127459937,-128144837.6,75.73016901839203,49.10678324637096,NaN,NaN,6.1524962192171735,-8.571691456626375
2001-04-24T09:30:00-04:00,122.52,123.64999,121.10001,121.58,10045301,12968905.15,54.38587057400097,51.05008195986876,NaN,NaN,94.9310767474231,171.7408275260781,1.202514843694331,0.9484205731485247,-0.25409427054580624,-137505238,-124109316.6,76.75650492304977,53.00302621136435,NaN,NaN,6.656439066874205,-6.396244238983435
2001-04-25T09:30:00-04:00,121.42,123.67,120.95,123.17,8249000,12737295.2,57.17239168797967,52.62464476947808,NaN,NaN,91.62086392362018,142.566800839522,1.085975016099121,1.103374499578095,0.01739948347897402,-129256238,-124922197.2,76.05878044647794,56.664933875925115,NaN,NaN,7.904099279879058,-4.353338022003079
2001-04-26T09:30:00-04:00,123.73,125.22,123.5,123.72,10590398,12719150.05,58.12532958378516,53.60197393798759,NaN,NaN,104.66657186256276,118.27438610683946,0.9909425924116428,1.2560777239935277,0.2651351315818848,-118665840,-126379077.8,74.74734646754314,59.91804791226863,NaN,NaN,9.202587662984913,-2.416777209861938
2001-04-27T09:30:00-04:00,124.92,125.84,124.2,125.78,8048898,12518525.05,61.57402533694329,55.0177809991979,NaN,NaN,108.4959930040299,103.91731633980189,1.0084784632587125,1.5257332106552752,0.5172547473965629,-110616942,-124700839,75.27618970799345,63.22035170389391,NaN,NaN,11.341635807858042,-0.45128963590194093
2001-04-30T09:30:00-04:00,126.45,127.27,124.67,124.91,10764898,12597589.85,59.35088245097791,56.08828429297206,NaN,NaN,99.79311939294931,99.90152498611704,0.9063664195855614,1.6502127718785147,0.7438463522929533,-121381840,-123485219.6,75.67358849269752,66.2920239995149,NaN,NaN,12.502515885204874,1.3992540099704611
2001-05-01T09:30:00-04:00,125.07001,127.14999,124.60001,127.05,10578102,12598444.95,62.89927330286416,57.117610454139125,NaN,NaN,97.71283010019252,100.45787565667092,0.9246396387997906,1.8996459007926916,0.975006261992901,-110803738,-118144919.6,77.39273126194271,68.85655477720289,NaN,NaN,14.5568430593389,3.2789095884516666
2001-05-02T09:30:00-04:00,127.41,127.69,126,126.82001,9572898,12435289.85,62.27014378696999,58.090786694677355,NaN,NaN,97.59340288251222,101.65238344844934,0.8640554303520402,2.055075549932951,1.191020119580911,-120376636,-116368999.2,77.95077689290171,70.9646416079214,NaN,NaN,16.06619014678903,5.105663953928433
2001-05-03T09:30:00-04:00,126.13,126.14999,124.22,125.21001,9926199,12187374.8,57.903938571590636,58.458644921372695,NaN,NaN,67.47080757176558,94.2132305902899,0.6671824669342539,2.024998203248728,1.3578157363144743,-130302835,-118696398.2,75.32654800708752,72.56916635248929,NaN,NaN,16.15076969153494,6.683536202157934
2001-05-04T09:30:00-04:00,123.64999,127.35001,123.44,127.34,12145301,11718759.85,61.72733517026387,59.281759251609984,NaN,NaN,77.29255927126289,87.97254384373649,0.6323635390148556,2.148270160083044,1.5159066210681882,-118157534,-120204516.6,73.59755230694114,73.70805738274305,NaN,NaN,17.32815777198685,8.204196426419207
2001-05-07T09:30:00-04:00,126.86,127.38,126.23,126.24001,7185199,11331129.75,58.75922641243571,59.662863883615486,NaN,NaN,85.24397903551356,85.06271577224933,0.4933711445773681,2.1326205517898984,1.6392494072125303,-125342733,-120996695.2,72.65418926148662,74.469013405962,NaN,NaN,17.469477145964184,9.527807957782775
2001-05-08T09:30:00-04:00,126.86,127.10001,125.56,126.17999,6952602,11227044.8,58.593670413061375,59.48032535854983,NaN,NaN,74.79640609170954,80.47943097055274,0.36161501369545124,2.0912681743318444,1.7296531606363932,-132295335,-125295014.6,67.59164572966269,74.51884660104369,NaN,NaN,17.539773300278913,10.672374435282222
2001-05-09T09:30:00-04:00,125.25,126.55,125.06,125.64999,9507398,10808749.9,57.064693579607265,59.026124100631186,NaN,NaN,58.635864503012186,72.68792329465273,0.21048408731353074,1.9927582697783066,1.7822741824647759,-141802733,-129580234,62.88698867876722,73.93990903845939,NaN,NaN,17.188568658663964,11.603259324336756
2001-05-10T09:30:00-04:00,127.25999,127.5,125.77,126.02,6872398,10516254.75,57.890825129592905,58.821606871355655,NaN,NaN,73.19186643561395,73.83213506742241,0.11208874715831518,1.92238511641267,1.8102963692543548,-134930335,-130505734,61.88512355992027,73.10915248249027,NaN,NaN,17.102826585881044,12.388911790271655
2001-05-11T09:30:00-04:00,126,126.49001,124.39999,125.14999,7736602,10441424.9,55.20127752004261,58.77992025143676,NaN,NaN,35.76573619348594,65.52677045186702,-0.027485555301719256,1.7759394251272056,1.8034249804289249,-142666937,-135407614.6,56.73007453148442,71.75200287628259,NaN,NaN,16.322524182655435,12.950856417755052
2001-05-14T09:30:00-04:00,124.89999,125.44,124.46001,125.39999,7914000,10469689.95,55.83622259168413,58.883516824128414,NaN,NaN,18.10164558107512,52.098303760979334,-0.11401425120208986,1.6609071664263126,1.7749214176284025,-134752937,-137289655.4,54.841194260923096,70.18662354327354,NaN,NaN,15.816762659556602,13.360271595155274
2001-05-15T09:30:00-04:00,125.55,126.5,124.85001,125.98,9782199,10412564.95,57.346663341175656,58.8959647993567,NaN,NaN,44.441870926213106,46.02739672788005,-0.14143868257636738,1.5981230644079432,1.7395617469843105,-124970738,-135824736,56.06735610116039,68.75866466146515,NaN,NaN,15.752027062989457,13.701950947703015
2001-05-16T09:30:00-04:00,124.84,129.2,124.62,128.95,14916199,9533824.5,64.11466081974649,59.32377417335393,NaN,NaN,145.03571852369603,63.307367532016826,0.022465873739051734,1.767644089158125,1.7451782154190734,-110054539,-129475097.2,61.00918429738831,67.77736736359694,NaN,NaN,17.586871718200324,14.25693962920263
2001-05-17T09:30:00-04:00,129.005,130.08,128.56,129.14999,11828898,9434749.5,64.52287873882943,59.53440655920294,NaN,NaN,205.80438287110107,89.82987081911425,0.12087281397623473,1.8962692328893667,1.775396418913132,-98225641,-122134158.4,65.79907322980665,67.10043047229787,NaN,NaN,19.22280459009157,14.966348909329621
2001-05-18T09:30:00-04:00,129.09,129.74001,128.10001,129.74001,6683301,9387579.6,65.76038393594612,59.99222809384353,NaN,NaN,174.98301004813106,117.67332559004328,0.19768377276398086,2.022501134868108,1.824817362104127,-91542340,-111909239,71.12068288059274,66.77522292857611,NaN,NaN,20.956888476260964,15.8221402760341
2001-05-21T09:30:00-04:00,129.84,131.84,129.14999,131.64999,11532102,9541594.65,69.47261524498767,60.46175251828091,NaN,NaN,221.8699845413255,158.42699338209337,0.34071843360646925,2.2507154041122135,1.9099969705057442,-80010238,-100960699.2,75.51409798928778,66.6410348376722,NaN,NaN,23.599355400168683,16.933171008053325
2001-05-22T09:30:00-04:00,131.83,132.09,131.07001,131.48,8343199,9456489.55,68.75810366599737,60.925178223925734,NaN,NaN,209.06012379884544,191.35064395661982,0.38424732221435587,2.390306123273689,2.006058801059333,-88353437,-93637239,77.93242355367695,66.6397238848704,NaN,NaN,25.59896260728904,18.17114123651557
2001-05-23T09:30:00-04:00,131.05,131.05,129.25,129.25,12331000,9660589.55,60.03508282825509,61.07740281368748,NaN,NaN,116.30267612576029,185.60403547703268,0.2307852612502579,2.2945403776221553,2.0637551163718975,-100684437,-91763218.6,78.51712442975136,66.86762220077497,NaN,NaN,24.906825054191643,19.133381781897867
2001-05-24T09:30:00-04:00,129.47,130,128.55,129.63,7905398,9526339.55,60.94434753453904,61.021475125421425,NaN,NaN,84.38530996582831,161.3202208959781,0.12793592053373848,2.2236750170390707,2.095739096505332,-92779039,-90673898.2,78.86762872396176,67.24405623056217,NaN,NaN,24.585192523800018,19.91221188788389
2001-05-25T09:30:00-04:00,129.64999,129.7,127.89999,128.10001,7425000,9495144.65,55.471985668029305,60.786672215106684,NaN,NaN,45.92839669207954,135.5092982247678,-0.059981506828858056,2.0207622129692595,2.0807437197981176,-100204039,-92406238,76.72378521420929,67.53474165575663,NaN,NaN,22.694900997711283,20.309738903573518
2001-05-29T09:30:00-04:00,128.226,128.35001,126.89999,127.08,9012301,9407514.8,52.11241997390498,60.32372575516694,NaN,NaN,-1.0146824046106264,90.93236483558059,-0.2586845786165295,1.7573879965274557,2.016072575143985,-109216340,-98247458.4,69.83095657021188,67.69469243008157,NaN,NaN,20.083663446305508,20.277442409678088
2001-05-30T09:30:00-04:00,126.59,127.09,125,125.3,10041801,9380699.75,46.787208971758815,59.589619711749194,NaN,NaN,-65.70994215839862,35.97835164413178,-0.501642731856434,1.3890191603234427,1.8906618921798768,-119258141,-104428399.2,63.345793296325674,67.7274641884786,NaN,NaN,16.128843115876343,19.68478536770641
2001-05-31T09:30:00-04:00,125.42999,126.75999,125.25999,125.95,9875199,9395814.8,48.84299872085819,58.943346396839566,NaN,NaN,-55.066385670912894,1.70453928479713,-0.6033825765903191,1.1364336714419778,1.739816248032297,-109382942,-106168100.2,61.61143446458374,67.70791496738316,NaN,NaN,13.434291923968086,18.79185773288665
2001-06-01T09:30:00-04:00,126.2,127.10001,125.12,126.73,8848301,9341919.9,51.2756221734714,58.66294244351305,NaN,NaN,-45.835040029498515,-24.339530714268225,-0.6016046233877423,0.987810468797619,1.5894150921853614,-100534641,-107719220.6,60.03321158838702,67.94385332859048,NaN,NaN,11.856567698817939,17.801102013733978
2001-06-04T09:30:00-04:00,126.8,127.42999,126.08,127.34,5634699,9016389.8,53.15183587232711,58.47120053498755,NaN,NaN,-22.73516612050745,-38.07224327678562,-0.5445147473766148,0.9087716579645928,1.4532864053412076,-94899942,-106658401.2,60.773276268352774,68.36757347197832,NaN,NaN,11.058653995547704,16.83789515399308
2001-06-05T09:30:00-04:00,127.49001,129.23,127.27,128.8,9115602,9112909.95,57.38181881325503,58.47371164013608,NaN,NaN,34.14799834356219,-31.039707127151065,-0.40026310185784664,0.9529575280188993,1.353220629876746,-85784340,-101972001.2,63.949185569135565,68.93056129111939,NaN,NaN,11.590804058141092,16.08831071172851
2001-06-06T09:30:00-04:00,128.83,128.83,127.36,127.73,12064898,9368524.75,53.56466190318959,57.72014028895345,NaN,NaN,12.249134857160774,-15.447891724039186,-0.36948846632307175,0.8913600469729062,1.260848513295978,-97849238,-97690220.6,66.60919220007774,69.33056185559721,NaN,NaN,10.925788953039064,15.350807603344304
2001-06-07T09:30:00-04:00,127.05,128.35001,127,128.19,7355301,9260919.9,54.952054674665064,57.036509998655994,NaN,NaN,2.751562090083111,-3.884302171839984,-0.3129691148830449,0.8696371196921717,1.1826062345752166,-90493937,-93912419.6,68.79678428248718,69.54468407364581,NaN,NaN,10.768080929144928,14.696132364172964
2001-06-08T09:30:00-04:00,127.7,127.87,126.14,127,8170602,9325830.1,50.729410882033534,55.962869066233665,NaN,NaN,-36.4304298025924,-2.0033801264587536,-0.3478621374471109,0.747778562766328,1.095640700213439,-98664539,-93538399.2,69.01323377369769,69.39415199458189,NaN,NaN,9.401558516743926,13.939764671683102
2001-06-11T09:30:00-04:00,126.71001,126.99001,125.41,126.10001,7012199,9289609.95,47.741471913126574,54.41064454252929,NaN,NaN,-78.04113145732657,-13.064573193822579,-0.41892090632388934,0.5719895673085773,0.9909104736324666,-105676738,-95693758.4,66.16488083856584,68.72635076953031,NaN,NaN,7.359717773035468,12.999757971876297
2001-06-12T09:30:00-04:00,124.86,126.74001,124.03999,125.88,9368500,9362334.95,47.01249359518551,52.857386680328446,NaN,NaN,-108.99995421456423,-41.69416370544786,-0.4645731057317438,0.41019409146778685,0.8747671971995307,-115045238,-101545938,59.03981205440915,67.37687851958262,NaN,NaN,5.466868722227113,11.923630936212128
2001-06-13T09:30:00-04:00,126.17,126.58,124.64999,124.8,7629398,9254694.9,43.5010584717747,51.67638494057985,NaN,NaN,-116.24065009858036,-67.3921206965961,-0.5457314924989866,0.1926028315757975,0.738334324074784,-122674636,-106511017.6,53.75118632604837,65.60788294074669,NaN,NaN,2.7989700462483222,10.620107951931583
2001-06-14T09:30:00-04:00,124.17999,124.3,121.75,122,12603301,9139050,35.99470602839354,49.894267690140886,NaN,NaN,-194.9092794532396,-106.92428900526063,-0.7534125621965694,-0.20343137867092764,0.5499811835256417,-135277937,-115467817.6,45.783719186167765,63.24474654518997,NaN,NaN,-2.1510614115434437,8.795655185720864
2001-06-15T09:30:00-04:00,120.91,122.39999,120.39999,121.85001,16821296,9388669.9,35.639929466661926,48.47769224718606,NaN,NaN,-200.28242133674465,-139.69468731209108,-0.8586739866305693,-0.5233612997625698,0.3353126868679994,-152099233,-126154756.4,38.458654812264214,60.51152294505103,NaN,NaN,-6.218496169378559,6.650776420706661
2001-06-18T09:30:00-04:00,121.64999,122.44,120.91,121.25999,11368801,9622944.9,34.2114409056084,47.19905088516488,NaN,NaN,-171.3852580739258,-158.36351263541093,-0.9203473787087934,-0.8151215365179922,0.10522584219080108,-163468034,-137713015.6,32.41769086825937,57.839146823483,NaN,NaN,-10.03908766023653,4.266510123429063
2001-06-19T09:30:00-04:00,122.38,122.89,120.89,121.78999,7732301,9432954.85,36.6670730539728,46.476184033894455,NaN,NaN,-143.18808911726708,-165.2011396159515,-0.8778928977514593,-0.9921402799985231,-0.11424738224706374,-155735733,-145851114.6,28.96753357143467,55.38355684313364,NaN,NaN,-12.546944612982506,1.8645880182274102
2001-06-20T09:30:00-04:00,121.19,122.86,121.10001,122.42999,8787199,9455154.85,39.59895304803795,45.815895057264434,NaN,NaN,-120.84721654619521,-166.1224529054745,-0.7633777787986625,-1.068469605745392,-0.3050918269467294,-146948534,-150705894.2,27.113675644425,52.9194312131223,NaN,NaN,-13.8528757063775,-0.3807639424304341
2001-06-21T09:30:00-04:00,122.22,124.31,122.14999,123.82001,12259102,9451559.95,45.5001204097733,45.403359217000286,NaN,NaN,-69.91666198159324,-141.12392941114518,-0.5600951031697771,-1.0052107059089508,-0.4451156027391737,-134689432,-150588193.2,27.235260987075648,50.57672045588578,NaN,NaN,-13.276515623809923,-2.223014182627504
2001-06-22T09:30:00-04:00,123.49001,123.599,122.16,122.85001,12212000,9666890.05,42.387897406388625,44.63450646943325,NaN,NaN,-76.80826467122057,-116.42909807804037,-0.4611654494220644,-1.0215724145167542,-0.5604069650946898,-146901432,-149548633,28.371771761104085,48.26232727679659,NaN,NaN,-13.689142287489208,-3.861032483322033
2001-06-25T09:30:00-04:00,123.28,123.44,121.5,121.72,8406801,9715980.1,39.03793285771725,43.324228901180554,NaN,NaN,-85.33444288043908,-99.21893503934302,-0.4419886791025044,-1.1128928139728202,-0.6709041348703159,-155308233,-147916672.8,30.214504492781145,45.85270719991412,NaN,NaN,-15.042839068753041,-5.458433424097891
2001-06-26T09:30:00-04:00,120.89999,122.39,120.571,121.55,8006398,9665684.95,38.54440575333483,42.25135346190522,NaN,NaN,-94.96277549640608,-89.57387231517083,-0.41153177198748103,-1.1853188498546672,-0.7737870778671861,-163314631,-149432452.4,29.456502241402944,43.19894363143735,NaN,NaN,-16.28892052152914,-7.00564586658807
2001-06-27T09:30:00-04:00,121.60001,122.24001,120.91,121.48,10105102,9668850,38.329527992649375,41.06403012747552,NaN,NaN,-83.63468446821382,-82.13136589957455,-0.3682815645258052,-1.2341390335244427,-0.8658574689986375,-173419733,-154726692.2,26.916544140215947,40.207497906989396,NaN,NaN,-17.374200040635852,-8.48686789145204
2001-06-28T09:30:00-04:00,122,123.94,121.92999,122.14999,10271000,9688640.05,41.680704829564405,40.41769398087059,NaN,NaN,-46.38862289009325,-77.42575808127457,-0.2712161903672864,-1.2048777069577454,-0.933661516590459,-163148733,-160418552.4,24.473267548961815,37.026071748079694,NaN,NaN,-17.397808839672884,-9.75985945548359
2001-06-29T09:30:00-04:00,122.8,124.00999,122.25999,122.60001,9824199,9737434.95,43.88635548708192,40.1423285218674,NaN,NaN,-34.382860883907114,-68.94067732381188,-0.1589286545532581,-1.1323223347820317,-0.9733936802287736,-153324534,-161703172.8,23.944976772932463,34.010364314820166,NaN,NaN,-16.817301916767356,-10.76806552138127
2001-07-02T09:30:00-04:00,122.8,124.32001,122.62,124.13,8522301,9881815.05,50.71149546562203,40.40654294118429,NaN,NaN,-8.315490307909881,-53.53688680930603,0.026296932055270728,-0.9405225151596852,-0.9668194472149559,-144802233,-159601972.8,26.73096206926496,31.7025893158813,NaN,NaN,-14.2863842911234,-11.270682488487289
2001-07-03T09:30:00-04:00,123.98,124.10001,123.05,124.10001,3303100,9591189.95,50.58162558965491,40.91229773531859,NaN,NaN,1.3671006610735665,-34.27091157781011,0.14791462930641908,-0.7819261605819321,-0.9298407898883512,-148105333,-156560113.2,30.689255078329467,30.055308512472802,NaN,NaN,-12.247066203243918,-11.410165876309664
2001-07-05T09:30:00-04:00,123.07001,123.64999,121.66,121.67999,5517801,9263835.1,41.373843236599235,41.296521821619,NaN,NaN,-47.90398457376943,-27.12477159892122,0.07042547472994332,-0.841808946475922,-0.9122344212058653,-153623134,-152600793.4,35.56849137159804,29.32564938286068,NaN,NaN,-13.09176596487012,-11.650394460389728
2001-07-06T09:30:00-04:00,121.31,121.49001,119.05,119.05,11666199,9479380,34.10727838334134,41.187046744238955,NaN,NaN,-154.15138633788976,-48.67732428848053,-0.14135819647803005,-1.0889321668034029,-0.9475739703253728,-165289333,-153028913.4,35.2792897419974,29.098551877841622,NaN,NaN,-16.372332177745946,-12.324956991440617
2001-07-09T09:30:00-04:00,119.491,120.53999,119.2,119.7,8339301,9487814.95,37.04995978260278,41.3897980925957,NaN,NaN,-153.95662641349665,-72.59207739439844,-0.21656953592395745,-1.2182858902303195,-1.001716354306362,-156950032,-153754013,34.7637305925807,29.26612614386457,NaN,NaN,-18.025889379325804,-13.139375903995644
2001-07-10T09:30:00-04:00,120.28999,120.64,118.21001,118.25999,8630699,9568739.95,33.48248942467136,41.16232783335988,NaN,NaN,-180.53793508377163,-107.03656634957079,-0.33512323074823347,-1.4206203927416539,-1.0854971619934204,-165580731,-157909712.6,31.88758140141948,29.474700988863493,NaN,NaN,-20.61874609641205,-14.20785736005513
2001-07-11T09:30:00-04:00,118.10001,118.89,117.09,118.38,15329699,9866799.9,34.052401981055795,40.76614561428973,NaN,NaN,-201.09793585977818,-147.52957365374112,-0.3743076481191532,-1.5533817221423618,-1.1790740740232086,-150251032,-158338852.4,31.5968657786255,29.7949288555921,NaN,NaN,-22.47403349204269,-15.388739664624781
2001-07-12T09:30:00-04:00,119.5,121.47,119.31,121.19,12004801,10085570.05,45.76882004124269,40.78533844510896,NaN,NaN,-59.68611329043621,-149.8859993970745,-0.18916882777539024,-1.4155351087424464,-1.2263662809670561,-138246231,-155263471.8,36.093393805419744,30.427652628330968,NaN,NaN,-20.150268719664172,-16.06895810105898
2001-07-13T09:30:00-04:00,120.84,122.32001,120.62,122.24001,10433602,9977085.1,49.38730785785459,41.28529633449939,NaN,NaN,3.7627831624853934,-118.30316549699947,0.014978873095810474,-1.207642689597293,-1.2226215626931034,-127812629,-147768131,45.49708263319295,31.650889119194456,NaN,NaN,-17.028742232692466,-16.206070119863764
2001-07-16T09:30:00-04:00,121.77,122.28,120.28999,120.71001,6915301,9481785.35,44.70639661355168,41.69018660277329,NaN,NaN,-31.431077369924477,-93.79805568828502,0.05565486149273258,-1.1530529858271876,-1.2087078473199202,-134727930,-143323710.6,50.17850358194401,33.07688905413466,NaN,NaN,-15.983389707635718,-16.174258632402616
2001-07-17T09:30:00-04:00,120.2,121.95,119.83,121.84,7470301,9286860.35,48.582487637778414,42.40719245166211,NaN,NaN,-23.59449011684403,-62.409366694899504,0.16136514384965528,-1.0070014175078512,-1.1683665613575065,-127257629,-135659090.2,57.03269544215,35.046617139902295,NaN,NaN,-13.825798633001027,-15.838764346773818
2001-07-18T09:30:00-04:00,120.56,121.64,120.06,121.00999,7709301,9285710.35,46.03005674424438,42.95723021963318,NaN,NaN,-37.30126994259805,-29.650033511463484,0.17684574917168838,-0.947309374892896,-1.1241551240645844,-134966930,-132602269.8,59.42992307934351,37.369001349839984,NaN,NaN,-12.895634672350912,-15.41831725042769
2001-07-19T09:30:00-04:00,122.17999,122.98,120.75999,122.07001,10082898,9350495.3,49.66704649284221,43.527683195581595,NaN,NaN,20.731365428081713,-13.566537767759893,0.25517485396683104,-0.8051865566060457,-1.0603614105728767,-124884032,-129929830,61.45464731290062,40.010528475835606,NaN,NaN,-10.953257693587899,-14.780451599450576
2001-07-20T09:30:00-04:00,121.14999,121.94,120.92,121.34,6705801,9072830.25,47.30288480002952,43.77172100364928,NaN,NaN,-3.887861789606316,-15.096666758178248,0.2539729116755973,-0.74289527097838,-0.9968681826539774,-131589833,-130685270.8,60.534953109824734,42.624098214185054,NaN,NaN,-10.09231956890957,-14.110718452230431
2001-07-23T09:30:00-04:00,121.8,121.88,118.95,118.95,8065199,8865490.2,40.505034150738105,43.04268805258614,NaN,NaN,-82.51129535942492,-25.31271035607832,0.09646991824421958,-0.8762807848487029,-0.9727507030929224,-139655032,-131670691.2,59.288530832178935,44.94963884010748,NaN,NaN,-11.57394644669499,-13.748322451439654
2001-07-24T09:30:00-04:00,119,119.2,116.75,117.8,12271000,9058700.15,37.69776401424347,42.122412225771036,NaN,NaN,-168.67310187277408,-54.32843270726433,-0.07182895013384438,-1.062536890760228,-0.9907079406263836,-151926032,-136604371.8,53.364152633978236,46.56927437979669,NaN,NaN,-13.720039532938255,-13.744282034510883
2001-07-25T09:30:00-04:00,117.92,119.48,117.46001,119.10001,12088898,9262825.15,42.54543647813555,42.20609745730935,NaN,NaN,-110.73190969743904,-69.01456065823251,-0.08155433175978355,-1.092650855326113,-1.0110965235663294,-139837134,-137578412.6,52.254000662540044,47.76109647200683,NaN,NaN,-13.93304357299224,-13.77124796857965
2001-07-26T09:30:00-04:00,119.06,120.85001,118.56,120.35001,12930000,9404070.05,46.82943136274999,43.11482267012425,NaN,NaN,-45.757599600654665,-82.31235366397979,0.005615254058130237,-1.0040774559936665,-1.0096927100517967,-126907134,-137983033,51.772180924943626,48.93916012793155,NaN,NaN,-12.719963246773256,-13.621064436893022
2001-07-27T09:30:00-04:00,120.83,121.35001,119.91,120.81,8481801,9314610.1,48.35549141505517,43.92236064387085,NaN,NaN,-4.592645477266281,-82.4533104015118,0.09851776368044685,-0.8865455054512381,-0.985063269131685,-118425333,-135350133,54.69930529364988,50.363129749436496,NaN,NaN,-11.27037572702431,-13.285251764054635
2001-07-30T09:30:00-04:00,121.19,121.35001,120.3,120.85001,8547699,9250785.1,48.493963838126014,44.994608816260474,NaN,NaN,8.714401974656566,-64.2081709346955,0.16311677144800485,-0.781167304821679,-0.9442840762696838,-109877634,-129394653.4,60.534182440347166,52.409315537931334,NaN,NaN,-10.07084290682311,-12.826050498735846
2001-07-31T09:30:00-04:00,121,122.67999,120.8,121.35001,11918602,9420600.15,50.287821875720276,46.15428166587936,NaN,NaN,61.37909676467331,-18.197731207206022,0.23557301691319188,-0.649817805128194,-0.8853908220413859,-97959032,-118601253.4,68.46248971506013,55.0425743905338,NaN,NaN,-8.555283669385513,-12.215940951685798
2001-08-01T09:30:00-04:00,121.97,122.7,121.55,122.11,11940801,9852485.2,52.96906451118875,46.668584842304085,NaN,NaN,102.21455036349705,24.3915608049812,0.32521078649060553,-0.4788773389281289,-0.8040881254187344,-86018231,-107837472.8,74.05921226407342,57.75441856615193,NaN,NaN,-6.494081466360447,-11.398532453782177
2001-08-02T09:30:00-04:00,123.23,123.25,121.89,122.61,11070199,10130105.1,54.70014379042989,47.048073123202315,NaN,NaN,129.2294768476099,59.38897609463411,0.40358546693774233,-0.2996062917465565,-0.7031917586842988,-74948032,-97445652.4,78.09996802166222,60.08319609389973,NaN,NaN,-4.266081291620549,-10.37961085918766
2001-08-03T09:30:00-04:00,122.36,122.36,120.89999,121.94,10816500,10087620.15,51.94124856643282,47.56484826269382,NaN,NaN,70.54714426437926,74.41693404296322,0.3952056114804925,-0.20918474433368317,-0.6043903558141757,-85764532,-90913492.2,80.18895922196744,62.22680006818712,NaN,NaN,-3.1055929955124646,-9.340465450091203
2001-08-06T09:30:00-04:00,121.35001,121.50999,120.10001,120.3,8550398,10098175,45.84586996120565,47.369375571510055,NaN,NaN,0.010796888304790253,72.67621302569287,0.2700850920695762,-0.2667839907272054,-0.5368690827967816,-94314930,-87800951.4,81.11341919472318,63.94685176479948,NaN,NaN,-3.829543483057711,-8.553190883372134
2001-08-07T09:30:00-04:00,120.27,121.2,119.911,120.77,8865102,10109895.15,47.73868142480713,47.491420191550255,NaN,NaN,-6.401528330788431,59.12008800660051,0.21239250261221326,-0.271378454531515,-0.48377095714372825,-85449828,-85299110.6,81.84669251692384,65.5480495817695,NaN,NaN,-3.896151574863361,-7.887899553585166
2001-08-08T09:30:00-04:00,120.12,121.16,118.42999,118.53,15183801,10102600.25,40.477258837584216,46.83500678760324,NaN,NaN,-109.18156214599738,16.840865504701622,0.026556819803598364,-0.4505749323892303,-0.47713175219282866,-100633629,-88222190.2,78.03458347245777,66.7323307360236,NaN,NaN,-6.232394794088716,-7.651398873657102
2001-08-09T09:30:00-04:00,118.7,118.97,117.86,118.88,14118500,10208285.2,41.96272583852492,46.45356686178149,NaN,NaN,-143.968982869404,-37.79882643870115,-0.06462743687806399,-0.5579160482904086,-0.49328861141234465,-86515129,-90535609.6,75.0550879717601,67.76948322616182,NaN,NaN,-7.689875006396248,-7.656895464048408
2001-08-10T09:30:00-04:00,118.8,119.84,117.34,119.28999,11173301,10245270.15,43.734119585113284,46.68421582137972,NaN,NaN,-108.36721250317713,-73.58169779221242,-0.08773026330224654,-0.6029514405401528,-0.5152211772379063,-75341828,-88451068.8,75.94629441625335,68.95932348216715,NaN,NaN,-8.386081122093184,-7.76106484376909
2001-08-13T09:30:00-04:00,119.60001,119.85001,118.819,119.32001,7435398,10271275,43.86921211846327,47.1250335431097,NaN,NaN,-67.42473376293195,-87.06880392245976,-0.09099872256549468,-0.6289695804447746,-0.5379708578792799,-67906430,-83169368.8,78.08291382917534,70.72494928182408,NaN,NaN,-8.918219111815304,-7.926372596347121
2001-08-14T09:30:00-04:00,120.14,120.35001,118.8,119.27,13178102,10556665.05,43.68105951109618,47.206149474035456,NaN,NaN,-52.55298681855011,-96.29909562001211,-0.08656396985181247,-0.6461758201940455,-0.559611850342233,-81084532,-82296309.6,78.42408246537705,72.59424083916959,NaN,NaN,-9.410470063367438,-8.138386520207167
2001-08-15T09:30:00-04:00,119.23,119.61,118.08,118.24001,8520602,10597230.1,39.88669303702161,46.71023959362629,NaN,NaN,-90.61262261497535,-92.5853077138077,-0.13987620756297714,-0.7344571097959545,-0.5945809022329773,-89605134,-80090610.6,79.30073684473967,74.56056626201214,NaN,NaN,-10.893955226330942,-8.532039192510563
2001-08-16T09:30:00-04:00,117.8,118.75,117,118.64999,10734699,10629820.15,42.044703704677616,46.25946904288504,NaN,NaN,-108.59941153074534,-85.51139344607597,-0.13437409699361036,-0.7625485234749902,-0.6281744264813799,-78870435,-78561671.8,79.91008536867464,76.36133626737107,NaN,NaN,-11.58419315123641,-8.968061186614255
2001-08-17T09:30:00-04:00,117.64999,117.87,116.00999,116.75,11604602,10874760.2,35.6562972957221,45.34249286128476,NaN,NaN,-158.1259218598164,-95.46313531740383,-0.23940734521388518,-0.9274336079987364,-0.6880262627848512,-90475037,-81588313.6,75.19126059670556,77.40827042139667,NaN,NaN,-14.142309435160122,-9.707239507835093
2001-08-20T09:30:00-04:00,116.8,117.89999,116.55,117.83,10417398,10992370.15,41.131743744287014,44.6884872804681,NaN,NaN,-112.65015803925729,-104.5082201726689,-0.21749434069997253,-0.9598941886598169,-0.7423998479598444,-80057639,-84018555.4,71.53830777812007,77.62797171161525,NaN,NaN,-14.718828695195954,-10.423180820315215
2001-08-21T09:30:00-04:00,117.8,118.53999,115.8,115.82001,14481398,11102890.05,35.138622737253755,43.4148842966156,NaN,NaN,-139.1333857078605,-121.82429995053099,-0.3138628296589111,-1.1347283850334833,-0.8208655553745722,-94539037,-86709456.4,67.62097008981885,77.16809727059706,NaN,NaN,-17.195780920209636,-11.390695120300132
2001-08-22T09:30:00-04:00,116.75,117.42999,115.78,117.02,11752898,11086090.05,40.69434405073571,42.41447002949458,NaN,NaN,-125.58595770825667,-128.81896696918724,-0.2737472904225643,-1.1630496684027776,-0.8893023779802133,-82786139,-85345657.4,68.5606149063264,76.48671490521592,NaN,NaN,-17.473021670498888,-12.259598913185668
2001-08-23T09:30:00-04:00,116.96001,117.52,116.49001,116.60001,8745301,10876855.1,39.42161855530854,41.520210742985704,NaN,NaN,-106.43469320058,-128.3860233031542,-0.2529485428860666,-1.2054880565877966,-0.95253951370173,-91531440,-87877858.4,64.80042126834667,75.38753362281443,NaN,NaN,-18.093178045494454,-13.092967360658351
2001-08-24T09:30:00-04:00,117.21001,119.13,116.74001,119.02,11688301,11037180.1,49.267341623718,41.7646015760223,NaN,NaN,-41.62291868749458,-105.08542266868983,-0.06353008108841884,-1.0319521150622535,-0.9684220339738346,-79843139,-85751478.8,66.46374715318487,74.34112847699028,NaN,NaN,-15.307249729642033,-13.409293413370305
2001-08-27T09:30:00-04:00,118.97,119.2,118.25999,118.31,7428102,10981200.25,46.860927902337444,41.70190489584589,NaN,NaN,-25.195518143746128,-87.59449468958759,0.02204247046778174,-0.9408689458891075,-0.9629114163568893,-87271241,-87194199.2,64.24550632045091,73.08390089152792,NaN,NaN,-13.849209573403948,-13.472138579089396
2001-08-28T09:30:00-04:00,118.28,118.49001,116.58,116.58,12046602,10987600.25,41.53714598533455,41.77761112068521,NaN,NaN,-79.96392951370682,-75.76060345075686,-0.027103693583216626,-0.99679103333591,-0.9696873397526934,-99317843,-88149960.4,62.75134053546207,71.99224068174252,NaN,NaN,-14.382856760085064,-13.602241176374491
2001-08-29T09:30:00-04:00,117.13,117.17999,115.17,115.53999,16181801,11199650.25,38.69137692282407,41.54394334099229,NaN,NaN,-131.3739337976962,-76.91819866864475,-0.11401729085408951,-1.1122089533203052,-0.9981916624662157,-115499644,-94692661.4,53.56704082399687,70.45738017118799,NaN,NaN,-15.765461839675021,-13.911272699703138
2001-08-30T09:30:00-04:00,114.85001,115.74001,112.03999,113.32001,17693104,11530795.5,33.426898882478,40.807713290804045,NaN,NaN,-213.13423489803623,-98.258107008136,-0.295089689509322,-1.3670537743528683,-1.0719640848435463,-133192748,-103024923,44.612040019467265,68.21921914284613,NaN,NaN,-18.813772154584573,-14.611629764686201
2001-08-31T09:30:00-04:00,113.39999,114.77,113.13,114.14999,15985699,11789255.45,36.884541657541575,40.30880825788107,NaN,NaN,-171.87975467726878,-124.30947420609084,-0.33037299533747033,-1.4849303290153841,-1.1545573336779138,-117207049,-110497705,38.41022357228401,65.38545555306817,NaN,NaN,-20.09364089076696,-15.394774211269167
2001-09-04T09:30:00-04:00,113.85001,116.17,113.37,113.42,24475392,12585505.15,35.15510864111559,39.69981176716817,NaN,NaN,-140.66498311543205,-147.40336720042802,-0.3712295671329575,-1.6185942925941106,-1.247364725461153,-141682441,-121379945,31.53508441057643,62.0362414062967,NaN,NaN,-21.686161992998013,-16.29354389437329
2001-09-05T09:30:00-04:00,113.7,114.19,111.95,113.7,21477696,13216134.85,36.38716314928811,39.44984534661578,NaN,NaN,-164.2954389806034,-164.26966909380732,-0.34813627550413484,-1.6825350698413217,-1.3343987943371869,-120204745,-125557325.4,29.362400144059407,58.46921735624811,NaN,NaN,-22.580162656787,-17.19163228900382
2001-09-06T09:30:00-04:00,112.64999,113.3,110.77,110.77,21654096,13539649.6,29.970096269988744,38.58737338699515,NaN,NaN,-194.94506349959548,-176.98389503418719,-0.4902322647648387,-1.9471891252932352,-1.4569568605283965,-141858841,-130829164.8,26.848407605650138,54.67909751603208,NaN,NaN,-25.589008344420733,-18.391257439777664
2001-09-07T09:30:00-04:00,110.02,111.25,108.63,108.72,33133904,14490419.8,26.45478684721614,37.9301226406733,NaN,NaN,-208.93111884696015,-176.14327182397196,-0.6711399058246319,-2.295881742809186,-1.6247418369845543,-174992745,-139189164.2,23.423471662927952,50.981398306476535,NaN,NaN,-29.387128866697083,-19.96209621505187
2001-09-10T09:30:00-04:00,107.7,110.35001,107.7,110.05,23408704,15102189.95,32.02541830429291,37.27967082353086,NaN,NaN,-173.02424786342524,-176.37217046120327,-0.649657093538679,-2.436813203907903,-1.787156110369224,-151584041,-146064562.6,21.045683004817533,47.37478225124064,NaN,NaN,-30.580628607553166,-21.479029413980626
2001-09-17T09:30:00-04:00,101,106.39999,100,104.3,32393808,16350110.45,23.675957147855655,36.46090899571671,NaN,NaN,-248.31046289973432,-197.9012664180637,-0.9527943904697285,-2.9781490984563845,-2.025354707986656,-183977849,-154523644.2,18.550574783428885,43.86975401506993,NaN,NaN,-35.11650545498286,-23.427240276980946
2001-09-18T09:30:00-04:00,104.33,105.3,103.36,104.05,22029200,16792665.35,23.390422671008253,35.224914611450465,NaN,NaN,-192.31065368938465,-203.50430935981996,-1.0903375627621203,-3.3882766614393063,-2.297939098677186,-206007049,-171684105,14.734253603129531,40.02501392198444,NaN,NaN,-38.51917669624282,-25.583231194018357
2001-09-19T09:30:00-04:00,104.10001,104.5,98.56,101.95,42772096,18505240.05,21.089599171398547,33.91548465545689,NaN,NaN,-192.80968750361328,-203.0772341606235,-1.2324568836559626,-3.8385102032471394,-2.606053319591177,-248779145,-193068165.8,11.546505291862616,36.221162780807006,NaN,NaN,-42.12768893077056,-27.946725156411528
2001-09-20T09:30:00-04:00,100.39999,101.81,98.569,98.71001,36212800,19779145.1,18.1269570162532,31.6911714692094,NaN,NaN,-178.69065692829545,-197.02914177689058,-1.439936796233399,-4.405974314882926,-2.9660375186495265,-284991945,-215068005.8,9.31394341683432,32.13903394249625,NaN,NaN,-46.301220163431125,-30.56879587170004
2001-09-21T09:30:00-04:00,94.05,98.99001,93.8,97.28,49783504,21688090.2,16.992352594628414,29.557701804373043,NaN,NaN,-177.38030819269952,-197.90035384274546,-1.5587164191868643,-4.914433042633107,-3.3557166234462423,-334775449,-251706287.4,6.915716044108308,28.04404892275749,NaN,NaN,-49.96658953512323,-33.33990925218907
2001-09-24T09:30:00-04:00,99.729,101.16,99.06,100.7,25549808,22444710.7,28.516232309257873,28.627636541796132,NaN,NaN,-114.7968185296747,-171.19762496873355,-1.3026048571973883,-4.9839726949429775,-3.681367837745589,-309225641,-276755845.8,5.813548279395832,23.977063761609905,NaN,NaN,-48.76351057598345,-35.54328086987398
2001-09-25T09:30:00-04:00,100.75101,102,99.89999,101.75,25466192,22993950.4,31.653452965565762,28.12492768770625,NaN,NaN,-92.29938279409672,-151.19537078967593,-0.9732235179070647,-4.89789723512942,-3.9246737172223556,-283759449,-292306325.8,5.2537770196032625,20.526116347010355,NaN,NaN,-46.72363029800552,-37.14047364532134
2001-09-26T09:30:00-04:00,102.35001,102.39999,100.42999,101.39,18587504,23335680.7,31.14870393100793,27.96219947688696,NaN,NaN,-80.11709605705664,-128.65685250036464,-0.7029495484812225,-4.8033606528238835,-4.100411104342661,-302346953,-303019887.4,4.90347094004926,17.689789984194793,NaN,NaN,-45.31640668273834,-38.30846407923806
2001-09-27T09:30:00-04:00,101.25,102.28999,100,102.27,20536800,23925255.65,33.922489788702876,27.75062434339848,NaN,NaN,-70.20247832915389,-106.95921678053632,-0.40315507412328255,-4.604354946996764,-4.201199872873482,-281810153,-302383529,5.307344041494488,15.325298589138399,NaN,NaN,-43.300769448446566,-39.02165056055356
2001-09-28T09:30:00-04:00,102.98,109.92,102.5,104.44,21787696,24430225.4,40.308572242275375,28.118728886338467,NaN,NaN,-22.53611594156092,-75.99037833030859,-0.01732978262525009,-4.2228621011550445,-4.205532318529794,-260022457,-287432930.6,14.49516292067186,14.108161339859503,NaN,NaN,-39.50462523920047,-39.09064694321741
2001-10-01T09:30:00-04:00,103.89999,104.32001,102.83,104.27,20457600,25081700.3,39.98256639541295,28.37554340391881,NaN,NaN,-36.89136195385338,-60.40928701514431,0.25289852378263333,-3.8894091638015027,-4.142307687584136,-280480057,-281683813.8,17.79813599002422,13.28214247171413,NaN,NaN,-36.597166684913645,-38.73443547774544
2001-10-02T09:30:00-04:00,104,105.58,103.64999,105.58,19833600,25471050.2,43.75742124230702,29.360352330512974,NaN,NaN,-18.05297489796816,-45.5600054359186,0.5303808006270971,-3.479331686800265,-4.009712487427362,-260646457,-277061215.4,20.458718006991916,12.82573607180997,NaN,NaN,-32.99567075638387,-37.91461194612236
2001-10-03T09:30:00-04:00,104.60001,107.881,104.35001,107.35001,32070192,26265469.75,48.473117369863004,30.933090224987755,NaN,NaN,9.887752308708233,-27.55903576276562,0.8260115645416457,-2.977198031750305,-3.8032095962919508,-228576265,-262307077.8,28.42191416669327,13.182767679221781,NaN,NaN,-28.437735853784424,-36.560772504359804
2001-10-04T09:30:00-04:00,108.28999,108.97,106.75,107.44,32675504,27014589.75,48.70858352634948,32.12474488370608,NaN,NaN,34.38470012260874,-6.6416000724130955,1.0084223963985446,-2.5426816007937703,-3.551103997192315,-195900761,-245125199.4,36.40644538939793,14.279964992406098,NaN,NaN,-24.703766453423366,-34.86691449708317
2001-10-05T09:30:00-04:00,107.25,107.62,105.521,107.23,29830192,27706814.4,48.15555095688773,33.87328729863694,NaN,NaN,28.018377210069435,3.4692985579129756,1.0888638314578096,-2.190024207870053,-3.2788880393278625,-225730953,-238266898.6,39.31630432904283,15.763231388521378,NaN,NaN,-21.778149555912275,-32.99709093405876
2001-10-08T09:30:00-04:00,106.27901,107.3,105.87,106.53,12971199,27131604.75,46.269708534963556,35.507522003205175,NaN,NaN,34.65429045725616,17.77842904013488,1.0674235549337672,-1.9446085956606538,-3.012032150594421,-238702152,-229911317.6,42.75311422007617,17.764578575446137,NaN,NaN,-19.78575585188128,-31.10975735089055
2001-10-09T09:30:00-04:00,106.61,106.75,105.60001,105.96001,15976301,26856535,44.73351494392682,37.19637312981434,NaN,NaN,36.45737868861261,28.680499757451038,0.989113790363489,-1.7756399126400595,-2.7647537030035485,-254678453,-228717716.8,43.24757860358985,20.028940954855223,NaN,NaN,-18.492714506195547,-29.307322658791264
2001-10-10T09:30:00-04:00,105.8,108.55,105.52,108.32001,19987392,26773199.8,51.86013353330507,39.60588573817518,NaN,NaN,76.11854922070646,41.926659139850685,1.0639951860941546,-1.4347597203858555,-2.49875490648001,-234691061,-229940676,42.8392939989475,22.423608853577594,NaN,NaN,-15.238190675153648,-27.29744666112875
2001-10-11T09:30:00-04:00,108.95,110.3,108.95,110,23008608,26266935,56.19090558027253,42.405782380006904,NaN,NaN,129.3191580885953,60.913550733047984,1.1851467169697862,-1.0173215102677773,-2.2024682272375635,-211682453,-233097014.4,41.74394879665128,24.91133976447352,NaN,NaN,-11.08446565557174,-24.981306517477748
2001-10-12T09:30:00-04:00,109.14999,109.89,107.3,109.5,31361504,26664575,54.616092335061815,44.27005809613576,NaN,NaN,110.68431183094134,77.44673765722237,1.1871254506665223,-0.7185614139044105,-1.9056868645709328,-243043957,-236559615.2,40.519949549257994,27.390368426606532,NaN,NaN,-8.08832433574884,-22.56802334865933
2001-10-15T09:30:00-04:00,108.63,109.45,108.06,109.3,16875008,25888635,53.964589099619126,45.86371067713957,NaN,NaN,99.11949395417503,90.33977835660615,1.1307448554746269,-0.4922557952276492,-1.623000650702276,-259918965,-240802977.8,39.01035631251084,29.801552661814213,NaN,NaN,-5.789735901444295,-20.171125141914327
2001-10-16T09:30:00-04:00,109.8,110.619,108.95,109.99001,15883602,25581355.1,55.918317490554536,47.63296878853576,NaN,NaN,106.22207715843281,104.29271805057019,1.0949624902304627,-0.25429753791419785,-1.3492600281446605,-244035363,-238674359.8,40.21363293459982,32.3237070899964,NaN,NaN,-3.2860557721644175,-17.758972374807197
2001-10-17T09:30:00-04:00,111.07001,111.14999,107.64999,107.64999,28601696,24872835.1,48.414287271049396,48.66809718013194,NaN,NaN,78.07494828742611,104.68399786391413,0.8781013902763486,-0.25163329029922465,-1.1297346805755732,-272637059,-246263559.4,37.38189157128637,34.614746199267245,NaN,NaN,-3.1488925787346247,-15.671818118225401
2001-10-18T09:30:00-04:00,107.82001,108.16,106.75,107.42,16517398,23888065,47.73623571744645,49.19864457121559,NaN,NaN,44.63918517185003,87.74800328056507,0.6917676791847664,-0.26502508159461513,-0.9567927607793816,-289154457,-261757960.2,32.37015187380776,35.89153112449124,NaN,NaN,-3.228078332490933,-13.89414100597762
2001-10-19T09:30:00-04:00,107,107.91,106.00999,107.35001,21916096,22494694.6,47.5181334057637,49.73689935766921,NaN,NaN,29.884898064994037,71.58812052737561,0.5429700127954353,-0.2780802447850874,-0.8210502575805227,-311070553,-275363279.4,28.728050562747782,36.672239308257204,NaN,NaN,-3.352516632105641,-12.388194666853051
2001-10-22T09:30:00-04:00,107.3,109.57001,107.21001,109.47,17570896,22095749,54.325353551236965,50.49175166544992,NaN,NaN,74.03496994489007,66.57121572551861,0.564021300496767,-0.116023631959564,-0.680044932456331,-293499657,-282079417.8,27.106690866014958,37.14709451247314,NaN,NaN,-1.5154583266532493,-10.83494661825308
2001-10-23T09:30:00-04:00,109.96001,110.28,108.379,108.91,22064496,21925664.2,52.39220126789777,50.77168622959526,NaN,NaN,84.17312776183456,62.16142584619895,0.5181108593258654,-0.032406358298999294,-0.5505172176248647,-315564153,-296385175.8,23.999605154160037,36.8312152972922,NaN,NaN,-0.518660999850914,-9.361191529909913
2001-10-24T09:30:00-04:00,108.98,109.45,108.22,108.62,16065398,21799558.9,51.37269359870221,50.961979806191884,NaN,NaN,63.67331096607138,59.281098381928004,0.4486866947310146,0.01034115078890352,-0.43834554394211106,-331629551,-308183674.2,21.7820425921758,35.78661509749061,NaN,NaN,0.03410403647921232,-8.019006448997182
2001-10-25T09:30:00-04:00,107.45,110.60001,106.74001,110.57001,27504000,22147918.9,57.37855789907478,51.6207660163481,NaN,NaN,81.40364184928983,66.63398971741597,0.5100934706475231,0.19927129436729274,-0.3108221762802303,-304125551,-311177893,21.245528900183587,34.49584542400067,NaN,NaN,2.290022813901357,-6.546287982868819
2001-10-26T09:30:00-04:00,109.95,111.78999,109.67,110.32001,18623296,21989698.9,56.41652595096132,52.34553868891937,NaN,NaN,128.06668420640335,86.27034694569782,0.5087213960202156,0.3250795687450392,-0.1836418272751764,-322748847,-313513551.8,20.814837906091682,32.92882568728749,NaN,NaN,3.8814108687030116,-5.0566167183585575
2001-10-29T09:30:00-05:00,110.16,110.55,107.45,107.45,18733808,21903509.3,46.73007971281722,52.48815045812582,NaN,NaN,20.927104473805883,75.64877385148098,0.2997102841754855,0.19099602794418047,-0.10871425623130501,-341482655,-323110151.4,19.10144442194121,31.204101817169732,NaN,NaN,2.359149815076247,-3.997221499296443
2001-10-30T09:30:00-05:00,107.35001,107.7,105.56,106.16,26197904,22221724.5,43.14438432465586,51.865596943222315,NaN,NaN,-99.5197663503111,38.91019502905185,0.07166120094264802,-0.019137755052994976,-0.090798955995643,-367680559,-333533432.6,17.423804226152683,29.388709690541532,NaN,NaN,-0.07301838561864982,-3.4366210544853297
2001-10-31T09:30:00-05:00,106.89999,107.86,105.8,105.8,28130496,22024739.7,42.17186738061312,50.86423707181807,NaN,NaN,-98.4308669073396,6.489359454369657,-0.09717870717525587,-0.21227233996471284,-0.11509363278945697,-395811055,-346369733.4,15.606010413026993,27.521714091711225,NaN,NaN,-2.3385874628533863,-3.2797591128236236
2001-11-01T09:30:00-05:00,106.60001,109.00999,105.69901,108.50999,29807296,21881329.3,51.106451280744004,50.613548425081085,NaN,NaN,-25.403389190236247,-14.872046753535557,-0.023915504750729052,-0.1449880137278683,-0.12107250897713924,-366003759,-358745375,14.080762837249324,25.63320075513918,NaN,NaN,-1.5410569737438338,-3.031373092955082
2001-11-02T09:30:00-05:00,108.44,109.38,107.87,109.25,17577904,21268714.9,53.23137969979798,50.56117632509386,NaN,NaN,34.20308425362073,-33.64476674409208,0.07158764581775176,-0.031587951704949546,-0.1031755975227013,-348425855,-363880776.6,13.491511689899141,23.81042613923834,NaN,NaN,-0.22306111093175005,-2.630185666951749
2001-11-05T09:30:00-05:00,110.12,111.09,109.95,110.67999,15991301,21419720,57.11042280289202,50.64632670454653,NaN,NaN,132.58590971503165,-11.313005695846925,0.2198936810146005,0.1716915037455493,-0.048202177269051176,-332434554,-362071156.4,14.84385805202622,21.998299361911656,NaN,NaN,2.130192177084087,-1.950131689232344
2001-11-06T09:30:00-05:00,110.35001,112.48,109.85001,112.39999,23245904,21783200.15,61.27128441109314,51.564683643121086,NaN,NaN,186.9601599587741,45.98297956597012,0.41152767241032134,0.4662074132438505,0.054679740833529174,-309188650,-350372774.6,23.20186845465065,20.98544056786625,NaN,NaN,5.50176876959507,-0.8855744808284278
2001-11-07T09:30:00-05:00,111.77,113.12,111.64,112.25,19716800,21769670.55,60.718102161165284,52.49195981767243,NaN,NaN,198.57960610226831,105.3850741678917,0.4999966688890756,0.6796755769448737,0.17967890805579806,-328905450,-336991653.6,31.485500671108127,20.922251196244847,NaN,NaN,8.00655253751823,0.3847293789353803
2001-11-08T09:30:00-05:00,112.87,114.08,111.89999,112.60001,22747808,21756630.55,61.589593325053265,53.497064097621696,NaN,NaN,189.00269879661073,148.2662917652611,0.5499353925699499,0.8670981487682354,0.3171627561982855,-306157642,-325022430.2,37.93431490223289,21.579841506208066,NaN,NaN,10.31008548739753,1.802637394429973
2001-11-09T09:30:00-05:00,112.25,112.96001,111.44,112.72,15897500,20983430.35,61.90164465551342,54.038227747927145,NaN,NaN,136.44668885166183,168.71501268486932,0.5571734642698634,1.0136295865356146,0.45645612226575133,-290260142,-313389287.6,43.500501172179824,22.75082795664841,NaN,NaN,12.284721132012024,3.300077928370266
2001-11-12T09:30:00-05:00,111,112.64999,110,112.03,26071600,21443259.95,58.936471983593655,54.50567565619114,NaN,NaN,87.23737881212773,159.64530650428853,0.48430658233302015,1.0618393501820265,0.5775327678490063,-316331742,-310168725.2,44.971832831264344,24.24884421929872,NaN,NaN,13.16270090176263,4.709024067426318
2001-11-13T09:30:00-05:00,113.44,114.55,113.17999,114.55,15347102,21416434.95,65.44641323729468,55.51094134466204,NaN,NaN,158.38765519354834,153.9308055512434,0.5688021378938408,1.2885354402163074,0.7197333023224666,-300984640,-308527923.2,45.74700618380055,25.960627332986203,NaN,NaN,15.973593078677695,6.3182482118908005
2001-11-14T09:30:00-05:00,115.17,115.39999,113.71001,114.66,17591392,20865919.75,65.70201640163604,56.10547409484497,NaN,NaN,147.43194765838675,143.70127386246708,0.5924030390867306,1.46023710118088,0.8678340620941493,-283393248,-299425482.8,49.95844892262062,28.011550191731704,NaN,NaN,18.31740855806552,8.032413975630046
2001-11-15T09:30:00-05:00,114.37,115.17999,113.92999,114.87,19472400,21013669.85,66.21582072805985,56.805423721780585,NaN,NaN,131.31172661288537,132.16307942572197,0.5816307124329891,1.5948724526353857,1.0132417402023965,-263920848,-290978124,53.561213119370706,30.350576992680203,NaN,NaN,20.397621437446332,9.798872184460944
2001-11-16T09:30:00-05:00,115.08,115.10001,113.39999,114.36,18135392,20824634.65,63.71929694011651,58.018939238016245,NaN,NaN,108.17599095448361,126.50893984628632,0.5026042436545306,1.64149704477056,1.1388928011160293,-282056240,-289337343.6,54.25019613162786,32.86120211480068,NaN,NaN,21.488714885973874,11.468849713248504
2001-11-19T09:30:00-05:00,114.92,115.85001,114.45,115.77,13682500,20630214.85,67.38096271877049,59.75012340902453,NaN,NaN,122.74199726014386,133.60986353588956,0.5063244767654278,1.7717983970728142,1.2654739203073864,-268373740,-279745743.2,58.158268498547905,35.77080670568605,NaN,NaN,23.515375413198765,13.18978195609854
2001-11-20T09:30:00-05:00,115.37,115.8,114.64,114.8,16223000,20338140.05,62.69324892170942,61.2159363762457,NaN,NaN,102.99115146966768,122.53056279111343,0.4086736629959997,1.776315999052386,1.3676423360563863,-284596740,-276468163.2,59.43349651115367,38.901341426980814,NaN,NaN,23.918655222536866,14.722478137018301
2001-11-21T09:30:00-05:00,114.50101,114.67,113.50999,114.03999,11471102,20108425.25,59.217063000838095,61.795265784823854,NaN,NaN,69.47501468940744,106.93917619731755,0.26507407922454584,1.6989849350870685,1.4339108558625226,-296067842,-279003082,57.96213958101931,42.035725480107246,NaN,NaN,23.257562843030488,15.9417759521629
2001-11-23T09:30:00-05:00,114.03999,115.75,114,115.67999,6716898,19069070.15,63.87220468863848,62.55532471259817,NaN,NaN,89.71529996300418,98.61989086734134,0.2527612979532923,1.7498624783041379,1.4971011803508456,-289350944,-284089101.2,55.01908222275862,45.00198051816864,NaN,NaN,24.05129785499018,17.100279081138225
2001-11-26T09:30:00-05:00,115.75,116.34,115.07001,115.92999,13729199,18824365.3,64.5367337558308,63.08577549495093,NaN,NaN,96.811417889717,96.34697625438801,0.23409935054833708,1.789725368536267,1.55562601798793,-275621745,-282802202.2,55.632937710566985,47.9154862080644,NaN,NaN,24.89123918228932,18.213273381302667
2001-11-27T09:30:00-05:00,115.62,116.89999,114.09,115.42999,19266400,18850994.9,62.0773822984327,63.14335391547518,NaN,NaN,82.62011227372521,88.32259925710427,0.1640393512983589,1.7606752071108787,1.5966358558125198,-294888145,-288105083.2,52.456162757971335,50.0050786583016,NaN,NaN,24.89835255704731,19.16828469212333
2001-11-28T09:30:00-05:00,114.74001,115.17,113.25,113.34,20247200,18553459.7,52.98772024308232,62.59118377846925,NaN,NaN,33.90592418869179,74.5055538009091,-0.03640661632980291,1.5511275854002662,1.587534201730069,-315135345,-294212804.2,48.98653286447919,51.25515238639953,NaN,NaN,22.080893836044833,19.584371712683545
2001-11-29T09:30:00-05:00,113.662,114.92,113,114.87,17265104,18010190.1,57.85305119573822,62.324287912089595,NaN,NaN,38.37240871494807,68.28503260601721,-0.07696599121090086,1.4913267127164431,1.568292703927344,-297870241,-294573284,48.78145075719267,52.029947804610934,NaN,NaN,21.14548508617766,19.80738790889699
2001-11-30T09:30:00-05:00,114.39999,114.912,114.02,114.05,13680398,17203845.2,54.592144764178464,61.80218077699424,NaN,NaN,34.66985943085018,57.27594449958642,-0.16498144673263626,1.3620658955115488,1.527047342244185,-311550639,-299013223,46.21510164632623,52.22384783847854,NaN,NaN,19.344353040441714,19.741240070546237
2001-12-03T09:30:00-05:00,113.64999,114.08,113.00999,113.37,15220398,17085969.9,51.975811338926604,61.3049907309466,NaN,NaN,-17.223500876764206,34.46896074629017,-0.26881703958187897,1.1910260427668362,1.4598430823487152,-326771037,-309243081.4,40.87884246729478,51.93149138390929,NaN,NaN,17.046184055931324,19.356232068458393
2001-12-04T09:30:00-05:00,113.918,115.3,113.35001,115.28999,17245808,17148695.25,58.0840621089971,60.779108507496765,NaN,NaN,44.161421366136246,26.77722256477238,-0.21058717850507058,1.196609109217377,1.4071962877224475,-309525229,-312170498.2,39.474199478935724,51.48343376213323,NaN,NaN,16.938367980921694,19.010822913096007
2001-12-05T09:30:00-05:00,115.61,118,115.56,117.39999,25204000,17246600.05,63.568169894406935,60.62669089983755,NaN,NaN,192.6841299785209,58.53286372273824,-0.041224371095726964,1.3556658238527888,1.3968901949485157,-284321229,-306007675,43.84849946793571,51.0470088010843,NaN,NaN,18.692900485219507,18.965405423399364
2001-12-06T09:30:00-05:00,117.349,117.94,116.92999,117.34,17969200,17159220.05,63.31453366038671,60.41945610928946,NaN,NaN,193.54213687376304,89.56680935450125,0.050526402221597655,1.4600481977255129,1.4095217955039152,-302290429,-306891712.6,43.36435318071277,50.31866166260874,NaN,NaN,19.97763435570282,19.11000955658557
2001-12-07T09:30:00-05:00,116.89999,117.09,115.7,116.56,18908000,16967229.65,59.964375379717346,60.151247426403806,NaN,NaN,115.75822235139492,105.78448193861018,0.04275721300029267,1.462968311754281,1.4202110987539884,-321198429,-308821270.6,42.26737268279996,49.46274570197817,NaN,NaN,20.01275405574197,19.238973056465056
2001-12-10T09:30:00-05:00,115.85001,116.39,114.35001,114.38,13862801,16865494.7,51.726395874518474,59.03306408038581,NaN,NaN,15.087055025692099,112.24659311910145,-0.11642406866325827,1.2746810129249155,1.3911050815881738,-335061230,-310479309.2,41.30055756761268,48.25862349262565,NaN,NaN,17.337971724037597,18.967401437546847
2001-12-11T09:30:00-05:00,114.89999,115.72,113.89999,114.14999,20833296,16603579.5,50.93135847147813,58.192929048226425,NaN,NaN,-33.24957584267269,96.76439367733965,-0.23745381044006542,1.094287818538092,1.3317416289781574,-355894526,-319753168.6,36.2992214505021,46.60617527400768,NaN,NaN,14.968755009049003,18.396166233475725
2001-12-12T09:30:00-05:00,114.55,114.78,113.11,114.28,16172398,16644844.3,51.38618913107023,57.63358091467158,NaN,NaN,-78.10550488992632,42.606466703650206,-0.30470948648431295,0.9508547708727662,1.255564257357079,-339722128,-330833348.4,31.40581607669087,44.709295023698516,NaN,NaN,13.19302595778234,17.65286047980524
2001-12-13T09:30:00-05:00,113.45,113.7,112.03999,112.06,19031904,16716869.9,43.90279282213196,56.20719435277827,NaN,NaN,-173.16186762148408,-30.73433419539922,-0.4840126198232495,0.6505484825780172,1.1345611024012667,-358754032,-342126069,27.357887003012962,42.73349536514525,NaN,NaN,9.176122927710871,16.44189797236319
2001-12-14T09:30:00-05:00,112.33,113.49001,112,113.13,16722699,16579384.85,47.8452053039915,55.014942320504026,NaN,NaN,-133.41828581843495,-80.5696358293652,-0.5130822855141353,0.49320824550859754,1.0062905310227328,-342031333,-346292649.8,26.025040508664304,40.618645565009345,NaN,NaN,7.029071846605,15.097208525826305
2001-12-17T09:30:00-05:00,112.99001,114.36,112.89999,114.3,13947301,16369980.3,51.83151109534357,54.28309437742623,NaN,NaN,-62.48973725516795,-96.0849942855372,-0.43891345958195804,0.4576487065452852,0.8965621661272433,-328084032,-344897210.2,27.302459068073233,38.82195244430234,NaN,NaN,6.462770891153719,13.863717435158794
2001-12-18T09:30:00-05:00,114.63,115.14999,114.34,114.98,13663898,16369050.2,54.03064906252999,54.357589293101064,NaN,NaN,5.606859144449779,-88.31370728811272,-0.3341950822891394,0.47881831326581903,0.8130133955549584,-314420134,-336602331.8,34.538756367395536,37.78996840879637,NaN,NaN,6.670977887888519,12.836183214120183
2001-12-19T09:30:00-05:00,114.09,115.92,114,115.78999,20147392,16565269.8,56.57393594186773,54.266223917824604,NaN,NaN,33.79153141834341,-65.93430002645876,-0.20676099211031918,0.5545621554170594,0.7613231475273786,-294272742,-327512454.6,41.420167162503354,37.26416243774713,NaN,NaN,7.617046770094631,12.090592293545104
2001-12-20T09:30:00-05:00,115.5,115.8,114.55,114.64999,14867898,16735109.6,52.196886475088085,54.09513404003243,NaN,NaN,14.409245918243927,-28.420077318513155,-0.1957419948964122,0.5166456539068633,0.7123876488032755,-309140640,-317589776.2,47.86323753733916,37.381886429962336,NaN,NaN,7.100126769659422,11.377668647275721
2001-12-21T09:30:00-05:00,115.03,115.07001,114.2,114.95,14042199,17101374.65,53.22257832268804,54.18418882458682,NaN,NaN,-2.7207794021562934,-2.280576035257416,-0.16592314698478094,0.5049837150722993,0.6709068620570803,-295098441,-308203197.8,53.116486430724095,38.25600385592157,NaN,NaN,6.97760604795988,10.749088275944887
2001-12-24T09:30:00-05:00,114.83,115.03999,114.61,114.73,5728801,16701354.75,52.33576756905987,53.77359635744843,NaN,NaN,5.011286583284569,11.21962873243309,-0.15869172109732965,0.47254221068541824,0.6312339317827479,-300827242,-302751839.8,55.89585053941492,39.42897893167009,NaN,NaN,6.628365827820165,10.160413640498499
2001-12-26T09:30:00-05:00,114.64999,116.21001,114.64999,115.36,10307898,16253429.65,54.66529784852166,53.137676925599486,NaN,NaN,52.6609510568601,20.630447114915142,-0.11139003226050126,0.49199639145712126,0.6033864237176225,-290519344,-297971681.8,58.23399051734928,40.456514006628204,NaN,NaN,6.977880158395684,9.705766000198096
2001-12-27T09:30:00-05:00,115.30099,116.08,115.259,116.06,9407301,15711434.7,57.170054027477214,52.698785523248816,NaN,NaN,74.50180679515661,28.772502190277784,-0.03673159470551979,0.5574719303357227,0.5942035250412425,-281112043,-295339542,59.50697372689146,41.60955833135525,NaN,NaN,7.97987517632317,9.459210168215964
2001-12-28T09:30:00-05:00,116.28999,116.75,115.92,116,10593801,15377869.55,56.87996459991035,52.47847046754832,NaN,NaN,93.70836629122135,44.63232626487327,0.0027420985268081788,0.5976311481997527,0.5948890496729445,-291705844,-291852582.8,61.19436978668362,42.961486695918374,NaN,NaN,8.733738813199613,9.355571403213629
2001-12-31T09:30:00-05:00,116.14999,116.39,114.23,114.3,14619500,15424824.65,49.25411595583498,52.30187904478521,NaN,NaN,1.7858670263187115,45.53365555056827,-0.08657381902514871,0.4866717758915087,0.5732455949166574,-306325344,-294097963.4,59.47565500316412,44.25970794131491,NaN,NaN,7.245813618933177,9.054177434030708
2002-01-02T09:30:00-05:00,115.11,115.75,113.81,115.53,18651904,15596399.95,54.053866908860485,52.524915361741094,NaN,NaN,0.2945424921391942,44.590306732339194,-0.06474740733027684,0.49231133575381136,0.5570587430840882,-287673440,-291467203,60.86260336802135,46.01423522113772,NaN,NaN,7.355548313508807,8.811516131099008
2002-01-03T09:30:00-05:00,115.64999,116.95,115.53999,116.84,15731801,15520699.6,58.550505532041434,53.03665224752475,NaN,NaN,98.08670103393833,53.67545672775484,0.03084967212807599,0.5956208332441832,0.5647711611161073,-271941639,-287751662,62.79912727470844,48.25661459242468,NaN,NaN,8.835842917410192,8.81499138628632
2002-01-04T09:30:00-05:00,117.17,117.98,116.55,117.62,20140608,15267530,60.998064534427414,54.25774308411729,NaN,NaN,161.82314771269085,71.1397249112617,0.13377974562695716,0.7319958431498037,0.5982160975228465,-251801031,-281889459.6,65.68414930058916,50.994204756537265,NaN,NaN,10.829696324563297,9.102806377468745
2002-01-07T09:30:00-05:00,117.7,117.99001,116.56,116.78999,13106500,15024395,57.132019463229966,54.92108695263432,NaN,NaN,146.1726395719017,81.63257956739776,0.13285824516583844,0.7642889039801446,0.6314306588143062,-264907531,-276529797,68.11856734860447,54.00088524510442,NaN,NaN,11.354862644440557,9.424528701321861
2002-01-08T09:30:00-05:00,116.798,117.06,115.97,116.52,12687000,14713345,55.89110291834122,55.21105779713415,NaN,NaN,101.69367317267118,101.61414079666825,0.10232925393875403,0.7593422262377487,0.6570129722989947,-277594531,-270783634.4,70.53221065527566,57.088724644190314,NaN,NaN,11.425395735353963,9.710366849040733
2002-01-09T09:30:00-05:00,116.67999,117.78,115.34,115.57001,16616898,14851049.85,51.640871289610644,55.040359384782775,NaN,NaN,71.91189569072392,115.9376114363852,0.011214000794056989,0.671030473291566,0.659816472497509,-294211429,-272091232.2,69.24745647340079,59.567917508904976,NaN,NaN,10.235806646971689,9.785429677316584
2002-01-10T09:30:00-05:00,115.69501,116.35001,115.3,116.08,12823398,14450554.95,53.677398291438145,54.83346383832352,NaN,NaN,44.99839790557677,105.31995081071288,-0.019952181594645513,0.6348762455042021,0.6548284270988476,-281388031,-273980510.6,67.33889996468037,61.41925556620333,NaN,NaN,9.820724257350026,9.790471760178503
2002-01-11T09:30:00-05:00,116.21001,116.28,114.7,114.94,13708398,14327354.95,48.73662392730194,54.58630222776736,NaN,NaN,-0.4450842034937202,72.86630442747597,-0.11716269712425065,0.5083750556935343,0.6255377528177849,-295096429,-282639590.2,59.27519475280346,62.23439536730792,NaN,NaN,7.984071205038166,9.532414538015598
2002-01-14T09:30:00-05:00,114.64999,114.84,113.96001,114.22,12301301,13990824.8,45.865188374907525,54.06077437435447,NaN,NaN,-83.83283141113894,26.86521023086784,-0.22360212902864895,0.34603509153197365,0.5696372205606226,-307397730,-291137630,52.61604832053633,62.1986497880088,NaN,NaN,5.569322861302003,8.96625858419937
2002-01-15T09:30:00-05:00,114.55,115.39,113.89999,115.14999,20221392,14165759.45,49.96573384262092,53.8914862510374,NaN,NaN,-59.60118929846927,-5.393762263360249,-0.22443819441507473,0.28908947754177916,0.5135276719568539,-287176338,-293053991.4,51.21865995094144,61.864564745974974,NaN,NaN,4.700482069057052,8.356861939179039
2002-01-16T09:30:00-05:00,114.3,114.39999,112.69,112.82001,17076704,14322229.6,41.486924968970236,52.950173902498015,NaN,NaN,-183.59348125525727,-56.494837652556484,-0.36657241708755023,0.05531215059741612,0.42188456768496635,-304253042,-295062314,49.72812646187958,61.25700302772714,NaN,NaN,1.0870847042473595,7.3183223341887995
2002-01-17T09:30:00-05:00,113.75999,114.24001,113.39999,113.67,17391104,14508589.9,45.14399327170917,52.091169562800296,NaN,NaN,-132.47692819411915,-91.98990287249566,-0.38604492742977947,-0.06067159160225799,0.3253733358275215,-286861938,-296157095.4,48.892836281146614,60.49885035303108,NaN,NaN,-0.7099759008704545,6.171422586323192
2002-01-18T09:30:00-05:00,113,113.85001,112.67,113.14999,17028192,14352629.9,43.358583933569804,51.1253566580617,NaN,NaN,-151.93048589524386,-122.2869832108457,-0.41416499661846745,-0.19233290994556285,0.2218320866729046,-303890130,-297915835.6,47.51213790132701,59.521548075505606,NaN,NaN,-2.728997424949718,4.899934013284206
2002-01-22T09:30:00-05:00,113.75,113.92999,112.02,112.37,11689801,14193725.05,40.754948345072634,50.51827325729295,NaN,NaN,-157.5734312955693,-137.03510318773178,-0.4618784381030424,-0.35551596095589844,0.10636247714714397,-315579931,-299552275.8,46.20469472889224,58.57362234162904,NaN,NaN,-5.223607471206341,3.4537138012141275
2002-01-23T09:30:00-05:00,112.63,113.55,112.02,113.23,12438898,14113560,44.698064244530215,49.850001638412216,NaN,NaN,-129.93828925764862,-151.10252317956764,-0.41365836343746887,-0.4107104771496921,0.0029478862877767575,-303141033,-302745214.8,43.67908112820141,57.34622789592761,NaN,NaN,-6.123122076069946,2.0855943901735454
2002-01-24T09:30:00-05:00,113.64,114.25,113.32001,113.58,12162398,14435239.85,46.26551823267752,48.972502545600506,NaN,NaN,-76.38664476689068,-129.66115588189433,-0.33944099284613466,-0.42135335476989155,-0.08191236192375691,-290978635,-300090333.4,46.30714828987944,56.16822939701126,NaN,NaN,-6.395927496572049,0.8739484063527465
2002-01-25T09:30:00-05:00,113.12,114.17999,113.03999,113.55,12810699,14560379.9,46.14478828308195,47.91155424193298,NaN,NaN,-75.0005393139226,-118.16587810585501,-0.2762966755908215,-0.4272832064122838,-0.1509865308214623,-303789334,-303475812.6,43.51846010966837,54.58496588337407,NaN,NaN,-6.651211918639155,-0.20107449721752513
2002-01-28T09:30:00-05:00,113.89999,114.19,112.92,113.86,10589500,14619489.85,47.664560790289194,47.23530719386578,NaN,NaN,-64.28534490986333,-100.6368499087789,-0.201075121386629,-0.40233043255474854,-0.20125531116811954,-293199834,-301337753.4,45.740795492440576,52.98655360793379,NaN,NaN,-6.449993533122337,-1.0937772166324982
2002-01-29T09:30:00-05:00,113.851,114.13,110.05,110.28,27735296,15476564.6,35.28200866699207,45.76322903305513,NaN,NaN,-155.43449698771354,-100.20906304720776,-0.3700194485827118,-0.6637796218965093,-0.2937601733137975,-320935130,-302408793.2,44.79006948287421,51.14782923847655,NaN,NaN,-10.38302962702808,-2.4208132752604383
2002-01-30T09:30:00-05:00,110.39,113.39,108.39999,111.87,34711808,16481180,42.434767954650354,45.105650223415104,NaN,NaN,-144.90937901301874,-103.2032809982818,-0.35236520805455196,-0.7342166833819874,-0.38185147532743546,-286223322,-299025251,48.43631791482389,49.66131934143533,NaN,NaN,-11.278791581115671,-3.6862387475254716
2002-01-31T09:30:00-05:00,112.14999,113.3,111.62,113.17999,19909200,16544044.8,47.57564498712762,44.669810701678635,NaN,NaN,-71.29126611835615,-102.1842052685749,-0.23574653721282307,-0.6765346468434643,-0.44078810963064124,-266314122,-294092348.4,53.28072646740056,48.65716409162963,NaN,NaN,-10.250784682316477,-4.624031023924187
2002-02-01T09:30:00-05:00,113.09,113.3,112.17,112.64999,15838500,16549379.75,45.79377515056109,44.45960721762572,NaN,NaN,-65.49265342425063,-100.28262809064049,-0.18009877134184415,-0.6659115738079464,-0.48581280246610226,-282152622,-289765006,57.08932816945518,48.50103076424761,NaN,NaN,-10.014341329814142,-5.394075353337037
2002-02-04T09:30:00-05:00,112.23,112.23,109.44901,109.85001,24243904,16754544.55,37.74981573928041,43.87993774365235,NaN,NaN,-159.75463627113533,-119.3764863628949,-0.31003787432704066,-0.8733601453749031,-0.5633222710478625,-306396526,-292404344.4,54.187782853736266,48.61329751661903,NaN,NaN,-12.664455536680672,-6.432701093814699
2002-02-05T09:30:00-05:00,109.39999,110.49899,108.53,109.17,33614000,17779919.55,36.0916964459384,42.88893507246074,NaN,NaN,-193.55099973590305,-126.9997869125328,-0.4134894370101423,-1.0801840673105403,-0.666694630300398,-340010526,-296219423.6,50.214947189372545,48.54160374793554,NaN,NaN,-15.312369936299062,-7.701225214169608
2002-02-06T09:30:00-05:00,109.64999,109.74001,108.06,108.7,29581008,18624619.95,34.949071196052714,42.42194551725233,NaN,NaN,-190.86358983213867,-136.19062907635677,-0.48057124707377186,-1.2674086891426128,-0.786837442068841,-369591534,-312893066,37.332510360478864,47.65620259783549,NaN,NaN,-17.77984385135956,-9.141027876625316
2002-02-07T09:30:00-05:00,108.72,109.86,108,108.02,23450000,18966275.05,33.306150144143274,41.57638529385478,NaN,NaN,-169.7041650154095,-155.87320885576747,-0.5336470517838076,-1.4538962567986005,-0.9202492050147929,-393041534,-338238548.4,26.29102875318253,46.041787774409485,NaN,NaN,-20.312097144855905,-10.73689491494397
2002-02-08T09:30:00-05:00,108.63,110.75,108.3,110.09,19278096,19289009.95,42.21181285450219,41.49447307392137,NaN,NaN,-105.58670427316282,-163.8920190255499,-0.3984469772178201,-1.418307926537068,-1.0198609493192479,-373763438,-356560711.6,21.370463737975612,44.17452533417009,NaN,NaN,-19.61409420140228,-12.005066241580872
2002-02-11T09:30:00-05:00,110.05,111.64,109.82001,111.44,18792096,19543194.85,47.16672641390066,41.95245722169479,NaN,NaN,-47.34620107910598,-141.41033198714402,-0.1973672170379166,-1.2665699706166436,-1.069202753578727,-354971342,-366275674.8,19.307109689985793,42.253269259962494,NaN,NaN,-17.375782917061244,-12.77231148093521
2002-02-12T09:30:00-05:00,110.96001,111.71001,110.03,111.09,13942500,19625254.8,46.063975596050646,42.050022318231974,NaN,NaN,-42.23645048963381,-111.14742213789016,-0.07357646819310326,-1.161173338820106,-1.0875968706270027,-368913842,-372056338,18.182176165664828,40.432061762638455,NaN,NaN,-15.941944595053755,-13.225116211523574
2002-02-13T09:30:00-05:00,111.481,112.53999,111.35001,112.27,16783808,19453375.6,50.284192720773504,42.337070495953114,NaN,NaN,11.313112726476868,-70.71208162616706,0.09309043136990436,-0.9712338314146223,-1.0643242627845266,-352130034,-368564038,21.170428861304913,38.63658180345457,NaN,NaN,-13.388881886364102,-13.248511307929363
2002-02-14T09:30:00-05:00,112.50999,112.97,111.591,112.06,20458000,19622440.4,49.541267759127024,42.57967617281348,NaN,NaN,21.59256095898587,-32.452736431287974,0.18897559264502428,-0.8281047719782464,-1.0170803646232707,-372588034,-364473338,24.64233212243306,37.28828694722347,NaN,NaN,-11.55939514632594,-13.007208999128874
2002-02-15T09:30:00-05:00,112.14999,112.24001,110.71001,110.89,18392096,19672490,45.50718596611654,42.42557797108685,NaN,NaN,-17.40477408379212,-14.816350393413845,0.173774002168263,-0.799862861912942,-0.973636864081205,-390980130,-367916676.4,23.69625838440139,35.7136771537921,NaN,NaN,-11.189809301687372,-12.747580470922946
2002-02-19T09:30:00-05:00,110.14999,110.298,108.61,108.75999,15988102,19620485.5,39.2423083252855,42.708456518107816,NaN,NaN,-108.41875610412508,-27.030861398417663,0.028080618750247255,-0.9385360906433959,-0.9666167093936432,-406968232,-378316054.4,21.06578899551691,34.01908569040943,NaN,NaN,-12.871978786928059,-12.765351658923677
2002-02-20T09:30:00-05:00,109.05,110.59,107.82001,110.59,29242896,20498140.25,46.107006171074225,42.97075924785238,NaN,NaN,-78.59204436166564,-34.30198017282404,0.06089021912941539,-0.890503935481874,-0.9513941546112894,-377725336,-380078353.2,20.64749870142205,32.0341700323093,NaN,NaN,-12.049295291206745,-12.663057892106973
2002-02-21T09:30:00-05:00,109.931,110.63,108.25999,108.3,26292608,21190825.75,40.01439918975593,42.430670262325826,NaN,NaN,-97.0806744247179,-55.98073760306299,-0.05920609612359462,-1.0254017747657826,-0.966195678642188,-404017944,-390455935.2,18.338304071729794,29.538282718332816,NaN,NaN,-13.442574973900163,-12.774417475220286
2002-02-22T09:30:00-05:00,108.35001,109.94,107.87,109.64,26572896,21911350.65,44.62545531092882,42.347218845209234,NaN,NaN,-84.17239978536261,-77.13372975193269,-0.037052167392350954,-1.0125108878826268,-0.9754587204902758,-377445048,-391427338,18.13386154143278,26.75574938775979,NaN,NaN,-13.004099900463487,-12.807229250255029
2002-02-25T09:30:00-05:00,109.748,111.81,109.7,111.45,17458704,22143750.9,50.19459753205992,43.23613183040777,NaN,NaN,14.484580393247352,-70.7558588565248,0.10317886424998812,-0.8464851401777906,-0.9496640044277788,-359986344,-385228580.8,23.9595432494051,24.596589416021846,NaN,NaN,-10.71051170158883,-12.507698171874143
2002-02-26T09:30:00-05:00,111.60001,112.03999,110.57001,111.22,22362000,22732375.9,49.51314966143891,44.19480706008638,NaN,NaN,40.1685461659687,-41.03839840250602,0.17964399437329726,-0.7251090114611571,-0.9047530058344544,-382348344,-380304603.2,28.32288367828933,23.03287059380162,NaN,NaN,-9.148613320595079,-12.027828907405706
2002-02-27T09:30:00-05:00,111.961,112.86,110.64999,111.64999,28597904,22775506.3,50.8564026316716,45.33104501977345,NaN,NaN,65.20613003903925,-12.278763522365043,0.2538430392431936,-0.5874492067804624,-0.841292246023656,-353750440,-375509624,32.391361154627305,22.679931364812223,NaN,NaN,-7.478767859548461,-11.3779630434261
2002-02-28T09:30:00-05:00,111.834,112.75,111.03,111.14999,23755504,22227691.1,49.21661500641081,46.4675067956497,NaN,NaN,58.46388441994255,18.830148246567052,0.26280376043001774,-0.5127875454861339,-0.7755913059161517,-377505944,-370207224,36.6720832603789,23.42143525818339,NaN,NaN,-6.592208131271068,-10.694283770261094
2002-03-01T09:30:00-05:00,111.72,113.85001,111.50999,113.74001,26179504,22541206.3,56.95850675678069,47.52084207438388,NaN,NaN,136.1950750140529,62.90364320645015,0.427003503017261,-0.2418369271445755,-0.6688404301618365,-351326440,-364983502.4,40.65835278968191,24.799141619019558,NaN,NaN,-3.278176083443919,-9.634839815001499
2002-03-04T09:30:00-05:00,113.901,115.99001,113.64999,115.75,27184800,23108521.3,61.82265332736196,48.567693996773976,NaN,NaN,227.79563784058965,105.5658546959186,0.6419070480035659,0.13354337984262088,-0.508363668160945,-324141640,-357814561.6,45.709126827034254,26.68499998595159,NaN,NaN,1.2185245607460398,-8.084359189894707
2002-03-05T09:30:00-05:00,115.33,116.39999,114.97,115.38,22733008,23032976.5,60.46797171804881,49.596550862630984,NaN,NaN,206.69620249049598,138.87138596082406,0.7239767173820202,0.39660722856658026,-0.3273694888154399,-346874648,-350719822.4,50.22437083699089,28.973728176760595,NaN,NaN,4.360600909568156,-6.306507747114298
2002-03-06T09:30:00-05:00,115.10001,117.14999,115.07899,116.75,20143808,22359466.9,63.64457074101835,50.55086357836276,NaN,NaN,197.49501286273306,165.32916252556282,0.8278791049251518,0.7074793923409999,-0.12039971258415194,-326730840,-345315902.4,53.403203163398366,31.2760691983387,NaN,NaN,8.034712833291945,-4.257761949913407
2002-03-07T09:30:00-05:00,117.36099,117.5,115.57001,116.5,19331808,21847006.9,62.655165274799884,51.48757054376796,NaN,NaN,171.1917939792026,187.87474443741482,0.8347475630708397,0.9230347412543978,0.08828717818355802,-346062648,-339027243.2,56.85625085610206,33.577063393600774,NaN,NaN,10.689753871524314,-2.1224025468508754
2002-03-08T09:30:00-05:00,117.381,117.907,116.48,116.99001,19930304,21671022.1,63.84167384470391,52.797176820809916,NaN,NaN,159.53606355734254,192.54294214607276,0.8257601290576118,1.1204873395055728,0.294727210447961,-326132344,-333988424,59.44924119074198,36.130847879767956,NaN,NaN,13.23254706620189,0.07116168358523378
2002-03-11T09:30:00-05:00,116.89101,117.89999,116.42999,117.24001,15622102,21488222.4,64.46204629581925,54.59858667584805,NaN,NaN,134.18528612715383,173.82087180338561,0.7901067132997797,1.2823606020726857,0.492253888772906,-310510242,-331262144.4,60.82125913664903,38.97052431842025,NaN,NaN,15.506694689103966,2.2762378272307666
2002-03-12T09:30:00-05:00,116.10899,117.25,115.94,117.17,17154896,21406362.4,64.13021933939507,55.88595904501382,NaN,NaN,105.37375396486952,153.55638209826031,0.7173854841387778,1.3889857439463782,0.6716002598076004,-327665138,-327420242.4,62.734745913550874,41.97675626214374,NaN,NaN,17.302278118678554,4.422815011723308
2002-03-13T09:30:00-05:00,116.631,116.75,115.64,116.03999,17175504,21568012.6,58.86327320701517,57.23230718910377,NaN,NaN,77.99896983838565,129.65717349339084,0.5559612443810612,1.3665518152839269,0.8105905709028657,-344840642,-331042202.8,59.7709568065766,44.93623145748994,NaN,NaN,17.46508344709603,6.285996216776553
2002-03-14T09:30:00-05:00,116.03999,116.42999,115.63,115.88,11169602,21287302.3,58.13527366263343,58.19729421422552,NaN,NaN,65.95102239827312,108.60901917720494,0.40803906355428843,1.3206394003457262,0.9126003367914378,-356010244,-333031722,58.14597707928507,47.79423971019367,NaN,NaN,17.407692507266766,7.874809972560869
2002-03-15T09:30:00-05:00,115.97,116.95,115.89999,116.64999,21221904,21325497.5,60.657180884550016,58.94462159654625,NaN,NaN,70.72333955303078,90.8464743763426,0.334753184269315,1.3310418171280816,0.9962886328587666,-334788340,-334762921.2,56.70141818702165,50.13294506288057,NaN,NaN,18.025554035668755,9.324916267290567
2002-03-18T09:30:00-05:00,117.10001,117.567,116.10001,116.67,17557504,21283767.9,60.723396658335965,59.74535352489603,NaN,NaN,70.22530861178879,78.05447887326959,0.26346471800608073,1.3256195303663674,1.0621548123602866,-317230836,-336107040,55.547551082037444,52.077564163148296,NaN,NaN,18.55909655138331,10.644084879303815
2002-03-19T09:30:00-05:00,117.30099,117.74001,116.82001,117.45,17913008,21380013.2,63.31526850596428,60.63527251591694,NaN,NaN,77.40928726766539,72.46158553382877,0.2450655476676875,1.368486746944896,1.1234211992772085,-299317828,-330437578,59.30895197380228,54.000249221660795,NaN,NaN,19.71011485480387,11.939232018660965
2002-03-20T09:30:00-05:00,116.5,116.58,115.19,115.24001,17115008,20773618.8,52.703262416147126,60.88431875946954,NaN,NaN,31.76755409677019,63.21530238550569,0.06940814769839809,1.2101813839002062,1.1407732362018081,-316432836,-324756016.8,62.71390666850491,55.86037946509837,NaN,NaN,17.697324761136798,12.761816696157512
2002-03-21T09:30:00-05:00,115.3,115.83,114.12,115.28999,26886704,20803323.6,52.89554574877118,60.59410725889743,NaN,NaN,8.954248900819733,51.81594768601501,-0.05153960234929289,1.076348733265192,1.1278883356144849,-289546132,-311463194.4,69.20634580719997,57.89952182349251,NaN,NaN,16.110451492837043,13.240193095683159
2002-03-22T09:30:00-05:00,115.5,115.94,114.7,115.03999,15235398,20236448.7,51.761972180767934,59.87548717699785,NaN,NaN,4.923822035333344,38.65604418247552,-0.1508826764268738,0.9392849900808926,1.0901676665077664,-304781530,-305461832.4,71.60985567865914,59.74957388432286,NaN,NaN,14.467249583832146,13.415486879704442
2002-03-25T09:30:00-05:00,115.091,115.36,113.3,113.61,17499600,20238493.5,45.72570206319672,58.82246791593699,NaN,NaN,-52.372961675773624,14.136390124963038,-0.3064369430469349,0.7071214876990979,1.0135584307460328,-322281130,-306471891.2,70.61091876877748,61.20575587945047,NaN,NaN,11.196272871837616,13.098456307152038
2002-03-26T09:30:00-05:00,113.521,115.02,113.47,114.27,19948608,20117823.9,48.69926449348312,57.754946041113044,NaN,NaN,-58.789204000149525,-13.103308128599949,-0.35499217348208456,0.5698182138934271,0.9248103873755117,-302332522,-307074830,69.9833357842883,62.390051066656895,NaN,NaN,9.241013450608925,12.547393041931594
2002-03-27T09:30:00-05:00,114.033,115.00999,113.75999,114.57001,19020496,19638953.5,50.03921446437156,56.85380669751101,NaN,NaN,-63.87690323211582,-32.23219959437715,-0.356101757366022,0.47968319066798415,0.8357849480340062,-283312026,-300450668,72.83947786780648,63.5317101389215,NaN,NaN,7.97588276116372,11.89432014467904
2002-03-28T09:30:00-05:00,114.97,115.77,114.5,114.52,17535904,19327973.5,49.805680700512376,55.85123575864019,NaN,NaN,-53.80503264466767,-44.78405590347463,-0.3489409936983313,0.399608705911092,0.7485496996094233,-300847930,-302711027.6,70.37860427480618,64.31237893064036,NaN,NaN,6.863890763116416,11.17568737588438
2002-04-01T09:30:00-05:00,114.23,115.10001,113.5,114.57001,17711808,18904588.7,50.05669654974805,54.82228220534939,NaN,NaN,-103.18358141281712,-66.40553659310473,-0.32979356562940143,0.3363077425726715,0.6661013082020729,-283136122,-298381946,72.30824261228197,65.13287775032843,NaN,NaN,5.993319070973096,10.43534904661134
2002-04-02T09:30:00-05:00,113.98,114.95,113.77,113.94,15594500,18325073.7,46.876341846333396,53.58986238441641,NaN,NaN,-107.01911370303476,-77.33476699855694,-0.3467824898559001,0.23262319588219782,0.5794056857380979,-298730622,-293671844.4,74.27203269565777,65.95696966333607,NaN,NaN,4.381626695457123,9.570531567875022
2002-04-03T09:30:00-05:00,114.011,114.217,112.16,113.14,25660704,18471458.5,43.12910576577738,52.46599328147086,NaN,NaN,-152.24849666178528,-96.02662553088413,-0.3955883693739815,0.08492022402062105,0.48050859339460256,-324391326,-298083605.2,69.31376042584952,66.63859849328414,NaN,NaN,1.9115912638794956,8.476397238732805
2002-04-04T09:30:00-05:00,112.60001,113.39999,112.23,112.67,23561008,18642318.5,41.05279376481815,51.24581614591263,NaN,NaN,-151.40469364319122,-113.5321836130992,-0.43981656024678795,-0.06926210691388235,0.3705544533329056,-347952334,-311011666.8,57.25220269147836,66.57475746558364,NaN,NaN,-0.7984982131964827,7.151412174171478
2002-04-05T09:30:00-05:00,113.19,113.63,112.17999,112.69,19404896,18645972.9,41.182555049430626,49.8547714434041,NaN,NaN,-130.7988026404397,-128.93093761225362,-0.44658394353494224,-0.18767547608577217,0.25890846744917007,-328547438,-316551568.4,52.99638054324581,66.31011191959966,NaN,NaN,-3.0318658534738607,5.696658170222144
2002-04-08T09:30:00-04:00,111.32001,113.03,111.23,112.92999,16471102,18473012.8,42.80942998445808,48.57520239526996,NaN,NaN,-138.28541125767674,-135.95130358122555,-0.4144597579457433,-0.2591662299830091,0.1552935279627342,-312076336,-322339611.2,48.90596465785642,65.83571288930102,NaN,NaN,-4.548443436769525,4.2330722263661915
2002-04-09T09:30:00-04:00,113.189,113.189,111.92999,112.14,15122699,18448042.65,38.986667950600456,46.83744521274398,NaN,NaN,-123.22047531317068,-139.19157590325273,-0.4244293730843601,-0.37524318839271587,0.049186184691644194,-327199035,-328033293.8,45.20941655848671,64.82860321677848,NaN,NaN,-6.957780923741752,2.634378919207914
2002-04-10T09:30:00-04:00,112.101,113.53999,112.092,113.41,17204096,18450502.65,47.1562242553769,46.44122820126039,NaN,NaN,-84.29696023223144,-125.60126861734196,-0.32782883364491955,-0.3605998573645053,-0.03277102371958571,-309994939,-325154016.4,47.37560668719971,63.733010360970965,NaN,NaN,-6.8620273111483066,1.277749457728454
2002-04-11T09:30:00-04:00,112.89301,113.052,110.5,110.59,25459104,18864682.65,35.719350023811586,45.214357078048984,NaN,NaN,-153.20386772737285,-125.96110343417827,-0.429763202614587,-0.5699750269878194,-0.14021182437323246,-335454043,-322654358.2,49.2514480372826,62.30766052026258,NaN,NaN,-10.713201038956823,-0.43524347036944255
2002-04-12T09:30:00-04:00,111.02901,111.64999,110.03999,111.42,14950602,19053732.65,40.30812939478906,44.396225450479065,NaN,NaN,-148.23410646496717,-129.44816419908378,-0.4168778476494077,-0.6613091339349921,-0.24443128628558441,-320503441,-321045558.8,50.475046796456745,60.79803131439098,NaN,NaN,-12.290900749425893,-2.1289087959489352
2002-04-15T09:30:00-04:00,111.62,111.86,110.2,110.57001,17402896,18862782.25,37.36630038778779,43.799125330807,NaN,NaN,-135.63600668024833,-128.9182832835981,-0.43896407384541314,-0.7931363785923509,-0.3541723047469377,-337906337,-326211559,46.59042079762616,59.08228145930875,NaN,NaN,-14.573946588498762,-3.9067713377417674
2002-04-16T09:30:00-04:00,111.702,113.32001,111.67,113.2,15097000,18739757.05,49.61865376623995,43.86479599314678,NaN,NaN,-43.60248753230774,-112.99468572742549,-0.2587273314783952,-0.6775814690949318,-0.41885413761653656,-322809337,-325333619.4,47.33226385505344,57.464347750077685,NaN,NaN,-12.097099756546697,-5.0768182547139
2002-04-17T09:30:00-04:00,113.39,113.67,112.60001,112.96001,12920398,18490126.55,48.682794212792835,43.767908832319726,NaN,NaN,-18.448209997663174,-99.82493568051183,-0.1436925068051308,-0.5984697711229501,-0.4547772643178193,-335729735,-330480578.6,43.51620822684718,55.36982849000917,NaN,NaN,-10.539719764374546,-5.8572327560939925
2002-04-18T09:30:00-04:00,112.89999,113.46001,111.14999,112.47,25211008,18894926.55,46.74418713597614,43.54923072056714,NaN,NaN,-54.229883523016746,-80.03013883964063,-0.0911834845853206,-0.56875662004947,-0.4775731354641494,-360940743,-335577918.6,40.07063703740782,53.20497368733786,NaN,NaN,-9.938109959900054,-6.440215213780572
2002-04-19T09:30:00-04:00,113.2,113.24001,112.56,112.88,10602500,18080716.35,48.58892465836721,43.44438987118279,NaN,NaN,-15.928806208334635,-53.569078788314116,-0.022972672510643333,-0.5062889761024536,-0.48331630359181027,-350338243,-341544879,36.433913857327575,50.642521633412535,NaN,NaN,-8.868354446574406,-6.787092247036834
2002-04-22T09:30:00-04:00,112.38,112.42999,110.84,111,13923301,18015111.5,41.49171512858854,43.05977367705815,NaN,NaN,-109.89393893314012,-48.42066523889248,-0.09458609700603482,-0.6015489248493537,-0.5069628278433189,-364261544,-346815920.4,33.538224190427016,47.73296388303891,NaN,NaN,-10.288905521928056,-7.2873512863070085
2002-04-23T09:30:00-04:00,111.09,111.48,110.17,110.52,16968608,17988561.9,39.889655428939,42.82838436728399,NaN,NaN,-142.5563829011983,-68.2114443126706,-0.16052423989770404,-0.707618127715449,-0.5470938878177449,-381230152,-358500083.4,28.189818606121094,44.79553946734403,NaN,NaN,-11.9432030287155,-7.9524729637939355
2002-04-24T09:30:00-04:00,110.56,111.81,109.39999,109.41,18903296,17936296.3,36.39043736020864,42.495358909811884,NaN,NaN,-153.2296953204783,-95.16774137723363,-0.2592879008123248,-0.8712037638331509,-0.6119158630208261,-400133448,-371380826,23.702330611355762,42.399120033049556,NaN,NaN,-14.484364347960332,-8.885600304389135
2002-04-25T09:30:00-04:00,109.21001,109.741,108.72,109.47,25455504,18258046.7,36.71360956753676,42.176148518248034,NaN,NaN,-178.45808707052404,-120.01338208673508,-0.29819096994225447,-0.9846545754486442,-0.6864636055063897,-374677944,-374128266.2,22.866194571390267,40.246963892202736,NaN,NaN,-16.38910769650275,-9.957529931833937
2002-04-26T09:30:00-04:00,109.78999,110.00999,107.28999,107.39,19769904,18369746.7,30.860220548217427,41.32263355851655,NaN,NaN,-198.0989006962621,-156.44740098432058,-0.433425379697303,-1.2282453301280185,-0.7948199504307155,-394447848,-382950187.2,20.380129814615685,38.20940426054268,NaN,NaN,-20.088224686787775,-11.404772039684484
2002-04-29T09:30:00-04:00,107.931,108.25999,106.63,106.86,17725008,18370406.7,29.566679898864635,40.64977726910685,NaN,NaN,-206.3361358922974,-175.735840376152,-0.522043953253733,-1.4473748919978817,-0.9253309387441487,-412172856,-392532449.6,18.080684955577183,36.27163771747771,NaN,NaN,-23.48853745252141,-13.13102424151833
2002-04-30T09:30:00-04:00,107.02,108.64,106.64,107.86,19474496,18564406.5,35.094704894123055,39.78824017187444,NaN,NaN,-159.22177534389763,-179.06891886469188,-0.47796822230946323,-1.5227912166309778,-1.0448229943215146,-392698360,-394826091.2,17.56968345948367,34.14264320121229,NaN,NaN,-24.593801376547397,-14.768563832236769
2002-05-01T09:30:00-04:00,107.97,109.25,106.8,109.17999,24580496,18510396.1,41.609346081968795,40.20895417602852,NaN,NaN,-112.09597468053778,-170.84217473670378,-0.3315223941611345,-1.4592259870229327,-1.1277035928617982,-368117864,-388422974.4,24.025150821717503,32.340764828671915,NaN,NaN,-23.413784322140952,-16.00359533079451
2002-05-02T09:30:00-04:00,109.10001,109.91,107.78,108.75999,15667301,18115710.75,40.22584691790612,40.20307685625117,NaN,NaN,-83.98745891792913,-151.9480491061848,-0.2388763948951642,-1.4262990864807534,-1.1874226915855892,-383785165,-390244418.6,23.462265659498044,30.41128046174629,NaN,NaN,-22.890685552971874,-16.987465362534135
2002-05-03T09:30:00-04:00,108.60001,108.75999,107.2,107.58,18186000,18054765.95,36.54898707387397,40.14469733382875,NaN,NaN,-107.80425417535429,-133.88911980200322,-0.23276408116965341,-1.478377793047656,-1.2456137118780026,-401971165,-391749082,22.98322452507732,28.72505215656423,NaN,NaN,-23.598542393667444,-17.931904938410323
2002-05-06T09:30:00-04:00,107.647,107.998,105.31,105.47,23636000,18413010.85,31.078556294530046,38.820404657278054,NaN,NaN,-144.42261358630165,-121.5064153408041,-0.34003037179317475,-1.670651676619471,-1.3306213048262963,-425607165,-394435943.8,22.114906874469625,26.923812372236817,NaN,NaN,-26.08761521142902,-19.097006405984423
2002-05-07T09:30:00-04:00,106.10899,106.32201,104.89999,105.10001,21921200,18752935.9,30.22428764288516,37.50193990228464,NaN,NaN,-148.2895351807664,-119.31996730817784,-0.40091872769271375,-1.8317697144421885,-1.4308509867494748,-447528365,-405401944.8,18.965557023549025,25.17019442914409,NaN,NaN,-28.329371345364727,-20.41591568303875
2002-05-08T09:30:00-04:00,107.05299,109.36,106.78999,109.00999,27918496,19288655.9,46.8507544836462,37.50955185568965,NaN,NaN,-45.48370936220134,-105.99751424451055,-0.15549496288003994,-1.6252196903495246,-1.4697247274694847,-419609869,-415700345.8,16.577902083039135,23.492141932403467,NaN,NaN,-24.26497985858723,-20.965781993831392
2002-05-09T09:30:00-04:00,108.64999,109.10001,107.58,107.75,18087008,18920051.1,43.272395744042846,37.129799790380766,NaN,NaN,-48.7784647398805,-98.95571540890083,-0.06052721728549271,-1.5453837490763505,-1.4848565317908577,-437696877,-426482688.2,14.517193289945965,21.926661891876215,NaN,NaN,-22.34279159296631,-21.162497650850668
2002-05-10T09:30:00-04:00,107.97,108.05,105.60001,105.72,18959504,19120496.2,38.20895150494305,36.89531667440609,NaN,NaN,-97.3131753952101,-96.85749965287201,-0.11384304141489254,-1.6271603335594733,-1.5133172921445808,-456656381,-437419731.4,12.781614757697525,20.444046932395537,NaN,NaN,-22.608650568042098,-21.369090924735158
2002-05-13T09:30:00-04:00,106.22,107.95,105.799,107.87,14686898,18984696.3,45.48474323335988,37.29496580329329,NaN,NaN,-66.01256245447922,-81.17548942650751,0.009712075361269612,-1.5011771979429938,-1.5108892733042634,-441969483,-440692195,12.307492051447142,19.309595035633112,NaN,NaN,-20.106518833817656,-21.188723483175515
2002-05-14T09:30:00-04:00,109.62,110.37,109,110.22,34212304,19940461.5,52.12087478751932,38.418568476672625,NaN,NaN,32.212292876198376,-45.075123815114566,0.2503909049301498,-1.197900642141576,-1.448291547071726,-407757179,-432737957.8,20.068716031991542,19.050051137107094,NaN,NaN,-15.522484033532729,-20.379260704655117
2002-05-15T09:30:00-04:00,109.5,110.91,109.28999,109.78999,29537808,20771332,50.89989304180344,39.43187443912024,NaN,NaN,47.90251222102015,-26.397879498470264,0.3738793915542886,-0.9809423076288653,-1.3548216991831539,-437294987,-436274981.4,19.252727431441812,18.791946341396486,NaN,NaN,-12.487761206363277,-19.25190363347057
2002-05-16T09:30:00-04:00,109.7,110.48,109.33,110.36,28095008,20915532,52.48874197856111,40.97676882700193,NaN,NaN,60.0689751324265,-4.628391524008867,0.4804085644605425,-0.7543109936074757,-1.2347195580680181,-409199979,-430575601.8,24.574508017430773,19.091544784454708,NaN,NaN,-9.582443157549287,-17.870552136910387
2002-05-17T09:30:00-04:00,110.66,111.25,110.10001,110.89999,27823696,21776591.8,54.00711591113568,42.72251425644987,NaN,NaN,104.75742666112319,35.78572888725779,0.567712778247218,-0.5250785852589956,-1.0927913635062136,-381376283,-415519582.2,36.483683122410945,20.406044653514265,NaN,NaN,-6.7790068250614715,-16.286045663789114
2002-05-20T09:30:00-04:00,110.64,110.69,109.492,109.7,13833801,21772116.8,50.170016540343454,43.79932223117989,NaN,NaN,73.850955745282,63.758432527210026,0.5260551380094327,-0.43522244099442275,-0.9612775790038555,-395210084,-406167702.4,42.55128751759488,22.19044494337935,NaN,NaN,-5.624218903064139,-14.762927555114118
2002-05-21T09:30:00-04:00,110.11,110.487,108.32001,108.7,16877296,21767551.2,47.162839078441145,44.196000302356495,NaN,NaN,39.06326684459774,65.1286273208899,0.41731437693001117,-0.43963460784134156,-0.8569489847713527,-412087380,-407033742.6,42.149727430376636,23.485057558283568,NaN,NaN,-5.592030788735475,-13.452799445631454
2002-05-22T09:30:00-04:00,108.22,109.12,108,108.94,15844301,21614601.45,47.96891074593522,44.749076290072864,NaN,NaN,17.447226372462715,59.03757015117842,0.350410344959314,-0.4189360535722102,-0.7693463985315242,-396243079,-398823361,47.23371337199845,25.183018109176455,NaN,NaN,-5.329783424243879,-12.292368585433229
2002-05-23T09:30:00-04:00,109.261,110.36,108.48,110.10001,13880199,21035836.2,51.79668456452441,45.83819753940504,NaN,NaN,73.23995844775277,61.67176681424367,0.371150217023398,-0.3054086272522767,-0.6765588442756747,-382362880,-393455941.2,50.30818637461641,27.13480109842925,NaN,NaN,-3.97196438827177,-11.103739414410164
2002-05-24T09:30:00-04:00,109.98,110.2,108.61,108.69,11875898,20641135.9,47.24679508982749,46.993071739069144,NaN,NaN,40.89084431532225,48.89845034508348,0.2808777730420726,-0.325461627973084,-0.6063394010151566,-394238778,-396028440.2,48.839399440343705,29.043693424563113,NaN,NaN,-4.163622200457503,-10.112294098131212
2002-05-28T09:30:00-04:00,109.05,109.13,107.45,108.10001,24237104,20966740.7,45.447844175622286,48.080468634264655,NaN,NaN,-17.161386987762825,30.69598179847452,0.17744877413433158,-0.38452843334724207,-0.5619772074815736,-418475882,-400681599.8,46.21127738706936,30.989816307671706,NaN,NaN,-4.85298857641328,-9.360964737885793
2002-05-29T09:30:00-04:00,107.629,108.02,107.13,107.3,14779102,20731971,43.05399980691884,47.80927187164127,NaN,NaN,-60.8328331585173,10.716761797851516,0.0573879931091581,-0.4902422160951261,-0.5476302092042842,-433254984,-404915120.6,43.89683256014865,32.9411684846081,NaN,NaN,-6.136169305517455,-8.900279676118886
2002-05-30T09:30:00-04:00,106.55099,107.50999,105.89999,107,18218096,20413851,42.15726187056641,47.72961945210724,NaN,NaN,-90.2471640123069,-10.822116279102408,-0.03502481096289911,-0.591411222907908,-0.5563864119450089,-451473080,-415961120.8,38.48134968441388,34.652893941355806,NaN,NaN,-7.45077338777786,-8.693207349213026
2002-05-31T09:30:00-04:00,107.39999,108.56,106.85001,107.22,19826304,20621801.15,43.09331698383505,48.07850270059953,NaN,NaN,-44.56452141236572,-34.383012251126104,-0.07199895300252923,-0.6463851031981704,-0.5743861501956412,-431646776,-425817900,34.40274374001598,36.197260297235694,NaN,NaN,-8.295395693716658,-8.636377112713545
2002-06-03T09:30:00-04:00,107.09,107.60001,104.13,104.37,26073904,21016196.35,35.15622110507127,47.34075112000748,NaN,NaN,-142.734403572537,-71.10806182869796,-0.2680430978254621,-0.9094400224774688,-0.6413969246520067,-457720680,-438514280.4,29.993021349324977,37.46051238994125,NaN,NaN,-11.574230141018859,-9.056070402471446
2002-06-04T09:30:00-04:00,104.14999,105.2,103.55,104.63,25859808,21127386.75,36.308731294957035,46.21131229911018,NaN,NaN,-170.8164763846931,-101.839079708084,-0.35442842176326517,-1.0844324518560882,-0.730004030092823,-431860872,-441191278.4,29.144756625803467,38.10880100378496,NaN,NaN,-13.899364731297423,-9.747969592303729
2002-06-05T09:30:00-04:00,104.95,105.67,104.35001,105.61,19718304,21017241.95,40.594608566265876,45.47522055085749,NaN,NaN,-134.18146266495606,-116.50880560937176,-0.3207967277734429,-1.1309999398096267,-0.8102032120361837,-412142568,-436968795.2,32.39270642176122,39.04737093166492,NaN,NaN,-14.642213293089581,-10.447147263844565
2002-06-06T09:30:00-04:00,105.543,105.60001,103.14999,103.46001,23364704,20789552.35,35.02601404520284,44.2278828413319,NaN,NaN,-154.16327195944268,-129.2920271987989,-0.41272120997484907,-1.326104724504745,-0.913383514529896,-435507272,-433775633.6,34.825756043856316,39.779602933552454,NaN,NaN,-17.07632659093501,-11.394172882000342
2002-06-07T09:30:00-04:00,101.789,103.92,101.72,103.34,24011600,21085781.95,34.73955197245337,42.851628274283165,NaN,NaN,-163.89728984339473,-153.1585808850047,-0.4480337814115398,-1.4734257412943208,-1.025391959882781,-459518872,-439350052.8,32.618823215351014,39.50354151161961,NaN,NaN,-19.106309301460694,-12.495906656208964
2002-06-10T09:30:00-04:00,103.243,104.46001,103.02,103.74001,18760192,21075816.35,36.600775169252586,41.882396747776674,NaN,NaN,-123.85174001279796,-149.38204817305692,-0.4118043394356854,-1.5401473841773878,-1.1283430447417024,-440758680,-435957652.8,35.30569371387331,38.98599909706807,NaN,NaN,-20.254392135616165,-13.604261724695707
2002-06-11T09:30:00-04:00,104.131,104.53999,101.73,101.96001,19990800,21341011.45,32.199920364376766,40.81361683962922,NaN,NaN,-132.05473110280198,-141.6296991166787,-0.4708175165767745,-1.7168649404626706,-1.246047423885896,-460749480,-441735374.4,32.899494354345634,38.32526816306585,NaN,NaN,-22.632093781678737,-14.893952018550426
2002-06-12T09:30:00-04:00,101.71001,102.81,100.78,102.58,31268304,21193811.45,35.12587530598884,39.896257165347336,NaN,NaN,-130.81973754348465,-140.9573540923844,-0.4321985106211983,-1.786295562162394,-1.3540970515411956,-429481176,-445203096,31.5113759258752,37.20224405977133,NaN,NaN,-23.744904543408264,-16.15837380781583
2002-06-13T09:30:00-04:00,102.13,103,101.34,101.55,21050896,20769465.85,32.60819053306936,38.52565044881483,NaN,NaN,-116.71762173471346,-133.46822404743858,-0.4387234551494259,-1.902501370477978,-1.4637779153285522,-450532072,-448208056,30.31763053445904,35.77434721404581,NaN,NaN,-25.451498420846104,-17.485963038248727
2002-06-14T09:30:00-04:00,100.31,101.56,98.5,101.39999,39267504,21328090.65,32.24568596153564,37.45414265393684,NaN,NaN,-135.90993597564287,-127.87075327388818,-0.4160428594013159,-1.9838314895801972,-1.5677886301788813,-489799576,-454264196.8,28.014251958397267,34.28683667962106,NaN,NaN,-26.94598522511941,-18.83739477923025
2002-06-17T09:30:00-04:00,101.92101,104.34,101.85001,104.12,17648496,20819330.65,44.33047964470022,37.374330901728115,NaN,NaN,-57.60009680904396,-114.62042463313739,-0.19213953377698134,-1.8079630474001078,-1.6158235136231265,-472151080,-460542676.8,25.823801306894836,32.830588388180026,NaN,NaN,-24.52555175651348,-19.649988633127855
2002-06-18T09:30:00-04:00,103.74001,105.03,103.631,104.97,21775104,21216395.8,47.482845281949906,37.69067700708748,NaN,NaN,-23.894749796791462,-92.98842837193529,0.027247173637396926,-1.5817645465763803,-1.6090117202137773,-450375976,-458467976,27.831901366722377,31.683093302935294,NaN,NaN,-21.52507858766895,-19.917858626633727
2002-06-19T09:30:00-04:00,103.5,104.42999,102.24001,102.52,21541392,21449600.6,40.384381327169265,37.56404268255911,NaN,NaN,-60.227740317005804,-78.87002892663952,0.02164194611864767,-1.5819592875654678,-1.6036012336841154,-471917368,-466955214.4,24.866209815636722,30.71058331230835,NaN,NaN,-21.169213584847533,-20.09662362066427
2002-06-20T09:30:00-04:00,102.265,103.05,100.96001,101.21001,25692000,21941985.55,37.183534477525114,37.14191536067984,NaN,NaN,-92.72356878596344,-74.07121833688952,-0.051986583553492505,-1.6685844631259812,-1.6165978795724887,-497609368,-476370673.6,22.058117753335594,29.828824313259755,NaN,NaN,-21.939150874569567,-20.3598417997936
2002-06-21T09:30:00-04:00,100.47,100.92999,98.687,99.28,31190704,22807510.8,33.029843024607246,36.990031212075266,NaN,NaN,-148.4573725467754,-76.580705651116,-0.20384081197473125,-1.8713988945409028,-1.6675580825661716,-528800072,-484170772.8,20.039171263265743,29.11783502139838,NaN,NaN,-24.016924975078442,-20.88228225340572
2002-06-24T09:30:00-04:00,98.61,100.69,97.25,99.8,37173296,24072380.7,35.13236289945557,36.90600489811088,NaN,NaN,-149.4734859331011,-94.95538347592745,-0.23994643433406027,-1.9674911254837468,-1.7275446911496866,-491626776,-488065912,19.0990669425055,28.40028575830567,NaN,NaN,-24.97989529273968,-21.46765554473914
2002-06-25T09:30:00-04:00,100.30299,100.89,97.53999,97.56,33389200,24529985.5,30.666078321617377,36.19682416635027,NaN,NaN,-153.03877977721748,-120.78418947201264,-0.3772002221278643,-2.199044968809517,-1.8218447466816525,-525015976,-502993912,16.000904695949373,27.22944277789054,NaN,NaN,-27.334892209184435,-22.305832211088468
2002-06-26T09:30:00-04:00,95.2,98.14999,95.19501,97.72,37918496,25686955.2,31.3375305169058,35.93336105718619,NaN,NaN,-180.62298429195744,-144.86323826700297,-0.4166345413247394,-2.342637923337577,-1.9260033820128375,-487097480,-506029934.4,15.451917255637838,25.84559715016065,NaN,NaN,-28.959286956245023,-23.256325746110832
2002-06-27T09:30:00-04:00,98.5,99.49001,96.57001,99.42999,31728800,26362490.4,38.22329756991949,36.182200028433776,NaN,NaN,-118.0822083634237,-149.934966182495,-0.2928239653717466,-2.2920333387275207,-1.999209373355774,-455368680,-497581796.8,23.334335341333627,25.182419444873695,NaN,NaN,-28.13764887275994,-23.95365762134642
2002-06-28T09:30:00-04:00,99.243,100.5,98.88,98.96001,28184304,26780390.4,37.12143321871093,36.21938988910937,NaN,NaN,-79.94090867699941,-136.23167340853985,-0.2116381942400105,-2.2637571161557872,-2.0521189219157767,-483552984,-488532379.2,30.778888036830566,24.859076182227785,NaN,NaN,-27.813773302144096,-24.50510271860323
2002-07-01T09:30:00-04:00,99.187,99.8,96.89,97.03,20282896,26490840,32.92405447953105,36.27111375447753,NaN,NaN,-113.01868267464998,-128.9407127568496,-0.25411805471542337,-2.369766490310056,-2.1156484355946326,-503835880,-490974200,29.934224858693312,24.64727121825262,NaN,NaN,-28.867425383444388,-25.128291670723396
2002-07-02T09:30:00-04:00,96.869,97.2,94.77,94.97,34218400,26908769.6,29.13708451177166,35.84334298346202,NaN,NaN,-155.511518743873,-129.43526055018071,-0.37959874447019804,-2.59014686618238,-2.210548121712182,-538054280,-493581860.8,29.01837206577966,24.46919951396008,NaN,NaN,-31.03812623383876,-25.972553751168448
2002-07-03T09:30:00-04:00,94.62,95.84,93.72701,95.50999,30566896,27451199.2,31.365639334059352,35.75458932638988,NaN,NaN,-152.27013007698292,-123.76468970718581,-0.3837343708471712,-2.690216085271146,-2.306481714423975,-507487384,-497659841.6,27.596406895498575,24.274826396891477,NaN,NaN,-32.07072203546864,-26.84372064892562
2002-07-05T09:30:00-04:00,96.78,99.53,96.668,99.31,19014800,27233704,44.57529265562642,36.63527551882493,NaN,NaN,-51.298867749416935,-110.40802158438446,-0.10267499732349794,-2.434825461078347,-2.332150463754849,-488472584,-504280622.4,25.418614370880874,24.08942371206888,NaN,NaN,-28.370009582181833,-27.061761925105078
2002-07-08T09:30:00-04:00,98.98,99.7,97.56,98.07001,19120896,26989168.8,41.75145595168245,36.45105954075224,NaN,NaN,-47.819233750279594,-103.9836865990405,0.020998471650789607,-2.305902374191362,-2.3269008458421516,-507593480,-509088721.6,23.941019110142562,23.954939269443717,NaN,NaN,-26.361006568576578,-26.961654017029577
2002-07-09T09:30:00-04:00,97.73,98.34,95.00999,95.60001,28623296,27482324,36.75638540618438,35.684883835340415,NaN,NaN,-101.80655695808852,-101.7412614557282,-0.039001887315972095,-2.375653204987117,-2.3366513176711448,-536216776,-515564900.8,22.079280698527015,23.54403779314405,NaN,NaN,-26.397292994288463,-26.881031013780845
2002-07-10T09:30:00-04:00,96,96.07001,92.03999,92.12,50525392,29009053.6,31.109254807803538,35.022374798242865,NaN,NaN,-168.6346824744226,-104.36589420183812,-0.27534771076192,-2.680835956123545,-2.405488245361625,-586742168,-525302478.4,19.610000426808014,23.168594265370576,NaN,NaN,-28.523442577332762,-27.115661237145403
2002-07-11T09:30:00-04:00,91.763,93.35001,90.32001,92.87,59532896,30422283.2,33.48120129736306,34.75792242823129,NaN,NaN,-177.33369063553604,-109.37860631354874,-0.3392568871007593,-2.829559354237574,-2.490302467136815,-527209272,-529246856,18.697804124943403,22.92857186334256,NaN,NaN,-29.330557793261253,-27.432075030876238
2002-07-12T09:30:00-04:00,93.33299,93.89,91.52,91.85001,39026096,31321043.2,31.87389559893431,34.675354754968936,NaN,NaN,-148.44187087921594,-128.80720693950855,-0.4039192807675702,-2.9952015680962774,-2.591282287328707,-566235368,-544799412.8,15.61372669567389,22.61246867994314,NaN,NaN,-30.509514432221845,-27.87170923106847
2002-07-15T09:30:00-04:00,91.64301,92.39999,87.89,92.34,77320192,33223677.6,33.524841417744554,34.56053179198958,NaN,NaN,-156.42629989158658,-150.52862016776993,-0.3683800571810272,-3.0517573588049913,-2.683377301623964,-488915176,-541063752,19.06684502033316,22.610167114073693,NaN,NaN,-30.921792746564225,-28.307435447567862
2002-07-16T09:30:00-04:00,91.127,92.38,89.87,90.56,53282400,35005372.8,30.621713191253704,34.55736285410646,NaN,NaN,-135.27071080899867,-157.22145093795197,-0.4159252719776978,-3.2032838915960866,-2.787358619618389,-542197576,-542259912,18.80154353556948,22.81021274547513,NaN,NaN,-32.197058456516146,-28.863095877417617
2002-07-17T09:30:00-04:00,92.46001,93.3,89.75,90.74001,48996096,36366422.4,31.269911217136,34.5525329041229,NaN,NaN,-114.60401242285165,-146.41531692763778,-0.38702256732841445,-3.271136828778907,-2.8841142614504927,-493201480,-523551774.4,34.218268029610215,24.15066637218744,NaN,NaN,-33.01688333332258,-29.456494085404042
2002-07-18T09:30:00-04:00,90.703,91.10001,87.75,87.8,32701808,36924443.2,26.856534815683517,33.740621278820335,NaN,NaN,-146.05639252812287,-140.15985730615515,-0.5099492000967181,-3.5215507615713904,-3.0116015614746723,-525903288,-523290577.6,34.40552310191717,24.94146549794341,NaN,NaN,-35.18096518740455,-30.274275671404116
2002-07-19T09:30:00-04:00,86.767,87.55299,84.3,84.71001,77690624,39524374.4,23.157202374277745,32.74317621850368,NaN,NaN,-183.30677246627747,-147.13283762356744,-0.7300045987591868,-3.924107309923656,-3.194102711164469,-603593912,-530762286.4,31.631648162361245,25.002376935481315,NaN,NaN,-38.35940667636462,-31.429294386398475
2002-07-22T09:30:00-04:00,84.10699,85.91299,81.45,82.2,78249376,41877308,20.666901530794732,31.86766529359394,NaN,NaN,-188.4568270910542,-153.53894306346098,-0.960725961758754,-4.395010163362912,-3.4342842016041577,-681843288,-569347908.8,21.83928699394346,24.424167087999184,NaN,NaN,-41.91185558574192,-32.926803129161826
2002-07-23T09:30:00-04:00,82.55,83.24001,79.75,79.95,74499632,43743624.8,18.723167667723104,31.123814090447613,NaN,NaN,-190.07045698225343,-164.4988922981119,-1.167254829902367,-4.8933527389821165,-3.7260979090797495,-756342920,-612176977.6,15.94047390013381,23.490031504738763,NaN,NaN,-45.53779222323438,-34.72837299974362
2002-07-24T09:30:00-04:00,78.13699,85.12,77.67999,84.72,106946000,47421464.8,33.090326297252545,31.24700601638998,NaN,NaN,-144.93465605380575,-170.56502102430272,-0.8971333165471989,-4.847514554763748,-3.9503812382165493,-649396920,-643416065.6,13.150432675714129,22.45817620332559,NaN,NaN,-43.41816861833549,-35.96977237382817
2002-07-25T09:30:00-04:00,84.27499,85.85001,81.60001,84,87194880,49885284,32.16605240943389,30.36063171309051,NaN,NaN,-110.4344044605696,-163.44062341079206,-0.6907310204648649,-4.81379501379763,-4.1230639933327655,-736591800,-685553768,10.484670670452672,21.39146593900929,NaN,NaN,-42.123948656490406,-36.84894041420849
2002-07-26T09:30:00-04:00,84.653,85.92999,83.8,85.60001,41210496,50359368.8,36.41635581550814,29.979553131935205,NaN,NaN,-83.02186783268783,-143.38364248407413,-0.38545471079726035,-4.604882381829341,-4.219427671032081,-695381304,-703911246.4,9.574114376560914,20.365258458039175,NaN,NaN,-39.638679252082646,-37.2474745339048
2002-07-29T09:30:00-04:00,87.508,90.34,87.3,89.77,53496304,51624968.8,45.92588958366063,30.63451771604065,NaN,NaN,-21.404758222636477,-109.97322871039057,0.13067947539317526,-4.056078326790612,-4.186757802183787,-641885000,-695919588.8,13.11181641047476,19.724725294606866,NaN,NaN,-34.03215231898799,-36.78814278891669
2002-07-30T09:30:00-04:00,89.323,91.39999,88.72,90.94,47559008,52988774.4,48.26388242134247,31.85984825986486,NaN,NaN,1.991949126937777,-71.56074748855232,0.560168488446319,-3.4865471916258883,-4.046715680072207,-594325992,-663516203.2,25.78930387343172,20.166104112222847,NaN,NaN,-28.835758343794165,-35.6520878681849
2002-07-31T09:30:00-04:00,90.49699,91.55,89.25,91.16,44707696,53513239.2,48.712920595941966,32.94782820976335,NaN,NaN,11.100587638710412,-40.35369875004914,0.8509319438893583,-2.9830507502105092,-3.8339826940998676,-549618296,-643560478.4,32.33695883551529,21.140329448692267,NaN,NaN,-24.658400347399514,-34.08156107950127
2002-08-01T09:30:00-04:00,90.88,91.35001,88.33,88.78,66576320,55313710.4,44.239510614096766,33.8310864251321,NaN,NaN,-3.6651140855754547,-18.99984067505032,0.8716372346330172,-2.744436150808596,-3.6160733854416134,-616194616,-619481041.6,39.29672868302671,22.8319724477889,NaN,NaN,-22.514502052853445,-32.42912407569444
2002-08-02T09:30:00-04:00,88.5,88.91701,85.62,86.78999,51775696,56951755.2,40.86070379678161,34.355076595063316,NaN,NaN,-37.498787653320655,-9.89522463917688,0.7448915072249664,-2.684959001410405,-3.4298505086353717,-667970312,-613998843.2,40.78997588484,24.383624652396527,NaN,NaN,-21.793986244610082,-30.909818671253817
2002-08-05T09:30:00-04:00,86.498,86.933,83.55,83.77,47196400,58355530.4,36.32640256555029,34.76255440751307,NaN,NaN,-71.22044434650469,-19.858361863950517,0.4649418829085019,-2.8486731549997444,-3.3136150379082463,-715166712,-628655185.6,38.092169031065765,25.761526473503405,NaN,NaN,-22.66582182787665,-29.73210483648565
2002-08-06T09:30:00-04:00,85.233,87.89999,85.05,86.59,65087696,60178750.4,42.718550426900315,35.58031435106766,NaN,NaN,-29.938657112857637,-26.24448311190961,0.47527726788334546,-2.7195184530540644,-3.19479572093741,-650079016,-639805790.4,36.13408223651815,25.898370345425402,NaN,NaN,-21.276519277340817,-28.524164042322102
2002-08-07T09:30:00-04:00,87.879,88.5,85.77,88.10001,43696496,59837305.6,45.85310872254149,36.9372124872718,NaN,NaN,-4.5113114216934145,-29.366862923990375,0.5823321205112988,-2.4668805702982866,-3.0492126908095853,-606382520,-651158635.2,34.206151568255976,25.884129521592456,NaN,NaN,-19.13063076512537,-27.182230717008284
2002-08-08T09:30:00-04:00,88.423,91.10001,87.8,90.95,48373600,59279340.8,51.272883725976826,38.94547544096459,NaN,NaN,56.23543796167275,-17.386752514540728,0.8285840098883135,-2.0134826784491935,-2.842066688337507,-558008920,-639521496,37.86573585663115,26.329421499754595,NaN,NaN,-15.50754456648181,-25.514418409790217
2002-08-09T09:30:00-04:00,90.10001,91.94,89.35001,91.28999,41880400,59422056,51.891522073948856,41.17580547976132,NaN,NaN,81.5755132992119,6.428107675965779,0.9871021275056222,-1.6081890289554792,-2.5952911564611014,-516128520,-609153137.6,46.26537212885896,28.07414186653427,NaN,NaN,-12.461908952254806,-23.64977420157087
2002-08-12T09:30:00-04:00,89.99699,91.27,89.55,90.62,25855696,56848831.2,50.530068382486625,43.44772695938729,NaN,NaN,73.41637253341297,35.355471051949316,1.0156162654839136,-1.3257708246062094,-2.341387090090123,-541984216,-574516638.4,53.91720522041044,30.786765532268316,NaN,NaN,-10.386334810934065,-21.754997145765614
2002-08-13T09:30:00-04:00,90.14999,91.66,88.64999,88.97,49637104,56666566.4,47.242748776536445,44.45861427933614,NaN,NaN,58.53376744685511,53.049955963891854,0.8962949257648463,-1.2210184328840654,-2.1173133586489117,-591621320,-562825099.2,56.1852616138378,33.86068188499144,NaN,NaN,-9.590810243459543,-20.01725615972189
2002-08-14T09:30:00-04:00,89.02,92.63,88.02,92.22,57431904,57088356.8,53.64033869354458,45.992491871058334,NaN,NaN,88.90850094650968,71.73391843753248,1.0012319097403726,-0.865773471473446,-1.8670053812138185,-534189416,-548386478.4,58.877033069153164,37.31727919918433,NaN,NaN,-6.885176260354829,-18.141244745526595
2002-08-15T09:30:00-04:00,92.847,93.99001,92.2,93.5,45552096,57730871.2,55.9081347828287,47.3847617972955,NaN,NaN,129.8247920311831,86.45178925143455,1.1132258885303288,-0.4754730205509077,-1.5886989090812365,-488637320,-534512158.4,61.3351629403378,41.01449695373982,NaN,NaN,-3.953054473716781,-16.114360420982337
2002-08-16T09:30:00-04:00,92.82001,94.08,92,93.22,36517296,55672204.8,55.27119939085136,48.05228392638056,NaN,NaN,112.88148515601235,92.71298362279464,1.1216793229858741,-0.18659975534889384,-1.308279078334768,-525154616,-536317377.6,60.82570253361085,44.42263167682097,NaN,NaN,-1.766644498626187,-14.0646867177886
2002-08-19T09:30:00-04:00,93.46001,95.75,93.10001,95.39999,33672304,53443351.2,59.17122846397211,48.83138007228268,NaN,NaN,137.17900618689933,105.46551035349191,1.2192266879088076,0.21575428155124143,-1.0034724063575662,-491482312,-526216996.8,62.692878068488135,47.058601262182144,NaN,NaN,1.305505569481507,-11.8689449624643
2002-08-20T09:30:00-04:00,94.82201,95.39999,93.62,94.39,30512096,51243974.4,56.70436921300305,49.402197830644184,NaN,NaN,127.76958566614648,119.31267399735017,1.1611468728827898,0.44796118474592106,-0.7131856881368688,-521994408,-512291614.4,65.15854430921256,49.40300022458909,NaN,NaN,3.163194926086256,-9.721496406957078
2002-08-21T09:30:00-04:00,95.063,95.78,93.57001,95.75,39632608,47878304.8,59.17263355942218,50.468849469596,NaN,NaN,135.54522700066477,128.6400192081812,1.1571683328123366,0.7332747278785519,-0.42389360493378464,-482361800,-501926091.2,66.91156694847083,51.37548867212082,NaN,NaN,5.460169514879969,-7.552686989551786
2002-08-22T09:30:00-04:00,95.493,97.14999,95.07001,96.67999,38403808,45438751.2,60.81762051619575,51.89434352098273,NaN,NaN,154.74695702208155,133.6244522063609,1.1572283310930773,1.022641808932562,-0.1345865221605153,-443957992,-492990225.6,68.38819336416236,53.34678992064384,NaN,NaN,7.862430728565306,-5.350527315535059
2002-08-23T09:30:00-04:00,96.017,96.14999,94.14999,94.60001,33717504,45064101.6,55.43763224506561,53.25943135523382,NaN,NaN,106.3096425993355,132.31008369502553,0.9650896507528137,1.071775541280502,0.10668589052768815,-477675496,-483494401.6,69.92419744391586,55.620506235847415,NaN,NaN,8.419221834977876,-3.383420294033211
2002-08-26T09:30:00-04:00,94.91,95.64,93.5,95.25999,33831104,44080841.6,56.74513661310181,54.26133036853393,NaN,NaN,88.80379955542028,122.6350423687297,0.8352150008998119,1.1507046416524531,0.3154896407526412,-443844392,-473966817.6,71.42447654741049,58.141248686625445,NaN,NaN,9.250149017828805,-1.5786246780529232
2002-08-27T09:30:00-04:00,95.7,96.25,93.505,94.16,35340704,43469926.4,53.906196535269736,54.83655092658595,NaN,NaN,75.2770884161645,112.13654291873331,0.6369536851316556,1.1116817471672107,0.47472806203555507,-479185096,-465404955.2,72.74043996975001,60.893697858160735,NaN,NaN,9.16086624525444,-0.044411689009014266
2002-08-28T09:30:00-04:00,93.287,93.49001,91.8,92.10001,38973808,43183232,48.965596595246325,54.671744702962336,NaN,NaN,21.49250995810489,89.32599951022135,0.34350541426575565,0.9041098298677497,0.560604415601994,-518158904,-472564376,69.8439454155115,63.17785568379504,NaN,NaN,7.638110745693121,1.0530915159484335
2002-08-29T09:30:00-04:00,91.27,93.058,90.81,92.14,42967104,42002771.2,49.06319521421828,54.46972135583873,NaN,NaN,7.896509174337038,59.95590994067243,0.1390117466221279,0.7343690988796538,0.595357352257526,-475191800,-478811137.6,67.324909848446,64.68210837805125,NaN,NaN,6.4212184365924365,1.819966790326148
2002-08-30T09:30:00-04:00,91.686,93.39,91.39999,91.78,30370896,40932531.2,48.170107680293455,54.3011527342535,NaN,NaN,6.908787448452867,40.0757389104959,-0.0248502663313529,0.5642945193433349,0.5891447856746878,-505562696,-484388577.6,65.06838449249683,65.47862118320029,NaN,NaN,5.157474480390822,2.29675360319253
2002-09-03T09:30:00-04:00,90.735,91,88.14999,88.28,76682192,42406820.8,40.45919680841601,53.81661330795919,NaN,NaN,-90.15839836253936,4.283299326903989,-0.35498605340663736,0.1454122189163911,0.5003982723230285,-582244888,-512068676.8,55.18312360008742,65.40703989650383,NaN,NaN,1.6294863353177473,2.2014297077818465
2002-09-04T09:30:00-04:00,88.61501,90.25,88.06,89.53999,51099504,41707411.2,43.93838113342313,53.123616339379076,NaN,NaN,-96.26295653903237,-30.02470966413539,-0.4674522307437227,-0.08391701610662494,0.3835352146370978,-531145384,-522460734.4,51.98971746619405,64.91508878200675,NaN,NaN,-0.356209181186002,1.8360527236435824
2002-09-05T09:30:00-04:00,88.49001,89.42999,87.5,88.78,67318320,42888502.4,42.331613644383864,52.15386482949016,NaN,NaN,-124.18765180775819,-59.16074201730801,-0.5654366371691184,-0.3232605818243002,0.24217605534481818,-598463704,-538521694.4,47.42216167490181,63.92130297733275,NaN,NaN,-2.4833439500364887,1.2189960559750008
2002-09-06T09:30:00-04:00,89.75,90.57001,89.347,90,38622896,42400967.2,45.76056093838269,51.47453351145669,NaN,NaN,-78.16321990245443,-76.37268783266629,-0.5215605649946873,-0.4097746508985409,0.11178591409614633,-559840808,-555451496,43.121589721933354,62.65672349078436,NaN,NaN,-3.332068381874762,0.5688439934250348
2002-09-09T09:30:00-04:00,89.10001,91.351,88.8,90.66,34074896,42010692,47.57656684820953,50.646343396045076,NaN,NaN,-66.42453136270883,-91.03935159489865,-0.4256182990426401,-0.4202369597071538,0.00538133933548629,-525765912,-559492139.2,42.13935325310115,61.188614575399576,NaN,NaN,-3.5373918012842154,-0.017761120104858086
2002-09-10T09:30:00-04:00,91.14,91.78,90.56,91.7,41426704,42789242.4,50.39496236074065,50.195671478026334,NaN,NaN,-33.64049814975114,-79.73577155234099,-0.2768506211908975,-0.34068193715313555,-0.06383131596223808,-484339208,-539911003.2,48.28679991575252,59.98348997586671,NaN,NaN,-2.9255153458358283,-0.43315458092356807
2002-09-11T09:30:00-04:00,92.47,93.33,91.10001,91.13,27745600,41694667.2,48.84499432188387,49.45798296105931,NaN,NaN,-21.436516968840593,-64.77048363830264,-0.2048870862382572,-0.31994017376005957,-0.11505308752180238,-512084808,-536098888,49.41362843751211,58.733637225083946,NaN,NaN,-2.8320439053745194,-0.7758530558451325
2002-09-12T09:30:00-04:00,90.75301,90.843,88.99001,89.45,43631504,41004647.2,44.50067877439157,48.29248712235901,NaN,NaN,-89.64496118503641,-57.86194551375829,-0.25520597525127076,-0.4340605565858908,-0.17885458133462007,-555716312,-527549409.6,51.94277166130327,57.55896424630829,NaN,NaN,-3.980198907426901,-1.2336167489282421
2002-09-13T09:30:00-04:00,88.698,89.89999,88.25,89.67,41131008,40783592.8,45.18818019959253,47.560383404825224,NaN,NaN,-94.84776047036902,-61.198853627341215,-0.2576960919976264,-0.500974696331653,-0.24327860433402665,-514585304,-518498308.8,54.53438061472348,56.4596916156517,NaN,NaN,-4.747058850389936,-1.7355370491370556
2002-09-16T09:30:00-04:00,89.317,89.89,88.466,89.89,28167600,40366108,45.90976845354964,46.786428536285776,NaN,NaN,-81.35960588732685,-64.1858685322648,-0.22949018332974147,-0.5301413334962035,-0.30065115016646204,-486417704,-510628667.2,56.71981655473666,55.409358759032145,NaN,NaN,-5.202424059228786,-2.230806622007303
2002-09-17T09:30:00-04:00,90.89,91.19,87.75,87.83,47762096,41070597.6,40.52937141541921,45.830941027725025,NaN,NaN,-87.63913065272808,-74.9855950328602,-0.3285044199088337,-0.7112816750525042,-0.38277725514367045,-534179800,-520596785.6,53.22960969495327,54.015728025118094,NaN,NaN,-7.142020505855714,-2.932408605414219
2002-09-18T09:30:00-04:00,87.017,88.5,86.283,86.95,54829504,42286468,38.45601648879006,45.08025673440672,NaN,NaN,-125.69899337018134,-95.83809031312835,-0.4260137176427933,-0.9152944021971621,-0.4892806845543688,-589009304,-535981684.8,48.29054610572942,52.4761995029908,NaN,NaN,-9.39473993026396,-3.8555987946784676
2002-09-19T09:30:00-04:00,85.995,86.8,84.7,84.7,48514000,42730537.6,33.70791297754066,43.98345086035831,NaN,NaN,-162.38212513878236,-110.38552310387755,-0.6039273783444208,-1.2441899074848948,-0.640262529140474,-637523304,-552343083.2,43.651767771919815,50.78526078323893,NaN,NaN,-12.89083548887775,-5.146346893849794
2002-09-20T09:30:00-04:00,84.92,85.2,84.05,84.35001,46325696,43126632,33.024859568069175,42.901647423770875,NaN,NaN,-176.1005593395058,-126.6360828777049,-0.7002797358930575,-1.515612199006796,-0.8153324631137384,-683849000,-586195822.4,35.95572266833986,48.70578493865629,NaN,NaN,-15.96536411298399,-6.691920782297536
2002-09-23T09:30:00-04:00,83.64999,84.06599,82.69,83.66,46904896,43786001.6,31.662618226274546,42.27332038218934,NaN,NaN,-189.39945106587527,-148.24405191341458,-0.7605633018141551,-1.7660365903814323,-1.0054732885672772,-730753896,-635063060.8,28.220970853314796,46.779916885315394,NaN,NaN,-18.95970789591898,-8.44446179852917
2002-09-24T09:30:00-04:00,82.44,83.64999,81.85001,82.31,69554496,45572171.2,29.13082127533211,41.215637535182836,NaN,NaN,-188.1795517128814,-168.35213612544524,-0.8354650261043131,-2.0498045711976687,-1.2143395450933556,-800308392,-688288779.2,22.53479390759462,44.67599377398686,NaN,NaN,-22.332117231771843,-10.428412574706694
2002-09-25T09:30:00-04:00,83.373,84.77,82.03999,84.35001,59294496,46769860.8,37.29092458053428,40.855588316336444,NaN,NaN,-132.23698784706193,-169.65973502082136,-0.6973559443926749,-2.0860344755841993,-1.3886785311915244,-741013896,-718689697.6,20.049886587282572,42.720831267728336,NaN,NaN,-22.90291060450459,-12.21048372182068
2002-09-26T09:30:00-04:00,85.02,85.97,84.45,85.73,53670800,47504710.4,42.14397883653151,40.59726102334707,NaN,NaN,-75.08192945043244,-152.19969588315138,-0.473507241677003,-1.980562583287778,-1.507055341610775,-687343096,-728653656,19.298755404074157,41.019200245024116,NaN,NaN,-21.899698452115157,-13.594657254719891
2002-09-27T09:30:00-04:00,85,85.63,82.75,82.75,64776608,48595185.6,35.71602341557754,39.750079349587644,NaN,NaN,-103.52193795633374,-137.68397160651696,-0.4848182817412332,-2.1130781937873166,-1.6282599120460834,-752119704,-742307796.8,18.287688615974787,39.3155099138008,NaN,NaN,-23.08854534718298,-14.950926982214618
2002-09-30T09:30:00-04:00,82,82.8,80.00999,81.78999,73095312,50731406.4,33.92107840606033,38.57337335282477,NaN,NaN,-137.40784954490147,-127.28565130232218,-0.5129139077000384,-2.2694022966711316,-1.7564883889710932,-825215016,-761200020.8,16.96344470949515,37.07812739906814,NaN,NaN,-24.631757114733002,-16.33390271543153
2002-10-01T09:30:00-04:00,82.438,85.77,81.47,85.72,67274816,50261037.6,45.90610234506632,38.363452497337796,NaN,NaN,-63.17998646383205,-102.28573825251232,-0.23681828081841982,-2.052511239994118,-1.815692959175698,-757940200,-752726382.4,19.76964960571351,34.960700339653954,NaN,NaN,-21.799431646578626,-17.11469256273826
2002-10-02T09:30:00-04:00,84.69,85.53,82.60001,83.14999,56846800,50548402.4,40.7065484951546,38.092443191678015,NaN,NaN,-68.58053396980577,-89.55444747706107,-0.19881119321050367,-2.0642069506888276,-1.865395757478324,-814787000,-767481003.2,18.591482522472404,32.578465401166035,NaN,NaN,-21.281620446501336,-17.709967974704412
2002-10-03T09:30:00-04:00,83.14,84.60001,81.95,82.31,55548896,49959931.2,39.14589713081635,37.66085154390829,NaN,NaN,-78.70559173211619,-90.27917993339784,-0.2011668181314583,-2.116854280142647,-1.9156874620111886,-870335896,-804079563.2,16.038274582395857,29.82874354171406,NaN,NaN,-21.40694160791333,-18.23810706516283
2002-10-04T09:30:00-04:00,82.8,82.92,79.58,80.8,68628368,51460204.8,36.44118167721016,36.9845239170269,NaN,NaN,-110.05334551877118,-91.58546144588531,-0.2709974966230704,-2.2544343327900265,-1.983436836166956,-938964264,-841448475.2,13.9340980835549,26.772620793772507,NaN,NaN,-22.411772226426134,-18.8343449453433
2002-10-07T09:30:00-04:00,80.065,81.2,78.55,79.13,53211104,52417015.2,33.67036753174983,36.49459506819337,NaN,NaN,-133.37391376990627,-90.77867429088626,-0.38905276002635913,-2.469752786199905,-2.0807000261735458,-992175368,-874840545.6,12.372083958094535,23.8542260982826,NaN,NaN,-24.161572875529316,-19.595377506798446
2002-10-08T09:30:00-04:00,79.81,81.31,78.2,80.37,79531632,54322261.6,37.47207634460888,36.42431362932329,NaN,NaN,-118.9675428866245,-101.93618557544475,-0.34454947535536995,-2.511386870367758,-2.1668373950123883,-912643736,-905781252.8,11.127368362777688,21.199713402357478,NaN,NaN,-24.361728719452266,-20.27628482289185
2002-10-09T09:30:00-04:00,79.09,79.7,77.78,78.10001,79893872,56929675.2,33.66779305262767,36.42144792040094,NaN,NaN,-147.57072693781174,-117.73422416904596,-0.4237046416283121,-2.6964681970477784,-2.2727635554194663,-992537608,-941331374.4,9.895509454474308,18.788552093968516,NaN,NaN,-25.783691465087394,-21.063057200348357
2002-10-10T09:30:00-04:00,77.94,81.07001,77.07001,80.63,76752128,58585706.4,40.872763694876554,36.98201250088717,NaN,NaN,-113.34961577270876,-124.66302897716449,-0.2689278661204697,-2.6089233880700533,-2.3399955219495836,-915785480,-950421291.2,9.602778325481069,16.906198926621457,NaN,NaN,-24.56726699442672,-21.56365859950241
2002-10-11T09:30:00-04:00,82.10001,84.73,81.82001,84.16,82321680,60645240,49.168932547406456,38.23246352382517,NaN,NaN,3.135863700571507,-102.02518713329593,0.08879050715183423,-2.2290073880097907,-2.317797895161625,-833463800,-929321198.4,15.82736892917356,16.020941646325653,NaN,NaN,-20.550437671435322,-21.418912752635684
2002-10-14T09:30:00-04:00,83.2,84.85001,83.03999,84.63,40638400,61268780,50.17141412601821,39.73536301315988,NaN,NaN,32.6848119990155,-68.8134419795116,0.3594721312339795,-1.8684577311191504,-2.22792986235313,-792825400,-889451204.8,26.17217321385111,16.280754453915403,NaN,NaN,-17.111663067212216,-20.80359136900376
2002-10-15T09:30:00-04:00,86.991,88.72,86.856,88.7,82538320,63007591.2,57.912193623222485,41.20831080192333,NaN,NaN,169.22764974683884,-11.174403452818922,0.7903355091339739,-1.2400104759356623,-2.030345985069636,-710287080,-848979873.6,34.916178799207145,17.34263246905287,NaN,NaN,-11.285583146898107,-19.443875908702953
2002-10-16T09:30:00-04:00,87.41701,87.8,85.924,86.55,63526896,63442460.8,53.20972523631837,41.99872125905096,NaN,NaN,125.51448900466114,43.442639735675655,0.9002639334136169,-0.9050160683026149,-1.8052800017162318,-773813976,-805235147.2,42.801795067372964,19.021421016431354,NaN,NaN,-8.171177656822262,-17.83349044414857
2002-10-17T09:30:00-04:00,88.87,89.3,87.85001,88.27,68584368,64445979.2,56.26900963633218,43.46679170339058,NaN,NaN,168.87919245595685,99.88840138140877,1.048196392023878,-0.49503451168638435,-1.5432309037102623,-705229608,-763123972.8,49.18463531570914,21.228345780698096,NaN,NaN,-4.61433714968759,-15.945039973511287
2002-10-18T09:30:00-04:00,87.64999,89.11,86.92999,88.64,47559104,64507649.6,56.921512857934864,45.10967987852448,NaN,NaN,144.35017666400043,128.13126397409457,1.1236512814053374,-0.13866680195359038,-1.2623180833589278,-657670504,-727965313.6,53.81826628681192,23.860833036220722,NaN,NaN,-1.6261091521043467,-13.89947842759601
2002-10-21T09:30:00-04:00,88.121,90.5,87.57001,90.17,45970704,64460940,59.60555530536904,46.088212232831815,NaN,NaN,152.5449029046587,152.1032821552232,1.2211906260002425,0.2641701991413754,-0.9570204268588671,-611699800,-691740193.6,58.06154035383811,26.595968089658193,NaN,NaN,1.7046482208396065,-11.670317477819493
2002-10-22T09:30:00-04:00,89.05,90.00999,88.52,89.52,41214704,63043950.4,57.953534642215836,47.320139814764765,NaN,NaN,128.46729536263473,143.95121127838237,1.1855530580755205,0.5249208957355336,-0.6606321623399869,-652914504,-680265678.4,59.33606844574118,29.506295655605964,NaN,NaN,3.9144902595047486,-9.44391637248746
2002-10-23T09:30:00-04:00,88.77,90.27,87.67999,90.2,55112496,62834850.4,59.226700072859835,48.75448288205358,NaN,NaN,111.14942734401312,141.07819894625277,1.150486339293349,0.7774757617766994,-0.3730105775166496,-597802008,-645063284.8,63.04642719649435,32.864020842327285,NaN,NaN,6.108259353499842,-7.222176983060702
2002-10-24T09:30:00-04:00,90.75,90.89999,88.10001,88.36,55149808,62908800.8,54.42446812607064,50.03900334268646,NaN,NaN,94.06937072802766,126.11623460066694,0.9541729691308981,0.819705633896973,-0.13446733523392507,-652951816,-634607726.4,64.09434943877045,36.4468959391284,NaN,NaN,6.601085265518976,-5.2474252332636055
2002-10-25T09:30:00-04:00,88.215,90.39,87.944,90.2,43724496,61856195.2,58.0845004940558,51.78286998285118,NaN,NaN,89.70123581993643,115.18644643185414,0.8997586426494224,0.9902309680778529,0.09047232542843053,-609227320,-624919089.6,65.0824840060476,40.21192451398219,NaN,NaN,8.118859767979426,-3.3379559473717437
2002-10-28T09:30:00-05:00,91.14999,91.28999,88.85001,89.61,39427008,60172780,56.517198526172145,53.143235852962846,NaN,NaN,87.27480920759339,102.13242769244107,0.780008721589461,1.0654832274152568,0.2854745058257958,-648654328,-632309995.2,63.643593819750464,43.96308347519453,NaN,NaN,8.916214782599551,-1.587360128804416
2002-10-29T09:30:00-05:00,89.08,89.49001,87,88.57001,59529808,59785529.6,53.76334681259479,54.57863255010335,NaN,NaN,52.713248179547605,86.98161825582363,0.5950900961504831,1.0293371260138997,0.43424702986341657,-708184136,-643363921.6,61.45519861966152,47.64591841556505,NaN,NaN,8.803949961306893,-0.10288725878851457
2002-10-30T09:30:00-05:00,88.67999,89.96001,88.23,89.42999,41703008,59028340,55.68618583892554,55.636734131821136,NaN,NaN,62.648056311673905,77.2813440493558,0.4989140452635732,1.057889586442883,0.5589755411793098,-666481128,-657099745.6,58.751770366911515,51.15656070423865,NaN,NaN,9.2455221957023,1.2325998061387446
2002-10-31T09:30:00-05:00,89.66,90.3,88.19,88.52,41621104,58331950.4,53.16660432631772,55.92228211602908,NaN,NaN,54.47271130508391,69.36201216476704,0.349309351930968,0.9956122310930198,0.6463028791620518,-708102232,-668129828.8,56.59863691764545,54.06879413198664,NaN,NaN,8.919225715502787,2.330689221762179
2002-11-01T09:30:00-05:00,88.35001,90.82001,88.05,90.27,51889504,57495007.2,57.179169833741426,56.42283609515217,NaN,NaN,63.89541950242372,64.2008489012645,0.3430173467400197,1.0750745625870763,0.7320572158470566,-656212728,-677526910.4,54.75747371478615,56.11060131062486,NaN,NaN,9.769216926869234,3.3933360367774723
2002-11-04T09:30:00-05:00,91.8,92.94,90.89999,91.13,49081808,57288542.4,59.03657985259677,56.50314939725034,NaN,NaN,101.18923534246396,66.9837341282386,0.36930126864106705,1.1936838016483904,0.8243825330073233,-607130920,-669222228.8,56.116118783977186,57.62488273810843,NaN,NaN,11.012432481243742,4.48177838598694
2002-11-05T09:30:00-05:00,90.84,92.07001,90.84,91.85001,37282192,55176070.4,60.57832481048783,57.02947793826244,NaN,NaN,100.96206836873687,76.63349816607645,0.4048497568735685,1.330444729099284,0.9255949722257155,-569848728,-641555147.2,60.38437720153496,58.88078146197715,NaN,NaN,12.493289612388017,5.626279989758522
2002-11-06T09:30:00-05:00,92.48,93.07001,90.78999,93.03999,65270000,54444876.8,63.05333711407754,57.51407275810139,NaN,NaN,132.1531970717439,90.53452631809043,0.4734112382797162,1.5173590200753608,1.0439477817956446,-504578728,-609174667.2,64.71047295005849,59.98976986443068,NaN,NaN,14.473683718312902,6.890194808123433
2002-11-07T09:30:00-05:00,92.02699,92.22,90.22,90.75999,51574096,53185975.2,55.8218682239123,57.43552671281406,NaN,NaN,94.60813017665849,98.56161009240536,0.33654550102403946,1.464629658075694,1.1280841570516544,-556152824,-578784785.6,68.2182927235284,61.01834318133899,NaN,NaN,14.143027634141529,7.926313783268875
2002-11-08T09:30:00-05:00,90.53,91.57001,89.52,89.64999,37911104,50965446.4,52.655681670584485,56.93910716747231,NaN,NaN,53.4317821393927,96.46888261979915,0.15199630239824713,1.3180795350494634,1.1660832326512163,-594063928,-566355025.6,69.55143553269905,61.839049979829056,NaN,NaN,12.92821106360267,8.640870537602275
2002-11-11T09:30:00-05:00,89.515,89.56,87.8,88.25999,33580800,50612566.4,48.91420023388821,56.29344042402033,NaN,NaN,-63.53121275361553,63.524793000583244,-0.07098096827493117,1.0773570223075524,1.1483379905824835,-627644728,-570457787.2,68.52961189311395,62.4957316546414,NaN,NaN,10.76619123759154,8.944487780457884
2002-11-12T09:30:00-05:00,88.66,89.92999,88.37,88.96001,37769392,48374120,50.80984467079874,55.69223646673026,NaN,NaN,-31.651018158715043,37.002175695092866,-0.1728133993339216,0.9323212414150817,1.1051346407490032,-589875336,-574463108.8,67.48720545129802,62.812930101413095,NaN,NaN,9.498616608303275,9.023649041578654
2002-11-13T09:30:00-05:00,88.32001,89.74899,87.45,89.05,63905008,48393025.6,51.06125205243507,55.45200674718486,NaN,NaN,-66.55801372256848,-2.740066463769611,-0.23191318034711483,0.8152431653151098,1.0471563456622246,-525970328,-578741428.8,66.32664596443156,62.97237985324603,NaN,NaN,8.526600948932916,8.952642171200692
2002-11-14T09:30:00-05:00,90.07001,91,89.759,90.73,31938704,46560742.4,55.62134485885927,55.276067058956535,NaN,NaN,55.27612246144187,-10.606468006812932,-0.15913155530618694,0.8482419015294909,1.0073734568356778,-494031624,-566317188.8,68.04520046344255,63.18400245734567,NaN,NaN,8.945192612094045,8.95157794847117
2002-11-15T09:30:00-05:00,90,91.55,89.95,91.39999,39166192,46141096.8,57.328989415396755,55.334052122472585,NaN,NaN,78.76178540002631,-5.540467354686217,-0.07159833859745801,0.9178755335888553,0.9894738721863133,-454865432,-538477489.6,71.54910492770594,63.74868182219963,NaN,NaN,9.777087032016524,9.069507817549079
2002-11-18T09:30:00-05:00,92.14999,92.14999,90.35001,90.48,29019392,45293531.2,54.24251535785903,55.36827844713431,NaN,NaN,71.49020897346915,21.46381699073072,-0.08071336789911687,0.8885821623124173,0.9692955302115341,-483884824,-509725508.8,74.6417072954949,64.69057529904488,NaN,NaN,9.632423781698092,9.149924383856082
2002-11-19T09:30:00-05:00,90.02,91.10001,89.75999,90.36,32813696,44873480.8,53.83537987917392,55.23607802143777,NaN,NaN,27.233823545207162,33.24078533151516,-0.09869036554499222,0.8459325732802938,0.944622938825286,-516698520,-495090145.6,76.0677486614932,65.927430891515,NaN,NaN,9.40292978682443,9.18606801285156
2002-11-20T09:30:00-05:00,89.98,92.42,89.95,92.37,36815296,43958620.8,59.34043142410481,55.677065671279706,NaN,NaN,96.52166360923665,65.85672079787619,0.014877069895741224,0.9632192761949625,0.9483422062992213,-479883224,-485872724.8,76.94703338478634,67.38088778202507,NaN,NaN,10.760514701673209,9.41098896839751
2002-11-21T09:30:00-05:00,92.60001,94.19,92.42999,94.09,55170800,43959670.4,63.366219718096566,56.1189978058765,NaN,NaN,192.7139068747159,93.344277680531,0.18639958457016115,1.1813416870119227,0.9949421024417615,-424712424,-472008884.8,78.24190200789623,69.05834694581864,NaN,NaN,13.169801730330486,9.94796222010222
2002-11-22T09:30:00-05:00,93.48,94.27,93.27299,93.42,32514096,43399150.4,60.83923313021949,56.24775875427813,NaN,NaN,166.8876047938353,110.96944155929279,0.2323066676028307,1.2853254369452998,1.053018769342469,-457226520,-472481102.4,78.08102731899942,70.62726898403452,NaN,NaN,14.455497859271308,10.59189588284066
2002-11-25T09:30:00-05:00,93.42999,94.25999,92.77,93.48,34059296,43130764.8,60.98926736776801,56.27711179408385,NaN,NaN,136.37752148538726,123.94690406167642,0.2431313272079616,1.3569329283524212,1.1138016011444596,-423167224,-460337582.4,79.26190338490912,71.97566371141838,NaN,NaN,15.54948099525265,11.300122327470945
2002-11-26T09:30:00-05:00,93.07401,93.45,91.62,91.7,42290400,42268794.4,54.33811097926017,55.65459564159689,NaN,NaN,68.53312489379769,132.2067643313945,0.11342091002517196,1.2555777386759246,1.1421568286507526,-465457624,-450089403.2,80.22991265196133,73.08419511869715,NaN,NaN,14.60849318158325,11.772746735201274
2002-11-27T09:30:00-05:00,92.52,94.64999,92.42999,94.28,37773008,42072294.4,60.98031079166395,56.023055825007724,NaN,NaN,130.08391856326165,138.9192153221995,0.18041196878197274,1.3676717896282184,1.1872598208462457,-427684616,-439649681.6,81.1929817698732,74.0109586220075,NaN,NaN,15.815407284175897,12.350269670769077
2002-11-29T09:30:00-05:00,94.8,94.95,93.77,93.98,19385696,40960524,59.889387620277205,56.539749107128635,NaN,NaN,134.6486573704113,127.30616542133859,0.1829738527540523,1.4159771367888112,1.233003284034759,-447070312,-444121259.2,79.40865959816765,74.71504605525524,NaN,NaN,16.462173858054502,12.937684554666994
2002-12-02T09:30:00-05:00,95.47,96.05,93.22,94.13,49794400,40855768.8,60.27208456790576,57.35102655955846,NaN,NaN,129.05554018149817,119.73975249887117,0.17331939427620524,1.4496525268800156,1.2763331326038103,-397275912,-432131137.6,80.63741547171297,75.57988916801231,NaN,NaN,17.09778410960863,13.531984491087227
2002-12-03T09:30:00-05:00,93.25,93.39999,92.35001,92.87,34433296,40123343.2,55.48333391136531,57.68484721959893,NaN,NaN,50.72902700170407,102.61005360213453,0.06613613574588695,1.359003302286169,1.292867166540282,-431709208,-433839534.4,79.90575616796826,76.46692850491733,NaN,NaN,16.26165783350969,13.921937825719008
2002-12-04T09:30:00-05:00,91.77,93.14,91.42999,92.45,64137200,41466093.6,53.94475882156606,57.89081198882258,NaN,NaN,25.245473041580716,93.95252323169115,-0.043101461710880695,1.2389903394016812,1.282091801112562,-495846408,-439917291.2,77.22134573775139,77.24512134586875,NaN,NaN,15.127339713049187,14.094138095337605
2002-12-05T09:30:00-05:00,92.7,92.80099,91.10001,91.42999,36778192,40041503.2,50.296906527719834,57.510494965169755,NaN,NaN,2.079375534484726,68.35161462593577,-0.1860932631597887,1.049475222162826,1.2355684853226148,-532624600,-460905288,68.64517842903743,77.28797691483983,NaN,NaN,13.092954227486242,13.951111828501697
2002-12-06T09:30:00-05:00,90.12,92.17,89.98,92.03,50132096,39969403.2,52.338613462754616,57.15403953998104,NaN,NaN,-15.67444348500953,38.28699445485163,-0.23893564330124795,0.9368989311960547,1.1758345744973027,-482492504,-467989726.4,65.98140925583871,76.8902843668493,NaN,NaN,11.933105671700188,13.66282523467291
2002-12-09T09:30:00-05:00,91.07001,91.46001,89.48,89.5,36804096,39914052.8,44.11052540316973,56.43032597178894,NaN,NaN,-70.62045561044411,-1.6482047035368281,-0.43170937102993423,0.6361978607098848,1.067907231739819,-519296600,-492393864,57.67828379756762,75.67861125985449,NaN,NaN,8.278550286704515,12.893643099248854
2002-12-10T09:30:00-05:00,90.02,91.10001,89.75999,90.7,33449104,39907468,48.26491562767261,56.03243566811028,NaN,NaN,-62.30669462596804,-24.255349029071244,-0.46306000013228954,0.4890822315744572,0.9521422317067467,-485847496,-503221521.6,54.40691259106369,74.13140868339524,NaN,NaN,6.444791471498442,11.972378580998795
2002-12-11T09:30:00-05:00,90.42,91.62,90.16,90.78,39206096,39979303.2,48.53954331588412,55.260943660380235,NaN,NaN,-53.76897275510544,-40.05823818840848,-0.462010682586835,0.37462887847320303,0.836639561060038,-446641400,-493380520,56.80487151466266,72.69268283552927,NaN,NaN,5.052569332011427,10.983834402572029
2002-12-12T09:30:00-05:00,91.2,91.49001,90.2,90.77,34480496,38508077.6,48.50488245763292,54.19941957034712,NaN,NaN,-65.16859473205928,-53.50783224171728,-0.44539928707629217,0.2798904522146728,0.725289739290965,-481121896,-483079979.2,59.22239057453559,71.33414630457493,NaN,NaN,3.908292560490655,9.97304271084612
2002-12-13T09:30:00-05:00,89.91,90.48,89.27,89.34,36873392,38754812,43.69937183806498,52.975143763764656,NaN,NaN,-119.94420485177588,-74.36178451507055,-0.5095106069372779,0.08840148061936759,0.5979120875566455,-517995288,-490180536,56.8599615961999,69.81835589580353,NaN,NaN,1.4874089176512149,8.760809311818276
2002-12-16T09:30:00-05:00,89.82001,91.78999,89.66,91.64999,37112304,38652117.6,51.9762880040281,52.33135952349752,NaN,NaN,-50.38571975562533,-70.31483734410679,-0.38101783737018446,0.12163979084391485,0.5026576282140993,-480882984,-482497812.8,58.77611050483502,68.35508497579825,NaN,NaN,1.8250806055573252,7.769990925209569
2002-12-17T09:30:00-05:00,91.37199,91.74001,90.74001,90.85001,32399904,38821143.2,49.27461803432242,51.96968145600197,NaN,NaN,-46.86788856706201,-67.22707613232559,-0.33614296243547753,0.08247892516975242,0.41862188760522995,-513282888,-487984891.2,56.83445970053846,66.68398119355375,NaN,NaN,1.2778972395599357,6.8425489701167646
2002-12-18T09:30:00-05:00,90.32001,90.39999,89.33,89.8,35643104,38962613.6,45.90206890569268,50.89266417843259,NaN,NaN,-109.81501600880638,-78.43628478306577,-0.3612207716830112,-0.03290407699853404,0.32831669468447716,-548925992,-508441809.6,50.1790276226596,64.46869875446707,NaN,NaN,-0.22006772293791255,5.833603728251811
2002-12-19T09:30:00-05:00,89.35001,90.7,88.60001,89.16,39287200,39086208.8,43.92849860632099,49.752600677435716,NaN,NaN,-114.46887798154069,-88.29634143296207,-0.4018397724194323,-0.1739830208398132,0.2278567515796191,-588213192,-529860068.8,44.32634370475186,61.962819047794504,NaN,NaN,-2.0560976884874442,4.706503525860489
2002-12-20T09:30:00-05:00,89.2,90.02,89.10001,89.99001,31181104,37886724,47.104820234539744,48.812081796481,NaN,NaN,-95.12577158831435,-83.33265478026975,-0.355341897646062,-0.21632062047795841,0.13902127716810359,-557032088,-537667428.8,42.3856525722218,59.230550269259425,NaN,NaN,-2.6690210528670053,3.652857157470847
2002-12-23T09:30:00-05:00,89.59,90.47,89.31,90.02,22645504,37393294.4,47.221157799648864,48.22192635992983,NaN,NaN,-77.81756300149921,-88.81902342944453,-0.30692385981160897,-0.24463354759640765,0.06229031221520133,-534386584,-548368148.8,39.812823309481175,56.366769350796055,NaN,NaN,-3.13384317839272,2.683328538061766
2002-12-24T09:30:00-05:00,89.59,89.86,89.25,89.355,10937000,36237179.6,44.86480909722343,47.573358522476774,NaN,NaN,-93.57566782601782,-98.16057928123568,-0.30349355113632237,-0.31707662670520165,-0.013583075568879263,-545323584,-554776288,38.31299410563193,53.587601377073234,NaN,NaN,-4.189641635605242,1.7014756561093365
2002-12-26T09:30:00-05:00,89.7,90.61,88.84,89.39,17489200,34997119.6,45.0203112078436,47.196458856771336,NaN,NaN,-80.47714010937798,-92.29300410135002,-0.2830764141241009,-0.36742859322400534,-0.08435217909990447,-527834384,-550557966.4,39.91756455872085,51.535628957764914,NaN,NaN,-5.021893134668855,0.7409944002838805
2002-12-27T09:30:00-05:00,88.96001,89.28999,87.38,87.38,22213008,34219119.6,38.333768568112085,46.19611279286829,NaN,NaN,-154.67013858841705,-100.33325622272528,-0.38294449635859934,-0.5630327995481537,-0.18008830318955432,-550047392,-542924806.4,42.81616109635112,49.880968374944366,NaN,NaN,-7.774336653232599,-0.47548146450418793
2002-12-30T09:30:00-05:00,87.797,88.47,87.22,88.11,29972192,34748444.4,41.719318572482685,46.02531230496207,NaN,NaN,-149.29905146481357,-111.16791219802512,-0.3772365669807716,-0.6516340119155188,-0.2743974449347472,-520075200,-535533428.8,45.55522494208822,49.01503559955298,NaN,NaN,-9.133268305488224,-1.7123081560733358
2002-12-31T09:30:00-05:00,87.99001,88.42999,87.11,88.23,34037504,33960599.6,42.280300608187936,45.59783980357031,NaN,NaN,-143.5176600276943,-124.30793160326417,-0.34372383444699756,-0.7040522379934941,-0.3603284035464966,-486037696,-525863651.2,48.997132645365795,48.62862274628884,NaN,NaN,-10.093635479385759,-2.9096406308322535
2003-01-02T09:30:00-05:00,88.85001,91.3,88.53999,91.07001,44641392,34471004.4,53.65101744965707,45.9629450988398,NaN,NaN,14.761073538452985,-102.64058333036999,-0.12017228287261905,-0.5105437571372704,-0.39037147426465135,-441396304,-505078195.2,55.50818110426472,48.53600200268899,NaN,NaN,-7.393100654878181,-3.5501349199816716
2003-01-03T09:30:00-05:00,90.91,91.38699,90.5,91.35001,32226000,32875444.4,54.60060860415673,46.39835410930579,NaN,NaN,80.10902607281963,-70.52335009393046,0.04767301646887512,-0.3307802036785574,-0.37845322014743255,-409170304,-481345379.2,61.54470448385338,48.701881567640264,NaN,NaN,-4.9283488917777385,-3.7470226302382525
2003-01-06T09:30:00-05:00,91.24001,93.49001,91.17599,92.96001,41005696,33086819.6,59.711849127606314,47.54210248713017,NaN,NaN,181.32683796296018,-3.3239547836550116,0.2565728246072562,-0.05773718938836225,-0.3143100139956185,-368164608,-444968822.4,68.58115902617715,49.539109955495796,NaN,NaN,-1.1092141637860173,-3.3701928493165045
2003-01-07T09:30:00-05:00,92.89999,93.37,92.2,92.73,38655104,32512970,58.69516937880325,48.0220225853284,NaN,NaN,179.22678640449263,62.38121279020622,0.36224400940058865,0.1384949977551173,-0.2237490116454713,-406819712,-422317724.8,72.01496627989803,50.48474251085744,NaN,NaN,1.660381520992751,-2.6515393678437538
2003-01-08T09:30:00-05:00,92.2,92.39999,91.05,91.39,38736704,32609600.4,53.03029292916783,48.290285077817366,NaN,NaN,88.83713533609368,108.85217186296381,0.3260114387989612,0.18376528685323024,-0.14224615194573098,-445556416,-414221468.8,73.14474826452515,51.649763122570775,NaN,NaN,2.345576434243094,-1.937665681831347
2003-01-09T09:30:00-05:00,91.821,93.17999,91.41,92.81,34851200,32679705.2,57.69039358065322,49.13230826888597,NaN,NaN,125.13754525171103,130.92746620561542,0.37812942079316675,0.33041562404572744,-0.047713796747439294,-410705216,-408083251.2,74.0017002493162,53.35138259590338,NaN,NaN,4.421551439591492,-1.0292060930566556
2003-01-10T09:30:00-05:00,91.95,93.64,91.8,93.06,37771600,32607980.4,58.471587973963736,50.17110036657474,NaN,NaN,128.4920714790842,140.60407528686835,0.4073632066784241,0.4614902116005908,0.054127004922166724,-372933616,-400835913.6,75.0154251637257,55.54345984297294,NaN,NaN,6.329262180270826,0.022003660275841774
2003-01-13T09:30:00-05:00,93.53999,93.86,92.44,93.03,31676096,32467760.4,58.332401856441884,50.97307048242488,NaN,NaN,124.6077689463776,129.26026148355183,0.40192372940241383,0.5565316666751841,0.1546079372727702,-404609712,-408124934.4,71.97568567725725,57.65703363618976,NaN,NaN,7.831052750799955,1.1375821017792864
2003-01-14T09:30:00-05:00,92.69,93.83,92.41,93.33,30902800,32169230.8,59.37385872822188,51.841120548751526,NaN,NaN,112.56902227544852,115.928708657743,0.3951806324764915,0.6485837278683846,0.2534030953918931,-373706912,-401502374.4,73.04443446084127,60.0307201470012,NaN,NaN,9.377786976257218,2.3147542267047054
2003-01-15T09:30:00-05:00,93.53999,93.57001,91.91,92.39999,33542000,31990715.6,54.801052783639655,52.55085224063839,NaN,NaN,79.22693899376628,114.00666938927755,0.3085768750220005,0.6391241891693937,0.33054731414739325,-407248912,-393840873.6,74.26708476549308,62.598869479848425,NaN,NaN,9.455927804969999,3.3349218807426046
2003-01-16T09:30:00-05:00,92.5,92.92999,91.455,92.02,45374496,32639445.2,53.004782095676255,53.1211715897693,NaN,NaN,54.15976409516272,99.81111315796787,0.21085559711413165,0.5941168105400578,0.3832612134259262,-452623408,-402224512,70.49883959360028,64.7832462680541,NaN,NaN,9.024336607583512,4.1476954131484485
2003-01-17T09:30:00-05:00,90.99001,92.3,90.14999,90.66,35621008,32638340.4,47.0593888175253,53.7444301790131,NaN,NaN,6.26201812251796,75.36510248665464,0.04826625235744947,0.443594028872738,0.39532777651528855,-488244416,-425286672,61.28668842654983,66.10256964878258,NaN,NaN,6.887679677634652,4.539121736646478
2003-01-21T09:30:00-05:00,90.87,90.92,88.95,89.25,42370304,32792495.6,41.82178132834833,53.75174894728922,NaN,NaN,-51.411840961249865,40.16118050512913,-0.1497588296217494,0.2081292394881018,0.3578880691098512,-530614720,-450487673.6,53.118473156302606,66.64280166408362,NaN,NaN,3.3579227155837708,4.370379019351805
2003-01-22T09:30:00-05:00,88.77,89.8,88,88.17,42808608,33373870.8,38.3051031334726,53.46780627052384,NaN,NaN,-90.97461547322698,-0.547547044605966,-0.33821238344378635,-0.06487741019488169,0.27333497324890466,-573423328,-490430956.8,43.27388509493259,66.2339982676241,NaN,NaN,-0.7860723020082828,3.633743116300364
2003-01-23T09:30:00-05:00,88.75,89.38,87.95,88.71001,56080800,35045635.6,40.97755580106266,52.56255900990995,NaN,NaN,-83.80881327124554,-33.15469749760833,-0.4066315341556879,-0.23495444444570524,0.1716770897099827,-517342528,-512449680,38.98466059165939,65.053746802438,NaN,NaN,-3.418392754317657,2.626295134783504
2003-01-24T09:30:00-05:00,88.59,88.67999,86.17,86.38,68700816,37933826.4,34.11156666946387,51.09905601457474,NaN,NaN,-132.3363373534463,-70.45391778733014,-0.5784599775039014,-0.5513978821698942,0.02706209533400733,-586043344,-539133667.2,34.51928533403171,63.12335972030788,NaN,NaN,-8.169285676774994,1.0840693045608618
2003-01-27T09:30:00-05:00,85.73,86.8,84.5,85.2,58287504,39973741.6,31.25535491676503,49.06644928522894,NaN,NaN,-162.55081950083752,-104.21648531200124,-0.7313864523062001,-0.8871709700487429,-0.1557845177425427,-644330848,-570350953.6,30.166053384402645,60.379423603038276,NaN,NaN,-13.102297357516402,-0.9425545043073185
2003-01-28T09:30:00-05:00,85.63,86.39999,85.13,85.83,46956704,41210926.4,34.412905755731956,47.332001883580986,NaN,NaN,-140.99990602089957,-122.13409832393117,-0.7472719317286902,-1.0898744324034055,-0.34260250067471526,-597374144,-583702838.4,28.509981951470692,57.271924722436324,NaN,NaN,-16.09037551841311,-3.10652893489386
2003-01-29T09:30:00-05:00,85.44,87.17999,84.77,86.48,53780192,42401326.4,37.59761756950124,46.229667929319085,NaN,NaN,-121.41601375258733,-128.22237797980327,-0.6734504899252216,-1.1844156130812422,-0.5109651231560206,-543593952,-577736963.2,30.349900437574604,54.215149877654135,NaN,NaN,-17.551457047111434,-5.170090093782084
2003-01-30T09:30:00-05:00,86.78999,86.88,84.39999,84.42999,49883392,43193620.8,32.274789134313025,44.41426761172335,NaN,NaN,-134.59983841869786,-138.38058300929373,-0.7180457303654226,-1.4085222861127988,-0.6904765557473762,-593477344,-592963926.4,28.344738516786876,50.95393832533062,NaN,NaN,-20.631261725406265,-7.378828898299824
2003-01-31T09:30:00-05:00,84.14999,86.215,84.14999,86.06,55321600,43727631.2,39.59726153381047,43.066101437426695,NaN,NaN,-110.12233677841824,-133.9377828942881,-0.5980376462620862,-1.438023613574984,-0.8399859673128978,-538155744,-583386406.4,31.414123227151492,47.83955961557531,NaN,NaN,-20.769095609842953,-9.291724142805986
2003-02-03T09:30:00-05:00,86.14,86.817,85.92,86.23,39799200,44106291.2,40.32197306163259,41.77964223779746,NaN,NaN,-79.31559974366515,-117.29073894285364,-0.4729617878878465,-1.4311882021727058,-0.9582264142848593,-498356544,-554191545.6,39.86955317864495,45.546264437103005,NaN,NaN,-20.645231653601705,-10.913653787205375
2003-02-04T09:30:00-05:00,85.31,85.75,84.3,85.38,43757296,44243871.2,37.87507048407024,40.24401450607235,NaN,NaN,-95.87276189446868,-108.26531011756747,-0.4152822714628366,-1.477329253613405,-1.0620469821505685,-542113840,-543139484.8,42.747085059807716,43.3821680513149,NaN,NaN,-21.302105496786027,-12.397718317145468
2003-02-05T09:30:00-05:00,85.754,86.53999,84.489,84.85001,55297904,45076011.2,36.39215595196461,38.92909330380984,NaN,NaN,-84.1049477804663,-100.80309692314326,-0.3815003291514423,-1.5389223935898713,-1.157422064438429,-597411744,-553903043.2,40.70411805889824,40.98481328655812,NaN,NaN,-22.288938795841418,-13.810749814102032
2003-02-06T09:30:00-05:00,84.37,84.89,83.64999,84.45,53655904,45821971.2,35.269742615180874,37.66230476948874,NaN,NaN,-96.49856563920049,-93.1828423672438,-0.35530329219674806,-1.601551179684364,-1.246247887487616,-651067648,-565421104,38.579320313152444,38.70484762366899,NaN,NaN,-23.429834398781434,-15.184904754770518
2003-02-07T09:30:00-05:00,84.91,84.99001,82.97,83.42,43168192,46237820.8,32.49093604912311,36.62170100031716,NaN,NaN,-98.95005743860355,-90.94838649928086,-0.3746283008964242,-1.7145332636081463,-1.339904962711722,-694235840,-596637123.2,33.478621796640894,36.71855715010407,NaN,NaN,-25.242916675869466,-16.621763600641795
2003-02-10T09:30:00-05:00,83.466,84.13,82.64999,84.00999,45470400,46622760.8,35.619894659088246,36.17870909537,NaN,NaN,-96.29464384084213,-94.34419531871626,-0.31723476612934753,-1.7364484203734065,-1.419213654244059,-648765440,-626718902.4,29.439260804779167,35.02718483928096,NaN,NaN,-25.851513012986903,-17.940299230976812
2003-02-11T09:30:00-05:00,84.37,84.707,82.834,83.42999,46468704,47362391.2,33.95382021414788,35.8679031725611,NaN,NaN,-90.59276767529823,-93.28819647488216,-0.2887071848213183,-1.7800976352707067,-1.4913904504493884,-695234144,-657342963.2,26.00001905120351,33.79333726472889,NaN,NaN,-26.842716572510305,-19.212073136910167
2003-02-12T09:30:00-05:00,83.16,83.62,82.09,82.10001,35906304,47612566.4,30.438050610339232,35.11508137322371,NaN,NaN,-114.813365459424,-99.42988001067371,-0.3269716363030386,-1.9001049958281868,-1.5731333595251482,-731140448,-684088704,23.4260068243112,32.68200485277545,NaN,NaN,-28.77568246062462,-20.578303040297946
2003-02-13T09:30:00-05:00,82.14999,82.66,81,82.35001,58064496,48838691.2,31.866201020814643,34.954698112605904,NaN,NaN,-131.03627770604953,-106.33742242404351,-0.3035182872076656,-1.9525312185347303,-1.6490129313270647,-673075952,-688490364.8,23.02205675820008,31.860774240216045,NaN,NaN,-29.95086281815468,-21.917240151420337
2003-02-14T09:30:00-05:00,82.37,84.2,81.82899,84.14999,59588304,49549381.6,41.22290104375447,35.66666569310515,NaN,NaN,-84.22958557038771,-103.39332805040036,-0.14300299756135892,-1.8277666782787634,-1.6847636807174045,-613487648,-672340726.4,27.9322786984161,31.70121890550272,NaN,NaN,-28.13020551137161,-22.804806631413378
2003-02-18T09:30:00-05:00,84.53,85.8,84.39,85.63,39512896,49743976,47.595418214640496,36.60827372588433,NaN,NaN,-4.931271373088096,-85.12065355684955,0.07491177923524939,-1.5911239566733428,-1.6660357359085922,-573974752,-657382588.8,32.24335880974242,31.96788868109356,NaN,NaN,-24.477967492143755,-23.04382961151772
2003-02-19T09:30:00-05:00,85.32001,85.47,84.28,85.17999,31440304,49197476,45.96364598906997,37.20584718442496,NaN,NaN,-8.854172060518438,-68.7729344338936,0.19403988325869825,-1.4234858818352194,-1.6175257650939177,-605415056,-639418771.2,37.10899500763458,32.45068115038356,NaN,NaN,-22.006383478869978,-22.89562302113947
2003-02-20T09:30:00-05:00,85.21001,85.42,84.05,84.33,29299296,48522010.4,42.9671914608504,37.96959020774906,NaN,NaN,-19.820208969326366,-49.77430313587403,0.21903747722308387,-1.3437289185650627,-1.5627663957881466,-634714352,-620133552,41.9301295143031,33.42106622163472,NaN,NaN,-20.826306422556023,-22.60000636419898
2003-02-21T09:30:00-05:00,84.38,85.74001,83.46001,85.17999,60965200,48766230.4,46.70859919795619,38.47754289804518,NaN,NaN,2.8928089392083143,-22.98848580682246,0.2917149973307356,-1.198122649124727,-1.4898376464554626,-573749152,-600268192,46.48129718257047,34.49729293273607,NaN,NaN,-18.68192275618828,-22.040280134483165
2003-02-24T09:30:00-05:00,84.92999,85,83.59,83.8,30648800,46863629.6,41.90245738890097,38.590434635707204,NaN,NaN,-33.81396022072634,-12.905360736890184,0.24749050428644592,-1.180474516097405,-1.427965020383851,-604397952,-598450252.8,46.891504660703276,34.99886089574024,NaN,NaN,-18.30308028578001,-21.506394441811285
2003-02-25T09:30:00-05:00,82.95,84.49001,82.22,84.47,56901296,46794319.2,44.868536990290195,39.08996795758007,NaN,NaN,-55.87992841920517,-23.095092146113597,0.26257390689788696,-1.0997476367614922,-1.3623215436593792,-547496656,-593154633.6,48.13850088448825,35.38396202607456,NaN,NaN,-17.075461481756257,-20.87340401894628
2003-02-26T09:30:00-05:00,84.024,84.53,83.08,83.24001,37799392,46336453.6,40.7549828731273,39.40159845194883,NaN,NaN,-57.12896145553889,-32.75005002511769,0.19218827050844056,-1.1220862055238285,-1.314274476032269,-585296048,-589130832,49.1161557146673,35.984821858629495,NaN,NaN,-17.298555027818345,-20.362711305928006
2003-02-27T09:30:00-05:00,83.7,84.75,83.16,84.34,51829008,46238894.4,45.56173189109462,40.13674054308552,NaN,NaN,-17.340604770787856,-32.25412918540998,0.2201778720476697,-1.0390521359726819,-1.2592300080203516,-533467040,-568881369.6,53.832824805833695,37.07435789382101,NaN,NaN,-15.973140510924644,-19.73562976378467
2003-02-28T09:30:00-05:00,84.47,85.23,84.16,84.89999,43888800,45939164.8,47.88008474209979,41.23596544972672,NaN,NaN,39.48167758530746,-24.93635545619015,0.27339653734287483,-0.917484336341758,-1.1908808736846328,-489578240,-552047187.2,57.3705826642145,38.78092652721913,NaN,NaN,-14.172002288290745,-18.940825838714108
2003-03-03T09:30:00-05:00,85.25999,85.78,83.72,84.09,42935392,45319854.4,44.901434436568756,41.89893257668961,NaN,NaN,25.813092038669183,-13.010945004311049,0.2515864315697276,-0.8763978342224732,-1.1279842657922008,-532513632,-537670323.2,60.17720127090169,40.976493703370735,NaN,NaN,-13.553376436213144,-18.1711902097854
2003-03-04T09:30:00-05:00,83.95,84.00999,82.64999,82.75,31475392,44903664,40.42135883262404,42.360899620866476,NaN,NaN,-87.5596271792627,-19.346884756322556,0.1494956510556622,-0.9411147019726229,-1.0906103530282851,-563989024,-540968796.8,59.213967510464386,43.34891859331794,NaN,NaN,-14.4120713698825,-17.634173232656416
2003-03-05T09:30:00-05:00,82.61,83.53999,82.36,83.45,44105200,44921059.2,43.587832214969815,43.300169735482946,NaN,NaN,-80.60131623741147,-24.041355712697065,0.13228556968007554,-0.9252533909281908,-1.0575389606082664,-519883824,-527886352,61.82402700434429,46.091634320463164,NaN,NaN,-14.157483986616315,-17.137503340364972
2003-03-06T09:30:00-05:00,82.87,83.52,82.47,82.75,41412400,44226784,41.22809727419015,43.96887661072406,NaN,NaN,-91.82740655879886,-38.938716070299265,0.07953301209947528,-0.9581226954839224,-1.0376557075833976,-561296224,-533452188.8,60.062975611149675,48.73741423853098,NaN,NaN,-14.657274859370247,-16.783184985937154
2003-03-07T09:30:00-05:00,81.61,83.99001,81.42999,83.32001,63582704,44723124,43.89184480694975,44.15951545095229,NaN,NaN,-83.6583202660986,-63.56671564058047,0.08813629464621076,-0.9274853392756341,-1.015621633921845,-497713520,-535079244.8,59.529147890144365,50.99433346651158,NaN,NaN,-14.287908628632673,-16.42671693489366
2003-03-10T09:30:00-05:00,82.60001,82.86,81.10001,81.32001,41027504,44616089.6,37.474045987909946,43.43656029190011,NaN,NaN,-164.8338707987853,-101.69610820807137,-0.029467683794411892,-1.0524562386648597,-1.0229885548704478,-538741024,-536324723.2,59.09616378787632,52.912390964949715,NaN,NaN,-15.998520056282366,-16.365545952234903
2003-03-11T09:30:00-05:00,81.48,82,80.48,80.52,48114496,44748294.4,35.25352483836956,42.67155163827865,NaN,NaN,-186.6569049144493,-121.51556375510867,-0.14336321228311433,-1.2021925702243408,-1.0588293579412265,-586855520,-540898022.4,57.44395578086692,54.36488816303774,NaN,NaN,-18.119627713585306,-16.616129060999246
2003-03-12T09:30:00-05:00,80.38,81.10001,79.383,81.06,62475392,45548628.8,37.927200299686184,42.311552269624066,NaN,NaN,-181.5169067583125,-141.6986818592889,-0.16312070292725145,-1.2627302366002908,-1.0996095336730394,-524380128,-541797283.2,57.1058699923045,55.448869625752124,NaN,NaN,-19.050620329349286,-16.963913527906396
2003-03-13T09:30:00-05:00,82.17999,83.91,81.53,83.86,72161184,47361372.8,49.55852745704753,42.51511857384487,NaN,NaN,-20.488316460796156,-127.43086383968837,0.021761130405804074,-1.0724081206657843,-1.0941692510715884,-452218944,-519981827.2,62.82234016897312,56.61608698192374,NaN,NaN,-15.964871919067306,-16.82119329807224
2003-03-14T09:30:00-05:00,84.2,84.77,83.35001,84.13,63963808,47656338.4,50.521328134336244,43.13075219851883,NaN,NaN,38.07169723268244,-103.08486033993215,0.16370682880247855,-0.8895357150684902,-1.0532425438709687,-388255136,-498090150.4,67.50267673603477,58.088313558733134,NaN,NaN,-13.235709410902933,-16.308981314190913
2003-03-17T09:30:00-05:00,83.46001,86.95,83.22,86.78,88287008,49091273.6,58.827846140401896,44.12784570924109,NaN,NaN,126.36668943276892,-44.84474829362131,0.422812880476809,-0.5247264432749574,-0.9475393237517664,-299968128,-450335571.2,74.91994778600773,60.001274051698815,NaN,NaN,-7.827566854638065,-15.097350677111935
2003-03-18T09:30:00-05:00,87.15401,87.35001,86.28,87.28999,51081008,49669679.2,60.21221311498976,45.51764786937412,NaN,NaN,190.30146189042006,30.546925067352543,0.6042358896038399,-0.19224446174696652,-0.7964803513508064,-248887120,-382741891.2,81.39343744752492,62.30679417547436,NaN,NaN,-3.1123175689849476,-13.38520309023665
2003-03-19T09:30:00-05:00,87.28,88.16,86.67999,87.96001,49659200,50580624,62.0190710816405,46.69317209727025,NaN,NaN,196.7693153613847,106.20416949129199,0.7362937436310726,0.12388682818803431,-0.6124069154430383,-199227920,-317711449.6,85.31942118691765,64.55583677412321,NaN,NaN,1.287605651655812,-11.289087555680585
2003-03-20T09:30:00-05:00,87.33,88.59,86.35001,88.14999,67461632,52488740.8,62.53854491257249,47.74020496658973,NaN,NaN,172.67288905664472,144.83641059478018,0.7981745901626877,0.3853113222603213,-0.4128632679023664,-131766288,-253620918.4,88.00553839523366,66.74404789776744,NaN,NaN,4.958190144773557,-8.968047884187136
2003-03-21T09:30:00-05:00,88.8,89.88,87.92999,89.67,71263632,53003662.4,66.48787394800814,49.282093503121125,NaN,NaN,195.784986326185,176.37906841348067,0.8958861577844798,0.7069944293282333,-0.18889172845624647,-60502656,-188070422.4,90.01737741324041,68.87548905079163,NaN,NaN,9.427067840419674,-6.340174209243306
2003-03-24T09:30:00-05:00,88.02,88.14,86.35001,86.69,65430400,54742742.4,54.383089635839205,50.279359989065064,NaN,NaN,97.07631400215038,170.52099332735696,0.7217114942648821,0.7132476393748561,-0.008463854890025935,-125933056,-153263408,90.89106386164423,71.13813879016162,NaN,NaN,9.421787532630368,-4.088465388975639
2003-03-25T09:30:00-05:00,86.74001,88.25999,86.44,87.52,61177600,54956557.6,56.74517547328759,51.21917022180204,NaN,NaN,95.67183287483857,151.59506752424068,0.627754704711789,0.7762295259997103,0.14847482128792133,-64755456,-116437075.2,91.71704932922532,73.27335467051026,NaN,NaN,10.200384769599006,-2.0472010806078322
2003-03-26T09:30:00-05:00,87.56,87.85001,86.8,87.08,45757808,55354478.4,55.115858242193156,52.21115314808797,NaN,NaN,79.8648098996082,128.21416643188536,0.5065230816448307,0.7816286733439597,0.275105591699129,-110513264,-98694144,92.0892474101245,75.56094551329419,NaN,NaN,10.301307300845435,-0.28312845468593695
2003-03-27T09:30:00-05:00,86.39999,87.66,85.99001,87.14999,53291392,55427597.6,55.335546443242066,53.028560407823136,NaN,NaN,62.79409916464665,106.23840845348577,0.40594318514787464,0.7825345731339723,0.3765913879860977,-57221872,-83785260.8,92.39834911609293,77.90874560086193,NaN,NaN,10.446424689967538,1.2496648516931308
2003-03-28T09:30:00-05:00,86.47,87.28,86.25,86.71001,32600704,54863192.8,53.56077558232344,54.17761252170981,NaN,NaN,51.97343151526845,77.47609749130245,0.2901096344994117,0.7392284311103623,0.4491187966109506,-89822576,-89649244.8,90.89399138472362,80.18001900063675,NaN,NaN,10.05207236680455,2.5071516395661906
2003-03-31T09:30:00-05:00,85.35001,86.59,84.39999,84.74001,60785904,55755718.4,46.38693475839095,54.97285608742562,NaN,NaN,6.815207353840908,59.423876161640564,0.07248405453758217,0.5397238647829283,0.46723981024534617,-150608480,-94584329.6,89.57224870381066,82.47489706656128,NaN,NaN,7.459492264820426,3.214628871745367
2003-04-01T09:30:00-05:00,85.25,86.39,84.91,86.03999,53780096,56870953.6,51.046483912143266,55.9099477740297,NaN,NaN,19.466144333152357,44.18273845330333,0.010982773660441203,0.48096827732089764,0.46998550366045644,-96828384,-100998915.2,87.78538016470432,84.66629065030413,NaN,NaN,6.677066109571378,3.7092627628633683
2003-04-02T09:30:00-05:00,87.53999,88.77,87.5,88.12,50498096,57190598.4,57.42272280366402,56.47167601307374,NaN,NaN,84.26366348016452,45.06250916941458,0.1003158379338262,0.5953803010777392,0.495064463143913,-46330288,-88162320,88.28886237955768,86.48532795106017,NaN,NaN,8.073171928016075,4.332678357885183
2003-04-03T09:30:00-05:00,88.87,88.99001,87.64999,87.7,49009392,57570448,55.841098983207736,56.85165964513599,NaN,NaN,78.1092706043763,48.125543457360514,0.11973252294836145,0.6447301168293649,0.5249975938810034,-95339680,-95785881.6,86.02107773665925,87.80807087967621,NaN,NaN,8.691756148026524,4.955403756476803
2003-04-04T09:30:00-05:00,88.42999,88.59,87.62,88.22,36261808,56204403.2,57.40537348702961,56.750054455609394,NaN,NaN,73.46540292518671,52.42393773934416,0.15402483058520067,0.7175286321125043,0.5635038015273036,-59077872,-89636940.8,86.32615759817814,88.62280015197409,NaN,NaN,9.670150881199044,5.628939060008552
2003-04-07T09:30:00-04:00,90.34,90.85001,87.97,88.05,69821184,57644087.2,56.69825102385295,56.49905716338533,NaN,NaN,96.23147701850746,70.30719167227747,0.15145798908220087,0.7528262878800547,0.6013682987978538,-128899056,-85295056,86.54938356220593,88.99108201730847,NaN,NaN,10.260586204679262,6.290602937818653
2003-04-08T09:30:00-04:00,88.3,88.64999,87.71001,88.19,39741392,57225432,57.16619359179159,56.15242305696755,NaN,NaN,66.79700745683502,79.77336429701401,0.1453613774413932,0.7830700205995953,0.6377086431582021,-89157664,-83760912,86.63242203925662,89.08486779247553,NaN,NaN,10.875480777670006,6.945585486368846
2003-04-09T09:30:00-04:00,88.36,89.10001,86.77,87.03,55678000,56885562.4,52.138589922976145,55.40956912913924,NaN,NaN,37.43378630444993,70.40738886187108,0.054077697771859445,0.7053057653730264,0.6512280676011669,-144835664,-103461987.2,79.81774718711546,88.50002556332423,NaN,NaN,9.992378703202611,7.380841660202241
2003-04-10T09:30:00-04:00,87.095,87.63,85.71001,87.50999,42126000,55383803.2,53.94356400487984,54.513546990344366,NaN,NaN,-16.909036929530476,51.403727355089735,0.018722732009394005,0.6746314826129094,0.6559087506035154,-102709664,-104935984,79.31504410471018,87.7355731841435,NaN,NaN,9.745341230925469,7.718627313162702
2003-04-11T09:30:00-04:00,88.16,88.701,86.86,87.14999,47735504,54572388,52.3489753824887,54.36825311510504,NaN,NaN,18.44861332274907,40.400369434602204,-0.0333727059924398,0.6141928681129656,0.6475655741054054,-150445168,-123209443.2,73.1630907136401,86.4692893878575,NaN,NaN,9.100464059951927,7.91603256270402
2003-04-14T09:30:00-04:00,87.47,89,87,88.95,36947504,52005412.8,58.8921809030262,54.52161064580065,NaN,NaN,77.52492276197052,36.659058583294815,0.04469303643696332,0.7034318696516095,0.6587388332146462,-113497664,-120129164.8,73.53571530453968,85.17062267180852,NaN,NaN,10.419564986535208,8.273680051822762
2003-04-15T09:30:00-04:00,88.84,89.78,88.42,89.78,49957008,51949212.8,61.51629691501154,54.97878483671625,NaN,NaN,151.34602245985272,53.56886158389834,0.13824331335360607,0.8315429749066539,0.6932996615530478,-63540656,-115005763.2,74.17793424431767,83.89124315996517,NaN,NaN,12.323306541662113,8.852198121799812
2003-04-16T09:30:00-04:00,89.91,90.06599,88.03,88.25,51809296,52056717.6,54.597517104612955,54.92606845538559,NaN,NaN,91.38748406531097,64.35960113607055,0.08567016531652083,0.8003873681986988,0.714717202882178,-115349952,-109108620.8,74.93200221733274,82.64364695291087,NaN,NaN,11.889751077255514,9.286134258293485
2003-04-17T09:30:00-04:00,88.3,89.72,88.194,89.56,37483392,50557805.6,58.86360770221039,55.30484217823466,NaN,NaN,106.65992832095834,89.07339418616831,0.12531256229884136,0.8713579057557297,0.7460453434568883,-77866560,-104140000,75.57908575782822,81.54972512241834,NaN,NaN,12.852994004278134,9.795685650577006
2003-04-21T09:30:00-04:00,89.86,90.16,89.06,89.64999,32082800,48598764,59.147579949895196,56.21631683477068,NaN,NaN,136.392522086333,112.66217593888511,0.1425319557197866,0.9242102881066216,0.781678332386835,-45783760,-83207718.4,78.1392675962878,80.73308361473813,NaN,NaN,13.7063040711315,10.354345424941934
2003-04-22T09:30:00-04:00,89.10001,91.56,88.89,91.34,59860608,48320274.4,64.15241033438372,57.15245443635928,NaN,NaN,177.52660877550355,132.66251314159172,0.2465790551605982,1.0899021513375828,0.8433230961769846,14076848,-57692816,80.783743997935,80.23296674568319,NaN,NaN,16.03877802416497,11.16640722483094
2003-04-23T09:30:00-04:00,91.62,92.35001,91.24001,92.17999,44250608,47473924.8,66.35846801950993,57.790721951776845,NaN,NaN,220.45040143340023,146.4833889363012,0.3447854635772869,1.2743049256485932,0.9295194620713063,58327456,-33319193.6,82.91048923323858,79.84879723523183,NaN,NaN,18.676891463223402,12.23933354460129
2003-04-24T09:30:00-04:00,91.53,92.08,90.96001,91.36,50017296,47686899.2,62.326223668460266,58.2539451435806,NaN,NaN,160.79210109232247,160.3643123417035,0.3274610164069758,1.338845732580026,1.0113847161730503,8310160,-8587171.2,84.75430739109365,79.75831363912,NaN,NaN,19.66018180200458,13.299454724230332
2003-04-25T09:30:00-04:00,91.3,91.47,90.02,90.23,43923696,47218514.4,57.17063698945709,58.237178250896854,NaN,NaN,100.43068990766743,159.11846465904534,0.21810177945224396,1.2840119404883552,1.0659101610361112,-35613536,-136566.4,85.3364642312332,79.6876212557668,NaN,NaN,18.90521525961797,14.100277657857138
2003-04-28T09:30:00-04:00,90.44,92.19,90.3,91.78999,46469104,47911934.4,61.860982484941545,58.60594478383175,NaN,NaN,126.24706442481673,157.0893731267421,0.22796149059960547,1.3508620242856182,1.1229005336860127,10855568,11191299.2,86.10254256058673,79.65570404136542,NaN,NaN,19.736472848576874,14.90544839938853
2003-04-29T09:30:00-04:00,92.14,92.8,91.39999,91.78999,52340192,47489648.8,61.860982484941545,58.94128684762818,NaN,NaN,137.3820436144299,149.06046009452737,0.21195397868390953,1.3878430070408996,1.17588902835699,10855568,10547043.2,85.82790618451621,79.59823862316968,NaN,NaN,20.392614363412804,15.689329251391998
2003-04-30T09:30:00-04:00,91.91,92.57001,91.41,91.91,48912496,47246268.8,62.230023740431676,59.662103548874995,NaN,NaN,119.76622239576544,128.9236242870004,0.1877482045529073,1.4105742840481241,1.2228260794952168,59768064,10835164.8,85.84964377916175,80.02908837974442,NaN,NaN,21.03121045892183,16.452455138181975
2003-05-01T09:30:00-04:00,91.92,92.731,90.5,91.89999,50405808,47241654.4,62.17598199141447,60.25013340505604,NaN,NaN,94.80632069560515,115.72646820765695,0.1509473363848799,1.4115102499763168,1.260562913591437,9362256,11045584,85.86669342953007,80.49706333151728,NaN,NaN,21.54072340729389,17.179350605197964
2003-05-02T09:30:00-04:00,91.56,93.47,91.491,93.21001,50236608,47303015.2,66.30056950758029,61.24667584256263,NaN,NaN,121.81955043319404,120.00424031276228,0.19207846085798108,1.5006609896639134,1.3085825288059323,59598864,30088064,87.35192864510927,81.51055175519365,NaN,NaN,23.179628829419528,18.036533208658188
2003-05-05T09:30:00-04:00,93.47,93.78,92.5,93.03,35453296,47262589.6,65.24768351462706,61.700640314819836,NaN,NaN,121.43855159570896,119.04253774694071,0.18437166773010993,1.5390471134685697,1.3546754457384598,24145568,32746064,87.54861992234609,82.5114735136084,NaN,NaN,24.25129736226664,18.924356659173682
2003-05-06T09:30:00-04:00,93.03999,94.38,93,93.91,44584096,46000735.2,67.92899564848639,62.15869022435375,NaN,NaN,130.33834155666415,117.63379733538754,0.21368535832632896,1.6217821436463709,1.408096785320042,68729664,44320883.2,88.39497171701427,83.52697619022958,NaN,NaN,25.951190769878767,19.928190103560123
2003-05-07T09:30:00-04:00,93.42,94.14,92.972,93.39,41442000,46085765.6,64.74986876032492,62.88385819976175,NaN,NaN,110.14522251056272,115.709597358347,0.17483433731475673,1.6266397069634877,1.451805369648731,27287664,37824803.2,84.90680093918886,84.23946181321931,NaN,NaN,26.521495743104783,20.87009090920936
2003-05-08T09:30:00-04:00,92.52,93.33701,92.28,92.45,40754800,45339605.6,59.34316508479674,62.91811229851792,NaN,NaN,72.53519801930645,111.25537282308726,0.06809372873352149,1.5369225305656329,1.4688288018321114,-13467136,33258924.8,82.44423355582823,84.72982951307644,NaN,NaN,25.476004873738084,21.52807861842775
2003-05-09T09:30:00-04:00,92.83,93.8,92.61,93.73,33639696,44915290.4,63.77850442964247,63.24889261849986,NaN,NaN,94.69395597758908,105.83025393196627,0.0659167752793044,1.551224770931242,1.4853079956519375,20172560,25373664,78.22468607651561,84.73593083309272,NaN,NaN,25.851573159697637,22.14572069575202
2003-05-12T09:30:00-04:00,93.5,95.12,93.28,94.88,35680704,44312550.4,67.23672829968534,63.46920104459283,NaN,NaN,134.14718835537485,108.37198128389943,0.12094588066063272,1.6364903464777285,1.5155444658170958,55853264,31715203.2,79.14895167908695,84.619159953175,NaN,NaN,27.240375053750633,22.873528461180392
2003-05-13T09:30:00-04:00,94.534,95.189,94.25999,94.71001,39295904,44429970.4,66.23013831515277,63.46003463713875,NaN,NaN,137.78398074379226,109.86110912132506,0.12443158062964521,1.6710839416041523,1.546652360974507,16557360,21280742.4,73.61235258425961,83.95500733539077,NaN,NaN,28.0711251486794,23.61604227368025
2003-05-14T09:30:00-04:00,95.09,95.24001,93.91,94.50999,32232096,43543724.8,64.99710509177575,63.650811881661284,NaN,NaN,117.27428423498557,111.28692146620963,0.09322809730907555,1.6631874826108515,1.569959385301776,-15674736,12688262.4,69.31260153179134,82.85202834544063,NaN,NaN,28.409456401092015,24.30081572045336
2003-05-15T09:30:00-04:00,94.89,95.33,94.25,95.11,43932096,43149864.8,66.98287152473222,64.35168577703807,NaN,NaN,121.38185418720664,121.05625269978968,0.09276140399288924,1.6859111402928875,1.5931497362999982,28257360,21033161.6,71.07940056405873,81.83366665492815,NaN,NaN,29.25796997629901,25.008980614145596
2003-05-16T09:30:00-04:00,94.89,95.45,94.25999,94.87,38905904,43220990.4,65.38500751216156,64.60340185041093,NaN,NaN,111.21366422506323,124.36019434928451,0.05776550222881904,1.665356614086022,1.607591111857203,-10648544,14868940.8,67.96651019212031,80.53823577146626,NaN,NaN,29.53257354822827,25.655208176157405
2003-05-19T09:30:00-04:00,94.14999,94.8905,92.33,92.64999,43235296,43778615.2,52.830746033108156,63.95838496099426,NaN,NaN,23.450918972952422,102.22094047280002,-0.12352936724995467,1.4531794027947598,1.5767087700447144,-53883840,-7078480,58.19434420130812,78.56440991552283,NaN,NaN,25.853527184013487,25.683539462993988
2003-05-20T09:30:00-04:00,92.82001,93.03,91.597,92.46001,55450896,43558129.6,51.912160229056056,63.22139471018172,NaN,NaN,-37.19075889062463,67.22599254591664,-0.25718449828150103,1.2552281471928382,1.5124126454743392,-109334736,-32256899.2,49.41633469726675,75.96203069538747,NaN,NaN,22.60530911917086,25.243792271019256
2003-05-21T09:30:00-04:00,92.11,92.88,91.91,92.64999,49848400,43838019.2,52.796045810796876,62.551399268709034,NaN,NaN,-32.49605984612295,37.27192372969495,-0.32913920632731575,1.1009886375651945,1.4301278438925102,-59486336,-41019219.2,46.772229825650136,73.16956900939603,NaN,NaN,20.187040687254783,24.521399187624333
2003-05-22T09:30:00-04:00,92.95,94.05,92.67999,93.57001,38456704,43259989.6,56.925174140187366,61.88172817103811,NaN,NaN,22.924158533915367,17.580384599036694,-0.311309677763532,1.0409907466880952,1.3523004244516272,-21029632,-50876617.6,43.92484437682875,70.06763441880457,NaN,NaN,19.255137193817447,23.76907604565192
2003-05-23T09:30:00-04:00,93.53,93.98,93.14,93.75999,26157696,42371689.6,57.74709846992171,61.345972096416304,NaN,NaN,29.049340375082952,1.1475198290406419,-0.2840196920181257,0.9972758094289702,1.281295501447096,5128064,-47721296,45.077434792138945,67.0339783380755,NaN,NaN,18.716880489819186,23.0473338233901
2003-05-27T09:30:00-04:00,93.3,95.84,93.17999,95.39999,43732608,42234864.8,64.11307708873325,61.073406485005364,NaN,NaN,109.92864756437551,18.443065547325258,-0.1590464339198594,1.0824874590472717,1.2415338929671311,48860672,-27172393.6,51.99733104668241,64.43414686162322,NaN,NaN,20.175275994267697,22.637039847801187
2003-05-28T09:30:00-04:00,95.85001,96.47,95.42999,95.67,37749808,41505345.6,65.04679633289791,61.094615597332,NaN,NaN,165.80898003947487,59.04301333334515,-0.06646556010719373,1.158451942833139,1.2249175029403327,86610480,12016649.6,61.865336901608025,62.78832800179601,NaN,NaN,21.64600930322466,22.495464055718827
2003-05-29T09:30:00-04:00,95.88,96.82001,95.08,95.42,50978400,41608640.8,63.40194182073765,61.38452822132779,NaN,NaN,138.47936604668104,93.23809851190596,-0.03207518251360009,1.1848235247983325,1.2168987073119326,35632080,31040332.8,65.56589664804143,61.58273250838266,NaN,NaN,22.39357605664285,22.4809086272794
2003-05-30T09:30:00-04:00,95.901,97.09,95.56,96.95,52537600,41715230.4,68.63012166732672,61.73107230973381,NaN,NaN,165.0409289037628,121.66145258587544,0.07770826639079575,1.3140340403004274,1.2363257739096316,88169680,52880195.2,69.25455373824353,60.94200876993466,NaN,NaN,24.7115241594297,22.79956798901516
2003-06-02T09:30:00-04:00,97.53,98.45,96.67,97.35001,50700608,41738430.4,69.84307376600316,61.91723984304223,NaN,NaN,192.20017082820428,154.2916186764997,0.15670116719098437,1.4322022328983621,1.2755010657073778,138870288,79628640,73.06080490048726,60.507141142891825,NaN,NaN,26.991386076014575,23.39839914430079
2003-06-03T09:30:00-04:00,97.14999,97.84,96.85001,97.75,39551808,41943356,71.04856452748875,62.26141314392338,NaN,NaN,165.6521008986381,165.43630934335224,0.21189578055128466,1.5403707913964837,1.328475010845199,178422096,105540924.8,76.14214660698326,60.687840715943516,NaN,NaN,29.248910770168873,24.234186519424803
2003-06-04T09:30:00-04:00,97.66,99.35001,97.569,99.16,49432704,42185786.4,74.86311170203402,62.96612790179897,NaN,NaN,192.14389617941288,170.70329257133983,0.3132542208430753,1.720042786899043,1.4067885660559678,227854800,133789788.8,78.9666589295922,61.37741624435786,NaN,NaN,32.50712954839365,25.41603552356321
2003-06-05T09:30:00-04:00,98.584,99.64999,98.27,99.64999,46407104,42434041.6,76.04433993230775,63.613375645197216,NaN,NaN,175.3518000809936,178.07777937820234,0.3788070179635932,1.8802973385104593,1.5014903205468662,274261904,181515753.6,82.69433957032291,62.207054744805305,NaN,NaN,35.568204671879386,26.86634540189409
2003-06-06T09:30:00-04:00,100.39999,101.39999,99.13,99.25999,60397600,43416181.6,73.09991003732229,64.16444011128013,NaN,NaN,169.75078796619263,179.0197511906883,0.36145886186738907,1.9533138978811024,1.5918550360137134,213864304,206654678.4,84.27519570417616,63.37196085280929,NaN,NaN,37.23025048655771,28.34690327113175
2003-06-09T09:30:00-04:00,98.769,99.10001,97.77,98.25,38388800,43653636.8,65.97542215825541,65.10334554879064,NaN,NaN,98.16744304023905,160.21320563309527,0.2526692621102131,1.9076916136514797,1.6550223515412665,175475504,213975721.6,84.71315425323682,65.2661615708042,NaN,NaN,36.50664252932861,29.512580308017018
2003-06-10T09:30:00-04:00,98.46001,99.25999,98.19,99.25,30105504,43374876.8,69.17843784527462,66.33665109280626,NaN,NaN,102.84512641611475,147.6518107365906,0.21996584930583052,1.9299796631735546,1.710013813867724,205581008,219407504,85.04593718025686,67.81113317673206,NaN,NaN,36.87115526778182,30.563805302269135
2003-06-11T09:30:00-04:00,99.16,100.39,98.71001,100.3,37617296,43290946.4,72.14370394236744,67.71862667363273,NaN,NaN,115.0662050924564,132.2362725191993,0.23935568791390072,2.0092084237601,1.7698527358461993,243198304,222476204.8,85.24140933837492,70.55893171335526,NaN,NaN,38.127978448384404,31.644401465999888
2003-06-12T09:30:00-04:00,100.754,100.89999,99.62,100.61,36488608,43503772,72.97051056379757,68.86472213246203,NaN,NaN,116.61557523147731,120.48902754929604,0.24260950865876874,2.07311462166966,1.8305051130108914,279686912,223561206.4,85.31450218828283,73.51533584274485,NaN,NaN,39.3984457856976,32.75212208309956
2003-06-13T09:30:00-04:00,100.61,100.74899,98.95,99.56,48635296,43738932,65.84204321691355,69.44293247153287,NaN,NaN,88.08463800464453,104.15579755698641,0.14823403641637078,2.015797658531355,1.867563622114984,231051616,226998668.8,85.55852687590043,76.40684242015638,NaN,NaN,38.261818930988866,33.53922163279803
2003-06-16T09:30:00-04:00,99.96001,101.7,99.8,101.66,36338608,43610567.2,71.77981289427186,69.99055645764277,NaN,NaN,111.47935822271744,106.81818059348211,0.19830151859826084,2.11544052036281,1.9171390017645493,267390224,245381612.8,86.81985232943144,78.89416536892416,NaN,NaN,39.2389536212473,34.35346905971936
2003-06-17T09:30:00-04:00,102.07001,102.179,101.23,101.66,36818192,43289712,71.77981289427186,70.47148621202662,NaN,NaN,118.877981229971,110.02475155625334,0.20180936284943174,2.169400705326339,1.9675913424769074,267390224,257743456,87.60391887370733,80.73263550978838,NaN,NaN,39.99035752027207,35.15873883979832
2003-06-18T09:30:00-04:00,101.28999,102.14,101,101.57001,35550096,42294672,71.16500102021622,71.02599044056082,NaN,NaN,107.70941555758928,108.55339364927993,0.16974772513689285,2.179775998898023,2.0100282737611304,231840128,255471820.8,86.58459239423819,82.23397092023103,NaN,NaN,40.404089742875065,35.908074683094995
2003-06-19T09:30:00-04:00,101.64,101.73,99.84,100.02,43559904,41980247.2,61.40851451698017,70.5101613583932,NaN,NaN,72.80031083695941,99.79034077037633,0.023510594324039236,2.0394165166661793,2.01590592234214,188280224,237190483.2,78.65302092036133,82.905290004668,NaN,NaN,37.646691978728846,36.156448582471256
2003-06-20T09:30:00-04:00,100.39,100.5,99.42,99.44,41551696,42134996.8,58.19352311487533,69.67805059759836,NaN,NaN,44.074968159001784,90.98840680124779,-0.1247733448950139,1.8599392412233726,1.9847125861183865,146728528,220325865.6,72.09217323147666,82.8361020283101,NaN,NaN,34.35967683678091,35.899766904515495
2003-06-23T09:30:00-04:00,99.45,99.66,97.92,98.42,34317808,42543002.4,52.94394520126478,68.38486350286807,NaN,NaN,-6.220991981391601,67.44833676042597,-0.2943622832360311,1.6167597320733478,1.9111220153093789,112410720,189329964.8,61.87618215855169,81.81710456770784,NaN,NaN,29.856846503466834,35.036492561508545
2003-06-24T09:30:00-04:00,98.22301,99.09,98.02,98.52,36220896,42167416.8,53.38789408801068,66.85091938758069,NaN,NaN,-22.22006790249107,39.22872693393356,-0.39626795523737823,1.4157870712626561,1.8120550265000344,148631616,165578243.2,55.397882040446774,80.13362050419745,NaN,NaN,26.395932811755667,33.802126882972416
2003-06-25T09:30:00-04:00,98.53,99.44,97.53,97.53,47856800,42672766.4,48.508609370658235,64.88408149032001,NaN,NaN,-50.454746268424785,7.595894568730751,-0.5190670821568242,1.1632211738040041,1.6822882559608283,100774816,139365180.8,49.26727541341412,77.74597306441827,NaN,NaN,21.872858803320394,32.09794572873641
2003-06-26T09:30:00-04:00,97.78,98.979,96.96001,98.8,33543504,41801021.6,54.2810895735911,63.53988002862492,NaN,NaN,-58.32420789963003,-18.629009178587136,-0.5031135095917769,1.0533963689711072,1.5565098785628841,134318320,128572800,46.96291949244163,75.0808104778658,NaN,NaN,19.70602995531512,30.327672046819085
2003-06-27T09:30:00-04:00,98.74699,99.19,97.58,97.66,54211104,41884696.8,48.97374857384797,62.325474772595825,NaN,NaN,-73.82621694063211,-42.20924619851391,-0.5536826180550345,0.8644066059940911,1.4180892240491256,80107216,115248537.6,44.21340760738819,72.18797143173376,NaN,NaN,16.120958165965384,28.298141492411414
2003-06-30T09:30:00-04:00,98.22,98.67,97.47,97.63,33863696,41042851.2,48.838419495752916,60.872616319058565,NaN,NaN,-90.66557517438815,-59.09816283711323,-0.5711963764785648,0.7040937534509197,1.2752901299294845,46243520,102015097.6,41.60791002391372,69.08525520628066,NaN,NaN,13.25556017055966,26.14920130357545
2003-07-01T09:30:00-04:00,97.25301,98.85001,96.42999,98.53,51416400,41636080.8,53.03156385485868,59.50746345566508,NaN,NaN,-93.10905503934585,-73.27596026448418,-0.5064212822955116,0.6422635270600949,1.1486848093556066,97659920,91820758.4,39.66856880008431,65.83005231068849,NaN,NaN,12.069970949622736,24.137882681582205
2003-07-02T09:30:00-04:00,98.77,99.78999,98.57001,99.77,34678000,40898345.6,58.12399289191634,58.44699790767357,NaN,NaN,-1.4206322545317005,-63.469137461705564,-0.37061250473263296,0.6854191784398154,1.0560316831724483,132337920,98133379.2,41.48728072601294,62.699536491954916,NaN,NaN,12.649621671366065,22.496702537265612
2003-07-03T09:30:00-04:00,99.07001,99.85001,97.90401,98.74001,30868400,40121410.4,52.98510987569054,57.52864552615764,NaN,NaN,-36.31051361974107,-59.06639860572777,-0.34142126893559566,0.6292550970029538,0.9706763659385494,101469520,91563619.2,40.13137705976455,59.45474007651664,NaN,NaN,11.50457471401717,20.926398562515836
2003-07-07T09:30:00-04:00,99.653,100.89999,99.64999,100.7,31426608,38672860.8,60.196796519156536,56.701287213649394,NaN,NaN,65.28941788129534,-31.24327164134229,-0.18899438901319576,0.7344333796720548,0.9234277686852506,132896128,102121401.6,43.336363478099145,56.34877658713577,NaN,NaN,12.961467615225766,19.78855128433154
2003-07-08T09:30:00-04:00,100.5,101.28999,100.17,101.14999,33158192,38411330.4,61.65120640864947,55.97781532181923,NaN,NaN,84.691138576019,3.828071108739144,-0.06325017966567525,0.8443650441031565,0.9076152237688317,166054320,126083561.6,49.89276180612543,53.655122510879906,NaN,NaN,14.596769672204216,19.04686819688478
2003-07-09T09:30:00-04:00,100.92,101.39999,100.03,100.58,36629296,38737520,58.7241275527018,55.089181502711064,NaN,NaN,65.43259299698454,35.53640071600522,-0.02577045132880118,0.8754021596078303,0.9011726109366315,129425024,132436582.4,51.49521184132396,51.148738185671746,NaN,NaN,15.003305822796733,18.469216429157918
2003-07-10T09:30:00-04:00,99.84,100.03999,98.63,99.3,49815600,39347435.2,52.67584875674163,54.465419662694025,NaN,NaN,-16.720724208727066,32.47638232516615,-0.09083038242975305,0.7876346328994401,0.8784650153291932,79609424,121890883.2,48.71046274271031,49.00998403012524,NaN,NaN,13.393444034699536,17.744106087092433
2003-07-11T09:30:00-04:00,99.39,100.45,99.39,100.24001,40076400,39526824.8,56.240330914034836,54.32590593406256,NaN,NaN,28.32140378515968,45.4027658061463,-0.07486676378176393,0.7848815606019883,0.8597483243837523,119685824,125534144,49.72203401561168,47.412116943277745,NaN,NaN,13.200416281080676,17.095007543376468
2003-07-14T09:30:00-04:00,101.2,101.89999,99.91499,100.73,42141504,39202135.2,58.01550900876762,54.68816049174133,NaN,NaN,72.77598335218143,46.900078900323514,-0.03750458167887183,0.8128675972851624,0.8503721789640343,161827328,131320384,51.36272871093994,46.661155982734044,NaN,NaN,13.59910966267068,16.5955935604185
2003-07-15T09:30:00-04:00,101.38,101.46001,99.95,100.50999,63620400,40566224.8,56.89937766355483,54.93898074713734,NaN,NaN,62.719815711415485,42.50581432740281,-0.03391384266793507,0.8079798756291154,0.8418937182970505,98206928,117750905.6,47.45201414036878,46.09359398987133,NaN,NaN,13.590663297965294,16.16631780863947
2003-07-16T09:30:00-04:00,100.81,100.87,99.23,99.92,40194192,40735024.8,53.9044735658751,55.32439961822426,NaN,NaN,31.706924931870148,35.76068071437993,-0.07521258514955742,0.7478779868601038,0.8230905720096612,58012736,103468448,43.68206361261073,45.694650289813936,NaN,NaN,12.706042152986202,15.671992714974717
2003-07-17T09:30:00-04:00,99.14999,99.88,98.16,98.5,48913600,41403200,47.433246601061384,54.83526797732928,NaN,NaN,-39.007923415465754,31.303240873032202,-0.19528011110295407,0.5789904331309685,0.7742705442339226,9099136,89366390.4,40.27933353348328,45.21725129274548,NaN,NaN,9.907782959815762,14.848534178523439
2003-07-18T09:30:00-04:00,99.02,99.8,98.46001,99.50999,35701696,41010289.6,51.85996259018633,55.041426121353446,NaN,NaN,-5.3328143949625675,24.572397237007753,-0.20290287864425616,0.5206419459286025,0.7235448245728586,44800832,74389392,36.98423799678354,44.70088203484516,NaN,NaN,8.89028262515918,13.997355385185687
2003-07-21T09:30:00-04:00,99.45,99.494,97.85001,98.28,35092304,40687320,46.70203223843015,54.888827031544686,NaN,NaN,-54.73720108748899,-0.9302396509263318,-0.2821356858541352,0.3708752172551897,0.6530109031093249,9708528,43965632,31.370194944183993,43.96961667200731,NaN,NaN,6.360633470839905,12.906395111707718
2003-07-22T09:30:00-04:00,98.69,99.41,97.91,99.17,50006704,41471764.8,50.53564903139491,54.71054740129727,NaN,NaN,-33.77434137726794,-20.229071068663018,-0.2661629105162594,0.32030726496400064,0.58647017548026,59715232,36267292.8,30.124125210312485,43.28787070130933,NaN,NaN,5.458631666277211,11.842428905217647
2003-07-23T09:30:00-04:00,99.21001,99.45,98.28,99.24001,37298304,41525635.2,50.83522492263574,54.18992111777722,NaN,NaN,-23.807635895773966,-31.331983234191842,-0.24307764679462174,0.28262311698698284,0.5257007637816046,97013536,44067452.8,33.02692140151575,42.683559320988095,NaN,NaN,4.831551551340489,10.84087499752091
2003-07-24T09:30:00-04:00,99.99001,100.34,98.37,98.49001,41173296,41191460,47.51525979261303,53.79921754041454,NaN,NaN,-22.351062316445685,-28.00061101438783,-0.2685216801972422,0.1900486635350518,0.458570343732294,55840240,53415673.6,36.43505861428242,42.41953657488222,NaN,NaN,3.3089552036077725,9.764886455533318
2003-07-25T09:30:00-04:00,98.66,100.28999,98.03999,100.23,43325104,41680540,54.87782232544934,53.4192908122926,NaN,NaN,10.016168525003252,-24.930814430394662,-0.16353175863852404,0.25415564543413893,0.41768740407266297,99165344,64288576,40.24396082712419,42.19865067124116,NaN,NaN,4.276181905302369,8.980785805500325
2003-07-28T09:30:00-04:00,100.37,100.98,99.67,99.86,34416304,40690800,53.16977300889337,52.81347414088145,NaN,NaN,58.16345351591268,-2.350683509714328,-0.11657401673302037,0.2719698831563875,0.38854389988940785,64749040,75296678.4,43.908591183508506,41.7712099124828,NaN,NaN,4.538424782843525,8.34616280226364
2003-07-29T09:30:00-04:00,100.14,100.27,98.67999,99.39999,53569808,41676105.6,51.042676438284495,52.26479906128021,NaN,NaN,-12.46340337795527,1.9115040901482054,-0.1139298553442658,0.2461315807090756,0.3600614360533414,11179232,65589478.4,41.49212748520696,41.05670388704588,NaN,NaN,4.123466526060373,7.742920477091745
2003-07-30T09:30:00-04:00,99.60001,99.78999,98.92999,99.16,28417600,40526165.6,49.92062448261066,52.067997327413714,NaN,NaN,-36.68384482447587,-0.6637376955921767,-0.12489836745681837,0.20393847673231846,0.32883684418913683,-17238368,42739097.6,36.41215558650746,40.17825337588853,NaN,NaN,3.461275581260565,7.131256920544433
2003-07-31T09:30:00-04:00,99.98,100.94,99.05,99.39,59112000,41747865.6,51.03162583335743,51.69594696450819,NaN,NaN,12.862650656596276,6.379004899016215,-0.11354571960772236,0.1869046946794839,0.30045041428720626,41873632,39945776,35.834578327022655,39.186292255275035,NaN,NaN,3.218096727799086,6.5722340358665265
2003-08-01T09:30:00-04:00,99.19,99.53,98.24001,98.50999,49324496,42670670.4,46.75746288912529,50.89180081310516,NaN,NaN,-93.67329708160474,-14.358888222305385,-0.1593771770382953,0.10122894298933716,0.26060612002763245,-7450864,18622534.4,31.700768797721224,37.78186654718798,NaN,NaN,1.7890415089666485,5.888920817737972
2003-08-04T09:30:00-04:00,98.31,99,97,98.50999,55544400,43876560,46.757462889125286,50.167378329217335,NaN,NaN,-139.85183632383456,-53.961946190254835,-0.18212452792522602,0.03295046012109992,0.21507498804632594,-7450864,4182553.6,29.240769242066477,36.481063340166386,NaN,NaN,0.6173736646702899,5.135842653014017
2003-08-05T09:30:00-04:00,98.411,98.75999,96.34,96.42,61736704,45305485.6,37.992738960990316,49.03082585743986,NaN,NaN,-215.06521925322897,-94.48230936530958,-0.3221739348854845,-0.18764243056052976,0.13453150432495478,-69187568,-11890806.4,26.75220132711084,35.271787462630684,NaN,NaN,-3.241327912503994,3.9391040007971587
2003-08-06T09:30:00-04:00,96.69,98.06,96.423,96.98,51180000,46033020.8,41.17459642556374,48.58377941633288,NaN,NaN,-188.63864719110683,-124.87326983863576,-0.35855390623363564,-0.3136608784670898,0.04489302776654587,-18007568,-12044646.4,26.728754358258044,34.30388895011459,NaN,NaN,-5.499696102475828,2.590703986043875
2003-08-07T09:30:00-04:00,97.17,98.07001,96.758,98,43546800,45719580.8,46.5541809747551,48.20479501523065,NaN,NaN,-125.90869226973068,-152.62753842390117,-0.297875443301289,-0.32745127636006544,-0.029575833058776396,25539232,-15311526.4,26.20354100390624,33.53383916490907,NaN,NaN,-5.797398684210734,1.392403604578931
2003-08-08T09:30:00-04:00,98.32001,98.547,97.75999,98.28,27359504,45083736,47.96105385544042,48.29472513073138,NaN,NaN,-69.32105288776813,-147.75708958513383,-0.2260896522253764,-0.31218789834049687,-0.08609824611512049,52898736,-3241606.4,31.554799532770645,33.54702520695098,NaN,NaN,-5.620602454788257,0.3905455960979043
2003-08-11T09:30:00-04:00,98.25999,99.03999,97.84,98.64999,34633904,44708356,49.840003983208696,48.24503619871808,NaN,NaN,-36.01669507350273,-126.99006133506745,-0.14484687722475126,-0.26715684264605954,-0.1223099654213083,87532640,15755094.4,39.046455866376675,34.18433453952699,NaN,NaN,-4.926472188366211,-0.3690283731112549
2003-08-12T09:30:00-04:00,98.71001,99.59,98.42,99.55,43347008,43694686.4,54.17447625731531,48.4835541511952,NaN,NaN,36.99609954810879,-76.57779757479992,-0.02778075491586407,-0.1570359090661384,-0.12925515415027433,130879648,55768537.6,51.17009836759475,35.480275751389776,NaN,NaN,-3.0243678440904023,-0.7483625832511331
2003-08-13T09:30:00-04:00,99.82001,99.849,98.53,99.03999,36155504,43492752,51.46072120849097,48.76537282375791,NaN,NaN,38.68664946581877,-31.112738243414793,0.015681083521987826,-0.10965379974778955,-0.12533488326977738,94724144,78314880,56.42890811543956,36.908407858615284,NaN,NaN,-2.2043353612944276,-0.9563586944001752
2003-08-14T09:30:00-04:00,99.10001,99.75,98.45,99.31,36247392,42859441.6,52.80852090149733,48.61756557918991,NaN,NaN,39.39437476753801,1.9478751640389533,0.06047415516298252,-0.049742189316049235,-0.11021634447903175,130971536,99401340.8,60.69262119737305,38.3690264564902,NaN,NaN,-1.137701621516723,-0.9822648268453963
2003-08-15T09:30:00-04:00,99.36,99.78999,99.12,99.62,12567199,41702716.75,54.37491922148787,48.70364745151809,NaN,NaN,72.9752803012795,30.407141801848486,0.1061677266967567,0.022493313891914113,-0.08367441280484259,143538735,117529340.6,63.95797049277862,39.801124978580916,NaN,NaN,0.19975750583887367,-0.8134044936047863
2003-08-18T09:30:00-04:00,99.92999,100.60001,99.74001,100.48,22882096,41092206.35,58.49115901743986,49.235681921457754,NaN,NaN,135.1354698054133,64.63757477763168,0.18488811896792437,0.14743573590506287,-0.03745238306286149,166420831,133306978.8,66.5615925085519,41.59180105167699,NaN,NaN,2.5816696068056375,-0.3283939078318686
2003-08-19T09:30:00-04:00,100.687,100.94,100,100.86,37456800,40464711.15,60.19980484756968,49.969909090383396,NaN,NaN,146.62644330953776,86.56364352991747,0.24912855354471478,0.27395830886803196,0.024829755323317194,203877631,147906575.4,68.80706859304081,43.905723409286516,NaN,NaN,5.0863575989046135,0.4451420217019145
2003-08-20T09:30:00-04:00,100.28999,100.89,100.164,100.45,23206192,39760105.55,57.45190547642209,50.428500493459445,NaN,NaN,121.99253665983154,103.22482096872004,0.2499418726462352,0.3372570961311112,0.087315223484876,180671439,165096034.4,71.25464656892802,46.43572828370833,NaN,NaN,6.465469089025176,1.3051887456052376
2003-08-21T09:30:00-04:00,101.05,101.52,100.39999,100.77,46550496,40028965.55,59.02402598084814,51.30468357143964,NaN,NaN,136.3950286422006,122.62495174365256,0.25697489552512937,0.4085338428912877,0.15155894736615833,227221935,184346114.2,73.7396963815751,49.43850882541218,NaN,NaN,8.072876101826576,2.272001225065429
2003-08-22T09:30:00-04:00,101.75,101.81799,99.73,99.77,52045008,40464960.75,52.4962037315893,51.71459363161564,NaN,NaN,92.54428371440405,126.53875242627745,0.18271261154827428,0.37994971180150117,0.19723710025322688,175176927,190673752.6,74.51947203346434,52.6727018819406,NaN,NaN,7.652543676090448,3.0406501466404317
2003-08-25T09:30:00-04:00,99.71001,100,99.28,99.92999,23485808,39918435.95,53.38447896963473,52.8140036322331,NaN,NaN,42.694957659197065,108.0506499970342,0.13500036867589427,0.3659875610980947,0.23098719242220045,198662735,197122133.4,75.32363634575705,56.14209009755819,NaN,NaN,7.551316157783976,3.6850310053752238
2003-08-26T09:30:00-04:00,99.5,100.39,98.83,100.11,45076608,39493775.95,54.41725974361883,53.759908154951326,NaN,NaN,43.72807991834886,87.47097731879641,0.10740026830178895,0.36523752779943663,0.2578372594976477,243739343,205094475.8,76.31872418582634,59.68423079952735,NaN,NaN,7.745630263895603,4.2651166137352785
2003-08-27T09:30:00-04:00,100.05,100.36,99.57001,100.14,18987808,39022286.35,54.59779575616081,54.33445206790888,NaN,NaN,57.16322566152794,74.5051151191357,0.08403483739167611,0.36288080623724284,0.2788459688455667,262727151,221505618.2,78.26201212032029,63.402693022128354,NaN,NaN,7.954951643276919,4.792235903669798
2003-08-28T09:30:00-04:00,100.39999,101,99.66,100.75999,27426400,37438006.35,58.275701331377775,55.0712126019044,NaN,NaN,84.0808699818448,64.04228338706454,0.1020087208431329,0.40635686989948283,0.30434814905634994,290153551,234091941.4,79.64181147987117,66.8374795897784,NaN,NaN,9.132910457087368,5.412332268443737
2003-08-29T09:30:00-04:00,100.61,101.48,100.48,101.44,28721200,36407841.55,61.919402019629,55.934026747363,NaN,NaN,114.9914109750754,68.5317088391988,0.14854890266315307,0.49003427738529126,0.3414853747221382,318874751,262831506.2,82.39041286870784,69.93347651851634,NaN,NaN,11.211173324613023,6.240738133610778
2003-09-02T09:30:00-04:00,101.64,102.88,101.05,102.8,50860608,36173651.95,67.94800878522167,56.917850499356305,NaN,NaN,166.4663098758226,93.28597928252391,0.2536109738662632,0.6584990920549672,0.40488811818870396,369735359,297046031,84.9887958842576,72.34909776970653,NaN,NaN,15.052224202817921,7.499521857783227
2003-09-03T09:30:00-04:00,103.03,103.7,102.78,103.36,44923904,35333011.95,70.05051079180735,58.24569261245034,NaN,NaN,206.46694110454158,125.83375151976244,0.3382137424341784,0.827655296231427,0.4894415537972486,414659263,331230015,87.04549869464977,74.53599709679297,NaN,NaN,18.954794506786023,9.13598937906934
2003-09-04T09:30:00-04:00,103.10001,103.55,102.75999,103.41,28404400,34194231.95,70.23822918693077,59.49067177569559,NaN,NaN,182.58015362286943,150.91713711203073,0.37224013346552787,0.9547417206291584,0.5825015871636305,443063663,367297317.4,88.79057706169627,76.54299394424463,NaN,NaN,22.15810711923894,10.996291913379283
2003-09-05T09:30:00-04:00,102.94,103.549,102.39999,102.83,31654496,33599616.75,65.1379475821921,60.25945951574589,NaN,NaN,147.57154444762674,163.61527200518714,0.3317289724746756,0.997162802756975,0.6654338302822994,411409167,391548440.6,89.78680504774798,78.38791069817101,NaN,NaN,23.447409492112715,12.775022996055487
2003-09-08T09:30:00-04:00,103.03999,103.88,102.92999,103.67999,32655392,33864411.15,68.72241265983249,60.990263347345355,NaN,NaN,152.28200994238415,171.07339179864888,0.33712532356177904,1.0868404847345232,0.7497151611727442,444064559,416586402.2,90.70527282249563,80.11245929202414,NaN,NaN,25.67841095458189,14.61836413298783
2003-09-09T09:30:00-04:00,103.37,103.46001,102.67999,103,35083504,33886891.15,63.13022032332485,61.19957873847073,NaN,NaN,109.9577944778989,159.77168871906414,0.27260460210842474,1.090470913808275,0.8178663116998504,408981055,424435541.4,90.97915101887112,81.69617946529773,NaN,NaN,25.876412981786384,16.226656825673338
2003-09-10T09:30:00-04:00,102.53999,102.8,101.55,101.96001,45944704,34016775.95,55.66902153873783,61.072229885778995,NaN,NaN,52.785105404202,129.03532157899625,0.14404781693470592,0.9979260828682328,0.8538782659335269,363036351,414110959,87.33380835696524,82.8446910215861,NaN,NaN,23.63795000857509,17.285412994659303
2003-09-11T09:30:00-04:00,102.10001,102.75999,101.84,102.25999,38797008,34148851.15,57.23890684880241,60.944721376347154,NaN,NaN,54.60697373943792,103.44068560230994,0.06727906758768876,0.9379771004181379,0.8706980328304491,401833359,405864898.2,84.42428018861867,83.60787557923207,NaN,NaN,22.299216519409576,18.0016706410522
2003-09-12T09:30:00-04:00,101.91,102.64,101.35001,102.45,42441200,34458541.55,58.24749074613777,61.35552759167205,NaN,NaN,40.73864392978099,82.07410549874079,0.019823029396773495,0.895476819576416,0.8756537901796425,444274559,412437976.6,84.85734137581515,84.34629481797141,NaN,NaN,21.504472514498634,18.502070908687404
2003-09-15T09:30:00-04:00,102.52,102.63,101.95,102.09,21321904,34896276.8,55.57301939115764,61.511851907495114,NaN,NaN,39.24021268381188,59.46574604702634,-0.041918179353878426,0.8232560659872945,0.8651742453411729,422952655,408215595.8,83.25597821638554,84.91289066587345,NaN,NaN,20.05073079658832,18.72330803553039
2003-09-16T09:30:00-04:00,102.23199,103.64,102.17,103.58,37946496,35649496.8,63.120675991296494,62.133524496614946,NaN,NaN,83.13596720664657,54.101380592775875,0.008781737996201744,0.8761514178364251,0.8673696798402234,460899151,418599215,84.05297422480848,85.46533709722932,NaN,NaN,21.096071354646693,19.062274223975578
2003-09-17T09:30:00-04:00,103.48,103.785,103.05,103.38,32072400,35380276.8,61.60771120696714,62.63423274310111,NaN,NaN,90.60167617278066,61.66469474649161,0.01942793418536426,0.8916545975719288,0.8722266633865645,428826751,431757295,85.02565988264918,85.94845479453853,NaN,NaN,21.469530430998628,19.406167967836012
2003-09-18T09:30:00-04:00,103.39999,104.7,103.17,104.60001,30295008,35734717.6,66.83062174862783,63.245298487190404,NaN,NaN,123.7092228010669,75.48514455881741,0.09498858333000038,0.9909623925490649,0.8959738092190646,459121759,443214975,85.83582395782273,86.39088425724935,NaN,NaN,23.510787675089777,19.992542211729408
2003-09-19T09:30:00-04:00,104.27,104.60001,103.39999,103.67,34381600,35126272.8,60.1167507254064,63.11653768046022,NaN,NaN,101.0262330962734,87.54266239211589,0.06984958814210263,0.9832857943966928,0.9134362062545902,424740159,439308095,84.16370111263647,86.51754770324426,NaN,NaN,23.018593417144213,20.42483524107438
2003-09-22T09:30:00-04:00,102.85001,102.96001,102.03,102.55,36700608,34359052.8,53.1869934742948,62.06217944396544,NaN,NaN,15.994427848938003,82.89350542514111,-0.02937208485837106,0.8767211001816264,0.9060931850399975,388039551,432325474.2,81.12203522612734,86.24135051337781,NaN,NaN,20.213924829076195,20.394705182217496
2003-09-23T09:30:00-04:00,102.59,103.28999,102.36,102.94,32513200,34810422.4,55.1267247121857,60.99619472399247,NaN,NaN,31.756029725772702,72.61751792896635,-0.07339436374964348,0.8143502303529431,0.8877445941025865,420552751,424256194.2,77.6304719330773,85.56884860183693,NaN,NaN,18.607172734332227,20.13934340394817
2003-09-24T09:30:00-04:00,103.118,103.22,101.07001,101.11,41717504,34642467.2,45.58243319410963,59.23506643879096,NaN,NaN,-58.148461283124675,42.867490437785264,-0.22201894427447633,0.6102209137594912,0.8322398580339675,378835247,414257893.4,73.41412072420927,84.47053029201642,NaN,NaN,13.717217080319646,19.221896786286955
2003-09-25T09:30:00-04:00,101.41,101.88,100.2,100.28,53174496,36351801.6,42.02829007019048,57.58437661650513,NaN,NaN,-150.13083845358378,-11.900521813144872,-0.3640913849768215,0.3771256268129406,0.7412170117897621,325660751,387565691.8,63.4986778524701,82.59280692092514,NaN,NaN,8.502144318122658,17.690503576549197
2003-09-26T09:30:00-04:00,100.44,100.66,99.84599,99.95,42916096,37126286.4,40.67048540897676,55.5806675271583,NaN,NaN,-198.52690029386065,-71.81114849117168,-0.4618707294459605,0.16387859998231136,0.6257493294282719,282744655,359166591,54.98899840967643,80.04164446286664,NaN,NaN,3.9579182063157035,15.728705666515841
2003-09-29T09:30:00-04:00,100.3,100.99001,99.78999,100.92999,36785200,37529486.4,46.226417546225534,54.37325304307977,NaN,NaN,-155.97056315867425,-106.20414669269412,-0.4421090662424815,0.07311299662517001,0.5152220628676515,319529855,345464651.8,51.409254535178846,77.21522328546004,NaN,NaN,1.9753805185285238,13.763944931089082
2003-09-30T09:30:00-04:00,100.48,100.75999,99.25,99.95,70775872,38525249.6,41.99161293550314,53.396295285705854,NaN,NaN,-168.54951975048652,-146.26525658794597,-0.4737846043551495,-0.0770086925762854,0.3967759117788641,248753983,311104898.2,43.72263838118728,74.10013971576163,NaN,NaN,-1.1111040997815174,11.638937926678997
2003-10-01T09:30:00-04:00,100.24001,102.17999,100.2,102.08,65802816,39569195.2,52.23406743504477,53.03880675615174,NaN,NaN,-57.43216331464085,-146.1219969942492,-0.33648735245300565,-0.023833278787392942,0.3126540736656127,314556799,298249208.6,41.23822493254194,71.01542148318471,NaN,NaN,-0.1630742011636803,9.952936194130043
2003-10-02T09:30:00-04:00,101.92999,102.56,101.63,102.45,44638800,40380915.2,53.761369775931136,52.71836954399413,NaN,NaN,-3.34922906349769,-116.765675116232,-0.21203074371260316,0.04761564402485874,0.2596463877374619,359195599,304956178.2,43.05616623542883,68.02962325887141,NaN,NaN,1.0949611861563469,8.687511192990943
2003-10-03T09:30:00-04:00,103.67,104.28,103.08,103.39,48820496,41239215.2,57.48100663954544,52.85465434745039,NaN,NaN,91.03221257284267,-58.85385254289133,-0.06528729309596898,0.1780372713675007,0.24332456446346967,408016095,330010466.2,49.35889392696107,65.60840295248394,NaN,NaN,3.401431556682995,7.932356959232665
2003-10-06T09:30:00-04:00,103.48199,103.99001,103.2,103.86,20242496,40618570.4,59.246301664440985,52.57791332410357,NaN,NaN,96.37765177854881,-8.38420955544672,0.05788708503035411,0.3156834207514123,0.2577963357210582,428258591,351756213.4,54.10684969689967,63.469394057633316,NaN,NaN,5.822929236864689,7.631010141751526
2003-10-07T09:30:00-04:00,103.25999,104.31,102.91,104.25999,42619392,40995364.8,60.74019112567947,52.5159476040116,NaN,NaN,99.20143126041863,45.16598064673432,0.15523200967117728,0.4518363478100298,0.2966043381388525,470877983,396181013.4,61.95454442029603,61.8214572388938,NaN,NaN,8.24981202490867,7.719410410773975
2003-10-08T09:30:00-04:00,104.33,104.39,103.41,104,30943808,40245320,59.220635188080614,51.972377135401075,NaN,NaN,93.84413258216247,75.42123982609499,0.18881236454578515,0.5326197938210839,0.3438074292752988,439934175,421256488.6,65.53681222887585,60.37152782968331,NaN,NaN,9.766427604445175,8.011841438441289
2003-10-09T09:30:00-04:00,104.88,105.22,103.83,104.28,40094800,40310209.6,60.37049592806882,51.99050179273411,NaN,NaN,110.18245908407314,98.12757745560916,0.2146965434377784,0.6121781085725218,0.39748156513474336,480028975,445423163.8,68.60491138487718,59.26018570627194,NaN,NaN,11.351626321866263,8.488953564644858
2003-10-10T09:30:00-04:00,104.27,104.60001,103.91,104.57001,22686000,39322449.6,61.578905473635125,52.58992407840128,NaN,NaN,94.03154686098249,98.72744431323713,0.23454949485816035,0.6906684337074438,0.45611893884928345,502714975,464362939.8,70.799000572158,58.522826088131275,NaN,NaN,13.017974688893572,9.135956582394673
2003-10-13T09:30:00-04:00,104.715,105.28999,104.50999,104.89999,23829504,39447829.6,62.9627692614613,53.14964154620668,NaN,NaN,110.50214781576042,101.55234352067944,0.2515976715042394,0.7706160282295826,0.5190183567253432,526544479,484020117.4,72.91471469517603,58.18598628542404,NaN,NaN,14.81305264894853,9.946970306188081
2003-10-14T09:30:00-04:00,104.8,105.42999,104.36,105.27,38504400,39475724.8,64.50653888249772,54.50136338109154,NaN,NaN,105.46146761233186,102.80435079106209,0.2679753551650238,0.853987550681623,0.5860121955165992,565048879,502854296.6,74.79876023370895,58.28488910753116,NaN,NaN,16.773111876626718,10.922133387679315
2003-10-15T09:30:00-04:00,105.86,105.89,104.64,104.99001,39881200,39866164.8,62.387422688635176,55.955587139551874,NaN,NaN,102.62590538136463,104.56070535090252,0.2409819900501613,0.8872396830793008,0.6462576930291395,525167679,519900997.4,76.39893668466691,59.20633616697378,NaN,NaN,17.879526490583746,11.916046688094234
2003-10-16T09:30:00-04:00,104.67999,105.73,104.64999,105.41,32793504,39991089.6,64.2828574860531,57.64218514505733,NaN,NaN,100.73779424150229,102.67177238238837,0.23234137022142443,0.93668440580592,0.7043430355844956,557961183,535487439,77.78770777818939,60.83481540758185,NaN,NaN,19.350948715354814,12.978175549131459
2003-10-17T09:30:00-04:00,105.47,105.63,103.98,104.25999,32801200,39912069.6,55.96619815774215,58.33788376016566,NaN,NaN,68.78809212979321,97.6230814361505,0.1349335659813543,0.8730099930611885,0.7380764270798342,525159983,539976440.6,78.18583795810008,62.74742850921909,NaN,NaN,18.324945736717037,13.741999861643684
2003-10-20T09:30:00-04:00,104.44701,105.03999,103.94,105.03999,27778096,39465944,59.76810840399663,59.60763343648663,NaN,NaN,64.87552490892212,88.49775685478284,0.10985567676901686,0.8753960230411053,0.7655403462720884,552938079,545255160.6,78.66999497337754,65.2436682658041,NaN,NaN,18.541102192098677,14.42758590885154
2003-10-21T09:30:00-04:00,104.82001,105.28,104.32001,104.86,26763696,39178468.8,58.51264554758674,60.056103301668195,NaN,NaN,65.36987939279524,80.47943921087551,0.06991269902732822,0.8529312200562487,0.7830185210289204,526174383,537480261.4,75.99463960184788,67.72626931361167,NaN,NaN,18.361571664637005,14.989583873963749
2003-10-22T09:30:00-04:00,104.03,104.19,103.19,103.53999,34121696,38798678.4,50.186651351163526,59.80076627132765,NaN,NaN,12.625884335212772,62.47943500164513,-0.05016630961246071,0.7203106340133445,0.7704769436258052,492052687,530857263,73.69553824779796,69.91479588592377,NaN,NaN,15.623450848859594,15.08013629894887
2003-10-23T09:30:00-04:00,102.89,103.95,102.84,103.35001,46399808,38459944,49.1036829577929,59.202386008345336,NaN,NaN,-5.411918782000515,41.249492396944575,-0.14194807606114335,0.593041848549376,0.7349899246105194,445652879,508395602.2,66.36271524534035,71.12935455152228,NaN,NaN,13.071766641741778,14.793226347919285
2003-10-24T09:30:00-04:00,102.83,103.58,102.17999,103.58,51735104,38900894.4,50.49636010475551,58.57739018265352,NaN,NaN,-31.28512374270653,21.23484922244462,-0.18405729480171185,0.5049183061083795,0.6889756009100914,497387983,502841202.2,64.64964134630782,71.88241109790859,NaN,NaN,11.34807054630141,14.301061233402447
2003-10-27T09:30:00-05:00,103.74001,104.17999,103.27,103.63,32499008,38686584.8,50.81147838406406,57.868196415395275,NaN,NaN,-6.961322329973279,6.867479774665536,-0.20389232563215443,0.43411019386989835,0.6380025195020528,529886991,498230984.6,63.1915658100835,71.97076976860768,NaN,NaN,10.01287337627569,13.688462968098625
2003-10-28T09:30:00-05:00,103.98,105.14999,103.82001,105.03999,35035200,36899551.2,58.77996013783015,57.83671962609167,NaN,NaN,55.86819223393108,4.967142342892705,-0.12147044544261731,0.4861644626987811,0.6076349081413984,564922191,505980546.2,64.63541828918554,71.90638448720122,NaN,NaN,11.136316978537854,13.323870683875658
2003-10-29T09:30:00-05:00,104.77,105.42999,103.87,105.17999,30965296,35157675.2,59.48183274345924,57.77324368433385,NaN,NaN,63.517028727916774,15.145371221433512,-0.06004754478224672,0.53257547716359,0.5926230219458367,595887487,526747506.2,68.23167192361238,71.8797245256823,NaN,NaN,12.25731997902749,13.171506297468776
2003-10-30T09:30:00-05:00,105.78999,105.97,104.8,105.39999,39144800,34882975.2,60.616690477766824,57.70451404177182,NaN,NaN,116.36799145350079,39.50135326853376,-0.009764014015726685,0.5804180044261784,0.5901820184419051,635032287,564623387.8,73.5205672581313,72.07412214610898,NaN,NaN,13.514255931900498,13.220470530959021
2003-10-31T09:30:00-05:00,105.39999,105.74001,105.22,105.3,25764704,33730185.6,59.796926068702184,57.478382385146176,NaN,NaN,110.22218909055158,67.80281583518538,0.010502869652386893,0.6033106055073887,0.5928077358550018,609267583,586999307.8,76.05662329545153,72.2985441889858,NaN,NaN,14.340560699969537,13.380483412246237
2003-11-03T09:30:00-05:00,105.75,106.61,105.71001,105.99001,37599200,34598020.8,63.468465929085156,57.40423431704528,NaN,NaN,167.73902514389812,102.74288532995965,0.0612854931584953,0.6694146023031209,0.6081291091446256,646866783,610395266.2,78.38740551578314,72.55487599484823,NaN,NaN,16.118881859012262,13.771683190355668
2003-11-04T09:30:00-05:00,105.99001,106.27,105.58,105.75999,31433760,34038739.2,61.453667107538806,57.33753748982411,NaN,NaN,130.7455054144518,117.71834796606382,0.06967883489059123,0.6952276527578647,0.6255488178672735,615433023,620497432.6,79.32335978520624,72.76376335917247,NaN,NaN,17.071777272908562,14.243125202148939
2003-11-05T09:30:00-05:00,105.53999,105.97,104.89999,105.84,33637008,34173399.2,61.906654543653936,57.16780870822417,NaN,NaN,89.3984369570519,122.89462961189084,0.07068998133474569,0.7139112945357056,0.6432213132009599,649070031,631133941.4,80.2911437372482,72.94258021339097,NaN,NaN,17.990246243046958,14.778428207991512
2003-11-06T09:30:00-05:00,105.60001,106.44,105.10001,106.39999,28409392,33589128.8,65.00631060033336,57.8135310255521,NaN,NaN,119.48423103606754,123.51787752840418,0.09749119033450104,0.7650853011190861,0.6675941107845851,677479423,639623368.6,81.05338768073149,73.14740519357892,NaN,NaN,19.664469661439547,15.47643412991266
2003-11-07T09:30:00-05:00,106.64,106.72,105.57001,105.61,31737008,34041679.2,57.85433091646749,57.67683263358574,NaN,NaN,105.52404424666062,122.57824855962599,0.05267737530111227,0.7334408299109754,0.6807634546098631,645742415,646918335,81.70805700280391,73.36440962425225,NaN,NaN,19.132161662496337,15.998680920281757
2003-11-10T09:30:00-05:00,105.74001,105.84,105.00999,105.17999,25538304,34127119.2,54.34919006224987,57.37944295606168,NaN,NaN,40.207404858492886,97.07192450254495,-0.011821114920078757,0.6659870609597647,0.6778081758798434,620204111,641585800.6,79.54436764797751,73.6179616275472,NaN,NaN,17.657581251634,16.235666681903506
2003-11-11T09:30:00-05:00,105.09,105.33,104.8,105.14999,26809008,33542349.6,54.10291657512597,57.65917618634471,NaN,NaN,15.63481379465706,74.049786178586,-0.05972181434159196,0.6031559079528535,0.6628777222944454,593395103,637178216.6,77.71258889273027,73.90489381647093,NaN,NaN,16.379227171086935,16.256175323215423
2003-11-12T09:30:00-05:00,105.23,106.47,105.16,106.33,28053696,32950974.4,61.49391436171042,58.54419271519596,NaN,NaN,92.69915468459574,74.70992972409476,-0.017352176735282998,0.6411875013753416,0.6585396781106246,621448799,631653970.2,75.36987890821052,74.54826264953309,NaN,NaN,17.399947525215797,16.41957135207262
2003-11-13T09:30:00-05:00,106.00999,106.53999,105.78,106.36,29723600,32797479.2,61.66294172577634,59.34180568812603,NaN,NaN,104.03668795736098,71.62042110835345,0.0060246704309890875,0.666070516149361,0.6600458457183719,651172399,626392565.4,73.10933299772434,75.15252633892,NaN,NaN,18.272156729494416,16.684226405990017
2003-11-14T09:30:00-05:00,106.39999,106.95,105.28999,105.46001,49162704,33615554.4,54.004217423924544,59.569858476687486,NaN,NaN,69.35603689121416,64.38681963726417,-0.04309176907228207,0.6061811343780192,0.6492729034503013,602009695,617646021.4,69.3837622790792,75.59482608670541,NaN,NaN,16.72253122845965,16.689698523485678
2003-11-17T09:30:00-05:00,104.91,105.14,104.03999,104.92999,44438704,34448584.8,50.06082955779448,58.94706343525637,NaN,NaN,-32.474019150380926,49.850534835489405,-0.11136199537094615,0.5100704092366186,0.6214324046075648,557570991,605119397.4,64.32783126285807,75.57285558482488,NaN,NaN,14.18299225272209,16.33159762766231
2003-11-18T09:30:00-05:00,105.24001,105.45,103.7,103.84,41167600,35168780,43.09208886578368,57.77636744399383,NaN,NaN,-59.91720140363465,34.74013179583106,-0.22354076678298396,0.3420064461288348,0.5655472129118188,516403391,589721055,58.66840756894538,74.88976527377723,NaN,NaN,9.587412114701362,15.368142554382173
2003-11-19T09:30:00-05:00,104.03,105.00999,103.92,104.72,29836704,34954530.4,49.23615162049106,56.963471811331274,NaN,NaN,-48.805544585946734,6.439191941722572,-0.23113031288885,0.2766343218007563,0.5077646346896063,546240095,574679314.2,53.69854238909709,73.47390635456051,NaN,NaN,7.687034889293486,14.270841459369503
2003-11-20T09:30:00-05:00,103.91,105.24001,103.75,103.78,53631696,35316124.8,43.79670965839644,55.82059921059515,NaN,NaN,-83.72730155852749,-31.113605961455118,-0.28838885766702926,0.14727856260581973,0.435667420272849,492608399,542966514.2,45.036402878797894,71.25817632479952,NaN,NaN,4.194465938620958,12.831359242119712
2003-11-21T09:30:00-05:00,104.24001,104.33,103.62,104.21001,30025504,34230644.8,46.69773356528234,54.6226897560378,NaN,NaN,-115.60437607830094,-68.10568855535814,-0.2856892468835547,0.07855586166840567,0.36424510855196035,522633903,527091355.8,41.43327175275536,68.6185953417261,NaN,NaN,2.344734272682562,11.333269960771547
2003-11-24T09:30:00-05:00,104.69,105.78,104.67999,105.59,28967104,34054049.6,54.766889167969055,54.14506276035426,NaN,NaN,8.169883702726285,-59.976907984736705,-0.18427389597855326,0.13390273857876878,0.31817663455732204,551601007,525897359,41.166505948536674,65.893105781964,NaN,NaN,3.550940081862591,10.22150854949884
2003-11-25T09:30:00-05:00,105.71001,106.42,105.45,105.99001,37582304,34181404.8,56.80799431894834,53.780872744303856,NaN,NaN,72.67489472544038,-33.4584887589217,-0.08842182858675507,0.2076493488238782,0.29607117741063327,589183311,540453343,45.75201573944046,63.426025210692025,NaN,NaN,5.1982147328404,9.503895147119062
2003-11-26T09:30:00-05:00,106.42,106.45,105.39,106.37,33076304,34286955.2,58.71388900988693,53.33141405927196,NaN,NaN,79.31520139888563,-7.83433956195523,-0.0021575416794078484,0.29337425031137343,0.2955317919907813,622259615,555657247,50.12468720671276,61.21683231969068,NaN,NaN,7.144994253030644,9.166909305106431
2003-11-28T09:30:00-05:00,106.31,106.66,106.201,106.45,10507801,32855105.25,59.12284697596726,53.42202234923623,NaN,NaN,108.33030153810341,30.57718105737095,0.05443545020705304,0.36357610474959756,0.3091406545425445,632767416,583689050.4,57.00573228409698,59.45238055406877,NaN,NaN,8.81260219587956,9.116294003788306
2003-12-01T09:30:00-05:00,106.92999,107.67999,106.8,107.60001,38710704,33502405.25,64.55775537107365,54.15120558558075,NaN,NaN,177.95096805099203,89.28824988322955,0.1576258201121059,0.5061729296826769,0.348547109570571,671478120,613457893.8,62.8650520090364,58.26100086557297,NaN,NaN,12.082914593384286,9.54009694515916
2003-12-02T09:30:00-05:00,107.42999,107.77,107.07001,107.33,35369904,33390940.45,62.45802864745368,54.74799930503273,NaN,NaN,161.1219463085943,119.87866240440314,0.19363149401075663,0.5905864770840168,0.39695498307326016,636108216,630359335.6,65.72137010635493,57.404485237974725,NaN,NaN,14.077234946391876,10.188259516763834
2003-12-03T09:30:00-05:00,107.64999,108.08,107.07001,107.16,39108096,33774657.25,61.11036052561428,54.720602602454434,NaN,NaN,144.3483938742755,134.21336223417018,0.19158070433004254,0.6364308634858133,0.4448501591557708,597000120,631922697.4,65.98201710896552,56.73392368088579,NaN,NaN,15.298802290998845,10.918337055940263
2003-12-04T09:30:00-05:00,107.17,107.72,106.94,107.60001,36094896,33897551.65,63.31664754699633,54.83872444682729,NaN,NaN,125.7039083637997,143.491103627153,0.20427712826528305,0.7001965694873746,0.4959194412220916,633095016,634089777.6,66.36381731123834,56.25210113185108,NaN,NaN,16.985929226524682,11.785135937452322
2003-12-05T09:30:00-05:00,107.12,107.8,106.62,106.85001,28842704,33919217.25,57.344839560672916,55.0773403137379,NaN,NaN,91.27900187511189,140.0808436945547,0.1491420054554915,0.6823469480414559,0.5332049425859644,604252312,628386756.8,64.317963783328,55.890258382154556,NaN,NaN,16.66783569057411,12.482664473612578
2003-12-08T09:30:00-05:00,106.74001,107.64,106.67999,107.57001,32493104,33957022.05,61.13456202232598,55.868321204061566,NaN,NaN,95.82203948519533,123.65505798139536,0.1478536985187049,0.7180220657343455,0.5701683672156406,636745416,621440216,61.8181508707208,55.710995497001896,NaN,NaN,17.555839137176157,13.207403711264519
2003-12-09T09:30:00-05:00,107.89999,107.92999,106.53999,106.74001,43621504,34861182.05,55.061419051090304,56.723273360154906,NaN,NaN,72.80288172503369,105.99124506468324,0.08112870035937703,0.6715792426648619,0.5904505423054849,593123912,612843355.2,58.773664881014106,55.71851387643538,NaN,NaN,16.409373908582257,13.664828025167052
2003-12-10T09:30:00-05:00,106.8,106.98,105.96001,106.73,36924800,35366971.65,54.990468660687775,57.134296005883236,NaN,NaN,33.790617257776695,83.87968974138347,0.02903202395753346,0.6267405722524018,0.5977085482948683,556199112,604683153.6,55.95661163871312,55.87980453712224,NaN,NaN,15.47825614699596,13.923889185428324
2003-12-11T09:30:00-05:00,106.67999,108.10001,106.67,107.92999,45474304,36238002.05,61.41008969695113,58.39239458006572,NaN,NaN,92.61883157851975,77.26267438432748,0.06598829346248158,0.6801939151229703,0.6142056216604888,601673416,598398833.6,53.81728947775933,56.507010722762345,NaN,NaN,16.660634202825992,14.314852759342276
2003-12-12T09:30:00-05:00,107.99001,108.2,106.64999,108.14,34144896,36459066.85,62.42028515686399,59.5154339794644,NaN,NaN,88.62115844435765,76.73110569817662,0.09349530400967276,0.7310747516725797,0.637579447662907,635818312,604712033.6,55.65162360493661,57.52260728363243,NaN,NaN,17.92401795230098,14.830447786907806
2003-12-15T09:30:00-05:00,109.17,109.23,107.48,107.60001,38688192,35935341.25,58.20141995533516,59.76075760713341,NaN,NaN,103.57226587799371,78.28115097673628,0.06556139658540117,0.7195311933946584,0.6539697968092573,597130120,596788974.4,52.816347063218,58.354738791823955,NaN,NaN,17.71757998619075,15.242895243948226
2003-12-16T09:30:00-05:00,107.67999,108.5,107.52,108.16,32905296,35358670.85,61.135061979419476,60.06983386859563,NaN,NaN,94.45987999744133,82.61255063121783,0.074391263593105,0.7469588763006385,0.6725676127075335,630035416,604171275.2,55.111120780368424,59.02324629474738,NaN,NaN,18.431292796733207,15.698380608631794
2003-12-17T09:30:00-05:00,108.06,108.5,107.8,108.5,23204896,34460535.65,62.84036048236106,60.364581830915206,NaN,NaN,101.04182094094043,96.06279136785056,0.09159227536209047,0.7870579569101466,0.6954656815480561,653240312,623579515.2,60.54411448148074,59.76749110008796,NaN,NaN,19.532465589344174,16.24610703444785
2003-12-18T09:30:00-05:00,108.55,109.73,108.39,109.72,29790496,34458225.25,68.22751265881303,61.01491509397562,NaN,NaN,158.60158143282595,109.2593413387118,0.1690892398679591,0.906827231383005,0.7377379915150459,683030808,639850993.6,64.43096683020909,60.29786499623882,NaN,NaN,22.27088638108685,17.10678979825342
2003-12-19T09:30:00-05:00,109.3,109.37,108.58,108.89999,41466608,33849970.85,61.74783383987184,60.81420641317549,NaN,NaN,135.42295608934742,118.61970086770975,0.14974195953997282,0.924915440940012,0.7751734814000392,641564200,641000171.2,64.69548851266964,60.42861046078405,NaN,NaN,22.51114282339216,17.878840230416095
2003-12-22T09:30:00-05:00,108.83,109.66,108.78,109.66,27635200,33730455.65,65.05992732367139,61.00005631861961,NaN,NaN,165.49090216957038,131.00342812602509,0.1712006921092718,0.989174346536629,0.8179736544273571,669199400,655414027.2,67.91822849776159,60.585528917313106,NaN,NaN,23.79363641498128,18.723811113925407
2003-12-23T09:30:00-05:00,109.48,109.95,109.38,109.73,24755808,33519890.85,65.35744983007721,61.30341984036696,NaN,NaN,166.15117597476367,145.34168732148956,0.1726859135801233,1.0338310464025113,0.861145132822388,693955208,668197985.6,70.49109911800086,60.90760620367276,NaN,NaN,24.89690711766085,19.6056819716019
2003-12-24T09:30:00-05:00,109.52,109.88,109.42999,109.62,8055801,32043565.7,64.42900358657866,61.382873843194275,NaN,NaN,138.9771184401318,152.92874682132782,0.1496935018669534,1.0482620101560798,0.8985685082891264,685899407,674729804.6,71.73823111922536,61.29149290424327,NaN,NaN,25.520370216836284,20.45063743520681
2003-12-26T09:30:00-05:00,109.71001,110.08,109.63,109.7,8308398,30805170.4,64.82041578168159,61.91684357326632,NaN,NaN,132.5307198313454,147.71457450103173,0.12434845845449805,1.0540040813572489,0.9296556229027508,694207805,676965204,72.17169392000214,61.85247362829142,NaN,NaN,26.141053001275626,21.263553944645214
2003-12-29T09:30:00-05:00,110.10001,111.27,109.7843,111.16,22547600,31407160.35,71.07571994372378,62.62692628193759,NaN,NaN,169.5009750150654,154.53017828617533,0.1866424209058033,1.162958649035005,0.9763162281292017,716755405,692003445,74.95464907069345,62.790794928289465,NaN,NaN,28.696034769466365,22.325336919619662
2003-12-30T09:30:00-05:00,111.09,111.27,110.85001,111.17999,19581696,30450709.95,71.15135580536354,63.776207478671395,NaN,NaN,159.6485830692415,153.36171446610956,0.20827779203004138,1.2366634681667534,1.028385676136712,736337101,705430985.2,77.1517798809839,64.1035174282873,NaN,NaN,30.75488559160216,23.529558158474305
2003-12-31T09:30:00-05:00,111.22,111.52,110.84,111.28,31503392,30257384.35,71.55215777583511,64.9591852726105,NaN,NaN,141.47548102981062,148.42657547711892,0.20792696613358075,1.288294383803688,1.0803674176701072,767840493,720208042.2,79.30357221533777,65.77115746947479,NaN,NaN,32.55825613304722,24.819372154841865
2004-01-02T09:30:00-05:00,111.74001,112.19,110.73,111.23,38075600,30205759.55,71.02090416114042,65.64567202005257,NaN,NaN,131.4557388043123,146.92229954995503,0.18376681339676404,1.3100759344160622,1.1263091210192981,729764893,728981139.4,80.47900961640678,67.67556605080674,NaN,NaN,33.90844506837059,26.117811142488826
2004-01-05T09:30:00-05:00,111.78,112.52,111.59,112.44,27967392,29799384.35,75.71921671719514,66.59559570293338,NaN,NaN,150.36488559737614,150.48913270316115,0.2259413656592688,1.4087358280933842,1.1827944624341153,757732285,741686035.4,82.06737642026391,69.56240553761583,NaN,NaN,36.612815411320874,27.61709746660769
2004-01-06T09:30:00-05:00,112.16,112.73,112,112.55,20501200,29382309.15,76.09859503132994,67.87396535121873,NaN,NaN,144.26763718713732,145.44246513757557,0.23676796990379367,1.4787544248138573,1.2419864549100637,778233485,753981651.4,83.46923965054964,71.75189786528237,NaN,NaN,38.9329106879792,29.233642212517903
2004-01-07T09:30:00-05:00,112.35001,113.06,111.89,112.92999,30180000,29266653.95,77.41158021570942,69.03657379666801,NaN,NaN,135.56655250470496,140.62605902466825,0.2440692281142094,1.5470729900528255,1.3030037619386161,808413485,768396928.2,84.95426105228367,73.88355074184776,NaN,NaN,41.29620937161585,30.95686609238904
2004-01-08T09:30:00-05:00,113.25,113.41,112.77,113.38,37044608,28937809.15,78.89051401388294,70.18301333463386,NaN,NaN,139.65380048796942,140.26172291630002,0.2526903533870919,1.6188667036724809,1.366176350285389,845458093,783920448.2,86.37385693190438,75.72853234544945,NaN,NaN,43.7673012538243,32.786928258308365
2004-01-09T09:30:00-05:00,112.83,113.5,112.27,112.39,54092304,29796184.35,68.29653163339646,70.1879432613898,NaN,NaN,106.44725867371726,135.260026890181,0.16921280562869212,1.5776923573212542,1.4084795516925621,791365789,796240627.4,87.39069947067473,77.36851324833984,NaN,NaN,42.77480130923668,34.21376726558384
2004-01-12T09:30:00-05:00,112.55,113.25,112.36,113.22,33566496,29200793.95,71.72475012605281,70.90058013897416,NaN,NaN,104.15325585725589,126.01770094215695,0.1481481027915632,1.593664680182016,1.4455165773904528,824932285,809680627.4,88.4070459854199,79.06219592496485,NaN,NaN,42.98017188559041,35.46611078272763
2004-01-13T09:30:00-05:00,113.09,113.23,111.75999,112.56,54286400,30207869.15,65.64592031868489,70.94243678147514,NaN,NaN,79.09216053579895,112.98260561188928,0.07188082996197842,1.5353676148429258,1.4634867848809474,770645885,808163107.4,87.54897794791981,80.46439231426189,NaN,NaN,41.19570794751219,36.284624663411144
2004-01-14T09:30:00-05:00,112.75999,113.66,112.67,113.5,30141392,29780529.15,69.59796782245367,71.24533092378773,NaN,NaN,103.11562549405343,106.49242020975899,0.06695614333683153,1.5471819640519868,1.4802258207151553,800787277,806637865.8,86.63877953639269,81.61779805843273,NaN,NaN,40.937172728431875,36.949274386985536
2004-01-15T09:30:00-05:00,113.57001,114.06,112.58,113.78,38432608,30056894.75,70.67995792443375,71.69182766220597,NaN,NaN,103.83210345893646,99.32808080395237,0.06473350310544101,1.5611426995969566,1.4964091964915156,839219885,805390224.2,85.85250564309223,82.62596052442322,NaN,NaN,41.07073966480996,37.53805514096045
2004-01-16T09:30:00-05:00,114.03999,114.31,113.63,114.23,31925808,30492940.35,72.3811945728917,72.23188329014954,NaN,NaN,119.33241833134325,101.90511273547757,0.07502242978116325,1.5901872337179697,1.5151648039368064,871145693,821346205,87.42435248730314,83.7154361363733,NaN,NaN,41.70978475898279,38.13401651496364
2004-01-20T09:30:00-05:00,114.53,114.64999,113.82001,114.2,29879504,30497390.75,72.08092321675302,72.30368352393734,NaN,NaN,115.73098817482598,104.2206591989916,0.06181053174153073,1.5924279686137197,1.530617436872189,841266189,824612985.8,87.72505119411798,84.6276077166179,NaN,NaN,42.13188648490888,38.70514079638439
2004-01-21T09:30:00-05:00,114.13,115.3,113.72,115.10001,30743008,29961210.75,75.38063340582599,72.60577478111324,NaN,NaN,129.79273732264116,114.36077455636004,0.09377154840605217,1.6478318723797543,1.554060323973702,872009197,844885648.2,89.41632249566075,85.5036464748091,NaN,NaN,43.52569820982383,39.39379185544717
2004-01-22T09:30:00-05:00,115.14,115.38,114.58,114.8,29914000,30075150.75,72.3125883644321,72.66009125172731,NaN,NaN,132.44137693328918,120.22592484420719,0.07557442629439404,1.6485283568416946,1.5729539305473006,842095197,853147232.2,90.01981174985278,86.26909215584588,NaN,NaN,43.75458987491781,40.016763001085835
2004-01-23T09:30:00-05:00,115,115.37,113.95,114.42999,49968608,31335790.75,68.60395811887076,72.48745224870804,NaN,NaN,108.52540422204835,121.16458499682956,0.022253591860964317,1.600770920373506,1.5785173285125418,792126589,843728573,84.13009047503306,86.52988364574776,NaN,NaN,42.845698478715235,40.42089664074718
2004-01-26T09:30:00-05:00,114.44,115.92999,114.38,115.87,30474096,32456705.5,74.15856139563428,72.37597686859655,NaN,NaN,139.67527541016167,125.23315641259323,0.06517358867909406,1.6599843143614095,1.5948107256823154,822600685,834019571.4,78.4333359936708,86.27030932956254,NaN,NaN,43.79885463482186,40.90346206847214
2004-01-27T09:30:00-05:00,115.85001,116.5,114.64999,114.67999,35353008,33808936,64.07053353362122,71.51682961876021,NaN,NaN,122.13291835690478,126.51354244900901,-0.0018247391097763188,1.592529801795095,1.5943545409048714,787247677,823215869,72.5465827709869,85.4901195524509,NaN,NaN,41.13747743797901,40.93689283554455
2004-01-28T09:30:00-05:00,114.98,115.28,112.94,113.37,52884096,35325760.8,55.172929515025935,69.9283545687114,NaN,NaN,34.664001114228896,107.48779520732656,-0.14185826459360928,1.4170317101628598,1.558889974756469,734363581,795686745.8,60.156785157157024,83.71887127422758,NaN,NaN,35.601081732163365,40.174634106490096
2004-01-29T09:30:00-05:00,113.56,113.85001,112.56,113.48,60119904,37352671.2,55.72889076802633,68.27395290829307,NaN,NaN,-7.967767379254038,79.40596634481791,-0.22938428014101708,1.2721596245801976,1.5015439047212147,794483485,786164403.4,56.5586117416337,81.58921090349396,NaN,NaN,31.562599289893928,38.94434341840493
2004-01-30T09:30:00-05:00,113.52,113.72,113.09,113.48,30992800,37327141.6,55.72889076802633,67.37626427505235,NaN,NaN,-7.123213511241892,56.276242798159856,-0.28590847718074697,1.1441583082452809,1.4300667854260278,794483485,786635782.6,56.696691448308265,79.3967817590392,NaN,NaN,28.42443230324701,37.441498973382366
2004-02-02T09:30:00-05:00,113.7,114.67999,113.12,113.97,38850192,37365871.2,58.39467991890349,66.4241164031131,NaN,NaN,22.429100045715135,32.827007725270576,-0.2881159446507635,1.0699218546125735,1.358037799263337,833333677,788782381,57.361344091122284,77.17923162373224,NaN,NaN,26.60556786563032,35.89350881513207
2004-02-03T09:30:00-05:00,113.74001,114.14,113.44,113.78,25155904,37225296.8,56.962374349971476,65.80386311963359,NaN,NaN,4.957765642148808,9.391977182319373,-0.298902356102253,0.9844098541355208,1.2833122102377739,808177773,792968400.2,58.692822936514546,75.11807769434616,NaN,NaN,24.698190946797897,34.294177691084336
2004-02-04T09:30:00-05:00,113.19,113.73,112.78999,112.85001,39597600,38180116.8,50.44078304030522,64.43549277805155,NaN,NaN,-60.63174176378807,-9.667171393284011,-0.36104361604472457,0.832007690181868,1.1930513062265926,768580173,799811718.6,60.84542378355741,73.2756951405722,NaN,NaN,20.978121112472444,32.39188389413978
2004-02-05T09:30:00-05:00,113.08,113.53999,112.78,113.17999,35990704,38470652,52.51803053081733,63.138212249936096,NaN,NaN,-61.378328334246554,-20.349283584282514,-0.37088431926993026,0.7294459071391799,1.1003302264091102,804570877,801829197,61.48268981795138,71.534994010205,NaN,NaN,18.52039924706076,30.410243230271348
2004-02-06T09:30:00-05:00,113.42,114.7,113.2,114.45,37237296,38480286.4,59.54599471702847,62.22141226023158,NaN,NaN,27.690369770936062,-13.386566927846928,-0.28659234194652505,0.7420897989759538,1.028682140922479,841808173,811294134.6,64.40932141540519,69.89106321935515,NaN,NaN,18.538846282733676,28.71432938062311
2004-02-09T09:30:00-05:00,114.67,114.87,114.28999,114.48,24859904,37018666.4,59.697744808454864,61.33689951678171,NaN,NaN,63.68813969088493,-5.13475899881297,-0.22619988823708614,0.7459322806261213,0.9721321688632074,866668077,817961014.6,66.34887279544145,68.3641933337354,NaN,NaN,18.59957966464396,27.26936513548323
2004-02-10T09:30:00-05:00,114.28,115.14,114.25999,114.85001,27933296,36737006.4,61.610489055249616,60.353317777454826,NaN,NaN,76.38284221478493,9.150256315714255,-0.16173886595995213,0.7699585864132672,0.9316974523732193,894601373,835245734.6,70.79291015154374,67.03394959486991,NaN,NaN,19.221481983293152,26.11966754231322
2004-02-11T09:30:00-05:00,114.8,116.39,114.17,116.07001,42976896,36171531.2,67.14697249756402,59.984345215535676,NaN,NaN,143.03281791316053,49.883168251103974,-0.043493885370086915,0.8773300956606107,0.9208239810306976,937578269,869045353.8,77.14816884334488,66.11454653011934,NaN,NaN,21.575592658911038,25.47051398754148
2004-02-12T09:30:00-05:00,115.98,116.27,115.58,115.64999,27828496,36055886.4,63.738810693922794,59.63683468518225,NaN,NaN,149.22259792424742,92.00335350280277,-0.0022998726029105354,0.9179491402770594,0.92024901287997,909749773,890081133,80.05669841079158,65.82358995410209,NaN,NaN,22.457154899711647,25.040034117851505
2004-02-13T09:30:00-05:00,115.82001,116.2,114.75,115.13,44741904,36371351.2,59.698917098304875,58.60400294965872,NaN,NaN,92.38884269449304,104.94304808751417,-0.01793398193779505,0.8978315354577262,0.9157655173955213,865007869,894721072.2,80.64196288651287,65.98134901787652,NaN,NaN,21.953002911551717,24.59902965980868
2004-02-17T09:30:00-05:00,115.85001,116.42999,115.77,116.17,23988000,35974460.8,64.53985497411915,58.6375259096943,NaN,NaN,143.3927781020654,120.88397576975026,0.03122850113433573,0.954801143813441,0.9235726426791052,888995869,899186630.6,81.21337831734839,66.60040584261664,NaN,NaN,23.072557527485237,24.380962212333902
2004-02-18T09:30:00-05:00,116.2,116.60001,115.35001,115.66,28660400,35913505.6,60.68994097062287,59.03159815652265,NaN,NaN,107.81339819657904,127.17008696610908,0.019438499420447952,0.9478707669546651,0.9284322675342171,860335469,892333449.8,77.43563364370551,67.83460930594154,NaN,NaN,22.780813807281877,24.152369583040755
2004-02-19T09:30:00-05:00,116.33,116.39,115.06,115.23,51183104,36935510.4,57.571663311327306,59.16322476675844,NaN,NaN,74.36818537717477,113.43716045891192,-0.024876178706345287,0.8973370441512856,0.9222132228576309,809152365,866648269,65.19522457643201,68.45151022271286,NaN,NaN,21.573949197380614,23.784023813660735
2004-02-20T09:30:00-05:00,115.48,115.5616,114.32001,114.88,46728800,37776250.4,55.09047975242533,59.1176239799298,NaN,NaN,23.594115553606635,88.31146398478377,-0.08209153429848659,0.8195988049845226,0.9016903392830092,762423565,837183027.4,54.543700829083676,68.29772517848252,NaN,NaN,19.826883787014857,23.218718095568466
2004-02-23T09:30:00-05:00,115.22,115.25999,114.17,114.59,36361600,37095900,53.0503716282342,58.73588767345342,NaN,NaN,3.6099097098965003,70.55567738786446,-0.1403772980730893,0.7262187166916476,0.8665960147647369,726061965,809393846.6,46.78095358349186,67.54198299936606,NaN,NaN,17.777665973028277,22.441424935205582
2004-02-24T09:30:00-05:00,114.27,114.99001,113.89999,114.39,43958896,37770140,51.630339110422604,58.355028013485644,NaN,NaN,-12.557342173753549,39.36565333270068,-0.19021499890817384,0.6288272661295196,0.8190422650376934,682103069,768015286.6,38.08839170835851,66.07023791164063,NaN,NaN,15.672674713831878,21.47446061786648
2004-02-25T09:30:00-05:00,114.46001,115.06,114.32001,114.87,31234304,37564204.8,54.76020960600288,58.66355848246404,NaN,NaN,16.710106028246564,21.144994899034184,-0.18831549307321804,0.5836478986961708,0.7719633917693889,713337373,738615667.4,33.34718476200024,64.10607798152941,NaN,NaN,14.740739400173094,20.512500443910284
2004-02-26T09:30:00-05:00,114.61,115.28999,114.34,114.94,29685600,36404280,55.215327814397256,58.85622257414832,NaN,NaN,22.236911299657375,10.718740083530708,-0.17982371671259822,0.547183745878641,0.7270074625912393,743022973,725389789,31.450515734445645,61.96092268985042,NaN,NaN,14.095680032067737,19.595811813647064
2004-02-27T09:30:00-05:00,115.19,115.74001,114.63,115.02,39275008,35362035.2,55.76305635462899,58.58601269111979,NaN,NaN,41.13656071023812,14.227229114857005,-0.16659715458565127,0.5187610193591752,0.6853581739448265,782297981,729364672.2,32.689595056277696,59.69522794991275,NaN,NaN,13.69971123157272,18.753511730493585
2004-03-01T09:30:00-05:00,115.42999,116.34,115.25,116.16,33192800,35472035.2,62.75372022137546,58.80429664918555,NaN,NaN,105.68116893522564,34.64148095992283,-0.08306984644981907,0.5815208658825526,0.6645907123323717,815490781,747250435.4,38.11059053138455,57.6782077881944,NaN,NaN,15.375404239686643,18.27092494609259
2004-03-02T09:30:00-05:00,115.94,116.97,115.23,115.48,38607392,35459895.2,56.97047156386039,58.472866828372034,NaN,NaN,93.25700575249456,55.804350545172454,-0.07581684734697258,0.5698196531486559,0.6456365004956285,776883389,766206499.4,43.32069828919496,55.71590694088377,NaN,NaN,15.116937830796193,17.820355358193105
2004-03-03T09:30:00-05:00,115.25,115.87,114.92,115.69,31355392,35769869.6,58.250097172783306,57.83737573374483,NaN,NaN,48.84610199412275,62.23154973834769,-0.059780798936084456,0.5709105018255229,0.6306913007616074,808238781,785186781,48.03761902359268,53.63658195375861,NaN,NaN,15.277081521059834,17.457030524316924
2004-03-04T09:30:00-05:00,115.72,116.10001,115.52,115.99001,21073296,34843654.4,60.076699045320154,57.575796330273214,NaN,NaN,80.2650836781768,73.83718421405158,-0.03319986107744277,0.5891914744148039,0.6223913354922467,829312077,802444601.8,51.95295268110126,51.62917154449502,NaN,NaN,15.937667061216468,17.23997860101686
2004-03-05T09:30:00-05:00,115.42,116.95,115.28,116.38,55923008,35840269.6,62.38079452543837,57.767359003639896,NaN,NaN,111.36822549458822,87.88351717092159,0.00441497510247979,0.6279100543703464,0.6234950792678666,885235085,823032022.6,56.193473709621536,49.88285088900278,NaN,NaN,17.168028501317227,17.229700015345482
2004-03-08T09:30:00-05:00,116.34,116.62,114.91,114.96001,39289600,35942884.8,50.868984901089675,56.79086828413779,NaN,NaN,18.73020597163975,70.49332457820442,-0.06854494465809291,0.5378138984452505,0.6063588431033434,845945485,829122963.4,57.39163291449446,48.18129764594179,NaN,NaN,14.654425017725451,16.86180358711405
2004-03-09T09:30:00-05:00,115.10001,115.21001,114.24001,114.5,39749504,36687364.8,47.79207184085127,55.869591917725536,NaN,NaN,-99.92535010842568,31.856853406020367,-0.1455663909929794,0.42440085436211916,0.5699672453550986,806195981,834985481.8,58.56629777266298,46.83348794086732,NaN,NaN,11.592131705877215,16.10899331836593
2004-03-10T09:30:00-05:00,114.72,114.77,112.56,112.58,67802816,38680840.8,37.57586309736375,54.44132047387099,NaN,NaN,-235.30847027323443,-24.974061047451073,-0.3139373077580533,0.17754561065753194,0.4914829184155852,738393165,821016358.6,54.69683315289652,46.08360283918621,NaN,NaN,4.931739025909796,14.51224270515791
2004-03-11T09:30:00-05:00,112.39999,113.27,111.10001,111.12,89377632,41000877.6,31.97800838505229,52.79042966191577,NaN,NaN,-293.1907275503446,-99.66522329315535,-0.5006663691953693,-0.1343500430786264,0.3663163261167429,649015533,784957049.8,46.20956502108097,45.48830742432888,NaN,NaN,-2.9173443299302555,12.022301700145315
2004-03-12T09:30:00-05:00,111.73,112.71001,111.58,112.58,54026608,42310783.2,41.38230051003332,51.956996010615704,NaN,NaN,-202.89617902711788,-162.51810419749657,-0.5016246158238326,-0.26071444366304775,0.24091017216078478,703042141,748518461,39.533772454303474,44.97065162938685,NaN,NaN,-5.8118659781379725,9.47456346039056
2004-03-15T09:30:00-05:00,112.27,112.35001,110.89999,111.2,57687296,42958052.8,36.27702333214399,50.86033059788152,NaN,NaN,-206.53422089384864,-207.57098957059424,-0.5661939431116281,-0.4668322567287504,0.09936168638287773,645354845,708400333,33.75230387829117,44.66093107009633,NaN,NaN,-10.157167131720968,6.670030518660342
2004-03-16T09:30:00-05:00,111.78,112.06,110.84,111.78999,60105504,44763928,39.70200174334125,49.78474432197713,NaN,NaN,-161.52983255668548,-219.89188606024624,-0.5402380025033268,-0.5759358167462807,-0.03569781424295396,705460349,688253206.6,31.278459365992802,44.51316497038152,NaN,NaN,-12.206787622661595,3.973342212757208
2004-03-17T09:30:00-05:00,112.17999,113.25999,112.10001,113.03999,41879200,45424868,46.28883138213738,49.14713743395856,NaN,NaN,-80.61939546351927,-188.95407109830316,-0.41555162305755633,-0.5551373430648994,-0.13958572000734304,747339549,690042483.4,31.756843958441806,44.5350455578098,NaN,NaN,-11.435989546021814,1.772009104360205
2004-03-18T09:30:00-05:00,112.71001,113.27,111.92999,113.07001,60025008,45866963.2,46.44015204320383,48.48121569742819,NaN,NaN,-72.13655989629557,-144.74323756749337,-0.31242833061781133,-0.5301211332796072,-0.21769280266179586,807364557,721712288.2,39.75122844889934,45.039447942997064,NaN,NaN,-10.807544450048663,-0.02506997484106166
2004-03-19T09:30:00-05:00,112.41,112.57001,111.03999,111.06,48643296,45962688,38.59896968512198,46.75587637341009,NaN,NaN,-112.23017038582721,-126.61003583923522,-0.3577041181145932,-0.6648229503050374,-0.30711883219044417,758721261,732848112.2,42.310319382530324,45.33942857522176,NaN,NaN,-13.085868391290223,-1.8908983200480847
2004-03-22T09:30:00-05:00,110.53999,110.57001,109.10001,109.64999,62759008,47282558.4,34.23245767440636,45.131732524163375,NaN,NaN,-159.2784705782292,-117.1588857761113,-0.4545142640205053,-0.8752616622160758,-0.4207473981955705,695962253,742969593.8,44.61309200742037,45.43174241223785,NaN,NaN,-16.571195614071776,-3.9880836477657544
2004-03-23T09:30:00-05:00,110.25,110.39999,109.36,109.46001,54104304,47789828.8,33.67962141247429,43.37669854128415,NaN,NaN,-137.33367237704982,-112.31965374018421,-0.499654805237312,-1.0453159047422105,-0.5456610995048985,641857949,730249113.8,42.326396631422064,45.023797955654246,NaN,NaN,-19.40181977464491,-6.190045951605633
2004-03-24T09:30:00-05:00,109.58,110.14,108.85001,109.55,51594800,48807853.6,34.22151419383589,41.529899623320986,NaN,NaN,-127.98350935252462,-121.79247651798528,-0.49103765176982894,-1.1594581642171846,-0.6684205124473557,693452749,719471753.8,40.43535610733264,44.20111248609934,NaN,NaN,-21.42666498012276,-8.366705812822365
2004-03-25T09:30:00-05:00,110.08,111.3,109.78999,111,49982096,49822678.4,42.38968898468698,40.101963513267314,NaN,NaN,-79.7468350471945,-123.31453154816506,-0.3612661070540293,-1.1200031462648923,-0.758737039210863,743434845,706685811.4,38.25188515550871,42.919570446519856,NaN,NaN,-20.502051796489436,-10.100326667631947
2004-03-26T09:30:00-05:00,110.955,111.78999,110.8,111.03,37413104,49729583.2,42.54864587424094,39.507653582778126,NaN,NaN,-57.62356275001942,-112.39321002100351,-0.25215785995218953,-1.0739343641510999,-0.8217765041989104,780847949,711111149,39.47018404202956,41.63946695562951,NaN,NaN,-19.73101223663386,-11.476138891775078
2004-03-29T09:30:00-05:00,111.63,112.74001,111.58,112.59,44116800,50275783.2,50.23761857402995,39.68233549229088,NaN,NaN,-15.495735994063669,-83.63666310417041,-0.0635048576759556,-0.9011575762938548,-0.8376527186178993,824964749,736911648.2,46.14203680919177,40.752019743952985,NaN,NaN,-16.518801023172287,-12.196519196260393
2004-03-30T09:30:00-05:00,112.3,113.07001,112.22,112.97,39061392,50298483.2,51.92544207798137,40.707305419477855,NaN,NaN,7.7611677128993675,-54.61769508618056,0.08995565110349979,-0.7252081547385245,-0.8151638058420243,864026141,781345286.6,55.28345875517624,40.793921572687246,NaN,NaN,-13.4000973894154,-12.36845893813968
2004-03-31T09:30:00-05:00,112.99001,113.39999,112.38,113.10001,48596496,51160538.4,52.518811687257184,42.17450565534964,NaN,NaN,23.44751742608605,-24.331489730458426,0.19715472839657622,-0.568720395346304,-0.7658751237428802,912622637,825179264.2,62.11494823027388,41.93002037334389,NaN,NaN,-10.719515918438606,-12.132895649610955
2004-04-01T09:30:00-05:00,113.07001,113.87,113.05,113.78,45114304,52362588.8,55.60521321656896,43.19042799153076,NaN,NaN,61.046055440776826,3.8270883671358407,0.30438756713719495,-0.3853906648213865,-0.6897782319585815,957736941,868039683.4,67.36497341353953,43.91796329900361,NaN,NaN,-7.509653240389633,-11.472432448293624
2004-04-02T09:30:00-05:00,114.81,114.84,113.89999,114.64,50997696,52116323.2,59.21599563568685,44.8289260132124,NaN,NaN,116.3020053380259,38.6122019847449,0.4168143011254506,-0.16876035555176827,-0.5855746566772189,1008734637,913617021,71.83473682783531,46.638137081113896,NaN,NaN,-3.6341276643372797,-10.352674622014145
2004-04-05T09:30:00-04:00,114.46001,115.38,114.44,115.27,30280096,51665848,61.675101043065816,46.39843310604987,NaN,NaN,149.78488449851866,71.66832608326136,0.5109748060772363,0.053143850919326496,-0.4578309551579098,1039014733,956427017.8,75.26199045558005,49.77981787322728,NaN,NaN,0.3900805675624339,-8.81799530921749
2004-04-06T09:30:00-04:00,114.83,115.17999,114.62,114.89999,28480096,51102377.6,59.409412877910704,47.33561749860511,NaN,NaN,140.94663701616832,98.30541994391515,0.5237674263452563,0.19687832777366054,-0.3268890985715957,1010534637,985728717,77.29821096930719,53.03277265971766,NaN,NaN,3.088896933201293,-7.117010703157664
2004-04-07T09:30:00-04:00,114.98,114.98,114.11,114.63,45898400,50007156.8,57.742530409641724,48.14293023906496,NaN,NaN,115.19223949946615,116.65436435859117,0.490078893381267,0.285709518154988,-0.20436937522627896,964636237,996131437,77.9908425041109,55.764173663661346,NaN,NaN,4.872244293785703,-5.404259989308612
2004-04-08T09:30:00-04:00,115.41,115.41,113.74001,114.37,46937808,47885165.6,56.10985731766666,49.393707927103854,NaN,NaN,98.65172651467756,124.17549857337133,0.4285434321574263,0.3313099149705039,-0.09723351718692239,917698429,988123734.6,76.06693670761246,58.17536061545293,NaN,NaN,5.927124200050167,-3.7854908194002146
2004-04-12T09:30:00-04:00,114.58,115.08,114.57001,114.82001,23087200,46338195.2,58.30720093327644,51.11333244559459,NaN,NaN,100.4528829524878,121.00567409626369,0.39711428866470483,0.39915934364395866,0.0020450549792538353,940785629,974533933,72.78542116328163,60.18766984087159,NaN,NaN,7.4380826300214515,-2.182123183768548
2004-04-13T09:30:00-04:00,115.25999,115.3,113.02,113.21001,56235504,46265605.6,48.878765943841806,52.19898562640655,NaN,NaN,52.39041493303817,101.5267801831676,0.2538326400727968,0.31933585507024986,0.06550321499745304,884550125,943641011.4,65.83275875072705,61.866695706536234,NaN,NaN,6.027991592165381,-1.0092496443494154
2004-04-14T09:30:00-04:00,112.61,113.64,112.55,113.39,62334304,46377045.6,49.85499621499082,53.3156629136319,NaN,NaN,20.560970935762544,77.44964696708645,0.1616095131339046,0.2675151064148338,0.10590559328092919,946884429,930910969.8,63.15559995318206,63.48957026695405,NaN,NaN,5.1579735464393,-0.12821775995102758
2004-04-15T09:30:00-04:00,113.45,113.78,112.36,112.96001,61621008,47364136,47.520328706744955,53.682137179493175,NaN,NaN,12.559412590286529,56.92308158525052,0.06692752775863439,0.18956500297922219,0.1226374752205878,885263421,915036406.6,59.88514745477966,65.03480328833055,NaN,NaN,3.7493331986245306,0.42571809127405214
2004-04-16T09:30:00-04:00,113.36,114.05,112.98,113.83,47059296,46715850.4,52.379385095891685,54.384332838182516,NaN,NaN,36.62377290469166,44.51749086325333,0.058476908915257,0.19573361136465905,0.13725670244940205,932322717,917961264.2,60.29313713903595,66.52215708097387,NaN,NaN,3.926147901367737,0.9257794927160071
2004-04-19T09:30:00-04:00,113.57001,113.99001,113.27,113.83,28278000,45697585.6,52.379385095891685,54.53731616117265,NaN,NaN,36.483440910650046,31.723602454885782,0.04886342538984853,0.19833598418671272,0.1494725587968642,932322717,916268681.8,59.913387269768656,67.50582497101507,NaN,NaN,4.069542247539726,1.374888457690824
2004-04-20T09:30:00-04:00,114.08,114.32001,111.78,111.92,53345104,45226890.4,42.38676124417689,53.8559818159009,NaN,NaN,-20.157041385057646,17.214111191266614,-0.08297807202016402,0.045749968771659155,0.12872804079182318,878977613,915154179.4,59.64698732197469,67.81750558292926,NaN,NaN,1.029364846799508,1.3255279418492074
2004-04-21T09:30:00-04:00,112.2,112.95,111.87,112.67,50301296,45036740,46.68766228502901,53.43947114431317,NaN,NaN,-41.80754478078687,4.740408047956731,-0.11457426186508088,-0.014489786539527927,0.10008447532555295,929278909,911633075.4,58.75807213152433,67.57772871873286,NaN,NaN,-0.17732571577604753,1.1108345621884568
2004-04-22T09:30:00-04:00,112.48,114.67,112.44,114.25,62142800,45564140,54.409064422294826,53.35403194472216,NaN,NaN,27.162519265118295,7.661029382923078,-0.02845251163318563,0.06451883578407092,0.09297134741725654,991421709,932864733,62.3970809425827,67.22287925652165,NaN,NaN,1.3438285611768706,1.1441194191868016
2004-04-23T09:30:00-04:00,114.42,114.57001,113.78999,114.36,29422096,44536140,54.89881692145468,53.04566203656271,NaN,NaN,54.29235526493973,11.19474585497271,0.033190801624168126,0.1344598494474667,0.10126904782329857,1020843805,950568950.6,65.15782959978418,66.74595731166082,NaN,NaN,2.687392331414569,1.3645869780764825
2004-04-26T09:30:00-04:00,114.5,114.94,113.60001,114.2,35565200,44443744.8,53.9903146948053,52.49674872597268,NaN,NaN,48.30759209321285,13.559576091485269,0.058953642688830785,0.17496110118433705,0.11600745849550627,985278605,961160128.2,66.73142024835387,66.13663086828753,NaN,NaN,3.4955357749993623,1.669008234779751
2004-04-27T09:30:00-04:00,114.23,115.12,113.96001,114.3,43490496,44412429.6,54.49714936613198,52.14587276084563,NaN,NaN,61.82266645516455,29.95551765952971,0.07733499351951134,0.21267620039489543,0.1353412068753841,1028769101,991118425.8,70.75486269808187,65.66924884891428,NaN,NaN,4.2980333013745655,2.044583244293296
2004-04-28T09:30:00-04:00,113.89,114.00999,112.5,112.82001,50173504,44968035.2,46.35790131166799,51.33268496813321,NaN,NaN,-77.13257022176735,22.890512571333613,-0.010881344258293707,0.12173952655251696,0.13262087081081067,978595597,1000981763.4,71.95733283892312,65.23828387282944,NaN,NaN,2.5203879801868636,2.1125553494209486
2004-04-29T09:30:00-04:00,112.72,113.32001,111.16,111.83,69703376,46023379.2,41.854710732142394,50.314460212024336,NaN,NaN,-165.64420002680254,-15.670831287050552,-0.12999242221659374,-0.02986965695993149,0.10012276525666224,908892221,984475865.8,66.99311597062908,64.59015382018778,NaN,NaN,-0.4573090707114996,1.7454318608305988
2004-04-30T09:30:00-04:00,112.12,112.38,110.89999,110.96001,48683904,46201859.2,38.33095672755389,48.887585625901295,NaN,NaN,-190.13542255130514,-64.55638685029953,-0.25426805022473636,-0.21771229752425825,0.03655575270047813,860208317,952348768.2,58.52930278914842,63.571859650606825,NaN,NaN,-4.122785598843176,0.9071150808772024
2004-05-03T09:30:00-04:00,111.37,112.28999,111.35001,112.14999,33764608,45340204.8,45.13499497055186,48.62017341352344,NaN,NaN,-126.47224301203559,-99.51235387134922,-0.24322398312017293,-0.26747422619973804,-0.024250243079565102,893972925,934087632.2,54.327850872298136,62.75008051643333,NaN,NaN,-5.072496517693064,0.05288485251002162
2004-05-04T09:30:00-04:00,112.25,113.25999,111.66,112.06,51193904,46385895.2,44.73304933996916,48.25432006530762,NaN,NaN,-85.40596107461695,-128.95807937730552,-0.2290734394441974,-0.31059204238481186,-0.08151860294061447,842779021,896889616.2,46.93665293374748,61.591584300759436,NaN,NaN,-5.9441627829848205,-0.8038362382749558
2004-05-05T09:30:00-04:00,112.41,112.96001,112.16,112.78,34430304,46683405.6,48.67158426884106,48.33655260545733,NaN,NaN,-55.4522519392281,-124.62201572079766,-0.16150383709690835,-0.2833983993117499,-0.12189456221484157,877209325,876612361.8,43.46522394660089,60.4187326216038,NaN,NaN,-5.4692500774096,-1.470323929579905
2004-05-06T09:30:00-04:00,112.02,112.58949,111,111.81,55006896,47138830.4,44.11081405100893,47.74594038796571,NaN,NaN,-110.19163996104946,-113.53150370764703,-0.17147806582034336,-0.3362421444902708,-0.16476407866992743,822202429,859274403.4,40.693830230582364,59.01878212814283,NaN,NaN,-6.488434593734878,-2.187196881602044
2004-05-07T09:30:00-04:00,111.22,112.23,109.96001,109.96001,60957104,47839795.2,36.99137860939598,46.64679706750173,NaN,NaN,-170.19303221981548,-109.54302564134912,-0.2853004728183961,-0.5213896696929226,-0.23608919687452645,761245325,839481805,37.735820216237876,57.43467019574778,NaN,NaN,-9.85124442055521,-3.2820608157382107
2004-05-10T09:30:00-04:00,109.44,109.75,108.36,108.83,75336320,50452251.2,33.440980338244074,46.007812717077954,NaN,NaN,-247.07304533300893,-133.6631861055438,-0.4116484483446504,-0.7506497573053394,-0.33900130896068903,685909005,797869021,32.402915732729454,55.48866508223026,NaN,NaN,-13.888008368678875,-4.79719618044402
2004-05-11T09:30:00-04:00,109.46001,110.05,109.33,109.75,48348704,50057911.2,38.607324575245265,45.43064573780769,NaN,NaN,-168.0786370241487,-150.19772129545012,-0.40745875882203153,-0.8483247574882284,-0.4408659986661969,734257709,776164758.6,30.01992396772954,53.435940213387774,NaN,NaN,-15.457048590867192,-6.320032239075902
2004-05-12T09:30:00-04:00,109.61,110.53999,108.06,110.45,90896000,51485996,42.27853012621006,44.564179002373066,NaN,NaN,-143.21993891704122,-167.75125869101277,-0.334781425337599,-0.8593427803381957,-0.5245613550005966,825153709,765753635.4,28.921191717156134,51.04480526871445,NaN,NaN,-15.518569559773326,-7.634108999175534
2004-05-13T09:30:00-04:00,109.75999,110.81,109.63,109.99001,57500704,51279980.8,40.56201855797244,43.54012197641004,NaN,NaN,-103.16099844588896,-166.34513038798067,-0.2962520466231038,-0.8948764132794764,-0.5986243666563726,767653005,754843750.6,27.774020356292723,48.374533179893625,NaN,NaN,-16.110856102957335,-8.845072871144362
2004-05-14T09:30:00-04:00,109.98,110.74001,109.27,110.03999,54131808,51633606.4,40.843056609334305,42.60103211316211,NaN,NaN,-97.04688663382066,-151.7159012707817,-0.24792540574459943,-0.9085311238371219,-0.6606057180925224,821784813,766951648.2,31.043082736308534,45.82536621474753,NaN,NaN,-16.497231020630718,-9.938238321070983
2004-05-17T09:30:00-04:00,108.89,109.5,108.41,109.10001,55069504,52973181.6,37.273544858013786,41.37077464829654,NaN,NaN,-127.17296424722909,-127.73588505362572,-0.25860325544013296,-0.9838597873926886,-0.7252565319525557,766715309,783112909,35.25543121353091,43.289692537279606,NaN,NaN,-17.913113442329678,-11.077506195536511
2004-05-18T09:30:00-04:00,109.49001,109.94,109.33,109.64999,30203104,51816081.6,40.5475067416118,40.95574646472109,NaN,NaN,-86.4108428327762,-111.40232621535124,-0.21002905068421351,-0.9877928453078226,-0.7777637946236091,796918413,795645049.8,38.39793930555906,40.89259299918216,NaN,NaN,-18.121151141963267,-12.08374118788319
2004-05-19T09:30:00-04:00,110.5,111.17999,109.14999,109.27,55014304,52051732,39.031678291724326,40.75410129040551,NaN,NaN,-68.81408043472607,-96.52115451888821,-0.1857329603090312,-1.009929995009898,-0.8241970347008669,741904109,778995129.8,35.90452838410695,38.67197960014487,NaN,NaN,-18.733583133517577,-13.033718608688103
2004-05-20T09:30:00-04:00,109.45,109.87,109.03999,109.62,38126192,50850901.6,41.21168326622375,40.959867471739074,NaN,NaN,-76.00218485391021,-91.08939180049245,-0.13091798349060402,-0.9878445140641219,-0.8569265305735179,780030301,781470589,36.56408105013923,37.103035190215635,NaN,NaN,-18.62628918648,-13.832657262658374
2004-05-21T09:30:00-04:00,109.97,110.55,109.47,109.81,47486608,51754127.2,42.41541504275411,40.76561176261066,NaN,NaN,-51.54311568437106,-81.98863761060254,-0.06976028920537325,-0.9441268920802344,-0.8743666028748611,827516909,782617008.2,36.88797779998273,35.85732997076454,NaN,NaN,-18.205097320620105,-14.457291556652907
2004-05-24T09:30:00-04:00,110.53,110.75999,109.67999,110.27,40976800,52024707.2,45.333825018988996,40.80852431111208,NaN,NaN,-32.31771709615288,-63.01758818038731,0.009556677157391169,-0.8624207564281221,-0.8719774335855133,868493709,802972688.2,42.501726956477825,35.54054954381671,NaN,NaN,-17.03809090250436,-14.825977177488829
2004-05-25T09:30:00-04:00,109.89999,111.98,109.60001,111.85001,51714096,52435887.2,53.96407911509372,41.18655965727299,NaN,NaN,27.34848136953407,-40.26572333992525,0.16755223706503541,-0.662537137254219,-0.8300893743192544,920207805,827630566.6,48.47994807009412,35.898744124066226,NaN,NaN,-13.294938470170353,-14.607257362157618
2004-05-26T09:30:00-04:00,111.66,112.28999,111.50999,112.24001,35982704,51726347.2,55.818198810715955,42.02280142582349,NaN,NaN,88.72618966800714,-8.757669319378607,0.290254083263071,-0.46727177024041566,-0.7575258535034867,956190509,870487846.6,56.873001505190054,37.054399215109626,NaN,NaN,-9.628819552774251,-13.896051960817138
2004-05-27T09:30:00-04:00,112.53999,113.03,112.06,112.87,45311904,50506773.6,58.711064998014244,43.574207596439074,NaN,NaN,124.66073641766944,31.374914934937316,0.3990563332993523,-0.25870543687929626,-0.6577617701786486,1001502413,914782269,63.49262675381834,38.89417111065109,NaN,NaN,-5.6243194318466765,-12.714375885249929
2004-05-28T09:30:00-04:00,112.73,112.88,112.36,112.86,23369008,49241028.8,58.64542476833129,45.37452505573101,NaN,NaN,115.66878326341923,64.81729472449538,0.4516907952362401,-0.09314827613334842,-0.5448390713695885,978133405,944905568.2,67.18186149483046,41.37838152222974,NaN,NaN,-2.393412196663006,-11.239952501166083
2004-06-01T09:30:00-04:00,112.46001,112.86,111.87,112.71001,41059200,49605758.4,57.605125603011004,46.731510843428566,NaN,NaN,98.25911765411294,90.93266167454854,0.45639786082641187,0.025658254663426305,-0.43073960616298557,937074205,958621667.4,68.73131342838145,44.143480769419156,NaN,NaN,0.030926554653440554,-9.629826921763295
2004-06-02T09:30:00-04:00,113.03,113.48,112.46001,113.13,39780496,49035088,59.75774735880312,47.98002636004236,NaN,NaN,122.90581617866005,110.04412863637374,0.46615277971630886,0.15195136848240054,-0.3142014112339083,976854701,969951046.6,69.99159408206673,47.07708093834134,NaN,NaN,2.722355624882204,-7.865229415099652
2004-06-03T09:30:00-04:00,112.81,113.19,112.07001,112.09,38719008,49249523.2,52.631235529879,48.84211328660711,NaN,NaN,92.63413511481536,110.82571772573537,0.3843246188187197,0.16620436228949131,-0.2181202565292284,938135693,966340083.4,69.03651762568605,50.02440217186943,NaN,NaN,3.1604399085328345,-6.290133797437868
2004-06-04T09:30:00-04:00,112.98,113.58,112.71001,112.98,32759904,48137173.6,57.32184989982647,50.0191699502137,NaN,NaN,117.09712851804962,109.31299614581141,0.3716756627992222,0.24647432196979935,-0.12520134082942286,970895597,960218720.2,67.35850786827149,52.61836110986678,NaN,NaN,4.94612232466353,-4.684954351423382
2004-06-07T09:30:00-04:00,113.5,114.81,113.42,114.7,31673600,46672998.4,64.61451052776803,51.97209606948185,NaN,NaN,149.8321515998824,116.14566981310404,0.4551715083002611,0.44376304454590354,-0.011408463754357584,1002569197,965105878.6,68.02669195409213,54.9591654484783,NaN,NaN,9.032177147446484,-2.725364137299116
2004-06-08T09:30:00-04:00,114.37,114.92,114.17,114.86,32852400,44548802.4,65.21004985052346,53.73370629154697,NaN,NaN,143.0509976806577,125.10404581841301,0.49395907907381276,0.6060403850879084,0.1120813060140956,1035421597,984775357,70.6323445503501,57.261622965963376,NaN,NaN,12.456411068475258,-0.5565391079027768
2004-06-09T09:30:00-04:00,114.50999,114.7,113.72,113.78999,36802496,43971492,58.160434590647185,55.10004602718432,NaN,NaN,104.94676263601447,121.51223510988389,0.4230688635067922,0.6409173853975858,0.21784852189079365,998619101,989128237,71.19186077196588,59.782146707953295,NaN,NaN,13.183800521977568,1.406366553508701
2004-06-10T09:30:00-04:00,114.03999,114.35001,113.92999,114.35001,21718608,40512622.4,60.56341676067053,56.482312705359085,NaN,NaN,100.20370083986379,123.02614825489357,0.3902113655486176,0.7056127288265657,0.3154013632779481,1020337709,1005568640.2,73.26374034791561,62.403550943508755,NaN,NaN,14.539095913444463,3.282470747785238
2004-06-14T09:30:00-04:00,113.82001,113.85001,112.87,113.22,34634896,39369332,53.84355219660593,57.298608216348505,NaN,NaN,58.32716213456391,111.27215497819643,0.2741713454933984,0.6581155451446961,0.38394419965129767,985702813,1008530083.4,73.63162218045565,65.0280969706854,NaN,NaN,13.5231171771857,4.74542023769959
2004-06-15T09:30:00-04:00,113.89999,114.44501,113.50999,114.02,37446000,38535041.6,57.443593503223276,58.163591679508095,NaN,NaN,80.39530777229025,97.38478621267802,0.23462097908852553,0.6772204235119546,0.442599444423429,1023148813,1012646006.6,74.1637136768649,67.28966745071304,NaN,NaN,13.832310473662385,6.043547414265704
2004-06-16T09:30:00-04:00,114,114.2,113.7,114,26638704,37113501.6,57.32322014502025,58.403530324502846,NaN,NaN,75.34786176996583,83.84415903053966,0.19222090830090233,0.6828755797995569,0.4906546714986546,996510109,1004863709,71.23665337708823,68.91514640121262,NaN,NaN,14.038941655900084,7.185746591642044
2004-06-17T09:30:00-04:00,113.78999,114.07001,113.33,113.83,28473904,37027041.6,56.2443448511406,58.43396932739033,NaN,NaN,60.715380971259705,74.99788269758871,0.1402466198826392,0.6659629463519536,0.5257163264693144,968036205,998747129.8,68.93384317414736,69.77663509185243,NaN,NaN,13.89326709965348,8.143963807072248
2004-06-18T09:30:00-04:00,113.27,114.22,113.17999,113.63,31803104,35866481.6,54.934406481644636,58.16420800479249,NaN,NaN,52.30829392040959,65.41880131369786,0.0827617950890217,0.6291685703305916,0.5464067752415699,936233101,981926208.2,62.910929927107674,69.73508531851596,NaN,NaN,13.403109844016189,8.895270383778525
2004-06-21T09:30:00-04:00,113.75,114.14,113.13,113.2,24740800,35197212,52.1236085900974,57.6983639920615,NaN,NaN,35.33487534544471,60.82034395587401,0.009969828806954628,0.5588690612502631,0.5488992324433085,911492301,967084105.8,58.08820601694179,69.08553849866676,NaN,NaN,12.192583224592445,9.36631507532337
2004-06-22T09:30:00-04:00,113.13,113.88,112.67,113.77,37337392,34689751.2,55.38258118142046,57.53961081909075,NaN,NaN,24.388670758872397,49.619016553190434,-0.004805541494821486,0.5428923055747816,0.5476978470696031,948829693,952220281.8,53.65237436248979,68.00847142253164,NaN,NaN,12.04706929306772,9.749279963572564
2004-06-23T09:30:00-04:00,113.58,114.84,113.42,114.75,35760304,34428926.4,60.376566980938506,57.583812220671845,NaN,NaN,92.8743179222921,53.124307783655695,0.04373351088835031,0.602364735680041,0.5586312247916907,984589997,949836259.4,52.95390153419457,66.7914933833979,NaN,NaN,13.392100289123215,10.269682867222656
2004-06-24T09:30:00-04:00,114.5,114.92999,114.25999,114.39,39410608,33813752,57.81647494410304,57.95418646454499,NaN,NaN,106.0061069775718,62.18245298491811,0.043796972439968274,0.613377440341651,0.5695804679016827,945179389,945264896.2,51.567600419889594,65.54371358298388,NaN,NaN,13.774554653141543,10.77037883663964
2004-06-25T09:30:00-04:00,114.41,114.94,113.67999,113.84,32872704,33658252,54.0460037878856,57.720197456549215,NaN,NaN,61.13798399490951,63.948390999818095,0.0012483677424635076,0.5711409275797621,0.5698925598372986,912306685,940479613,50.08933811642786,64.31020145785219,NaN,NaN,12.999943884544262,11.088888129197443
2004-06-28T09:30:00-04:00,114.53,114.61,113.41,113.45,41277392,33456526.4,51.48218354051181,56.78217410031663,NaN,NaN,18.68225452294761,60.61786683531868,-0.05557020545238556,0.5004298030218166,0.5560000084742022,871029293,932387011.4,47.60401226845128,62.85143862316357,NaN,NaN,11.601394871672323,11.162103378122426
2004-06-29T09:30:00-04:00,113.5,114.17,113.42,113.92,28426896,33709420.8,54.296002229294174,56.00259927022882,NaN,NaN,14.729358662302745,58.68600441600476,-0.06334454832891823,0.4768193230630544,0.5401638713919726,899456189,922512310.6,44.69014178287817,60.998424139772716,NaN,NaN,11.204521453188695,11.168163103131892
2004-06-30T09:30:00-04:00,114.07001,114.78999,113.64999,114.53,52610400,34286980.8,57.723013598787645,55.97135491366742,NaN,NaN,77.06500825223172,55.52414248199268,-0.03089252591306968,0.5015482140006355,0.5324407399137052,952066589,916007629,42.83034685728981,58.97260171729585,NaN,NaN,11.854042026886841,11.266145806525456
2004-07-01T09:30:00-04:00,114.25,114.39999,112.58,112.94,57778192,35186865.6,47.68600553777285,55.05153982631759,NaN,NaN,-84.22168148082442,17.478584790313437,-0.11525703576900992,0.3883694452024429,0.5036264809714528,894288397,905829430.6,40.023625467735364,56.59830779728298,NaN,NaN,9.211022588504463,10.9725567753796
2004-07-02T09:30:00-04:00,113.16,113.28999,112.60001,112.88,34620496,34981940,47.35140475446822,54.58781500902204,NaN,NaN,-158.03279777505804,-26.35557156368007,-0.170513638188576,0.2904844332357328,0.4609980714243088,859667901,895301673.8,37.300825299539355,54.003250877217525,NaN,NaN,7.017643817752628,10.407569210004318
2004-07-06T09:30:00-04:00,112.37,112.45,111.63,111.89,38710608,35279475.2,42.10202898866646,53.49198897226797,NaN,NaN,-265.838973972781,-83.25981726282579,-0.26359111801248974,0.13150917390869665,0.3951002919211864,820957293,885287273.8,34.870673241022914,51.19660513180025,NaN,NaN,3.4090669684789674,9.407783175500697
2004-07-07T09:30:00-04:00,111.81,112.57001,111.75,112.22,30039296,35197760,44.31794589536206,52.563040811578105,NaN,NaN,-192.31794092983333,-124.66927718125301,-0.2906546220694092,0.03178201433442496,0.32243663640383413,850996589,875595353.8,32.65342978185295,48.44066058928344,NaN,NaN,1.1284092583029974,8.225015473043882
2004-07-08T09:30:00-04:00,111.75,112.32001,111.2,111.42,45292000,35819740,40.29198526633949,51.423586555520885,NaN,NaN,-208.09606921438908,-181.70149267457717,-0.34637463085270914,-0.1105316521620523,0.23584297869065685,805704589,846322953.8,27.057482333120845,45.449491957781554,NaN,NaN,-2.107502042372424,6.748941542270124
2004-07-09T09:30:00-04:00,111.67,111.94,111.38,111.73,27411392,35350184.8,42.472803649993814,50.533472067545816,NaN,NaN,-167.28406860121535,-198.31397009865535,-0.3455079820106686,-0.19604199882267892,0.1494659831879897,833115981,834088470.6,25.119839756712636,42.750128374181905,NaN,NaN,-4.109977781185812,5.197667353204991
2004-07-12T09:30:00-04:00,111.52,112.03999,111,111.78,35691296,36048819.2,42.83546936745988,49.87003355164314,NaN,NaN,-145.34358280774603,-195.77612710519296,-0.3250244536116915,-0.2568145838266247,0.06820986978506682,868807277,835916345.8,25.972789154281415,40.456170026849016,NaN,NaN,-5.628065186538697,3.651134133241607
2004-07-13T09:30:00-04:00,111.92,112.02,111.60001,111.86,26816096,35657879.2,43.44975793046178,49.01768903371751,NaN,NaN,-106.93979844355191,-163.99629199934714,-0.2906638991646348,-0.2951200041707267,-0.004456105006091879,895623373,850849561.8,32.71590197940888,38.96070771377181,NaN,NaN,-6.714922239404249,2.170268937149342
2004-07-14T09:30:00-04:00,111.25999,112.39,111.12,111.52,54236096,36497384,41.412925450980204,47.663143210149066,NaN,NaN,-102.27010439204496,-145.98672469178945,-0.27554766765750305,-0.34889068957797065,-0.07334302192046763,841387277,848927699.4,32.30802139942597,37.486001989859766,NaN,NaN,-8.206871842166077,0.6878202543899969
2004-07-15T09:30:00-04:00,111.74001,111.91,110.7,110.8,38432800,37087088.8,37.41319261805731,46.2057659011458,NaN,NaN,-121.64943395097275,-128.69739763910619,-0.296908506157181,-0.4444786546169439,-0.1475701484597629,802954477,848377677,32.18435216522482,36.10148425738372,NaN,NaN,-10.689428060036196,-0.9375009333851734
2004-07-16T09:30:00-04:00,111.57001,111.67,110.44,110.71001,40873200,37707053.6,36.933064810894614,44.98341311707502,NaN,NaN,-116.98419824091354,-118.63742356704581,-0.299130214081868,-0.521482916062098,-0.22235270198022994,762081277,834170736.2,29.087228609834284,34.60133357834132,NaN,NaN,-12.881267183584596,-2.643753254842234
2004-07-19T09:30:00-04:00,110.75,110.96001,109.99001,110.24001,39598096,38096803.2,34.446683174342155,43.76659166234861,NaN,NaN,-130.8966590726623,-115.74803882002907,-0.3128089923097586,-0.6133639423674282,-0.3005549500576696,722483181,804905917,23.97022398235326,32.913205843620034,NaN,NaN,-15.498069328867775,-4.480084122560168
2004-07-20T09:30:00-04:00,110.53,111.89999,110.25,111.64,47290096,39224268,46.089047938786294,43.18038064159805,NaN,NaN,-73.28382499000305,-109.0168441293193,-0.21290042795491526,-0.5666804850013136,-0.35378005704639837,769773277,779735897.8,20.611691958890262,31.193316570478043,NaN,NaN,-14.403643451473211,-5.897735455262032
2004-07-21T09:30:00-04:00,111.82001,112.06,109.45,109.58,56264192,40170608,35.96683036691864,41.6263675536074,NaN,NaN,-112.47550740083146,-111.05792473107661,-0.26735812534812586,-0.6879777137315557,-0.42061958838342983,713509085,754160259.4,17.87158184656714,29.410547641140706,NaN,NaN,-16.950333321076826,-7.476678007521288
2004-07-22T09:30:00-04:00,109.36,110.39,108.77,109.88,72660128,42015599.2,38.09896469004051,40.94157892162652,NaN,NaN,-140.82594892273394,-114.89322772542883,-0.2644957926907875,-0.7512393292469142,-0.4867435365561267,786169213,750803206.6,17.541935509448905,27.804712644120237,NaN,NaN,-18.207483826200786,-9.009650267332646
2004-07-23T09:30:00-04:00,109.62,109.71001,108.69,108.96001,49610608,42525599.2,34.32446124338797,40.011082956549366,NaN,NaN,-162.41176751062426,-123.97874157937099,-0.3031104961463311,-0.8656316567390405,-0.5625211605927094,736558605,745698672.2,17.027628925952556,26.356627188864035,NaN,NaN,-20.553185716988544,-10.658726760140631
2004-07-26T09:30:00-04:00,109.21001,109.42999,108.21001,108.75,49687904,43366359.2,33.50836488557171,39.39724980632831,NaN,NaN,-166.4706890549526,-131.09354757582904,-0.31969784063986695,-0.962143461392543,-0.6424456207526761,686870701,738576176.2,16.309114142328383,25.03080153895728,NaN,NaN,-22.660219656905646,-12.373225745392777
2004-07-27T09:30:00-04:00,109.05,110.11,108.97,109.77,51311392,43868059.2,40.8627100517481,39.150447246070165,NaN,NaN,-104.95011205955205,-137.42680498973883,-0.2423843065498248,-0.9454260039399571,-0.7030416973901323,738182093,732257939.4,15.677143599607803,23.818209668796914,NaN,NaN,-22.032593242538372,-13.753135387842146
2004-07-28T09:30:00-04:00,109.55,110.37,108.59,110.10001,66079120,45750670.4,43.057169982191105,39.347960440059566,NaN,NaN,-91.07913159813498,-133.14752982919953,-0.15374953113108758,-0.8952286113039918,-0.7414790801729042,804261213,750408365,24.703581159306196,23.650073870667295,NaN,NaN,-20.82494959749079,-14.763394560649095
2004-07-29T09:30:00-04:00,110.53999,110.87,110,110.57001,52353600,45737830.4,46.12351441729931,39.608725494867095,NaN,NaN,-35.5060135885424,-112.08354276236123,-0.0533809413262849,-0.8082052568307603,-0.7548243155044754,856614813,764497485,30.888096428625673,24.06209220437537,NaN,NaN,-18.863238585289416,-15.349086564169141
2004-07-30T09:30:00-04:00,110.32001,110.89999,110.10001,110.84,41589696,44928405.6,47.86044984430967,39.96765267178494,NaN,NaN,-19.465556879523767,-83.49430063614113,0.03643818370811425,-0.7092765858693326,-0.7457147695774469,898204509,796826665.8,42.548826989426054,25.246094906885705,NaN,NaN,-16.732659151746212,-15.546739790965866
2004-08-02T09:30:00-04:00,110.19,113.61,110.05,111.07001,38802608,45137511.2,49.35832694797738,40.389693315893204,NaN,NaN,59.31013879071172,-38.338135067008274,0.11230216145736471,-0.605337067755741,-0.7176392292131057,937007117,846853949,55.15727887914264,26.849050399723826,NaN,NaN,-14.535693504823271,-15.40230460723121
2004-08-03T09:30:00-04:00,110.92999,111.06,110.16,110.21001,40988096,45251385.6,44.240713895148396,40.591678204762346,NaN,NaN,-21.39537482495277,-21.627187620088417,0.10562455709127805,-0.5856085328490082,-0.6912330899402862,896019021,878421334.6,60.976973475167156,28.896832690848196,NaN,NaN,-14.11048289917241,-15.217758648937096
2004-08-04T09:30:00-04:00,109.89,110.75,109.64,110.2,40787008,45788771.2,44.18329096027063,41.07525665777759,NaN,NaN,-38.7947091814428,-11.170303136750004,0.10156517554367173,-0.5642766205106966,-0.6658417960543683,855232013,888615494.6,62.66218585007308,31.073820811194505,NaN,NaN,-13.784055038201876,-15.012943847403493
2004-08-05T09:30:00-04:00,110.28999,110.38,108.27,108.39999,50819296,46065136,35.308338027768585,40.95920474469715,NaN,NaN,-128.18693488346952,-29.70648739573543,-0.015105460989398467,-0.6847236222911164,-0.6696181613017179,804412717,878175075.4,59.81325253385926,33.26853680576772,NaN,NaN,-16.35550493534903,-15.20473828853857
2004-08-06T09:30:00-04:00,107.63,107.965,106.62,106.85001,74748624,48431997.6,29.764156549736,40.624738557225285,NaN,NaN,-232.59633341083332,-72.33264270199734,-0.18025182406319873,-0.8949329413807163,-0.7146811173175176,729664093,844466992.2,51.64862606347038,35.24556552584751,NaN,NaN,-20.6205026921402,-15.978418917624516
2004-08-09T09:30:00-04:00,107.02,107.48,106.87,107,37481104,48521488,30.894969360679696,39.539447230217675,NaN,NaN,-190.789164111937,-122.35250328252707,-0.2582256438297297,-1.0374631721046796,-0.77923752827495,767145197,810494608.2,44.984028931730336,36.98644673819323,NaN,NaN,-23.5529343461329,-17.06049255026857
2004-08-10T09:30:00-04:00,107.31,108.41,107.25999,108.22,56101696,49985768,39.436317103377796,39.78726771139333,NaN,NaN,-119.18808047257146,-141.9110444120508,-0.20859979884879554,-1.0399872768359444,-0.8313874779871488,823246893,795940182.6,42.4564071039418,38.742505685148565,NaN,NaN,-23.204980962740972,-17.9382766091932
2004-08-11T09:30:00-04:00,107.66,108.33,107.10001,108.16,53001200,49924023.2,39.179835951152874,39.86447280147279,NaN,NaN,-112.2850511572478,-156.60911280721183,-0.16280959336679712,-1.0348994696956453,-0.8720898763288482,770245693,778942918.6,39.65413164036595,40.321948265928356,NaN,NaN,-23.01537682949922,-18.66357664066549
2004-08-12T09:30:00-04:00,107.62,107.95,106.63,106.98,50037808,50504273.6,34.436407207476435,39.872468941764815,NaN,NaN,-131.61075818102185,-157.29387746672228,-0.19292859812963625,-1.1132506239908935,-0.9203220258612572,720207885,762101952.2,37.0451466734037,41.75177096217487,NaN,NaN,-24.404231183779373,-19.483670146824615
2004-08-13T09:30:00-04:00,107.12,107.35001,106.59,107.19,41640800,50542653.6,35.92320704737921,40.044957667608216,NaN,NaN,-121.5384212941897,-135.08229504339357,-0.17990086126207783,-1.1451981024388544,-0.9652972411767766,761848685,768538870.6,38.70512707038222,43.35148617132156,NaN,NaN,-25.044853276324737,-20.278124879610345
2004-08-16T09:30:00-04:00,107.14,108.64,107.10001,108.3,45747008,50850099.2,43.24895528912741,40.21540375599245,NaN,NaN,-61.97698354739285,-109.31985893048473,-0.0826665902368584,-1.0686304789728496,-0.9859638887359912,807595693,776628969.8,40.81729798904586,45.14721148485285,NaN,NaN,-23.228609302313348,-20.6996226542822
2004-08-17T09:30:00-04:00,108.75,109.28,108.53,108.91,40775104,50524349.6,46.84547933364205,40.48599728109609,NaN,NaN,-7.992261886643325,-87.0806952132991,0.030529105859610994,-0.9478025064114775,-0.9783316122710884,848370797,781653750.6,42.150669597761556,46.39343208759966,NaN,NaN,-20.570344238305243,-20.681154309142634
2004-08-18T09:30:00-04:00,108.53999,110.17,108.49001,110.03,43204192,49871349.6,52.764507738491034,40.9603539468955,NaN,NaN,33.97703971275767,-57.828277039297994,0.1802726350695114,-0.7529908184341991,-0.9332634535037105,891574989,805919609.8,48.218010316629666,47.631283079599946,NaN,NaN,-16.300348106629983,-20.055324851640826
2004-08-19T09:30:00-04:00,109.81,110.02,109.17999,109.71001,39968800,48236783.2,51.01657551662956,41.18579149491835,NaN,NaN,38.6241266852322,-23.78130006604718,0.25276615926355617,-0.6173057544242653,-0.8700719136878214,851606189,832199270.6,53.8617842397598,48.43935145462378,NaN,NaN,-13.416898119732338,-19.1069781756539
2004-08-20T09:30:00-04:00,109.61,110.63,109.50999,110.48,44893696,48000937.6,54.889127748009976,41.58084869492068,NaN,NaN,66.74368521786214,13.875121236363176,0.34202451856851734,-0.44254126547717476,-0.7845657840456921,896499885,859129510.6,58.81548717959203,48.70065204751303,NaN,NaN,-9.74257406976711,-17.769206160527215
2004-08-23T09:30:00-04:00,110.55,110.77,110.05,110.2,33850304,47209057.6,53.24077506560837,42.223710207096396,NaN,NaN,67.44337709349955,39.759193364541645,0.369324229150785,-0.3229104976072108,-0.6922347267579958,862649581,870140288.2,60.67459598257072,48.67905365518471,NaN,NaN,-7.253560528719223,-16.26697107026893
2004-08-24T09:30:00-04:00,110.69,110.73,109.85001,110.35001,30553600,46171168,54.03715007306181,42.927557286581475,NaN,NaN,62.20615721879085,53.798877185628484,0.3829588321061982,-0.2135361866252481,-0.5964950187314463,893203181,879106765,62.17211204749186,48.64404838357177,NaN,NaN,-4.994484147917957,-14.656615795647362
2004-08-25T09:30:00-04:00,110.33,111.27,109.89999,111.10001,38582000,44796312,57.897966289194926,44.54110216239764,NaN,NaN,80.4426047732204,63.09199019772102,0.4247307813921684,-0.06558154199123578,-0.4903123233834042,931785181,887148803.4,63.514111147209334,48.908395427382494,NaN,NaN,-1.8737950728603803,-12.830498549534935
2004-08-26T09:30:00-04:00,110.99001,111.31,110.85001,111.10001,26634096,43510336.8,57.897966289194926,46.55066000093042,NaN,NaN,94.11773110010881,74.19071108069633,0.43311762441247575,0.05108470713219049,-0.38203291728028527,931785181,903184601.8,66.09689870914171,49.9404149020733,NaN,NaN,0.6548903206339105,-10.9040144252251
2004-08-27T09:30:00-04:00,111.23,111.63,111.05,111.45,24904704,42676087.2,59.72872576217011,48.61021402960831,NaN,NaN,104.27413244456214,81.69680052603636,0.44148805891554804,0.1698271563641498,-0.27166090255139824,956689885,915222601.8,67.9320960218939,51.5795625513707,NaN,NaN,3.323090403953757,-8.871570878199549
2004-08-30T09:30:00-04:00,111.23,111.34,110.45,110.53,26729808,42072447.2,53.182193182219095,49.59206232095412,NaN,NaN,78.26393022761309,83.86091115285906,0.36735538140784063,0.18753332420840252,-0.17982205719943808,929960077,928684701,69.89468622398269,53.53943963137362,NaN,NaN,3.8515553312656534,-7.05398141970452
2004-08-31T09:30:00-04:00,110.66,111.16,110.10001,111.11,44207808,42233432.8,56.42478631717708,50.823844489955846,NaN,NaN,77.47419041267055,86.91451779163499,0.3402867275999656,0.24553635230051896,-0.09475037529944666,974167885,944877641.8,72.10608068395324,55.85743599162985,NaN,NaN,5.251316232792268,-5.296081755062122
2004-09-01T09:30:00-04:00,110.94,111.64,110.48,111.32001,52792608,42833712.8,57.570679498159386,52.47629251071892,NaN,NaN,90.23749203151246,88.8734952432934,0.3197483959059061,0.30493511958293595,-0.014813276322970137,1026960493,963912704.2,74.4792551395951,58.53130088207208,NaN,NaN,6.737922314702205,-3.5769383165243616
2004-09-02T09:30:00-04:00,111.24001,112.7,111.24001,112.58,42831392,42434317.6,63.73280311439622,54.462692229791564,NaN,NaN,124.11531403973986,94.8730118312196,0.370658296267358,0.44850959401122736,0.07785129774386937,1069791885,991514045,77.47220455447564,61.30037784522161,NaN,NaN,10.014276424174398,-1.6353362107102531
2004-09-03T09:30:00-04:00,112.27,112.82001,112.00999,112.12,30491600,40221466.4,60.29020364737354,55.67992425538058,NaN,NaN,120.97194552699658,98.2125744477065,0.35307123437397087,0.519190340711333,0.1661191063373621,1039300285,1008036125,79.05561283892587,64.03168604878448,NaN,NaN,11.715978108269539,0.27199440628686
2004-09-07T09:30:00-04:00,112.53999,113.13,112.32001,112.86,37352496,40215036,63.688249494676576,56.88297926688305,NaN,NaN,132.19772576602523,108.99933355538892,0.36925002221071285,0.6276816341007532,0.2584316118900403,1076652781,1037374665.8,81.53720364076594,66.84500990899907,NaN,NaN,14.228674761559173,2.265805885611476
2004-09-08T09:30:00-04:00,112.62,113.06,112.31,112.58,33004800,39060191.2,61.54231529945017,57.50996552123727,NaN,NaN,118.3548601192383,117.17546749670248,0.33980885912625813,0.683192685797863,0.34338382667160483,1043647981,1051270685,82.58943663755025,69.30011178906483,NaN,NaN,15.657560420105062,4.1789136762534165
2004-09-09T09:30:00-04:00,112.57001,112.88,112.03,112.48,34332400,38126751.2,60.75496944202975,58.205565087337284,NaN,NaN,101.37212862481114,119.40239481536221,0.2940300353887838,0.7109213709075846,0.41689133551880075,1009315581,1047741702.6,81.3218850473285,71.26154756103402,NaN,NaN,16.60165503076172,5.953591012611746
2004-09-10T09:30:00-04:00,112.52,113.27,112.08,113.06,27914608,37020591.2,63.65900052343048,58.83198457129589,NaN,NaN,113.43224722005631,117.26578145142551,0.2831367415225238,0.7708122624219556,0.4876755208994317,1037230189,1041229363.4,78.91490557785174,72.69722030376685,NaN,NaN,18.256947982853475,7.711213436931993
2004-09-13T09:30:00-04:00,113.31,113.74001,113.00999,113.42999,44537904,37165446.4,65.41702768900632,59.7017169015386,NaN,NaN,135.14903617381165,120.10119958078853,0.28063239291435427,0.8384660120423746,0.5578336191280203,1081768093,1049722925,79.75647249054751,74.06021148290804,NaN,NaN,20.16393265718826,9.490173325540031
2004-09-14T09:30:00-04:00,113.3,113.69,113.19,113.66,28067296,36281460.8,66.50192825977061,60.592058200589236,NaN,NaN,127.46788001782758,119.155230431149,0.2739445401945987,0.9002642943712686,0.62631975417667,1109835389,1056359446.6,80.41426413136183,75.36322234604162,NaN,NaN,22.06932446403998,11.28719491675431
2004-09-15T09:30:00-04:00,113.3,113.36,112.67999,112.8,38458800,36165645.6,59.0436705508492,60.67389421927883,NaN,NaN,84.041853514847,112.29262911027074,0.19479886967810112,0.8698183412742964,0.6750194715961952,1071376589,1061905168.2,80.9707150483434,76.61012262469406,NaN,NaN,21.609705000697694,12.761839214460506
2004-09-16T09:30:00-04:00,112.94,113.37,112.8,113.14,23917504,35201311.2,60.910187278866054,60.88905286139819,NaN,NaN,84.47721312031666,108.91364600937183,0.15052420009173384,0.8631747217108625,0.7126505216191287,1095294093,1079100870.6,82.61961013170722,77.79031629773445,NaN,NaN,21.75428561880185,14.046474415080699
2004-09-17T09:30:00-04:00,112.91,113.36,112.69,113.14999,33694496,34887596,60.96647580500238,60.97746357874336,NaN,NaN,75.50161964679,101.32752049471857,0.10902340732856974,0.8489297807798408,0.7399063734512711,1128988589,1097452550.6,84.19373903207682,78.95186222703322,NaN,NaN,21.887832990250093,15.166668497247755
2004-09-20T09:30:00-04:00,112.67,112.99001,112.28,112.47,37189808,34502401.6,55.145593432715316,61.1177064537788,NaN,NaN,39.17489463830892,82.13269218761802,0.02715536887333636,0.7738505845429415,0.7466952156696052,1091798781,1099458688.2,84.36049194904847,79.98513406453792,NaN,NaN,20.33736902379479,15.905340001040189
2004-09-21T09:30:00-04:00,112.75,113.47,112.53999,112.96001,40929392,34856356,58.23978738977996,61.247349387536154,NaN,NaN,63.50108645986286,69.33933347602508,-0.0011176451937909837,0.7452981591773664,0.7464158043711574,1132728173,1104037245,84.75576969543806,80.88868327964397,NaN,NaN,19.8694904304997,16.47164720524869
2004-09-22T09:30:00-04:00,112.5,112.52,111.47,111.55,49169200,35787136,47.98260313833235,60.56248679040566,NaN,NaN,-32.25179035957429,46.080604701140814,-0.11556850843363997,0.6019551688291074,0.7175236772627474,1083558973,1106473721.8,84.97341926048121,81.63826643113585,NaN,NaN,16.097508970523304,16.418198886002205
2004-09-23T09:30:00-04:00,111.60001,111.7,110.95,110.95,44090304,36062551.2,44.39918784345171,59.18151427105248,NaN,NaN,-92.02930823967633,10.779300429142221,-0.2260779247437087,0.43492627133311146,0.6610041960768201,1039468669,1095308637,79.38035549494037,81.77456292688332,NaN,NaN,11.766081506727655,15.753610688962985
2004-09-24T09:30:00-04:00,111.17,111.73,111.13,111.46001,35011600,36481426.4,47.95703658229549,58.30057376640405,NaN,NaN,-74.61346544490348,-19.243716589196477,-0.25697030992995695,0.339791308664374,0.596761618594331,1074480269,1084406973,74.24191543888378,81.4307273983089,NaN,NaN,9.274430296633573,14.828013490058783
2004-09-27T09:30:00-04:00,111.10001,111.2,110.58,110.75,39672096,37219796,43.759017886089644,56.87705722293355,NaN,NaN,-120.79965916153708,-51.238627349165675,-0.3136139914620477,0.20474412926677132,0.518358120728819,1034808173,1073008851.4,69.19833364718889,80.54937954162482,NaN,NaN,5.794590502204098,13.537524491793828
2004-09-28T09:30:00-04:00,110.91,111.50999,110.41,111.28,41702304,37968420.8,47.45650822167677,55.87092814594973,NaN,NaN,-105.15880582321165,-84.9706058057806,-0.3035794002383788,0.1388838704308455,0.4424632706692243,1076510477,1061765312.2,64.54057314580987,79.2601750065005,NaN,NaN,4.0544545830363505,12.182800219114188
2004-09-29T09:30:00-04:00,111.21001,111.85001,111,111.84,33866704,37451365.6,51.113624990579076,55.18226068513183,NaN,NaN,-68.87589643930251,-92.29542702172623,-0.2496717405020507,0.1303735950416609,0.3800453355437116,1110377181,1067128953.8,65.72577034136665,78.14616681321752,NaN,NaN,3.7409996981836398,10.97682871612411
2004-09-30T09:30:00-04:00,111.55,111.98,111.25999,111.75999,43592096,36991340,50.57203422997894,54.247477378456715,NaN,NaN,-64.39804900669104,-86.76917517512918,-0.21136611060606947,0.11583769728612481,0.3272038078921943,1066785085,1072592237,66.93795090588767,77.29067005093437,NaN,NaN,3.3289293096691166,9.884271658059111
2004-10-01T09:30:00-04:00,112.25999,113.64999,112.21001,113.64999,62844304,37991985.6,61.06649797206199,53.93672525581783,NaN,NaN,76.06981998570424,-56.63251808900763,-0.05864439315019282,0.25389831645445327,0.3125427096046461,1129629389,1083622061,69.29873079143258,76.54368850099759,NaN,NaN,6.53080545314412,9.40520505735697
2004-10-04T09:30:00-04:00,114.09,114.44,113.8,113.84,33587104,38146760.8,61.94136108164333,53.610970457380176,NaN,NaN,138.58946003018409,-4.7546942506633965,0.04942945871168525,0.37432953299425265,0.3249000742825674,1163216493,1109303725,73.96092665888172,76.08273582439186,NaN,NaN,9.32872011317611,9.394278636759704
2004-10-05T09:30:00-04:00,113.85001,114.16,113.53999,113.89999,37162704,38137271.2,62.22993129223134,53.838560510336045,NaN,NaN,113.19664517115744,38.91639594821042,0.11544325110944537,0.4692041381693741,0.35376088705992875,1200379197,1134077469,77.50902492069429,75.8354722438455,NaN,NaN,11.632769473561146,9.714063042017052
2004-10-06T09:30:00-04:00,113.77,114.67999,113.67999,114.62,42297808,38601921.6,65.60114709362301,54.17362906853295,NaN,NaN,133.17427687564904,79.32643061120072,0.19349187694563608,0.5956257332419739,0.4021338562963378,1242677005,1160537433.8,80.55641929213948,75.68810146959068,NaN,NaN,14.677957748804266,10.423190857272369
2004-10-07T09:30:00-04:00,114.38,114.39999,113.36,113.45,39410304,38855816.8,56.73876139795737,53.87164946802973,NaN,NaN,79.4673242816609,108.09950526887113,0.1539352353730295,0.5945529005126247,0.44061766513959516,1203266701,1187833757,83.1003112165864,75.60999948276992,NaN,NaN,14.518324627365809,11.008209967285717
2004-10-08T09:30:00-04:00,113.14999,113.7,112.35001,112.50999,51882800,40054226.4,50.800754824487015,53.56130385315629,NaN,NaN,14.205370244652197,95.72661532066071,0.057066090058836005,0.5119502777131402,0.45488418765430416,1151383901,1192184659.4,83.47151745467228,75.54650130460018,NaN,NaN,12.390688079794618,11.205706840501275
2004-10-11T09:30:00-04:00,112.78,113.02,112.64,112.97,20246192,38839640.8,53.37246914726009,53.21363826440487,NaN,NaN,18.233204892054,71.65536429303468,0.018568558928629575,0.4780948863150911,0.45952632738646154,1171630093,1193867379.4,83.62135878739389,75.4654719540256,NaN,NaN,11.493640163371484,11.246840172339876
2004-10-12T09:30:00-04:00,112.2,112.83,111.94,112.53,41855296,39529040.8,50.64552973390846,53.40384730694602,NaN,NaN,-11.406879552848366,46.73465934823352,-0.03880352819549426,0.4110219171420937,0.44982544533758795,1129774797,1179746499.4,77.28919665796974,74.91659891098907,NaN,NaN,9.894641881419835,11.053668987922727
2004-10-13T09:30:00-04:00,113,113.07001,111.32001,111.53999,54434304,40327816,45.06621493529766,53.45149209922073,NaN,NaN,-42.293483530503174,11.641107267003072,-0.14001019393221564,0.2748127029223184,0.41482289685453405,1075340493,1146279197,64.77058290017558,73.87304372564873,NaN,NaN,6.67601014141292,10.42828915270704
2004-10-14T09:30:00-04:00,111.75,111.92999,110.58,110.64,64549392,42359410.4,40.67896452356933,52.93162980931172,NaN,NaN,-99.84456720820359,-24.22127103096982,-0.2573221260224296,0.09317023932649704,0.35049236534892664,1010791101,1107784077,53.94693044474028,72.42340194035278,NaN,NaN,2.4748669236385017,9.29208597712582
2004-10-15T09:30:00-04:00,111.03999,111.74001,110.57001,111.25999,63483392,43848855.2,44.674700616720244,52.997035718642486,NaN,NaN,-80.29191962484161,-43.12072900486858,-0.2809907798974901,-0.0007461095229359671,0.28024467037455414,1074274493,1092362195.4,50.3191133464048,71.07488620458248,NaN,NaN,0.3027662462952048,8.007897444150018
2004-10-18T09:30:00-04:00,110.89,111.89999,110.7,111.67999,43762608,44177495.2,47.26605963470955,52.983432248144815,NaN,NaN,-57.983771188154726,-58.364124220910334,-0.2568473509732686,-0.04081451834203165,0.21603283263123696,1118037101,1081643597,47.907712560825125,69.88682473422644,NaN,NaN,-0.6512178500003906,6.7708809735571025
2004-10-19T09:30:00-04:00,112.02,112.23,110.59,110.74001,56057808,44933916,42.47143359037137,52.36613286241569,NaN,NaN,-68.13258369907041,-69.70926505015474,-0.2902072126347618,-0.1467261831622153,0.14348102947254648,1061979293,1068084496.2,44.97172927330308,68.40439322936474,NaN,NaN,-3.0234081546277967,5.371696812387831
2004-10-20T09:30:00-04:00,110.38,110.82001,109.75,110.52,57174896,45334200.8,41.41255573431553,51.71188439843974,NaN,NaN,-112.33427630590944,-83.717423605236,-0.31125199937937953,-0.24558396975167796,0.06566802962770159,1004804397,1053977277,42.082108540519684,66.62897591755275,NaN,NaN,-5.253726084061007,3.8537792557522828
2004-10-21T09:30:00-04:00,110.78999,111.32001,110.21001,111.24001,53261696,45792770.4,46.144702098347935,50.64604183603159,NaN,NaN,-74.69931352243748,-78.68837286808278,-0.2627754466444684,-0.26280127867788394,-0.00002583203341552376,1058066093,1063432275.4,44.64913529772891,64.86829052514535,NaN,NaN,-5.695970049380333,2.4895293550190525
2004-10-22T09:30:00-04:00,111.19,111.25,109.86,109.99001,48759808,46480180.8,40.0905685260932,49.08527093920658,NaN,NaN,-102.45918262569295,-83.12182546825304,-0.298388003674529,-0.37301083662657675,-0.07462283295204776,1009306285,1050438633.8,41.90065533262753,62.57827114469863,NaN,NaN,-8.06721220202208,0.9814234182988908
2004-10-25T09:30:00-04:00,109.75,110.12,109.35001,109.86,44055392,46699345.6,39.50995372643194,47.46241539879234,NaN,NaN,-130.12664493410048,-97.55040021744219,-0.3126838846248324,-0.46547768873308826,-0.15279380410825588,965250893,1019881392.2,36.24936213576994,59.63115237434688,NaN,NaN,-10.12452777116291,-0.6051410373385091
2004-10-26T09:30:00-04:00,110.10001,111.60001,109.88,111.53999,54483296,47338395.2,49.65622143250618,46.32349213728399,NaN,NaN,-57.59058269568919,-95.44200001676595,-0.1966468309462702,-0.39860234279109363,-0.20195551184482344,1019734189,1011432371.4,34.849762683182405,56.366391187992804,NaN,NaN,-8.60165496058535,-1.747500169230915
2004-10-27T09:30:00-04:00,111.38,113.10001,111.12,112.88,73928496,49341484.8,55.99633804569842,46.270461897836924,NaN,NaN,19.732869948303765,-69.02857076592332,-0.026251004346266066,-0.234769267277656,-0.20851826293138995,1093662685,1029204029,40.089534010263215,53.294192816112584,NaN,NaN,-5.056650222226432,-2.2202358910874174
2004-10-28T09:30:00-04:00,112.78,113.56,112.49001,113.22,54427008,49883230.4,57.46020755498847,46.74613709287274,NaN,NaN,56.180450757768945,-42.85261790988203,0.10552494657496092,-0.0766120797126888,-0.18213702628764972,1148089693,1047208749,44.92249928534535,50.54069151830352,NaN,NaN,-1.7836104615997626,-2.157860829732038
2004-10-29T09:30:00-04:00,113.17999,113.64,112.89999,113.2,48824800,49182255.2,57.339369918074794,47.02948714793093,NaN,NaN,64.64777790826027,-9.43122580309139,0.1829719228422287,0.04657787726513618,-0.13639404557709253,1099264893,1065200470.6,49.32198215563796,48.090736044606665,NaN,NaN,0.7350165967296541,-1.7445926259517963
2004-11-01T09:30:00-05:00,113.56,113.84,113.2,113.50999,36770896,49341444.8,58.78607942341544,47.61095498289571,NaN,NaN,83.17416569024982,33.228936321778676,0.2429488127121666,0.1672919703131157,-0.07565684239905088,1136035789,1099357449.8,56.43644528347976,46.60125380357166,NaN,NaN,3.237871114784859,-1.0328120915608456
2004-11-02T09:30:00-05:00,113.67,114.57001,113.22,113.55,56258496,50296234.4,58.97943701881013,48.60475656028946,NaN,NaN,99.03240305736321,64.55353347238915,0.27104848084083705,0.2631537586519954,-0.007894722188841616,1192294285,1133869469,62.20921258199753,46.418298780844665,NaN,NaN,5.322354176582859,-0.12493119611174497
2004-11-03T09:30:00-05:00,115.03,115.36,114.24001,114.98,77030000,52032844,65.25388751807499,50.36010820275415,NaN,NaN,156.5647440631315,91.91990829535476,0.3657832331252771,0.4493343192177548,0.08355108609247767,1269324285,1169001789,67.00278383048004,47.35085973696896,NaN,NaN,9.228739019062031,1.2113074060559375
2004-11-04T09:30:00-05:00,114.78,116.67,114.67999,116.55,55456704,52835164,70.57537781270301,52.21015657389578,NaN,NaN,194.57464120855735,119.59874638551244,0.5054181919217906,0.7153238259947159,0.20990563407292534,1324780989,1204340048.2,70.98898469778064,48.82727911921008,NaN,NaN,14.584748869847678,3.121799043740472
2004-11-05T09:30:00-05:00,117.05,117.64,116.49001,117.28,63308496,53406448.8,72.67120480902895,54.024809800632866,NaN,NaN,208.43404112804947,148.3559990294703,0.6111170471207625,0.9738019429738785,0.362684895853116,1388089485,1262104966.6,76.07654406640415,50.83933851246574,NaN,NaN,19.7036296111695,5.4906319819446185
2004-11-08T09:30:00-05:00,116.98,117.23,116.72,117.11,34161200,54102199.2,71.39585800910078,56.0908401162564,NaN,NaN,166.66668566723064,165.05450302486642,0.6311757445852023,1.151654576584619,0.5204788319994166,1353928285,1305683465.8,79.05997835654979,53.27421344698336,NaN,NaN,23.368162333693537,8.044564889337321
2004-11-09T09:30:00-05:00,117.08,117.5,116.75999,116.88,44713200,54245094.4,69.61578722217742,58.10535665110368,NaN,NaN,140.23695846092366,173.29541410557854,0.5912377032160031,1.2595259610194205,0.6682882578034174,1309215085,1329067625.8,80.46758918050442,56.01603349269654,NaN,NaN,25.82199177576392,10.584197301683979
2004-11-10T09:30:00-05:00,117.06,117.55,116.75999,116.97,45270192,53786888.8,69.93170381162177,59.8044282020518,NaN,NaN,122.72296524242962,166.52705834143813,0.5348625884998518,1.3368664934282322,0.8020039049283804,1354485277,1346099824.2,81.44590454647965,58.64437415332161,NaN,NaN,27.91184051563713,13.059574903677285
2004-11-11T09:30:00-05:00,117.17999,118.12,117.10001,117.86,38408000,52479819.2,72.92919425111323,62.15004432526752,NaN,NaN,122.71131108595286,152.15439231691727,0.5209753823411034,1.4532231328547596,0.9322477505136562,1392893277,1359722281.8,82.21324685332918,61.523844976228865,NaN,NaN,30.658355710614504,15.57368644752546
2004-11-12T09:30:00-05:00,117.97,119,117.67999,118.78999,55641808,52087740,75.65972698697703,64.73217098673503,NaN,NaN,125.7783233011044,135.62324875152822,0.53581142453015,1.6020120311763435,1.0662006066461935,1448535085,1371811401.8,82.889539944234,64.855286248262,NaN,NaN,33.91622442851486,18.194049016238232
2004-11-15T09:30:00-05:00,118.5,118.77,118.23,118.73,35299392,51664579.2,75.13326895428574,66.55196009543356,NaN,NaN,111.54480598702378,124.59887281548686,0.5034734790286375,1.6955424554319904,1.192068976403353,1413235693,1383672883.4,83.55041908593671,68.33390456274445,NaN,NaN,36.394841312786816,20.794162201459457
2004-11-16T09:30:00-05:00,118.36,118.41,117.73,117.88,40136704,50868524,67.92166216112938,67.4037689608215,NaN,NaN,87.06247091307924,113.96397530591798,0.3916988900002898,1.681692588903715,1.2899936989034253,1373098989,1396449664.2,84.25583799391018,71.48864056157639,NaN,NaN,36.4448053986804,23.02996837249102
2004-11-17T09:30:00-05:00,118.37,119.14,118.07001,118.58,54935008,50756529.6,70.43815173543547,68.33076497371056,NaN,NaN,92.83075038862101,107.98553233515625,0.3340189783229828,1.7075174218071538,1.373498443484171,1428033997,1411159408.2,85.0506821545593,74.35493933794882,NaN,NaN,37.234508274241215,25.059188358455334
2004-11-18T09:30:00-05:00,118.49001,118.8,118.23,118.74001,31910704,49688980,70.99822093139522,69.30639718894774,NaN,NaN,84.74644910282895,100.39255993853146,0.2780460416013246,1.7210559954858269,1.4430099538845023,1459944701,1424569693,85.75666120336909,76.95741641278676,NaN,NaN,38.04037882080585,26.91364413879112
2004-11-19T09:30:00-05:00,118.7,118.72,117.14,117.42,54280096,49964994.4,60.769717396165824,69.44808561557277,NaN,NaN,58.223886272417836,86.88167253279414,0.1309920555709565,1.606750023348198,1.4757579677772414,1405664605,1415995597,83.05596165405467,78.85881043925637,NaN,NaN,35.584500700992166,28.15233793339127
2004-11-22T09:30:00-05:00,117.17,118.12,117.03,117.98,37566496,49640549.6,63.192405768628184,69.74901195484549,NaN,NaN,52.348576862041995,75.04242670779779,0.054238334072169714,1.5435558853674536,1.4893175512952839,1443231101,1421994678.6,83.44871618557686,80.37591783951204,NaN,NaN,34.25994266953897,29.024852895698086
2004-11-23T09:30:00-05:00,117.92999,118.25999,117.37,118.16,41973008,49015035.2,63.962770992282074,69.65678934586028,NaN,NaN,55.35280308329276,68.7004931418405,0.0011966809644738952,1.4908134025008764,1.4896167215364025,1485204109,1444415702.6,84.86110364337102,81.65151211186141,NaN,NaN,33.40701073468094,29.650875444124207
2004-11-24T09:30:00-05:00,118.27,118.59,118.05,118.44,29732800,46805250.4,65.18348721579805,69.27165430322421,NaN,NaN,68.69845600462668,63.87403426504163,-0.0278231370479336,1.4548378002264855,1.482660937274419,1514936909,1461796285,85.867858446212,82.71428880817794,NaN,NaN,33.04197270959116,30.135317910619484
2004-11-26T09:30:00-05:00,118.50999,118.98,118.3,118.35001,15490000,44858400,64.42811732191012,68.68286233985857,NaN,NaN,75.78129590334677,62.08100362514519,-0.06381375026824254,1.4028937494391158,1.4667074997073584,1499446909,1469696726.6,86.3134085244986,83.44549341232754,NaN,NaN,32.532042378230905,30.477707120278257
2004-11-29T09:30:00-05:00,118.78999,119.00999,117.48,117.81,61760608,45505190.4,59.93935721688045,67.86454085469998,NaN,NaN,49.96306278200395,60.428838927062415,-0.1308606160876058,1.303131729597851,1.4339923456854569,1437686301,1476101065.8,86.68001482873491,83.98978173176933,NaN,NaN,30.825750874415984,30.527427656583647
2004-11-30T09:30:00-05:00,118,118.24001,117.64,117.89,54476096,46390450.4,60.37975084367735,67.2048239705214,NaN,NaN,33.235104281515575,56.60614441095713,-0.17399238432248287,1.2165018652823534,1.3904942496048363,1492162397,1485887325,87.24235884533581,84.47369385068588,NaN,NaN,29.52169726696973,30.3837518866388
2004-12-01T09:30:00-05:00,118.16,119.5,118.10001,119.23,49909904,46073020.8,66.93628408726647,66.99086541878174,NaN,NaN,113.32990756209125,68.20156530671684,-0.11906677389193421,1.2416607822399186,1.3607275561318528,1542072301,1497260963.4,87.88264422081494,84.93346097028125,NaN,NaN,30.20865559973311,30.35873813136656
2004-12-02T09:30:00-05:00,119.10001,119.87,119.00999,119.33,60177104,45230376,67.3702451471137,66.59379762563891,NaN,NaN,157.7539629393405,86.01266669365961,-0.08442251533149703,1.2551994119674816,1.3396219272989787,1602249405,1514723462.6,88.81114152409913,85.40473916105053,NaN,NaN,30.893239686228753,30.435095496346875
2004-12-03T09:30:00-05:00,119.27,120.14,119.09,119.25,49073696,44911225.6,66.61696141213328,65.94788579886436,NaN,NaN,154.8440813176528,101.8252237765208,-0.0756010879866611,1.2451205673156522,1.3207216553023133,1553175709,1525469222.6,89.3518490414661,85.86633266799569,NaN,NaN,31.25286809987055,30.551920153993116
2004-12-06T09:30:00-05:00,119.21001,119.64,118.84,119.21001,33045104,43398056,66.21838175769595,65.3111081419651,NaN,NaN,112.14091118325781,114.26079345677158,-0.08070168987313098,1.2198445429608995,1.3005462328340305,1520130605,1541958083.4,90.13929841401347,86.33696690571546,NaN,NaN,31.44788671014851,30.67991537630103
2004-12-07T09:30:00-05:00,119.49001,119.62,118.03999,118.10001,52105696,44295280.8,56.17206328478195,64.47185107936885,NaN,NaN,34.46345857965133,114.50646431639873,-0.1623625709740455,1.0975930191164736,1.259955590090519,1468024909,1537130585.8,88.08544847312332,86.61051051137352,NaN,NaN,28.707507832157507,30.39814286999481
2004-12-08T09:30:00-05:00,118.21001,118.82001,118.00999,118.78999,43901104,44254676,60.21287946588546,63.741474488686706,NaN,NaN,22.291529067093563,96.2987886173992,-0.17248857788165894,1.0443448677384453,1.2168334456201042,1511926013,1531101328.2,85.46620767714369,86.64019090584384,NaN,NaN,27.48681408703117,29.982238758142863
2004-12-09T09:30:00-05:00,118.14,119.46001,117.73,119.21001,60953104,45038821.6,62.48061266666251,63.13307389834865,NaN,NaN,53.01569393455339,75.35113481644177,-0.1540821696555501,1.0242307335506666,1.1783129032062167,1572879117,1525227270.6,82.88048129962817,86.43474948414806,NaN,NaN,27.121743053756482,29.573596514659094
2004-12-10T09:30:00-05:00,118.88,119.56,118.85001,119.33,47852800,45511061.6,63.127182647310526,63.30146427343042,NaN,NaN,115.97654662673736,67.57762787825868,-0.13755311996568276,1.0063715032491132,1.143924623214796,1620731917,1538738512.2,84.07401881080729,86.50746785248752,NaN,NaN,27.00525471384787,29.206690543114632
2004-12-13T09:30:00-05:00,119.75999,120.39999,119.35001,120.37,38708896,44664416,68.23648217082544,63.66175544501594,NaN,NaN,196.39236504072844,84.4279186497528,-0.06404084206011085,1.0638735706396574,1.1279144126997682,1659440813,1566600553.8,86.20920684335744,86.70464575661471,NaN,NaN,28.46462858032298,29.100681691287253
2004-12-14T09:30:00-05:00,120.17999,120.96001,120.17999,120.78999,41736096,44986251.2,70.04182893283706,64.0959738693413,NaN,NaN,212.68761195597563,120.07274932501767,0.0019121565509734317,1.1303046083884851,1.1283924518375117,1701176909,1613230953.8,88.8930923098301,86.99264494707607,NaN,NaN,30.24130034893904,29.263627213808938
2004-12-15T09:30:00-05:00,120.7,121.11,120.31,120.88,46759296,45317380.8,70.42973251023025,64.47070567608645,NaN,NaN,184.61487705897656,152.53741892339426,0.03860686928037582,1.1766510384379814,1.1380441691576055,1747936205,1660432992.2,90.83704829621584,87.34758707921921,NaN,NaN,31.799045679166753,29.625829851717196
2004-12-16T09:30:00-05:00,120.72,121.24001,120.03999,120.81,51650192,45153140,69.67416681045947,64.84542349669711,NaN,NaN,148.0278489654705,171.5398499295777,0.04474000051799609,1.1939691698051007,1.1492291692871046,1696286013,1685114371.4,91.6591006890514,87.72942223383014,NaN,NaN,32.87507923416722,30.09000833492434
2004-12-17T09:30:00-05:00,119.46001,119.97,119.16,119.44,71183008,47116755.2,56.82529238520663,64.6229902944347,NaN,NaN,42.95834607345523,156.93620981892127,-0.05166871879531043,1.0846432707929665,1.136311989588277,1625103005,1685988589,91.6875471406397,88.0871031132519,NaN,NaN,29.896550740114336,30.06237153566577
2004-12-20T09:30:00-05:00,119.75,120.28999,119.17,119.47,47201392,46762820,57.01224152526702,64.38245391454824,NaN,NaN,46.9651164069798,127.05076009217154,-0.11783228628755582,0.9890216317288321,1.1068539180163879,1672304397,1688561305.8,91.77643298004578,88.41096555144546,NaN,NaN,27.571550583854922,29.706539971121362
2004-12-21T09:30:00-05:00,119.60001,120.48,119.07001,120.39,33197600,46544375.2,62.39051313310227,64.0577559892508,NaN,NaN,69.91280565064523,98.49579883110546,-0.1045040906130712,0.9762238047500489,1.08072789536312,1705501997,1689426323.4,91.80815077431336,88.69135887669536,NaN,NaN,27.136377499752218,29.339373903782914
2004-12-22T09:30:00-05:00,120.38,121.08,120.05,120.67999,31507904,46021120,63.92270034144557,63.81150278884593,NaN,NaN,114.78407979933326,84.5296393791768,-0.08201826425834757,0.9782050650401857,1.0602233292985332,1737009901,1687241062.6,90.85479802427906,88.83733434099392,NaN,NaN,27.242077703562085,29.039760160894225
2004-12-23T09:30:00-05:00,120.87,121.28,120.09,120.77,25647696,45816864.8,64.40739322561195,63.653676489808696,NaN,NaN,112.02296486422942,77.32866255892858,-0.06754667677505166,0.9757899833297188,1.0433366601047704,1762657597,1700515379.4,91.43652098762102,88.98623948000498,NaN,NaN,27.4682108494895,28.815253116407835
2004-12-27T09:30:00-05:00,121.2,121.36,120.39,120.52,29984304,46541580,61.91915712709061,63.346589016194024,NaN,NaN,102.95737958913635,89.3284692620648,-0.08040157481877896,0.9428346915812966,1.0232362664000756,1732673293,1722029437,92.29226614253207,89.14002288918486,NaN,NaN,26.954276168273207,28.549399266674317
2004-12-28T09:30:00-05:00,120.64,121.33,120.60001,121.17999,23429296,44625014.4,65.68781152791829,64.02628531927522,NaN,NaN,113.55373469270431,102.6461929192097,-0.05145362224168326,0.9589192385979715,1.0103728608396547,1756102589,1738789075.4,92.88845667099417,89.4830949033185,NaN,NaN,27.602506315944623,28.414128845141505
2004-12-29T09:30:00-05:00,121.08,121.39999,120.95,121.36,23770192,43089719.2,66.65704370507375,64.48658276493151,NaN,NaN,118.83141004475242,112.42991379803114,-0.028335881325667334,0.9749530091825704,1.0032888905082378,1779872781,1753663232.2,93.37800923255384,90.04822358584781,NaN,NaN,28.41883832166828,28.414801627502474
2004-12-30T09:30:00-05:00,121.39999,121.57001,121.03999,121.13,21079696,41648208.8,64.16313324991317,64.60676280659227,NaN,NaN,107.87574964661628,111.04824776748774,-0.03618557144448609,0.9580569262026302,0.9942424976471163,1758793085,1758019869,93.51874302516345,90.80809942338603,NaN,NaN,28.412311659994653,28.4144459178585
2004-12-31T09:30:00-05:00,121.3,121.66,120.8,120.87,28655600,40072133.6,61.367972569727705,64.4811049439078,NaN,NaN,86.08178249765854,105.86001129417357,-0.06486560934772145,0.9131604859624645,0.9780260953101859,1730137485,1751515846.6,90.42892746016314,91.26202146976858,NaN,NaN,27.63205159435777,28.30267530021554
2005-01-03T09:30:00-05:00,121.56,121.75999,119.89999,120.3,55997600,40418328.8,55.64485794715896,63.581703213645895,NaN,NaN,42.87951091843371,93.84443756003304,-0.12473388465172208,0.8221087394955333,0.9468426241472554,1674139885,1739809165,84.98617431960976,91.17466200378661,NaN,NaN,25.28434022732015,27.8714845755162
2005-01-04T09:30:00-05:00,120.46001,120.53999,118.44,118.73,69258880,42229017.6,43.587283506555956,61.692092826054385,NaN,NaN,-78.51738136699628,55.43021434809292,-0.26454531908637224,0.61616097528929,0.8807062943756623,1604881005,1709564848.2,72.79591554216157,90.02486366323885,NaN,NaN,18.87837264118207,26.58675429918275
2005-01-05T09:30:00-05:00,118.74001,119.25,118,118.00999,65871680,42917316.8,39.37358522604765,59.47379659146991,NaN,NaN,-146.05951980322345,2.4520283784977495,-0.39228710212465123,0.3903474167198482,0.7826345188444994,1539009325,1661392157,58.42179305673075,87.70948828898993,NaN,NaN,12.028995711054584,24.507074500878726
2005-01-06T09:30:00-05:00,118.44,119.14999,118.25999,118.61,48281808,43136352,44.213496678690916,57.655177296343595,NaN,NaN,-126.34696021679169,-44.39251359418384,-0.4206327318956793,0.25684360397490025,0.6774763358705795,1587291133,1627091766.6,50.73930827888276,84.78664597397788,NaN,NaN,7.9723948695186495,22.14497741068443
2005-01-07T09:30:00-05:00,118.97,119.23,118.13,118.44,55853600,42881376.8,43.16213164064881,56.6792372431609,NaN,NaN,-129.92770713844106,-87.59441152140376,-0.43337438590574473,0.1357583534883986,0.5691327393941433,1531437533,1587351776.2,43.587693787415496,81.3509421630333,NaN,NaN,4.424565552144276,19.61349000232155
2005-01-10T09:30:00-05:00,118.34,119.46001,118.34,119,56796496,43328561.6,47.58381712565638,56.00577835747442,NaN,NaN,-98.36480318122968,-115.84327434133645,-0.3880931891752833,0.08401625292503923,0.4721094421003225,1588234029,1570170605,40.90340807790531,77.71715467002325,NaN,NaN,2.8334837549132947,17.2163462526918
2005-01-11T09:30:00-05:00,118.64,118.74001,117.99001,118.17999,63353392,44560786.4,42.384216040437614,54.5767571365698,NaN,NaN,-128.04074266259474,-125.74794660045613,-0.3960025802100207,-0.022893783162203363,0.37310879704781735,1524880637,1554170531.4,38.52409706407536,73.91115083357768,NaN,NaN,-0.24630729412980532,14.721681460288714
2005-01-12T09:30:00-05:00,118.39999,118.84,117.52,118.57001,74303376,46189150.4,45.438100766402194,53.25642859549527,NaN,NaN,-111.30453003302522,-118.7969486464165,-0.3587123201026977,-0.07528160308055476,0.28343071702214295,1599184013,1566205469,41.290446532790355,70.37084001275706,NaN,NaN,-1.789610349669396,12.362925487437556
2005-01-13T09:30:00-05:00,118.64,118.73,117.5,117.62,55780000,46640185.6,39.891605328291874,51.50530088854384,NaN,NaN,-119.46071745935781,-117.41970009492971,-0.3797466174843868,-0.19125255483334058,0.18849406265104623,1543404013,1557428045,39.88091386198498,66.6882966466402,NaN,NaN,-4.980154410559485,9.885342644866551
2005-01-14T09:30:00-05:00,117.97,118.53,117.75999,118.24001,42033600,46159356,44.64103692695599,50.27114944567709,NaN,NaN,-94.43518887887632,-110.32119644301675,-0.33517443703635813,-0.23047398364440141,0.1047004533919567,1585437613,1568228061,42.48266828780216,63.1304682284452,NaN,NaN,-6.060120202865936,7.607419380904767
2005-01-18T09:30:00-05:00,118.05,119.62,117.95,119.47,57437008,45472056,52.63640933168749,49.3389064316606,NaN,NaN,-38.47710752037219,-98.34365731084526,-0.2121265057281452,-0.1604576787682248,0.051668826959920394,1642874621,1579156179.4,45.07294363923936,59.71507444046272,NaN,NaN,-4.1990776228249524,5.920776951800522
2005-01-19T09:30:00-05:00,119.42999,119.52,118.21001,118.22,54907808,45857376.8,45.451917209738625,47.82425453913667,NaN,NaN,-55.78943447219682,-83.89339567276568,-0.2041255588707898,-0.2034881216285669,0.0006374372422229407,1587966813,1591773414.6,47.98550497242829,56.472752707596605,NaN,NaN,-5.191788045753699,4.333267666435633
2005-01-20T09:30:00-05:00,117.89,118.2,117.28999,117.5,72090000,47801996.8,41.90400762119264,46.23431699422805,NaN,NaN,-103.13253915853554,-82.25899749786774,-0.23436465062957612,-0.2923183760447472,-0.05795372541517109,1515876813,1575111974.6,44.62071257521755,52.98003624688619,NaN,NaN,-7.246387553755522,2.6790312064083253
2005-01-21T09:30:00-05:00,117.78999,118,116.64999,116.78,63274704,49390336.8,38.65458613149464,44.611932248639974,NaN,NaN,-122.24706983349154,-82.81626797269449,-0.28645251015670103,-0.41601936311104737,-0.12956685295434633,1452602109,1556951593.8,41.22734668038803,49.4656376197594,NaN,NaN,-10.04168046803867,0.8617866814873261
2005-01-24T09:30:00-05:00,117.09,117.34,116.37,116.55,58554800,51035692,37.65020655195103,43.32660000612513,NaN,NaN,-134.21282916897502,-90.77179603071423,-0.31758068388783833,-0.5265427078141443,-0.20896202392630592,1394047309,1518673533,35.158166057475896,45.90649417246413,NaN,NaN,-12.553691389587968,-1.0547101858091443
2005-01-25T09:30:00-05:00,116.91,117.47,116.72,116.88,68335312,52953242.4,40.05682571799474,43.074424449799324,NaN,NaN,-111.96986087095463,-105.47034670083072,-0.29747821995834867,-0.5808097988742418,-0.2833315789158931,1462382621,1482575133,30.58537648785712,42.89145566858524,NaN,NaN,-13.818631711520165,-2.8781275466250045
2005-01-26T09:30:00-05:00,117.32001,117.60001,117.03999,117.23,57442896,54653922.4,42.58795404150024,43.30402222233165,NaN,NaN,-91.6709256633789,-112.64664493906712,-0.24436482290919798,-0.5887876075523906,-0.3444227846431926,1519825517,1468946873.8,29.049249781352742,40.793416863201095,NaN,NaN,-14.07840688081477,-4.478167451509257
2005-01-27T09:30:00-05:00,117.19,117.75,116.98,117.42999,56600496,56295437.6,44.04194581814621,43.291768589435605,NaN,NaN,-81.07727654310965,-108.23559241598196,-0.18236143543569505,-0.5723745789378114,-0.39001314350211636,1576426013,1481056713.8,32.30286507877449,39.476528063193356,NaN,NaN,-13.86096153568685,-5.81856660639177
2005-01-28T09:30:00-05:00,117.49001,117.55,116.61,117.42999,60814096,58282157.6,44.04194581814621,43.35461245925685,NaN,NaN,-89.80763618442963,-101.74770568616957,-0.13038355020664782,-0.5529925812604262,-0.42260903105377834,1576426013,1505821494.6,38.51263952648265,39.11402418741245,NaN,NaN,-13.684636603039928,-6.942290891627222
2005-01-31T09:30:00-05:00,117.97,118.25,117.71001,118.16,54141296,59556442.4,49.460458788442104,43.48865829231297,NaN,NaN,-12.300305139563896,-77.36520088028735,-0.04052951894293766,-0.47327092973245044,-0.4327414107895128,1630567309,1553125494.6,48.273095140974355,39.640430406203095,NaN,NaN,-11.952972315851621,-7.658102523659279
2005-02-01T09:30:00-05:00,118.25,119.08,118.10001,118.91,52014000,59357262.4,54.351091495898984,44.34343511056022,NaN,NaN,66.94966779686213,-41.58129514672398,0.06972234014850337,-0.34558848560388356,-0.4153108257523869,1682581309,1597165232.2,55.3752703052069,40.84408563771249,NaN,NaN,-8.945195347308147,-7.841972927037689
2005-02-02T09:30:00-05:00,119.06,119.59,118.89999,119.27,52606304,58524633.6,56.5257533597222,45.135410295797364,NaN,NaN,126.46373840090361,2.045637666132521,0.16193177770915218,-0.21289610361594669,-0.37482788132509887,1735187613,1640237651.4,61.01333662995679,42.2528635017958,NaN,NaN,-5.772040774513763,-7.5462683338199845
2005-02-03T09:30:00-05:00,119.06,119.16,118.57001,118.96001,49143104,57688204.8,54.134290414940935,46.152744944843725,NaN,NaN,82.81132523236961,34.823358021228366,0.19487253205029087,-0.13123721626223528,-0.32610974831252615,1686044509,1662161350.6,63.53849394017216,43.94269065023775,NaN,NaN,-3.7841448752735047,-7.008822125456202
2005-02-04T09:30:00-05:00,119,120.42999,118.98,120.23,50015008,57774864.8,61.34895069398472,47.34616735677435,NaN,NaN,164.57929122020818,85.70074350215592,0.2893244937594721,0.03554586888681399,-0.2537786248726581,1736059517,1694088051.4,66.90064197812748,45.68683162811813,NaN,NaN,0.37441753458280247,-5.954073602593487
2005-02-07T09:30:00-05:00,120.25,120.52,119.96001,120.07001,46212800,57292824.8,60.067087828193536,47.876930106524775,NaN,NaN,167.44835280341496,121.65047509075171,0.3254617487179807,0.1530485610248178,-0.17241318769316294,1689846717,1705943933,68.07781247126393,47.33003654469131,NaN,NaN,3.34811768212031,-4.625189133348659
2005-02-08T09:30:00-05:00,120.17,120.64999,120.07001,120.21001,39454800,56425740,60.83819894661623,48.975950230587465,NaN,NaN,158.3062913527413,139.92179980192753,0.3415569684190672,0.25453302283067103,-0.08702394558839614,1729301517,1715287974.6,69.01318023046221,48.83201334883659,NaN,NaN,6.006991967412337,-3.1063061189542314
2005-02-09T09:30:00-05:00,120.42,120.49001,119.25,119.31,55382896,56027215.2,53.66400597673154,49.81595011312596,NaN,NaN,94.89276571182151,133.6076052641111,0.27709700471881205,0.25934731031011893,-0.017749694408693117,1673918621,1703034176.2,66.27077000479454,50.378446022377794,NaN,NaN,6.242446835908952,-1.7707699825452052
2005-02-10T09:30:00-05:00,119.66,120.02,119.25999,119.74001,46020608,54613076.8,56.314632864128434,51.0773820225998,NaN,NaN,83.61354530920997,133.7680492794792,0.24977291959409104,0.29446645508392066,0.04469353548982964,1719939229,1709813120.2,67.05081745542746,52.222979649166334,NaN,NaN,7.23551324034561,-0.4841580935608032
2005-02-11T09:30:00-05:00,119.7,121.03999,119.46001,120.77,53271104,54487632,61.93196058092143,52.81179302466911,NaN,NaN,118.68477479940734,124.58914599531902,0.2848772963418563,0.40079015591715006,0.11591285957529374,1773210333,1717243283.4,67.92637291509476,54.563565853281965,NaN,NaN,9.91714203744854,1.0017419251548172
2005-02-14T09:30:00-05:00,120.69,120.86,120.48,120.67999,32548896,54013396.8,61.191457270390636,54.32140956412595,NaN,NaN,119.25146808205858,114.94976905104772,0.28514531765575457,0.47234450664498695,0.18719918898923238,1740661437,1727406227.4,69.13451492410314,57.317075741585256,NaN,NaN,11.837812610509292,2.549752023062599
2005-02-15T09:30:00-05:00,120.8,121.42999,120.67999,121.13,44440096,53363551.2,63.538712230330006,55.81789229189951,NaN,NaN,125.8255894386147,108.45362866822241,0.29737744711281416,0.5589209978802501,0.2615435507674359,1785101533,1738566230.6,70.4507859286856,60.2743283235376,NaN,NaN,14.168174739288464,4.209526696809151
2005-02-16T09:30:00-05:00,120.92999,121.46001,120.67,121.21001,51789008,53207611.2,63.956130190765265,57.240334032800874,NaN,NaN,111.78474282391673,111.83202409064145,0.2921769003641478,0.6267646762226207,0.3345877758584729,1836890541,1771160614.6,73.94554572508713,63.24880551255994,NaN,NaN,16.187619268460303,5.920682778473601
2005-02-17T09:30:00-05:00,121.23,121.33,120.22,120.23,58153808,52510801.6,55.56515262150842,58.06342023304103,NaN,NaN,77.46750985997951,110.60281700079535,0.20800858089363078,0.5945985019755113,0.38658992108188056,1778736733,1782920115.4,75.09019519792918,65.8614880605204,NaN,NaN,15.490905680902307,7.287857478820559
2005-02-18T09:30:00-05:00,120.17,120.48,119.89999,120.39,49544192,51824276,56.56705141777329,58.57103399227896,NaN,NaN,55.36246588179653,97.9383552172732,0.15103571502633978,0.5753845648648053,0.4243488498384655,1828280925,1793934233.8,76.14719644839344,67.85249529676462,NaN,NaN,15.211403527838122,8.419792628680211
2005-02-22T09:30:00-05:00,119.89999,120.47,118.58,118.60001,80842192,52938645.6,44.483066255203234,57.86617504651498,NaN,NaN,-7.6232865873760485,72.56340428338628,-0.010693002827712628,0.4109825963038247,0.42167559913153735,1747438733,1795289693,76.28058866078025,69.34573232216272,NaN,NaN,10.826554574602683,8.763615763811993
2005-02-23T09:30:00-05:00,118.92999,119.57001,118.62469,119.45,68308688,52937314.4,49.950622019493686,57.396522807927234,NaN,NaN,-16.061470954079134,44.18599220484752,-0.06110084497325202,0.34529954291497233,0.40640038788822436,1815747421,1801418870.6,76.90940893222651,70.48116605803914,NaN,NaN,8.988266690626611,8.795708753356939
2005-02-24T09:30:00-05:00,119.24001,120.32001,118.98,120.24001,69306368,53530488,54.44158816704457,57.41847264736321,NaN,NaN,20.258338230951995,25.88071128625457,-0.04278097877881781,0.3529241644147021,0.3957051431935199,1885053789,1811051520.2,77.90098007838823,71.50705792505457,NaN,NaN,8.986209370397255,8.822923127219841
2005-02-25T09:30:00-05:00,120.27,121.67,120.17999,121.42999,61173392,53759132.8,60.23033767992133,57.338571717787254,NaN,NaN,110.25063540822944,32.43733639590455,0.043278383369582785,0.44980312240549836,0.40652473903591557,1946227181,1844549609.8,80.9626252108891,72.51148529882325,NaN,NaN,11.02831994000408,9.137979814760447
2005-02-28T09:30:00-05:00,121.14999,121.3,120.03999,120.63,69426688,54189762.4,55.15643697092977,56.98781094226841,NaN,NaN,68.4147244111717,35.04778810177958,0.04019029862238355,0.45676261231389503,0.4165723136915115,1876800493,1854253523.4,81.75134765601767,73.48816638344852,NaN,NaN,10.926663079954373,9.393505995502437
2005-03-01T09:30:00-05:00,120.78,121.52,120.78,121.23,47569296,53861162.4,58.013302247478286,56.7860326066157,NaN,NaN,110.77624367513388,58.727694154281565,0.07064069308719845,0.5048731800505095,0.43423248696331107,1924369789,1889639734.6,84.30494192286686,74.58043507576315,NaN,NaN,11.81390405195342,9.739277146424007
2005-03-02T09:30:00-05:00,120.75999,121.92999,120.64999,121.17,64233296,54472127.2,57.617997082195885,57.068460542720295,NaN,NaN,110.9676293878657,84.13351422267053,0.07823543403071592,0.532026779501706,0.45379134547099004,1860136493,1898517549,84.87671526791542,75.90943116598605,NaN,NaN,12.378128890814203,10.116255967051178
2005-03-03T09:30:00-05:00,121.66,121.89999,120.7,121.22,62098608,54946742.4,57.87559486475804,57.17995782847955,NaN,NaN,103.91136174671813,100.86411892582376,0.07794819390506924,0.5512265878523266,0.47327839394725735,1922235101,1905953811.4,85.35788480665906,77.21707883393117,NaN,NaN,12.90376077032103,10.514470938946872
2005-03-04T09:30:00-05:00,122.05,122.83,121.78999,122.73,56172608,55298217.6,64.82819063785792,57.386831403975016,NaN,NaN,204.92719090824173,119.79943002582623,0.16573186781924698,0.680443228721316,0.514711360902069,1978407709,1912389917,85.77959783107907,78.49230918507291,NaN,NaN,15.663242166838337,11.250009685788509
2005-03-07T09:30:00-05:00,122.66,123.25,122.59,122.78999,43808192,54987876.8,65.07481643078322,57.66421420114591,NaN,NaN,208.25381147480357,147.7672474385526,0.21120093203109058,0.7787125259409322,0.5675115939098416,2022215901,1941472998.6,87.52768191022,79.8061068269384,NaN,NaN,17.913455309762323,12.20193048921334
2005-03-08T09:30:00-05:00,122.67,123,122.11,122.33,44665808,54910527.2,61.51305139075769,57.51952414117646,NaN,NaN,144.74073768936032,154.5601462413979,0.19409917669411259,0.8101355647774824,0.6160363880833698,1977550093,1952109059.4,88.10363838940955,81.06702485984725,NaN,NaN,18.72975123137054,13.13447630952151
2005-03-09T09:30:00-05:00,121.97,122.28999,120.96001,120.97,73601376,56617856,52.383990649471066,56.692942745369734,NaN,NaN,48.846470789928745,142.1359145218105,0.08079681923777815,0.7170324121305924,0.6362355928928143,1903948717,1960871504.2,88.57185560303255,82.1117612797005,NaN,NaN,16.508955471404786,13.61654476121912
2005-03-10T09:30:00-05:00,121.2,121.5,120.39999,121.24001,65303392,57113880.8,53.84842849330391,56.57031959335512,NaN,NaN,14.001592989167884,124.15396077030043,0.016976562794402184,0.657456296385817,0.6404797335914149,1969252109,1970274905.8,89.06906015520913,83.11025163379192,NaN,NaN,15.172825654389632,13.838870603100622
2005-03-11T09:30:00-05:00,121.31,121.72,120.16,120.39,58132704,57719485.6,48.76395762582003,56.01295575107275,NaN,NaN,-18.229176726571367,79.52268724333781,-0.08399946091058907,0.5354804074531785,0.6194798683637676,1911119405,1956817245,83.47188527612182,83.63344369291538,NaN,NaN,12.402351092877794,13.633653530211646
2005-03-14T09:30:00-05:00,120.61,121.16,120.28,121.14,36338704,56872865.6,52.98242654212143,56.62005291442405,NaN,NaN,-10.682825745003914,35.73535979937632,-0.10067031764308387,0.4936419713099127,0.5943122889529966,1947458109,1941865686.6,77.6347503211823,83.73016952580123,NaN,NaN,11.385015048110708,13.312419461340083
2005-03-15T09:30:00-05:00,121.42,121.46001,120.08,120.14,62465808,58368711.2,47.380904557088,56.43650166710936,NaN,NaN,-39.94812527804819,-1.2024127941053693,-0.17507787878601389,0.3754649404704793,0.5505428192564932,1884992301,1923354128.2,71.0134773217334,83.30903155362316,NaN,NaN,8.671648896075954,12.649452237730921
2005-03-16T09:30:00-05:00,119.7,119.88,118.89999,119.12,76723872,59982900,42.45091386528871,55.580024931269655,NaN,NaN,-140.57080613531497,-39.085868179154126,-0.28265043577575943,0.1972297745367939,0.47988021031255335,1808268429,1904218070.6,64.85565239044423,82.37722243305572,NaN,NaN,4.698812111298693,11.513646505383461
2005-03-17T09:30:00-05:00,119.31,119.74001,118.98,119.36,62726400,60529769.6,43.92925556447445,54.41566192302345,NaN,NaN,-117.5304643883286,-65.39227965465342,-0.3243165645292341,0.07448450465101075,0.3988010691802448,1870994829,1884566614.6,59.18032581404587,80.82134390470978,NaN,NaN,2.0077156706186634,10.155656386131348
2005-03-18T09:30:00-05:00,119.11,119.53,118.14999,118.53999,61884192,60716288.8,40.135593232454724,53.34274451313238,NaN,NaN,-143.43893022487012,-90.43423035431317,-0.38939779233495,-0.08794617123844262,0.30145162109650736,1809110637,1864164861,53.906324933827605,78.83241371026763,NaN,NaN,-1.4991110734180941,8.490689606195714
2005-03-21T09:30:00-05:00,118.71001,118.78,117.75999,118.10001,61430608,61310609.6,38.22800375202538,51.92950890631431,NaN,NaN,-154.36283418310296,-119.17023204193296,-0.44060334198110496,-0.24930255637987386,0.1913007856012311,1747680029,1824209245,45.37734745742974,76.05187124845068,NaN,NaN,-4.974610783941262,6.567075264747574
2005-03-22T09:30:00-05:00,118.37,118.92999,116.89999,116.89999,93324624,61934731.2,33.54501178058429,50.2100099561992,NaN,NaN,-172.9250687411345,-145.76562073455025,-0.5279273589145098,-0.46860841304190615,0.05931894587260364,1654355405,1778081865.8,37.9184670024838,72.69771065806272,NaN,NaN,-9.580002697434939,4.260349841578643
2005-03-23T09:30:00-05:00,116.94501,117.72,116.75,117,71946000,62116596.8,34.26771526318802,48.52373284180134,NaN,NaN,-171.34508732744308,-151.92047697297588,-0.5491439314162669,-0.6271109683977301,-0.07796703698146312,1726301405,1761688461,35.6741546585868,69.14887279034328,NaN,NaN,-13.00693740462881,1.793594520691864
2005-03-24T09:30:00-05:00,117.46001,117.99001,117.06,117.14,52019200,61252238.4,35.327989518035466,46.416575618956884,NaN,NaN,-135.17931962477826,-155.4502480202658,-0.5240097521968432,-0.7329792272275171,-0.20896947503067392,1778320605,1743153616.2,33.276046720158945,65.39861913956327,NaN,NaN,-15.481821657268421,-0.6743220761596049
2005-03-28T09:30:00-05:00,117.42,117.94,117.31,117.31,46941504,60540644,36.663957291720195,44.38722853759524,NaN,NaN,-110.66590736542952,-148.89564344837768,-0.46803254083276624,-0.7940101510716318,-0.3259776102388655,1825262109,1746383910.6,34.107407372298425,61.582885243997445,NaN,NaN,-17.15604101438803,-3.0288533530493797
2005-03-29T09:30:00-05:00,117.14,117.89999,116.25,116.53,73040192,60721319.2,33.26818122417767,42.36973781141095,NaN,NaN,-117.96098099996996,-141.61527281175108,-0.4552179721598805,-0.8950000754387162,-0.43978210327883566,1752221917,1747292288.2,34.355102614734264,57.74370411723492,NaN,NaN,-19.626772856861592,-5.399984710736838
2005-03-30T09:30:00-05:00,116.78,118.2,116.77,118.17999,62896704,61487689.6,44.895026553417075,41.83481180454995,NaN,NaN,-76.95235728311155,-122.4207305201465,-0.31401485385142225,-0.8323006705931135,-0.5182858167416913,1815118621,1779444931.4,42.58246391513252,54.458747568099206,NaN,NaN,-18.22131523587129,-7.231603357184617
2005-03-31T09:30:00-05:00,118.19,118.46001,117.87,117.96001,65048800,61528464.8,43.7993480318586,41.11702034301815,NaN,NaN,-56.80934524403617,-99.51358210346511,-0.21836379415824791,-0.7912405594395011,-0.5728767652812532,1750069821,1784198614.6,43.705829862557806,51.21851683290982,NaN,NaN,-17.425794779969017,-8.687916417582388
2005-04-01T09:30:00-05:00,118.63,118.99001,116.91,117.42999,97394816,63293275.2,41.19091270081808,40.576088562660864,NaN,NaN,-63.41032626199954,-85.15978343090937,-0.17556640215281993,-0.7923347679722781,-0.6167683658194582,1652675005,1759069494.6,39.32571900209877,48.06521924190817,NaN,NaN,-17.542259435036176,-9.952822562932928
2005-04-04T09:30:00-04:00,117.36,117.86,116.74001,117.63,71609504,64065120,42.580594142851616,39.83310053414159,NaN,NaN,-71.75720427432698,-77.37804281268886,-0.12115121465586376,-0.7682073841392878,-0.647056169483424,1724284509,1738873974.6,36.18694467738672,45.10466169592278,NaN,NaN,-17.23035306875096,-10.99246977804979
2005-04-05T09:30:00-04:00,117.78,118.38,117.67,118.19,50079904,64378705.6,46.399678191938946,39.76301293663094,NaN,NaN,-38.68123305164997,-61.522093223024875,-0.03905690314205379,-0.6958772984109913,-0.6568203952689375,1774364413,1743302473.8,37.36745474330469,42.701374368892154,NaN,NaN,-15.838012092516287,-11.68469010868786
2005-04-06T09:30:00-04:00,118.45,118.95,118.17999,118.60001,53311696,64811000,49.070594232904064,40.23584724860347,NaN,NaN,-7.916626289976946,-47.71494702439795,0.046599634794438516,-0.5985708517758894,-0.6451704865703279,1827676109,1745813971.4,38.067202848406325,40.78791368731801,NaN,NaN,-13.880097791967074,-11.998319777727747
2005-04-07T09:30:00-04:00,118.41,119.25999,118.32001,119.24001,47225504,63492206.4,53.0069695493336,40.884255390379124,NaN,NaN,21.11331916825252,-32.130414141940214,0.14456986448912423,-0.4644581559589227,-0.6090280204480469,1874901613,1770780329.8,44.68334322378885,39.75241493087109,NaN,NaN,-11.009435220292149,-11.857050555236947
2005-04-08T09:30:00-04:00,119.17,119.21001,118,118,64288800,63441476.8,45.645627914157885,41.27782929621507,NaN,NaN,-4.510683760698272,-20.350485641679956,0.12481496617477583,-0.4530093127295771,-0.577824278904353,1810612813,1802367891.4,51.71195030440101,39.59567388591205,NaN,NaN,-10.675740483914465,-11.68829197361945
2005-04-11T09:30:00-04:00,118.28999,118.42,117.83,118.09,45858000,62827741.6,46.22930368207751,41.849350719790216,NaN,NaN,-18.284273747146212,-9.655899536243776,0.11690147525091088,-0.4316974348407143,-0.5485989100916252,1856470813,1828805152.2,56.67385508755882,40.40256728806413,NaN,NaN,-10.234457152925282,-11.480601284948854
2005-04-12T09:30:00-04:00,117.89,119.06,117.07001,118.7,86547680,65338190.4,50.13755730772069,43.034532543157106,NaN,NaN,7.291878103623072,-0.4612773051891617,0.14974353042021982,-0.36141949706635046,-0.5111630274865703,1943018493,1862535968.2,62.03423955168661,42.12512247015004,NaN,NaN,-8.681959411335178,-11.080795303004043
2005-04-13T09:30:00-04:00,118.56,118.8,117.13,117.3,66058192,65517809.6,42.50217006975667,43.62270788648344,NaN,NaN,-39.72001000114159,-6.821954047422091,0.0777939374443542,-0.41392060568112754,-0.49171454312548174,1876960301,1872392806.6,63.45704344762674,44.109614526510036,NaN,NaN,-9.717626147043964,-10.886056852152603
2005-04-14T09:30:00-04:00,117.44,117.5,115.77,115.77,99638816,66663556.8,36.04224085263068,43.673725838954525,NaN,NaN,-185.87316727470989,-48.21925133601457,-0.06453891829827452,-0.5723881909983248,-0.5078492727000503,1777321485,1852876781,58.7615162329968,45.930005205998455,NaN,NaN,-12.892497504758154,-11.172691231096254
2005-04-15T09:30:00-04:00,115.74001,116.2,114.10001,114.14999,134028816,70228677.6,30.718388201244423,43.249042332491975,NaN,NaN,-299.23935085999676,-107.16498475587427,-0.24912244677135997,-0.8192523311642503,-0.5701298843928904,1643292669,1819412752.2,51.697587133240205,47.1864466174943,NaN,NaN,-17.61260264148072,-12.092678575436892
2005-04-18T09:30:00-04:00,114.12,114.96001,113.96001,114.5,100314816,72150208.8,33.02038302494199,43.231342461118,NaN,NaN,-255.3242394757712,-154.57297790159927,-0.3242218302853933,-0.975407172249632,-0.6511853419642387,1743607485,1796840086.6,47.54562657635964,48.128626900467545,NaN,NaN,-20.471032454900232,-13.289586272503083
2005-04-19T09:30:00-04:00,115.10001,115.71001,114.83,115.41,68397120,72498534.4,38.72126169223884,42.79035925674812,NaN,NaN,-149.484824501667,-185.92831842265727,-0.2902856183240128,-1.0140423648692547,-0.7237567465452419,1812004605,1770637309,43.20759957389932,48.17327944752231,NaN,NaN,-20.888415785382378,-14.375133345771554
2005-04-20T09:30:00-04:00,115.39999,115.63,113.55,113.8,114822128,73573409.6,33.31809391439923,42.041698248358166,NaN,NaN,-174.59590087431283,-212.90349659729154,-0.34994589297469325,-1.1611891127636085,-0.8112432197889152,1697182477,1734681744.2,38.074086879753814,47.77101209160774,NaN,NaN,-23.175286715598467,-15.632298112889684
2005-04-21T09:30:00-04:00,114.78999,116.21001,114.38,116.00999,87459504,74349084.8,44.72084110470661,42.29383599149306,NaN,NaN,-87.02716540328979,-193.1342962230075,-0.22056270690372204,-1.0869466034185677,-0.8663838965148457,1784641981,1736145843.4,38.395052976469195,47.70453594691991,NaN,NaN,-20.82403503088348,-16.373974815460226
2005-04-22T09:30:00-04:00,115.74001,116.5,114.27,115.57001,89839504,76240100,43.139224787202224,42.33373818037525,NaN,NaN,-80.59228286909159,-149.40488262482648,-0.1480854100048885,-1.0514906590209563,-0.9034052490160678,1694802477,1746447805,40.72317522207786,48.02855241439784,NaN,NaN,-19.600442551283205,-16.834898777720653
2005-04-25T09:30:00-04:00,115.86,116.5,115.72,116.33,52363504,76511200,46.649106624347425,42.35155449697586,NaN,NaN,-38.03095150392792,-105.94622503045782,-0.03815820300009687,-0.9511030027661889,-0.912944799766092,1747165981,1747159504.2,40.88936986301326,48.28011778009131,NaN,NaN,-17.40884834888941,-16.916891573601905
2005-04-26T09:30:00-04:00,115.96001,116.77,115.14999,115.2,75363808,76627380.8,42.45302779415773,41.87887117992255,NaN,NaN,-56.62591557703604,-87.37444324553162,-0.03104845987898197,-0.9517553746148195,-0.9207069147358375,1671802173,1719119017.8,36.54225446213417,48.171192895357585,NaN,NaN,-17.032120825468315,-16.933352895297105
2005-04-27T09:30:00-04:00,114.86,116.07001,114.44,115.64999,85186128,77741852,44.5904676104749,41.27769247000408,NaN,NaN,-65.08852280422099,-65.47296763151326,0.012146620678202602,-0.9055236388880843,-0.9176702595662869,1756988301,1731080182.6,39.49713097162547,47.800749163060196,NaN,NaN,-16.032292735902058,-16.804630015383527
2005-04-28T09:30:00-04:00,115.27,115.67999,114.2,114.2,74218192,78200321.6,39.499401260614576,40.838676280465265,NaN,NaN,-88.94413981770133,-65.85636251439557,-0.045585035353945313,-0.9746515537587186,-0.9290665184047733,1682770109,1710705808.2,36.388861542984344,46.706242822959005,NaN,NaN,-16.882128805713783,-16.81570127114499
2005-04-29T09:30:00-04:00,115.07001,115.87,113.97,115.75,104283312,78544746.4,46.52765360849485,40.85998698949508,NaN,NaN,-59.80193259055079,-61.69829245868742,0.028007024994581742,-0.8940577371615461,-0.9220647621561279,1787053421,1729155997,40.92278647497418,45.58116649348868,NaN,NaN,-15.178392919630815,-16.581800078071538
2005-05-02T09:30:00-04:00,116.07001,116.41,115.52,116.39999,56057104,77767126.4,49.1931004601233,40.79252578609526,NaN,NaN,-13.557750562658176,-56.803652270433474,0.12255205991102869,-0.768874687267342,-0.8914267471783707,1843110525,1748344905.8,45.29035009794865,44.38517438965026,NaN,NaN,-12.92828288460766,-16.05986905043384
2005-05-03T09:30:00-04:00,116.07001,116.85001,115.69,116.60001,86824192,79604340.8,50.01875670852222,41.329424831721376,NaN,NaN,4.384850961019076,-44.60149896282245,0.1962784512792033,-0.6460786830793666,-0.8423571343585698,1929934717,1799971414.6,54.941940506980295,43.77695275103265,NaN,NaN,-10.896561676201644,-15.322253711257812
2005-05-04T09:30:00-04:00,116.64999,117.75,116.28,117.5,82477632,81062637.6,53.667250380065845,42.58835408368103,NaN,NaN,54.718660856641286,-20.64006223064999,0.29731435278178364,-0.47071419338134035,-0.768028546163124,2012412349,1851056224.2,62.07207519870535,44.01342124858326,NaN,NaN,-8.038473155879593,-14.281713631918066
2005-05-05T09:30:00-04:00,117.67,118,116.74001,117.46001,97322816,83567503.2,53.480440465740216,44.21421495971644,NaN,NaN,78.08154519850618,12.765074772591518,0.3495058900669855,-0.3311461835793921,-0.6806520736463776,1915089533,1897520109,67.1619898987053,45.11802144611649,NaN,NaN,-5.815189651840128,-13.072210206192647
2005-05-06T09:30:00-04:00,117.92999,117.99001,117.06,117.09,69602880,83833207.2,51.68767166186423,45.547592719496606,NaN,NaN,84.41083115118167,41.60762752093801,0.3464890594720653,-0.247540749306296,-0.5940298087783613,1845486653,1909206755.4,68.31379940750809,46.601462362627096,NaN,NaN,-4.470556750508598,-11.843402569666354
2005-05-09T09:30:00-04:00,117.21001,118.08,117.05,117.82001,43971808,83738897.6,54.8999030225791,46.70320995737806,NaN,NaN,106.18290440534214,65.55575851453808,0.3784378285971931,-0.12098252303186996,-0.49942035162906306,1889458461,1918476342.6,69.23553914237748,48.460600903232674,NaN,NaN,-2.3849666036867863,-10.492197431669274
2005-05-10T09:30:00-04:00,117.36,117.5,116.39,116.60001,75030624,83163044.8,49.032467769502226,47.82566523274255,NaN,NaN,60.11058572650835,76.70090546763592,0.30531993197768703,-0.1177704366569543,-0.42309036863464133,1814427837,1895374966.6,64.22157490548912,50.32827861935663,NaN,NaN,-2.2706059916559487,-9.317684368810227
2005-05-11T09:30:00-04:00,116.92999,117.39999,115.85001,117.24001,92009312,84460600.8,51.934580588366345,48.34093233871824,NaN,NaN,66.76897313048475,79.11096792240463,0.2881862145274071,-0.06285760047538247,-0.3510438150027896,1906437149,1874179926.6,59.93312674805768,51.86671246018438,NaN,NaN,-1.315663271679738,-8.174538497791586
2005-05-12T09:30:00-04:00,117.32001,117.59,115.41,115.95,95571312,84257225.6,46.221591827559884,48.561101413029505,NaN,NaN,27.57282299075035,69.00922348085346,0.18321490974576032,-0.12202517782058919,-0.3052400875663495,1810865837,1853335187.4,55.97439963505141,52.95608563253963,NaN,NaN,-2.233937103370385,-7.325881155731414
2005-05-13T09:30:00-04:00,116.3,116.62,114.8,115.72,85440496,81827809.6,45.26551315247286,48.4622733078956,NaN,NaN,-23.41914346446919,47.44322855772329,0.09592125415865904,-0.18533851986802574,-0.2812597740266848,1725425341,1829322925,51.73509001114076,53.73077992883446,NaN,NaN,-3.26293017797407,-6.745459587480365
2005-05-16T09:30:00-04:00,115.7,116.84,115.66,116.8,49351008,79279619.2,50.44856520704678,49.033383123101956,NaN,NaN,29.255429353155776,32.05773354728602,0.10766619994556514,-0.14667702409472838,-0.2543432240402935,1774776349,1806386502.6,47.99582348973568,54.54889200223456,NaN,NaN,-2.6016434964681334,-6.1534858601929034
2005-05-17T09:30:00-04:00,116.42999,117.7,116.16,117.58,61411904,78930358.4,53.84773654019467,49.694616618081945,NaN,NaN,83.48610227494184,36.732836856972725,0.16148024071778416,-0.05249292314306331,-0.21397316386084747,1836188253,1810738585.8,48.75270578588727,55.21000448896755,NaN,NaN,-1.009435980087106,-5.418621591606361
2005-05-18T09:30:00-04:00,118.07001,119.08,118.00999,118.78999,78052688,77091886.4,58.59302077848955,51.05844658364445,NaN,NaN,189.46329642242173,61.27170151536012,0.265914265404494,0.11841966789476999,-0.147494597509724,1914240941,1812299344.2,49.03915649796152,56.113596985751634,NaN,NaN,1.8727742117582207,-4.376993619697135
2005-05-19T09:30:00-04:00,119.02,119.41,118.7,119.28999,62850096,75861416,60.404717820469,52.04966545592831,NaN,NaN,190.94356602417446,93.94585012204493,0.3506853356599468,0.29086207206520953,-0.059823263594737275,1977091037,1845544384.2,54.83074569193061,57.10702264410566,NaN,NaN,4.802680906112303,-3.0656115445815013
2005-05-20T09:30:00-04:00,119.34,119.39,118.74001,119.12,46424800,73690680.8,59.452318934632444,52.78246677553609,NaN,NaN,161.26116130072376,130.8819110750835,0.3751317280347624,0.4090913964487157,0.03395966841395333,1930666237,1886592563.4,60.76049558792783,58.212033036247036,NaN,NaN,6.909175073350282,-1.6406420277341036
2005-05-23T09:30:00-04:00,119.21001,120.03999,119.19,119.78,51291600,73637085.6,61.96011631371681,53.63542103305,NaN,NaN,168.6637852655562,158.7635822575636,0.41259928241566085,0.5497087714335294,0.1371094890178685,1981957837,1928028861,65.66111892876788,58.97768863780329,NaN,NaN,9.444759711850802,-0.05701320779340291
2005-05-24T09:30:00-04:00,119.44,119.83,119.2,119.5,50997600,72418775.2,60.25742557223715,54.106147832490805,NaN,NaN,138.46003570151962,169.75836894287914,0.3953351365538126,0.6312784097101343,0.2359432731563217,1930960237,1946983257.8,67.65132486335028,59.376206470992216,NaN,NaN,11.080496344405201,1.5340595853778263
2005-05-25T09:30:00-04:00,119.35001,119.87,118.83,119.41,48481008,70583519.2,59.68963052197653,54.549661407936256,NaN,NaN,114.81297180657845,154.82830401971052,0.3558955437438624,0.6808127028361497,0.3249171590922873,1882479229,1940630915.4,66.26518858556761,59.31214923433953,NaN,NaN,12.283531373724834,3.0696984122845414
2005-05-26T09:30:00-04:00,119.78999,120.21001,119.62,120.05,43554192,69050319.2,62.402693703363994,55.315020125186244,NaN,NaN,128.80256598773812,142.40010401242324,0.3504000356749825,0.7629172036860155,0.41251716801103294,1926033421,1930419392.2,63.995226935979055,59.00367977208746,NaN,NaN,14.084435687891936,4.643232308799884
2005-05-27T09:30:00-04:00,120.06,120.25,119.8,120.25,24641504,65068228.8,63.23542968113079,55.91041488651137,NaN,NaN,118.34668554066326,133.81720886041114,0.33758970128978016,0.8345042946232581,0.496914593333478,1950674925,1934421129.8,64.50832728795223,58.66602178248564,NaN,NaN,15.827452704497045,6.240978079613764
2005-05-31T09:30:00-04:00,120.08,120.17,119.39999,119.48,44926800,64511713.6,57.91679084369183,56.545009391810616,NaN,NaN,85.58166344394145,117.20078449608818,0.25819354525803584,0.8196565249060228,0.561462979647987,1905748125,1919179187.4,60.94576738207236,58.43203553081302,NaN,NaN,15.927348802882104,7.624745325794955
2005-06-01T09:30:00-04:00,119.52,120.92,119.45,120.5,69917680,63666388,62.425269619651985,57.29434432261674,NaN,NaN,104.1976234917621,110.34830205413668,0.25486990681186894,0.8800503631628231,0.6251804563509542,1975665805,1928120301,62.2623766880521,58.5984105265269,NaN,NaN,17.312645512169116,9.00873106670555
2005-06-02T09:30:00-04:00,120.23,120.84,120.10001,120.75999,40481008,61566556.8,63.49869227874488,58.52842292627281,NaN,NaN,105.70178547528897,108.5260647878788,0.2503183164875903,0.9380783519604421,0.6877600354728518,2016146813,1954853817.8,65.95773399708534,59.31150583810076,NaN,NaN,18.771142751015148,10.403361307321207
2005-06-03T09:30:00-04:00,120.55,120.89,119.73,120.14999,61052000,59753016,59.223764615711474,59.52544088793271,NaN,NaN,82.81441521175893,99.32843463268294,0.18914441617925803,0.9241905556969243,0.7350461395176663,1955094813,1960666096.2,66.72074445804927,60.38190972716564,NaN,NaN,18.825209934221824,11.60648253973558
2005-06-06T09:30:00-04:00,120.02,120.2,119.55,120.03999,36332000,58089472,58.45946027867805,60.097647678763515,NaN,NaN,62.073883089816974,88.07387414251369,0.12716531939297304,0.8940027887588826,0.7668374693659096,1918762813,1954283673.8,64.99794210473874,61.59634677109443,NaN,NaN,18.660286933672502,12.614168881726568
2005-06-07T09:30:00-04:00,120.39,121.25,120.00999,120.13,66684192,59225091.2,58.92656483128303,60.460421128126974,NaN,NaN,81.31181009691053,87.21990347310751,0.08040492317705972,0.8673436233372342,0.7869387001601745,1985447005,1970223449.8,67.27089314517931,62.9190744396153,NaN,NaN,18.643797614583463,13.47554441499184
2005-06-08T09:30:00-04:00,120.42999,120.59,119.67,119.91,50022192,57974669.6,57.232608887847604,60.363248850223975,NaN,NaN,57.83767130879328,77.94791303651374,0.025667197836688027,0.8190226974560346,0.7933554996193466,1935424813,1962175251.4,64.97657081066751,64.05746117623715,NaN,NaN,18.188105557271804,14.148767435317549
2005-06-09T09:30:00-04:00,119.74001,120.58,119.44,120.48,57162896,56232348.8,60.408257633260575,60.3635016939948,NaN,NaN,60.861687051270714,68.97989335171009,0.01915633283993423,0.8173009156692643,0.7981445828293301,1992587709,1957463430.6,63.608781856196245,64.68446375939898,NaN,NaN,18.61698620923028,14.787084403019367
2005-06-10T09:30:00-04:00,120.56,120.64999,119.60001,120.2,36504096,53278988,58.12502221750564,60.2686947856286,NaN,NaN,57.022853051149696,63.82158091958824,-0.011074235503627738,0.7843017884497954,0.7953760239534231,1956083613,1957661190.6,63.64337422055426,64.89038366172944,NaN,NaN,18.38220429058539,15.300672958385942
2005-06-13T09:30:00-04:00,119.94,121.08,119.81,120.58,49501696,51482048,60.317157751756994,60.15134060263147,NaN,NaN,82.32525694683082,67.87185569099101,-0.012442219489298467,0.7798232495918,0.7922654690810985,2005585309,1975025689.8,66.64180919198154,64.96043296624471,NaN,NaN,18.753865382013103,15.79398616176125
2005-06-14T09:30:00-04:00,120.45,121.2,120.38,120.86,34001600,50714577.6,61.89985749014131,60.26865716819605,NaN,NaN,116.26607824161911,74.86270931993273,-0.0020013908263512015,0.7897637305481595,0.7917651213745107,2039586909,1985853670.6,68.39235355424444,65.01336358702287,NaN,NaN,19.491459229243087,16.32219659997294
2005-06-15T09:30:00-04:00,121.16,121.24001,120.23,121.09,53889904,50338477.6,63.19828672540589,60.519275468441,NaN,NaN,127.91949021173954,88.87907310052199,0.012107325722524487,0.8068992785276663,0.7947919528051418,2093476813,2017464070.6,72.8685650136239,65.48503333188403,NaN,NaN,20.466623632924914,16.914257604680365
2005-06-16T09:30:00-04:00,121.09,121.64,120.92,121.39999,46642304,48767958.4,64.9328748930447,60.70000269627534,NaN,NaN,184.04558378909422,113.51585244808669,0.032852580988855795,0.8358576790412116,0.8030050980523558,2140119117,2046970352.2,76.24966047812055,66.36035001346555,NaN,NaN,21.774180312246276,17.60853227718978
2005-06-17T09:30:00-04:00,121.53999,121.89999,120.49001,121.36,53732800,48312093.6,64.51045259542803,60.79107576158229,NaN,NaN,155.3052781193902,133.1723374617348,0.03426020593081813,0.8458303554658784,0.8115701495350602,2086386317,2073030893,78.76652256186462,67.37879253303073,NaN,NaN,22.77467854938807,18.34655317321811
2005-06-20T09:30:00-04:00,121.08,121.84,120.94,121.39999,42228096,48102258.4,64.75736068059538,61.27968789278968,NaN,NaN,155.2258118673869,147.752448445846,0.028499639604874893,0.8471946990411539,0.818695059436279,2128614413,2097636713.8,80.83193584783496,68.79923313772805,NaN,NaN,23.69091977421638,19.11003411621786
2005-06-21T09:30:00-04:00,121.5,121.64999,121.03,121.47,40059200,47540638.4,65.21364664681406,61.478857680444115,NaN,NaN,132.91839611166662,151.0829120198555,0.020399018093099408,0.8441938320526532,0.8237948139595538,2168673613,2123454054.6,82.7301009100866,70.26121343930194,NaN,NaN,24.594206726169627,19.89348734621097
2005-06-22T09:30:00-04:00,121.67999,121.94,121.07001,121.57001,46678400,47324678.4,65.89297625408886,61.649877964397255,NaN,NaN,134.12324900955025,152.32366377941767,0.013124379716530798,0.8402002886052173,0.8270759088886865,2215352013,2147829094.6,84.30989367539436,71.57208198775258,NaN,NaN,25.54638810188214,20.701044597021138
2005-06-23T09:30:00-04:00,121.32001,121.60001,119.83,119.86,62813392,48041297.6,48.465212437073546,60.8814099516374,NaN,NaN,-17.712258081463375,111.97209540530613,-0.10879236084776855,0.6910854578289758,0.7998778186767443,2152538621,2150312995.4,84.46583877163144,72.83958872443704,NaN,NaN,21.319819742465846,20.78944104637038
2005-06-24T09:30:00-04:00,119.88,120.0078,118.84,118.98,59186608,48822918.4,42.269411596335786,59.724977902898665,NaN,NaN,-167.64888525569023,47.38126273029005,-0.24295621413641277,0.4961825510062283,0.7391387651426411,2093352013,2151706134.6,84.55853865404964,74.23677419224495,NaN,NaN,15.490551275117223,20.032456793334216
2005-06-27T09:30:00-04:00,118.97,119.41,118.75,119.14999,51163600,50149023.2,43.764957478929595,58.64200594915913,NaN,NaN,-169.8255712771282,-17.62901389861297,-0.31020157434111284,0.3513867972162501,0.6615883715573629,2144515613,2154886374.6,84.78179553661079,75.48755293449005,NaN,NaN,11.222239222335924,18.773854283191604
2005-06-28T09:30:00-04:00,119.39999,120.24001,119.37,120.14999,42615392,50033452.8,51.6929868854458,58.24631866327329,NaN,NaN,-71.23822129258447,-58.46033737946319,-0.27830229532726647,0.3137105023982798,0.5920127977255463,2187131005,2158577853,85.05195853687424,76.92150920064769,NaN,NaN,9.918369217208058,17.508784988051097
2005-06-29T09:30:00-04:00,120.37,120.39999,119.75999,119.83,43059008,48690519.2,49.297971205272376,57.452726775559846,NaN,NaN,-58.200144633961756,-96.92501610816561,-0.26953766095590603,0.2550907215306637,0.5246283824865697,2144071997,2144321849.8,79.2041577175066,78.0354646193127,NaN,NaN,8.091986381806574,16.16352804430188
2005-06-30T09:30:00-04:00,120.22,120.32001,118.95,119.17999,62301600,49781548.8,44.76120102175718,56.49816811872067,NaN,NaN,-107.019929165269,-114.78655032492672,-0.2961796048324582,0.15440387644599696,0.45058348127845516,2081770397,2130168205,73.78035150146373,78.75953442509196,NaN,NaN,5.058652657032016,14.5771172746919
2005-07-01T09:30:00-04:00,119.45,119.8,119.21001,119.53,49786400,49218268.8,47.55971740984343,55.58692238001255,NaN,NaN,-93.30169291216583,-99.91711185622185,-0.27912309789233936,0.10167960891303096,0.3808027068053703,2131556797,2137809161.8,74.78425534705632,79.34113772188302,NaN,NaN,3.43912007278945,12.985974817277265
2005-07-05T09:30:00-04:00,119.25,120.64999,119.19,120.49001,51550192,49979178.4,54.38569252206432,55.0501963108642,NaN,NaN,-30.180707981030057,-71.98813919700221,-0.1960064259086618,0.13579467441954307,0.33180110032820487,2183106989,2145527437,75.7925144073717,79.86972063996352,NaN,NaN,4.261821827120241,11.739667247254832
2005-07-06T09:30:00-04:00,120.39,120.64999,119.41,119.48,54068800,49348408.8,47.39574897966314,53.921443614739715,NaN,NaN,-53.932682268657054,-68.52703139221674,-0.20111697134433226,0.08040488614778951,0.2815218574921218,2129038189,2133908873.8,71.17862901464378,79.74901092575067,NaN,NaN,2.5736144795494282,10.430231137582632
2005-07-07T09:30:00-04:00,118.28999,119.95,118.25999,119.95,103262368,52010417.6,50.57890713735359,52.896160203618926,NaN,NaN,-94.70826216964889,-75.82865489935416,-0.1663495572904469,0.07358491087906316,0.23993446816951006,2232300557,2151554585.8,73.78841675800979,79.5732078028856,NaN,NaN,2.278802340782169,9.26574130946828
2005-07-08T09:30:00-04:00,119.97,121.32001,119.72,121.32001,64550608,52379803.2,58.468056722468326,52.464560498407515,NaN,NaN,43.092525506851636,-45.80616396493003,-0.050594296185444365,0.17669159793770461,0.22728589412314898,2296851165,2194570739.4,78.8227052903976,79.57722085492368,NaN,NaN,4.8666855579781325,8.637304773541116
2005-07-11T09:30:00-04:00,121.33,122.10001,121.31,121.94,49762496,53042723.2,61.46589853962869,52.22945605976703,NaN,NaN,123.85046096233482,-2.3757331900298966,0.062105286810907545,0.3049175026367834,0.24281221582587587,2346613661,2237582112.2,82.45190757211896,79.69293312094396,NaN,NaN,8.00823933534788,8.547438282370655
2005-07-12T09:30:00-04:00,121.89,122.63,121.64,122.25999,52165008,53175888.8,62.95226049451995,52.06792847746031,NaN,NaN,136.37129397016307,30.934667200208736,0.1476948819426207,0.42743081825415175,0.27973593631153104,2398778669,2280716448.2,85.19251319956552,79.8688197130496,NaN,NaN,10.986275535389218,8.89584360423045
2005-07-13T09:30:00-04:00,122.27,122.52,121.99001,122.42999,41266000,53539108.8,63.752201892365974,51.915016023051535,NaN,NaN,129.46807179905926,67.614818013752,0.20189707597406326,0.5321072812791101,0.33021020530504686,2440044669,2342917744.2,88.08285849068783,80.13831719985627,NaN,NaN,13.598876008205696,9.567705376226913
2005-07-14T09:30:00-04:00,122.98,123.44,122.49001,122.91,64775808,54083404,65.98549951157068,53.16646509980133,NaN,NaN,151.36529993396027,116.82953043447382,0.2529088361792361,0.646346250529092,0.3934374143498559,2504820477,2397421728.2,89.93651865956338,80.52908004899427,NaN,NaN,16.48139745372721,10.55537567301267
2005-07-15T09:30:00-04:00,122.78999,123.03999,122.36,122.84,56137808,54558179.2,65.353140267545,54.815302862030556,NaN,NaN,124.1659545919923,133.04421625150195,0.2635699898359962,0.7228999016448512,0.45932991180885496,2448682669,2427788029,90.79554128081237,80.97458023662018,NaN,NaN,18.610323247082373,11.706082469308342
2005-07-18T09:30:00-04:00,122.5,122.63,122.05,122.35001,56816304,54712354.4,60.94999610098318,56.04280562074867,NaN,NaN,90.44896016184451,126.3639160914039,0.2209777797896063,0.7355521365458628,0.5145743567562565,2391866365,2436838569.8,91.04100261414197,81.42166645644384,NaN,NaN,19.14010104680517,12.76808512323646
2005-07-19T09:30:00-04:00,122.71001,123.11,122.41,123.02,59507296,55576314.4,64.47453274824919,56.95577318237749,NaN,NaN,108.34529527156889,120.75871635168505,0.2207637077099659,0.7905289913937139,0.569765283683748,2451373661,2447357568.2,91.33038312709103,81.87012535574503,NaN,NaN,20.66755794394291,13.896581240480238
2005-07-20T09:30:00-04:00,122.59,123.73,122.3,123.44,69602496,57053479.2,66.5148550887777,58.18555060262787,NaN,NaN,111.57240116527605,117.17958222492841,0.23066571059551033,0.8580974219281359,0.6274317113326255,2520976157,2463543865.8,91.77085906393081,82.76774688048963,NaN,NaN,22.568358153557178,15.135406513776942
2005-07-21T09:30:00-04:00,123.55,123.61,122.47,122.72,100791120,59759115.2,60.138407436694855,59.28392248940913,NaN,NaN,91.05923986813356,105.11837021176306,0.1731113233692957,0.8438208655442452,0.6707095421749495,2420185037,2446616777.8,86.80400434835533,83.69800779812475,NaN,NaN,22.27264401368727,16.15501187090699
2005-07-22T09:30:00-04:00,122.88,123.56,122.63,123.53999,55933008,59415096,64.33211592715648,60.481950954931484,NaN,NaN,93.92881664403541,99.0709426221717,0.17417768213077622,0.8884316448384197,0.7142539627076435,2476118045,2452103853,87.04870393436029,84.57403984007503,NaN,NaN,23.338020646282175,17.181155981674873
2005-07-25T09:30:00-04:00,123.41,123.95,122.85001,123.19,57591504,59335340.8,61.364598662420995,60.98044425067125,NaN,NaN,89.19171074365946,98.81949273853468,0.13686811203291505,0.8853391027487874,0.7484709907158723,2418526541,2457435888.2,87.295247715022,85.39566364776434,NaN,NaN,23.297080289328736,18.054859454196855
2005-07-26T09:30:00-04:00,123.23,123.53,122.37,123.34,42847504,58919536,62.17001764997498,62.035749155693516,NaN,NaN,71.97868906557004,91.54617149733492,0.10905732612629948,0.8847926483737467,0.7757353222474472,2461374045,2459435965,87.39220009520263,86.55377586780426,NaN,NaN,23.500419360914506,18.832796583727948
2005-07-27T09:30:00-04:00,123.5,123.89,123.05,123.78999,45262704,59051901.6,64.55707204052429,63.03418950591999,NaN,NaN,89.81070772882457,87.19383281004463,0.10755417874347173,0.910178045676787,0.8026238669333152,2506636749,2456568083.4,86.37436743513051,87.45277234474146,NaN,NaN,24.375248366768158,19.62457540987655
2005-07-28T09:30:00-04:00,123.99001,124.64,123.64,124.57001,48448496,59321376,68.29200273302135,63.73589993524521,NaN,NaN,116.93207121444775,92.36839907930747,0.14343555285376064,0.981918308000516,0.8384827551467554,2555085245,2483548125,87.81245704825733,88.09489747030287,NaN,NaN,26.29394707883355,20.57734279115612
2005-07-29T09:30:00-04:00,124.41,124.63,123.5,123.74001,62446304,59328611.2,60.93385281842947,63.69789666944528,NaN,NaN,97.21927285255656,93.02649032101169,0.09779322611667662,0.9607242877926012,0.8629310616759246,2492638941,2486852304.2,87.9797768980381,88.48974527929711,NaN,NaN,25.648352483289187,21.30177274717513
2005-08-01T09:30:00-04:00,123.83,124.03999,123.45,123.64999,42940704,58986326.4,60.17654639263613,63.49963137645357,NaN,NaN,80.2526890565707,91.23868598359395,0.05044697358086825,0.9259897786520099,0.8755428050711417,2449698237,2493086643.4,88.30599357036341,88.71213673435409,NaN,NaN,24.9038650729398,21.81635736514151
2005-08-02T09:30:00-04:00,123.87,124.60001,123.74001,124.39,46241200,58720876.8,64.12386281925558,63.526178585517115,NaN,NaN,109.36658943842691,98.71626605816532,0.057370298800259345,0.9472556785714659,0.8898853797712065,2495939437,2499999721.8,88.67308234624143,88.75429558117935,NaN,NaN,25.460915822692947,22.337008573363143
2005-08-03T09:30:00-04:00,124.25,124.74001,124.12,124.72,37197600,57877316.8,65.75403495325176,63.50964540278005,NaN,NaN,129.03745657671777,106.56161582774396,0.07164917297425966,0.9794468459890311,0.9077976730147714,2533137037,2505299779.4,88.95923689868897,88.68448974111689,NaN,NaN,26.413616460906614,22.919381128726496
2005-08-04T09:30:00-04:00,124.23,124.31,123.57001,123.72,51043696,55266383.2,57.26279566418936,62.93176364539751,NaN,NaN,74.03178702374117,97.98155898960265,0.004749044717583195,0.9137339789117505,0.9089849341941673,2482093341,2490701398.6,82.75760995337129,88.11035178915681,NaN,NaN,24.55950182911907,23.153684085925434
2005-08-05T09:30:00-04:00,123.45,123.98,122.67,122.88,53711104,54724408,51.27313136112491,62.24055902112192,NaN,NaN,-4.059187869725276,77.72586684514629,-0.09932549211630548,0.7848280690487854,0.8841535611650909,2428382237,2477850057.8,77.62714595673016,87.15221917077024,NaN,NaN,20.986991485276363,22.844156571546996
2005-08-08T09:30:00-04:00,123.17,123.41,122.38,122.64999,48227008,54647633.6,49.73894327812833,61.188016916113284,NaN,NaN,-55.72776987449204,50.52977505893371,-0.18208994922240307,0.6565411246370871,0.8386310738594902,2380155229,2463941456.2,72.39615560031461,85.79977434742908,NaN,NaN,17.635043094323848,22.09999750337226
2005-08-09T09:30:00-04:00,123.06,123.59,122.87,123.39,47522304,54415498.4,54.460178528840885,60.32696859040352,NaN,NaN,-4.808830975208323,27.69469097620665,-0.1848395815130074,0.607581596968231,0.7924211784812384,2427677533,2450289075.4,67.58209492570128,84.0720054804127,NaN,NaN,16.237534148554815,21.26250273839834
2005-08-10T09:30:00-04:00,123.82001,124.5,122.82001,123.33,73115632,56007980,54.017127391330824,59.88973430144893,NaN,NaN,24.149756393451796,6.717150939553457,-0.18792681392108412,0.5575126610798833,0.7454394750009674,2354561901,2414574048.2,56.919055499760056,81.93736627694159,NaN,NaN,14.99174860885353,20.36668071989194
2005-08-11T09:30:00-04:00,123.27,124.03,123.00999,123.82001,58860304,55712204.8,57.087538958187295,59.37226451795114,NaN,NaN,29.742606782261905,-2.1406851087423995,-0.15553513321918033,0.551020558476992,0.7065556916961724,2413422205,2400839821,53.42800411401493,79.53588771834549,NaN,NaN,14.845843438447353,19.57798967968557
2005-08-12T09:30:00-04:00,123.57001,123.69,122.75,123.06,54814608,55646044.8,51.35932953566373,58.65760243746847,NaN,NaN,-40.57405632350826,-9.443658799498996,-0.18202284264304347,0.4790271383923681,0.6610499810354116,2358607597,2386884893,50.06780390090963,76.87678458876603,NaN,NaN,12.950915852345657,18.63126484720844
2005-08-15T09:30:00-04:00,123.22,123.87,122.83,123.82001,36227504,54616604.8,56.10282827466228,58.22423176780328,NaN,NaN,2.218879416955668,2.145671058790545,-0.14660749138358276,0.47779061680593315,0.6243981081895159,2394835101,2389820867.4,50.769325963433914,74.2608650079254,NaN,NaN,12.801677025537742,17.798466586969766
2005-08-16T09:30:00-04:00,123.44,123.52,122.09,122.21001,72265008,55254490.4,45.89264422050037,56.891058352087285,NaN,NaN,-144.8668359544113,-25.865929937050044,-0.2251633854795092,0.34294387634012935,0.5681072618196386,2322570093,2368799379.4,45.806968033253185,71.36319362207702,NaN,NaN,9.095781563442817,16.55522586932306
2005-08-17T09:30:00-04:00,122.19,122.87,122.03,122.2,62507696,54899750.4,45.83679001272835,55.28711458635207,NaN,NaN,-162.15586979043363,-63.127055173827124,-0.26841540156527033,0.23258800986305062,0.5010034114283209,2260062397,2349899478.6,41.8466660285829,68.07992283495743,NaN,NaN,6.240709088984955,15.081723472131902
2005-08-18T09:30:00-04:00,122.05,122.56,121.84,122.19,53546096,52537499.2,45.776851034515126,54.20447160178676,NaN,NaN,-168.22065375670442,-102.71970728162039,-0.28665987753859623,0.14267856450507566,0.4293384420436719,2206516301,2308518297.8,34.76050694378117,64.27854640965336,NaN,NaN,3.9723730943921467,13.49467341816908
2005-08-19T09:30:00-04:00,122.63,122.82001,122.2,122.47,39955808,51738639.2,47.83381612745556,53.322848011416724,NaN,NaN,-112.50230121362436,-117.10535625964363,-0.26911322791455594,0.09294690715047693,0.3620601350650329,2246472109,2286091200.2,31.634002455140404,60.230547044280286,NaN,NaN,2.688936971228142,11.950996782891803
2005-08-22T09:30:00-04:00,122.58,123.23,121.88,122.47,69948320,52356480,47.83381612745556,52.15927324771672,NaN,NaN,-95.976844192669,-136.74450098156854,-0.24730880090968155,0.05292413392793094,0.3002329348376125,2246472109,2256418601.8,28.040441679730094,55.89964413952948,NaN,NaN,1.6462673321828374,10.478892575647665
2005-08-23T09:30:00-04:00,122.5,122.61,121.14999,122.24001,56743296,53051269.6,46.16549380647022,50.760091737232315,NaN,NaN,-138.88659773733306,-135.5484533381529,-0.23809246334178874,0.0026173556603765746,0.24070981900216532,2189728813,2229850345.8,25.2721882305525,51.35056923466259,NaN,NaN,0.30646695529871326,9.025688915597815
2005-08-24T09:30:00-04:00,121.94,122.73,121.09,121.14999,79135312,54744900,39.189244144154884,49.46912377151557,NaN,NaN,-149.7581839652834,-133.06891617312286,-0.2915916765337576,-0.1237797766650317,0.1678118998687259,2110593501,2199956566.6,22.572003000195096,47.05159730943573,NaN,NaN,-3.048613013147416,7.300788640062782
2005-08-25T09:30:00-04:00,121.35001,121.67,121.21001,121.59,35642000,54104575.2,42.93781472294989,48.87374401164593,NaN,NaN,-143.54448095365288,-128.13368161251256,-0.2832877281964118,-0.1862977603767888,0.09698996781962296,2146235501,2187900406.6,21.571003362605595,43.04758712414111,NaN,NaN,-4.787283801522889,5.5739211484076865
2005-08-26T09:30:00-04:00,121.48,121.49001,120.67999,120.75999,61962304,54080375.2,38.159317375799795,48.04662787576532,NaN,NaN,-164.26904507705825,-138.48703038519935,-0.3170861015981121,-0.2993676591780172,0.017718442420094918,2084273197,2155460624.2,19.11468537940432,39.24176782264751,NaN,NaN,-7.81498243602114,3.6612206363464255
2005-08-29T09:30:00-04:00,120.41,121.78,120.38,121.69,56183392,54742509.6,45.48066366734318,47.405233957086914,NaN,NaN,-122.5202730607261,-143.79571615881076,-0.2624585599876051,-0.31035475756441144,-0.047896197576806354,2140456589,2134257520.2,17.696273809276647,35.67849488576005,NaN,NaN,-8.115607866372871,1.9788165645293831
2005-08-30T09:30:00-04:00,121.25,121.3,120.39,121.05,74179872,56139443.2,41.81210285059657,46.53344648989161,NaN,NaN,-138.8305664564618,-143.78450990263647,-0.2548672081633056,-0.36648020778093837,-0.11161299961763275,2066276717,2109567101,16.189708878511,32.769255841385124,NaN,NaN,-9.550317179653375,0.3317974582175607
2005-08-31T09:30:00-04:00,121.19,122.66,120.74001,122.58,102979312,59428528.8,51.8178828400871,46.15704248145588,NaN,NaN,-43.38422645376333,-122.50971840033246,-0.1380899556552446,-0.2842254441866885,-0.1461354885314439,2169256029,2121299606.6,19.688598323366435,30.35929828491022,NaN,NaN,-7.3126922933897704,-0.7602725062977722
2005-09-01T09:30:00-04:00,122.50999,123.14999,121.14,122.49001,74582624,60605475.2,51.25956601455003,46.149916515662035,NaN,NaN,-13.14396944276268,-96.42961609815443,-0.06206799468907176,-0.2237204818927836,-0.16165248720371184,2094673405,2110987187.4,18.940135183151725,28.135893376498945,NaN,NaN,-5.774981625364623,-1.476659523307322
2005-09-02T09:30:00-04:00,122.85001,122.88,122.03999,122.27,47656304,60302735.2,49.84553110423993,45.70296671777472,NaN,NaN,4.304708520660846,-62.71486537861061,-0.023731964848922177,-0.19131744326486455,-0.16758547841594237,2047017101,2103535968.2,18.39597118750183,25.823510892503794,NaN,NaN,-4.982430871141758,-1.9774840015693842
2005-09-06T09:30:00-04:00,122.66,123.8,122.64999,123.7,57253808,60754075.2,57.96260190407372,46.565106552315676,NaN,NaN,99.46890573685425,-18.31702961909454,0.09432748885188721,-0.04967611735108335,-0.14400360620297056,2104270909,2096298832.2,17.859267656142862,23.827246579853057,NaN,NaN,-1.4857713855366692,-1.907239342136139
2005-09-07T09:30:00-04:00,123.63,124.13,123.46001,123.91,41754304,60465675.2,59.011703406401644,47.50617179472091,NaN,NaN,135.64801513352842,36.5786866989035,0.17809462719704816,0.07861467779333964,-0.09947994940370852,2146025213,2112248531.4,23.17868328830467,22.49381924126175,NaN,NaN,1.6128027823403728,-1.4043761814966373
2005-09-08T09:30:00-04:00,123.66,124,123.31,123.5,39070800,58763433.6,56.069597092094526,48.24136794169086,NaN,NaN,112.98159526605518,67.8518510428672,0.19600392957198123,0.145524962561268,-0.050478967010713215,2106954413,2099788208.2,21.981072428101925,21.581002490141806,NaN,NaN,3.2460052723397594,-0.7400359738057235
2005-09-09T09:30:00-04:00,123.83,124.74001,123.8,124.60001,44112304,58026033.6,61.60102551472083,49.22474004078124,NaN,NaN,172.8486498364599,105.05037489871172,0.26761455895316,0.28403923168073675,0.01642467272757677,2151066717,2111066870.6,25.72217090094891,21.15872880769956,NaN,NaN,6.515178750272694,0.2964232724911934
2005-09-12T09:30:00-04:00,124.45,124.67,124.27,124.35001,33024608,56936533.6,59.759379124988946,50.07656596917649,NaN,NaN,156.6462290639233,135.5186790073642,0.2823657601679576,0.3693818729375238,0.08701611276956617,2118042109,2125271872.2,30.258051495892886,21.317129508854045,NaN,NaN,8.56367434621638,1.47745914016622
2005-09-13T09:30:00-04:00,124.13,124.42,123.52,123.66,58479008,58049108.8,54.88239421067321,50.699201712333846,NaN,NaN,106.1961714734766,136.86413215468866,0.23198131207479533,0.37699275286306033,0.145011440788265,2059563101,2116330310.6,29.055277026573208,21.58735013714124,NaN,NaN,8.77737038537619,2.5203036037676445
2005-09-14T09:30:00-04:00,123.75,123.92,123.02,123.21001,55195392,57195628,51.90726622317996,51.607631860835646,NaN,NaN,60.94300917390645,121.92313096276428,0.15820112024233718,0.3427628410911865,0.1845617208488493,2004367709,2087998809.8,25.584961927393422,21.802561489083978,NaN,NaN,8.035331943281658,3.3081647951267894
2005-09-15T09:30:00-04:00,123.50999,123.64999,122.89999,123.14999,73655808,57753033.6,51.50620564664301,52.21965978395658,NaN,NaN,44.83292468096493,108.29339684574623,0.09815101106195115,0.30725048467628824,0.2090994736143371,1930711901,2052750307.4,22.05544347819651,21.837164354483324,NaN,NaN,7.321742406133196,3.8815330252705618
2005-09-16T09:30:00-04:00,123.28,123.74001,122.87,123.5,75425808,58847019.2,53.750392497494566,53.33330800693478,NaN,NaN,49.274991287254316,83.57866513590511,0.07579802833035398,0.30384700902727957,0.22804898069692559,2006137709,2023764505.8,19.65430256647801,21.87570843927431,NaN,NaN,7.361135307254356,4.378619065553961
2005-09-19T09:30:00-04:00,123.47,123.55,122.64,123.09,53373696,59517913.6,50.785553434482864,53.712228704587616,NaN,NaN,27.230349110572153,57.69548914523489,0.029569832716504235,0.2650112715925559,0.23544143887605165,1952764013,1990708886.6,17.33635169735315,21.849999716994056,NaN,NaN,6.546673969303756,4.688341194661074
2005-09-20T09:30:00-04:00,123.21001,123.61,121.87,122.05,84997120,60270353.6,44.13527954790942,53.87816989725281,NaN,NaN,-13.463668983944562,33.763521053750665,-0.06947204922490749,0.1486013773449173,0.21807342656982479,1867766893,1952349645,15.109433923747105,21.772837220225206,NaN,NaN,3.7604640148599158,4.555787311832337
2005-09-21T09:30:00-04:00,121.78999,121.87,120.78,120.91,94497808,62158079.2,38.226237370046114,52.90733807796418,NaN,NaN,-98.81127912822086,1.8126633933251952,-0.20264801300380209,-0.03523658968492782,0.16741142331887426,1773269085,1906129920.2,12.95077402073764,21.291564055751724,NaN,NaN,-0.6782752781481649,3.8080640846922655
2005-09-22T09:30:00-04:00,120.95,121.66,120.44,121.34,84600368,62431332,41.41252012592954,52.203977657348425,NaN,NaN,-97.29022833054262,-26.611967208976314,-0.24958164590040582,-0.14456563405663303,0.1050160118437728,1857869453,1891561430.6,12.351760336793447,20.82096585244042,NaN,NaN,-3.3165560004751238,2.7902612153826385
2005-09-23T09:30:00-04:00,121.24001,121.89,120.89999,121.44,59368704,63617667.2,42.15970315509759,51.6549899466954,NaN,NaN,-79.52320031011797,-52.37160552845078,-0.26049090000464026,-0.22059761316202753,0.03989328684261273,1917238157,1873781520.2,11.64391286051027,20.338675971941022,NaN,NaN,-5.207006764675976,1.6477943610885508
2005-09-26T09:30:00-04:00,122.02,122.24001,121.08,121.58,70425808,64040842.4,43.250877265444544,50.60415247250761,NaN,NaN,-69.35416226413054,-71.68850780339132,-0.24510247225747417,-0.26648480347923,-0.021382331221755813,1987663965,1880761510.6,13.733981394275062,20.044012667521894,NaN,NaN,-6.444962176365856,0.4916862843093497
2005-09-27T09:30:00-04:00,121.52,121.99001,121.02,121.55,66151376,64539241.6,43.06339950655843,49.464987908233084,NaN,NaN,-78.70318281143341,-84.73641056888908,-0.2243282185428619,-0.3017926044003332,-0.07746438585747129,1921512589,1891510649.8,16.990513213337096,19.60200051930993,NaN,NaN,-7.512494968079482,-0.6517681803176261
2005-09-28T09:30:00-04:00,121.91,122.12,121.2,121.67,58708496,63765672.8,44.10705343599254,48.6105205042258,NaN,NaN,-74.35038459424516,-79.84423166209395,-0.19118331520056414,-0.3164435298581765,-0.12526021465761233,1980221085,1932901049.8,28.226032393266365,20.04806908825024,NaN,NaN,-8.136172702934594,-1.7209688264057643
2005-09-29T09:30:00-04:00,121.55,122.86,121.08,122.66,66645632,61948988.8,51.93476293749278,47.92007317728094,NaN,NaN,-37.545437874735555,-67.89527357093253,-0.0960651259643805,-0.24534162211308796,-0.14927649614870747,2046866717,1970700502.6,36.657979985388906,20.829198308567385,NaN,NaN,-6.461102380484999,-2.398130762702798
2005-09-30T09:30:00-04:00,122.62,123.03999,122.45,123.03999,47827104,60611212.8,54.564971320108924,47.54904404836093,NaN,NaN,6.503696666298271,-50.689894175649286,-0.005799995658453072,-0.15652649072177383,-0.15072649506332075,2094693821,2006191635.4,43.383460199444315,21.7667275016782,NaN,NaN,-4.26730757789621,-2.6651560220161423
2005-10-03T09:30:00-04:00,122.96001,123.34,122.45,122.60001,51015104,60779152.8,51.07957780380764,47.277414305013394,NaN,NaN,1.668509374899609,-36.485359847843256,0.024376133605423483,-0.1202563280565414,-0.1446324616619649,2043678717,2017394585.8,45.35576037145201,22.931047740598114,NaN,NaN,-3.370645698834366,-2.7659402615616027
2005-10-04T09:30:00-04:00,122.78999,123.03,121.16,121.22,60779696,60955447.2,42.01450802214532,46.570788719225206,NaN,NaN,-64.74561854505619,-33.69384699456781,-0.04473831808394829,-0.20055535926690027,-0.15581704118295198,1982899021,2029671872.2,47.51365711567575,24.497383111189713,NaN,NaN,-5.42594065095463,-3.145940317189178
2005-10-05T09:30:00-04:00,121.25,121.31,119.57001,119.63,106061184,64170791.2,34.432389208950994,45.351230402247204,NaN,NaN,-158.06743570116342,-50.43725721595146,-0.18576219212135717,-0.38801978133464843,-0.20225758921329126,1876837837,2008995222.6,44.33805983023862,26.088998564907005,NaN,NaN,-10.026749455441976,-4.128913051225292
2005-10-06T09:30:00-04:00,119.78,120.25999,118.17,119.2,141120816,69273292,32.71302446845594,43.84856125731587,NaN,NaN,-187.13028785349653,-80.35422721170366,-0.29001291482139613,-0.5647737327400364,-0.27476081791864027,1735717021,1946765283.4,36.4434549681004,27.288223736451464,NaN,NaN,-14.262237842480157,-5.576530878547416
2005-10-07T09:30:00-04:00,119.7,120.05,119.13,119.61,75663120,70850832.8,35.9948526768416,42.79208263177007,NaN,NaN,-146.31729590549122,-110.91842572606156,-0.31148210782412755,-0.6641134526987997,-0.3526313448746722,1811380141,1890102547.4,31.02635003677196,28.26608076069566,NaN,NaN,-16.592790739882656,-7.150282287309593
2005-10-10T09:30:00-04:00,119.67999,119.71001,118.3,118.60001,52678608,71833532.8,31.871039643669434,41.91606549575293,NaN,NaN,-170.70087938274938,-145.39230347759135,-0.36985050489830185,-0.8149444759975495,-0.44509397109924764,1758701533,1833107110.6,26.7233970730731,29.09564955707609,NaN,NaN,-19.99712926898081,-8.985546141834053
2005-10-11T09:30:00-04:00,118.99001,119.39,118.32001,118.42999,75640688,72691616.8,31.222562415101876,41.415802998971195,NaN,NaN,-157.92836480177908,-164.0288527289359,-0.39383895321361106,-0.9373926626162614,-0.5435537094026504,1683060845,1773139475.4,23.094273649592736,29.82018524485145,NaN,NaN,-22.88366331854925,-10.970991452793367
2005-10-12T09:30:00-04:00,118.39,119.13,117.41,117.5,100520496,74957872,27.88086107759743,40.44925592409033,NaN,NaN,-164.8413133849498,-165.38362826569318,-0.44262307292912717,-1.0968325505640593,-0.6542094776349321,1582540349,1714279977.8,20.19529751274588,30.38043790027663,NaN,NaN,-26.47638739287065,-13.18604801566155
2005-10-13T09:30:00-04:00,117.46001,118.08,116.88,117.42999,99073120,76228737.6,27.641022151252358,39.412207280958526,NaN,NaN,-158.73898139563235,-159.70536697412038,-0.44850055289233826,-1.214835168750355,-0.7663346158580167,1483467229,1663830019.4,18.09826042623392,30.841462726399747,NaN,NaN,-29.383367291704506,-15.499950769381972
2005-10-14T09:30:00-04:00,118.12,118.81,117.56,118.67,88654368,76890165.6,37.840355861455016,39.02574146638784,NaN,NaN,-103.00509215813011,-151.04292622464814,-0.3425522356500075,-1.194524910420526,-0.8519726747705185,1572121597,1615978310.6,16.362727434548987,31.029230300705027,NaN,NaN,-28.670272526724666,-17.381425306145214
2005-10-17T09:30:00-04:00,118.77,119.27,118.45,119.11,68967808,77669871.2,41.017345959334534,38.87959478444328,NaN,NaN,-68.40158956588397,-130.58306826127506,-0.2223416844006152,-1.1298997802712876,-0.9075580958706724,1641089405,1592455885,15.572202766670756,30.92792241165743,NaN,NaN,-27.06964834622952,-18.7654571690144
2005-10-18T09:30:00-04:00,118.94,118.96001,117.8,117.82001,75013312,77170680.8,35.31803644885453,38.25180785679056,NaN,NaN,-90.94308957044683,-117.18601321500861,-0.20939063547005843,-1.1692963902082454,-0.959905754738187,1566076093,1569058934.6,14.805973842069648,29.969346800857664,NaN,NaN,-27.542648505166508,-20.019341645607557
2005-10-19T09:30:00-04:00,117.56,119.8,117.12,119.78,116569184,78274249.6,47.29976404885651,37.920736507602264,NaN,NaN,-54.80803711606785,-95.17935796123223,-0.05646330534888233,-1.03048488642429,-0.9740215810754076,1682645277,1589079920.2,18.501440653043943,28.672451134261596,NaN,NaN,-23.52541726710465,-20.520209591535714
2005-10-20T09:30:00-04:00,119.49001,119.81,117.3,117.67,132087632,80648612.8,38.9375995923485,36.80449566990509,NaN,NaN,-74.61350348049936,-78.35426237820563,-0.08342681958101628,-1.078305105551678,-0.9948782859706616,1550557645,1602498003.4,20.97550838171169,27.071883147280694,NaN,NaN,-23.29934639934653,-20.917229135508688
2005-10-21T09:30:00-04:00,118.28999,118.78,117.50999,118.13,96580624,82509208.8,41.37110060565084,36.11103301289389,NaN,NaN,-73.12226071359133,-72.37769608929787,-0.05752741540914785,-1.0667875552320965,-1.0092601398229486,1647138269,1617501337.8,23.76235531142916,25.52949707156478,NaN,NaN,-22.23089156206655,-21.104895196445526
2005-10-24T09:30:00-04:00,118.44,120.09,118.41,119.96001,72345120,82605174.4,49.921548498211436,36.675821618327184,NaN,NaN,-12.244769602173655,-61.14633209655582,0.08770970655316968,-0.8996230066314865,-0.9873327131846562,1719483389,1633180134.6,26.672585895353592,24.040849127256056,NaN,NaN,-18.04461265579781,-20.667711976352994
2005-10-25T09:30:00-04:00,119.72,120.24001,118.94,119.72,77054816,83150346.4,48.91398886206699,37.710221593549754,NaN,NaN,-1.4316763656215288,-43.24404945559077,0.16782807952559975,-0.7775476137776565,-0.9453756933032562,1642428573,1648450630.6,29.495513740376694,22.98066726369449,NaN,NaN,-15.260739905674638,-19.895287394827513
2005-10-26T09:30:00-04:00,119.50999,120.53999,119.19,119.37,82692496,84349546.4,47.41123661300953,38.7600938895893,NaN,NaN,7.404180773143449,-30.80160587774849,0.19552952570574667,-0.7009637861710729,-0.8964933118768196,1559736077,1623868790.6,27.650170538096788,22.35257551869423,NaN,NaN,-13.58529787456165,-18.993860320503817
2005-10-27T09:30:00-04:00,119.2,119.37,117.92999,118.10001,68286816,84431605.6,42.32947666745317,39.21256703177583,NaN,NaN,-55.1518989715318,-26.90928497595498,0.12976763819763915,-0.7342837641297706,-0.8640514023274097,1491449261,1612047113.8,26.782370672737954,22.049434135548946,NaN,NaN,-13.875369579837448,-18.26264735755148
2005-10-28T09:30:00-04:00,118.42999,119.95,118.10001,119.8,72959872,85688244,50.047727094349945,40.51090184968159,NaN,NaN,6.290791809165608,-11.026674471403592,0.19811350911738068,-0.6164095159306839,-0.8145230250480646,1564409133,1595501286.6,25.57263275841784,21.967236684502144,NaN,NaN,-11.403758679748721,-17.28280611786537
2005-10-31T09:30:00-05:00,120.28999,121.3,120.13,120.13,80144880,87144732.8,51.4072566334546,41.95266572242107,NaN,NaN,125.28563055255827,16.479405559542798,0.2590516194157688,-0.4907085007783536,-0.7497601201941224,1644554013,1580515411.4,24.493508191840135,22.067182008948386,NaN,NaN,-9.029604710200582,-16.10377734534183
2005-11-01T09:30:00-05:00,120.58,120.89999,120.22,120.49001,66996128,87455554.4,52.912895064035396,43.74066815002378,NaN,NaN,145.5599097521709,45.877722783101284,0.31347694948134186,-0.35791393334244503,-0.6713908828237869,1711550141,1594339725,27.5315333014248,22.59119885099688,NaN,NaN,-6.658106555357401,-14.754395803915482
2005-11-02T09:30:00-05:00,120.17,121.75,120.13,121.75,74690880,85887039.2,57.836905534346386,45.897516963101914,NaN,NaN,189.6431646354508,82.32551955556275,0.4176872730397696,-0.14928179152407495,-0.5669690645638445,1786241021,1639640713.8,36.541908233250496,23.908602265783777,NaN,NaN,-3.006488945765115,-13.076123395608287
2005-11-03T09:30:00-05:00,122.14999,122.66,121.75,122.27,84900880,83076042.4,59.70948693205891,47.459597753859335,NaN,NaN,218.28687587835478,137.01327452554008,0.4994625618304399,0.05735913772420531,-0.4421034241062346,1871141901,1715579241.8,48.17449956328839,26.180871703550878,NaN,NaN,0.5549282944026535,-11.128830297035295
2005-11-04T09:30:00-05:00,122.39999,122.46001,121.55,122.11,59156400,82250706.4,58.843506469370794,48.73289493314764,NaN,NaN,169.7559681418845,169.70630979208386,0.5183548220965567,0.20584010351446125,-0.31251471858209545,1811985501,1765094515.4,54.08477681617695,28.931769849944175,NaN,NaN,3.1578715499618153,-9.087872890321423
2005-11-07T09:30:00-05:00,122.39999,122.62,121.85001,122.23,46765696,81955060.8,59.32003756411919,50.44732358423797,NaN,NaN,151.29345899649323,174.90787548087084,0.5135303652060444,0.3293982379254601,-0.18413212728058434,1858751197,1807933952.2,58.49493990180915,32.05241028278271,NaN,NaN,5.414928885905195,-7.0160440651461915
2005-11-08T09:30:00-05:00,121.95,122.42,121.78999,122.23,42153696,80280711.2,59.32003756411919,51.30591454961388,NaN,NaN,125.01255040875719,170.7984036121881,0.48526507623623166,0.42244921801470525,-0.06281585822152641,1858751197,1837374163.4,61.249528782766745,35.10584514919149,NaN,NaN,7.265550227961969,-4.975816308987882
2005-11-09T09:30:00-05:00,122.08,122.95,121.86,122.39,57668704,78138121.6,60.03557854471394,52.81291304621141,NaN,NaN,118.22016016594274,156.51380271828648,0.4528940499405167,0.5033017042041195,0.05040765426360276,1916419901,1863409939.4,63.55324459799534,38.14711202178317,NaN,NaN,9.01554087211148,-2.9770509974022596
2005-11-10T09:30:00-05:00,122.34,123.86,121.75,123.34,79143376,77141634.4,64.07600245605725,54.43469174981187,NaN,NaN,127.41919482938435,138.3402665084924,0.4690302869843709,0.6366955129940663,0.1676652260096955,1995563277,1888294214.6,65.6548742130154,41.1394348004679,NaN,NaN,11.72672910509258,-0.8765109827601401
2005-11-11T09:30:00-05:00,123.35001,123.84,122.42999,123.75999,34867008,74452266.4,65.72576413475676,55.56356429527939,NaN,NaN,126.70268844512857,129.72961056914122,0.4798310338388037,0.7674540183082001,0.28762298446939644,2030430285,1931983171.4,69.03126099893768,44.165054450723915,NaN,NaN,14.510027590568649,1.3215659562868298
2005-11-14T09:30:00-05:00,123.75999,124.02,123.38,123.69,45092800,73258516,65.18849825983452,56.726029252262784,NaN,NaN,124.17097489056547,124.30511374795564,0.4543583949072833,0.8555709781035006,0.4012125831962173,1985337485,1957300429,70.82137842896172,47.11690192847998,NaN,NaN,16.694983208270646,3.5177684208559463
2005-11-15T09:30:00-05:00,123.58,124.09,122.86,123.24001,69592496,72987475.2,61.69656335811803,57.74640973405625,NaN,NaN,100.41744194240073,119.38609205468435,0.3821993313817717,0.8789617474234319,0.4967624160416602,1915744989,1968699187.4,71.61688474413475,50.25738151462555,NaN,NaN,17.692203257902815,5.542687683291213
2005-11-16T09:30:00-05:00,123.37,123.55,122.98,123.49001,51133904,69715711.2,62.88603567177047,59.21473537722177,NaN,NaN,89.2475347178505,113.59156696506591,0.3283614356428316,0.9072142105951997,0.5788527749523681,1966878893,1978790985.8,72.33598553111497,53.51121114736677,NaN,NaN,18.856835524015008,7.444708803394612
2005-11-17T09:30:00-05:00,123.75,124.64999,123.14,124.64,55717504,65897204.8,67.83425508294974,60.48520166212176,NaN,NaN,112.09230100179806,110.52618819954864,0.34551602151677685,1.0107478018483391,0.6652317803315623,2022596397,1984197609.8,72.73453740810864,56.87991862234468,NaN,NaN,21.347682297153497,9.430847873931596
2005-11-18T09:30:00-05:00,125.03999,125.756,124.33,125.13,72437184,64690032.8,69.6886554452106,61.79101586296148,NaN,NaN,140.97330113984927,113.3803107384928,0.3633615269278757,1.119433688991407,0.7560721620635312,2095033581,1997118269,73.70933492730748,60.395334817735204,NaN,NaN,24.01965657061995,11.514963402029931
2005-11-21T09:30:00-05:00,125.14999,125.91,124.98,125.75999,50021200,63573836.8,71.92935936267908,63.14933474143603,NaN,NaN,149.72551668191738,118.49121909676319,0.3888102567750713,1.2420849830323704,0.853274726257299,2145054781,2029061728.2,75.99438796289633,63.8569672935546,NaN,NaN,26.999233902569188,13.72700204496411
2005-11-22T09:30:00-05:00,125.56,126.52,125.42,126.3,66439872,63043089.6,73.72250693309294,64.28402055563221,NaN,NaN,154.11191173508325,129.23011305529968,0.4110619853155282,1.3671022079017092,0.956040222586181,2211494653,2088211661,79.54046012033405,66.92829242834628,NaN,NaN,30.087353982233022,16.06419517885967
2005-11-23T09:30:00-05:00,126.25,127.41,126.21001,127.03,50854704,61451200,75.95831421268635,65.44465107567703,NaN,NaN,163.7774832793919,144.13610276760795,0.4413312475286839,1.5077042819970359,1.066373034468352,2262349357,2147305753.8,82.34620044760163,69.36912820579722,NaN,NaN,33.45741395232375,18.548940717925966
2005-11-25T09:30:00-05:00,126.98,127.22,126.81,127.13,15270000,58800359.2,76.25634412036865,66.68842519360545,NaN,NaN,155.5106735531395,152.81977727787626,0.43382796838928095,1.608657994954953,1.1748300265656721,2277619357,2198310345.8,84.3420850715014,71.53036450974898,NaN,NaN,36.30470345565182,21.0854782518868
2005-11-28T09:30:00-05:00,127.25,127.27,126.03999,126.23,54503296,57877530.4,68.07693185127074,67.3139176426877,NaN,NaN,119.38710284390766,148.5025376186879,0.33823648088489344,1.597625627671789,1.2593891467868956,2223116061,2223926841.8,85.24438257751088,73.4410389865848,NaN,NaN,36.45279278840299,23.28080889996054
2005-11-29T09:30:00-05:00,126.64999,126.98,126.09,126.09,51809504,56460761.6,66.87527108138892,67.85357717963554,NaN,NaN,100.26689787075676,138.6108138564558,0.24017458980521722,1.5596073840434173,1.3194327942382,2171306557,2229177197,85.42970915017452,75.16819472711394,NaN,NaN,36.231410029199544,25.130894775566112
2005-11-30T09:30:00-05:00,126.16,126.52,125.28999,125.41,56075392,55914724.8,61.222534188948956,67.93835972565232,NaN,NaN,66.07877520199644,121.00418654983844,0.11069591906018239,1.457802693063428,1.3471067740032456,2115231165,2209924499.4,81.39275653301732,76.44244557961551,NaN,NaN,34.378796307932305,26.45202356590414
2005-12-01T09:30:00-05:00,126.02,127.03,125.98,126.69,65510800,55455720.8,66.89500737837307,68.13971722010345,NaN,NaN,88.83079642876056,106.01484917971217,0.09314362803047938,1.463536309041345,1.3703926810108655,2180741965,2193603021,78.0265577357502,77.32613725981085,NaN,NaN,34.413747388386035,27.58941268340155
2005-12-02T09:30:00-05:00,126.77,127.08,126.5,126.85001,46724704,53546912,67.53435766911525,68.26890247255763,NaN,NaN,88.7108947100641,92.6548934110971,0.0749773050631608,1.4641143123398166,1.3891370072766558,2227466669,2183572483.4,75.94773140846725,77.82017086049153,NaN,NaN,34.631312100896544,28.595398314472266
2005-12-05T09:30:00-05:00,126.64,126.73,126.17999,126.58,59367104,53557447.2,65.24450918334043,68.27290325280805,NaN,NaN,69.42018126511826,82.66150909533921,0.02976466720201909,1.4263428412791797,1.3965781740771606,2168099565,2172569184.2,73.63025428176317,78.02080484997735,NaN,NaN,34.14164953508377,29.387719917416767
2005-12-06T09:30:00-05:00,127.05,127.74001,126.63,126.82001,57942800,54116302.4,66.33712467410234,68.6043719182355,NaN,NaN,86.68904693192921,79.94593890757369,0.002450489529612465,1.3996412859891763,1.3971907964595638,2226042365,2183516345.8,74.46508488141019,78.22424771692559,NaN,NaN,34.03758193393847,30.05198591977701
2005-12-07T09:30:00-05:00,126.78999,126.87,125.67999,126.08,66826000,55349917.6,60.067044079989415,68.40301537596544,NaN,NaN,44.24426432736961,75.57903673264832,-0.07476159777506441,1.3037387992407332,1.3785003970157976,2159216365,2192313385.8,75.14602358582493,78.42496472083346,NaN,NaN,32.095512822375994,30.343918334434008
2005-12-08T09:30:00-05:00,126.22,126.82001,125.48,126,62586704,55595817.6,59.413256123782965,67.80151545031066,NaN,NaN,34.00056018482233,64.61298948386067,-0.1369104498503353,1.2073623347028786,1.3442727845532139,2096629661,2175490925,71.23402467180154,78.31778523966865,NaN,NaN,30.316786115504808,30.34004230315841
2005-12-09T09:30:00-05:00,126.16,126.78,125.82001,126.33,50744704,54175884,61.285173225106334,67.20126672030321,NaN,NaN,41.03117189833228,55.077044921514315,-0.15988272361068012,1.1444193800398637,1.3043021036505438,2147374365,2159472464.2,67.62400514326224,77.88311882652258,NaN,NaN,29.304924684264,30.192168357602064
2005-12-12T09:30:00-05:00,126.71001,126.86,125.96001,126.45,48393808,54852224,61.97201655760399,66.49002794851214,NaN,NaN,43.842064386214275,49.961421545733515,-0.17013293684294828,1.0916359325968585,1.2617688694398068,2195768173,2165006185.8,68.22312601207052,77.32802868717786,NaN,NaN,28.63848081012389,29.97021299367661
2005-12-13T09:30:00-05:00,126.39999,127.7,126.28999,127.31,88650880,57030128,66.55189334426383,65.97784126359576,NaN,NaN,88.95003192019405,50.41361854338648,-0.12425903728566356,1.1064450728327273,1.2307041101183909,2284419053,2176681523.4,69.50531573245712,76.61123265947238,NaN,NaN,29.326737075441162,29.87828786250012
2005-12-14T09:30:00-05:00,127.19,128.09,127.14,127.81,64374896,56769248,68.89723307387335,65.47347832510913,NaN,NaN,139.10756997305978,69.38627967252452,-0.06830356424784068,1.14532465480859,1.2136282190564307,2348793949,2214597040.2,73.27641567839285,75.96339089024318,NaN,NaN,30.603904238213993,29.98194734474496
2005-12-15T09:30:00-05:00,127.84,128,127.17999,127.44,55903104,57007708,65.25105271825133,64.68738608210074,NaN,NaN,130.75010054531685,88.73618774462344,-0.0643281245056635,1.1332180634243514,1.1975461879300149,2292890845,2253849277,76.51441922104053,75.40427190092453,NaN,NaN,30.642732582322708,30.076345235827496
2005-12-16T09:30:00-05:00,127.27,128.57001,126.36,126.36,46239008,56533783.2,55.94428621792249,63.820768536861586,NaN,NaN,75.21257694010905,95.57246875297878,-0.1383050862355497,1.0246648301355776,1.1629699163711273,2246651837,2273704771.4,77.96862288590712,74.88457478009569,NaN,NaN,27.769494294347258,29.74679510133032
2005-12-19T09:30:00-05:00,126.73,126.87,125.69,125.71001,48819504,55352899.2,51.210207911517095,62.70183545329932,NaN,NaN,-72.48869714111761,72.3063164475124,-0.22950564955814512,0.8760878544234458,1.105593503981591,2197832333,2274117603.4,77.99912579074658,74.35381882585084,NaN,NaN,23.80324001180132,28.897715802826177
2005-12-20T09:30:00-05:00,125.86,126.59,125.48,125.83,46604704,55182074.4,52.017417624999005,62.044327127302886,NaN,NaN,-97.17568584608554,35.08117289425648,-0.27705933386539217,0.7592693366498509,1.036328670515243,2244437037,2266121200.2,75.80969942215246,73.95502903221764,NaN,NaN,20.846150721667552,27.747492219803515
2005-12-21T09:30:00-05:00,126.17,126.75999,125.8,126.03,51801200,54450140.8,53.40130513816725,61.08049125300248,NaN,NaN,-63.75609348343997,-5.49155979704347,-0.2890256317289843,0.6750466308540126,0.9640722625829969,2296238237,2255610057.8,72.91247351781018,73.58973730236478,NaN,NaN,18.79584420495105,26.468685360538878
2005-12-22T09:30:00-05:00,126.31,126.69,126.08,126.69,32250496,53519930.4,57.733537094296786,60.38043264051544,NaN,NaN,-16.62899834409305,-34.96737957492546,-0.24804427886984537,0.6540169139956902,0.9020611928655355,2328488733,2262729635.4,73.64711384113474,73.42540747612675,NaN,NaN,18.270122516743513,25.29746209713954
2005-12-23T09:30:00-05:00,126.78999,126.86,126.42,126.75999,27977296,54155295.2,58.17757890023759,59.875651906008095,NaN,NaN,18.040190755000793,-46.40185681194711,-0.213112391282815,0.6356707037620168,0.8487830950448318,2356466029,2284692473.8,75.82525598963016,73.58219331240295,NaN,NaN,17.96722702304795,24.2502856579836
2005-12-27T09:30:00-05:00,126.92,127.05,125.38,125.47,44500704,53655165.6,48.13923302728799,58.57580250266421,NaN,NaN,-92.48014420187724,-50.40014622409903,-0.27010839879105375,0.5111475965560146,0.7812559953470684,2311965325,2307519072.2,77.87231960186776,73.82556722100706,NaN,NaN,14.49605468571827,22.856824090517126
2005-12-28T09:30:00-05:00,125.73,125.99001,125.5,125.75,30764304,52602905.6,50.149850033914525,57.867431499373154,NaN,NaN,-115.4343245369559,-54.05187396227311,-0.28092647941546267,0.43009789607773996,0.7110243754932026,2342729629,2327177590.6,79.48357852488513,74.13539257379708,NaN,NaN,12.267809762557842,21.344107757951512
2005-12-29T09:30:00-05:00,125.72,125.96001,125.06,125.19,33033600,51450816,46.28489555281761,56.929691458589915,NaN,NaN,-159.72697528817648,-73.24605032322042,-0.31520057775649646,0.3170236532975821,0.6322242310540785,2309696029,2329869149,79.70151542472686,74.74021334186317,NaN,NaN,9.166370876210808,19.604431060559982
2005-12-30T09:30:00-05:00,124.8,125.06,124.36,124.50999,44646096,50407580.8,42.04725293282589,55.555554294855604,NaN,NaN,-218.0789382807732,-113.53603831055644,-0.3693201006729713,0.17057410521286442,0.5398942058858357,2265049933,2317181389,75.62347419088445,75.31160398812189,NaN,NaN,5.1483142595527625,17.53927151755895
2006-01-03T09:30:00-05:00,125.10001,127,124.39,126.7,73388816,51740786.4,56.01448143472097,55.13001607179253,NaN,NaN,-41.59484557359464,-125.46304557627552,-0.24904158969883872,0.2285922187622873,0.477633808461126,2338438749,2313575933,74.45759390219493,75.75692312313079,NaN,NaN,6.333988610947328,15.938516816614435
2006-01-04T09:30:00-05:00,126.86,127.49001,126.7,127.3,52243200,51384591.2,58.934610162734344,54.58592441596899,NaN,NaN,90.20247970470925,-88.92652079495824,-0.1266620755173829,0.3193062140643974,0.4459682895817803,2390681949,2329319257.8,76.18416358983093,76.23398368437176,NaN,NaN,8.324083195144748,14.850740584975908
2006-01-05T09:30:00-05:00,127.17,127.59,126.88,127.38,47310496,50852976,59.32237753325892,53.90200616306797,NaN,NaN,100.84759321716551,-45.67013724413395,-0.04227752627868625,0.3931213817334225,0.43539890801210873,2437992445,2348371821,78.11240738338228,76.57941166329958,NaN,NaN,9.97483247329889,14.154182283307762
2006-01-06T09:30:00-05:00,128.03999,128.58,127.36,128.44,62892608,50656306.4,64.15246671965191,53.82353573459659,NaN,NaN,162.74424538674762,18.824106890850867,0.07650660708428247,0.5310321668674618,0.4545255597831793,2500885053,2386609625.8,81.37214840164803,76.92639231905727,NaN,NaN,13.063685978443182,13.998397096898536
2006-01-09T09:30:00-05:00,128.42,129.06,128.38,128.77,43532704,49703606.4,65.52492018160311,54.50786673200235,NaN,NaN,181.9703715733487,98.83396886167525,0.16386360417316076,0.6593550649996303,0.4954914608264695,2544417757,2442483190.6,84.90889703978522,77.42212618719142,NaN,NaN,15.974925137563996,14.28075824556503
2006-01-10T09:30:00-05:00,128.39,128.98,128.25999,128.89999,44961392,49414440.8,66.07588961444404,55.56970113935428,NaN,NaN,150.911504079997,137.3352387923936,0.21380563371196948,0.7627485029664314,0.5489428692544619,2589379149,2492671270.6,87.25050093201601,78.08293869728209,NaN,NaN,18.45884912644773,14.877628371405416
2006-01-11T09:30:00-05:00,129.02,129.44,128.73,129.31,49603904,49474945.6,67.8226818710192,56.69864858549858,NaN,NaN,156.05990122969413,150.50672309739056,0.2550615586596099,0.8677698175789743,0.6127082589193644,2638983053,2542331491.4,89.05944289868033,79.02934894560552,NaN,NaN,21.06417536905331,15.76142079964083
2006-01-12T09:30:00-05:00,129.08,129.28,128.44,128.8,40509296,47067866.4,63.44644808465223,57.41615879596179,NaN,NaN,117.52645278326575,153.84249501061063,0.22941627199466352,0.8994785989126939,0.6700623269180304,2598473757,2574427753.8,90.0427752381562,80.25294192563022,NaN,NaN,21.963243516412838,16.6473954734654
2006-01-13T09:30:00-05:00,128.57001,128.89999,128.2,128.67999,44858896,46092066.4,62.425694574286695,57.751312901675355,NaN,NaN,94.97421517052008,140.2884889673651,0.18754833490882972,0.9044977455540675,0.7169494106452378,2553614861,2584973715.4,90.34969053382466,81.44598311796521,NaN,NaN,22.40353015438439,17.4697004278824
2006-01-17T09:30:00-05:00,128.2,128.42,127.81,128.33,52181600,45905991.2,59.42313250811441,57.840281016523704,NaN,NaN,66.47082899099094,117.18858045089357,0.12260289435249994,0.8702030285858626,0.7476001342333627,2501433261,2576376816.2,87.969281448056,82.31341350785279,NaN,NaN,21.92372289470749,18.105989351714555
2006-01-18T09:30:00-05:00,127.58,128.89999,127.16,127.82001,75066496,47347365.6,55.2527738728121,58.34839107691829,NaN,NaN,48.759365922930925,96.75815281948034,0.03610720601054973,0.7927341417465499,0.7566269357360002,2426366765,2543774339.4,79.42322262179725,82.4241922949906,NaN,NaN,20.304557864518827,18.420070567829452
2006-01-19T09:30:00-05:00,128.09,128.77,127.81,128.31,78049184,48808849.6,58.28212933003086,58.92926816949803,NaN,NaN,61.41546851993437,77.8292662775284,0.004372578602642396,0.7620926589893031,0.7577200803866607,2504415949,2516860918.6,73.10915018809798,81.9688759852201,NaN,NaN,19.774536384655132,18.613565684518836
2006-01-20T09:30:00-05:00,128.28,128.31,125.97,125.97,115312000,52244214.4,43.23039242277752,58.71108937449516,NaN,NaN,-29.09424972652901,48.505125775569454,-0.17198861152063416,0.542734315985868,0.7147229275065021,2389103949,2474986957,64.51535536230915,80.88415026647598,NaN,NaN,13.906369180470932,17.941109041083422
2006-01-23T09:30:00-05:00,126.21001,126.82001,126.13,126.42,67094816,53008895.2,46.11256549345364,59.00146884311143,NaN,NaN,-47.52604024362411,20.0050746927406,-0.2513105053757856,0.4005847957867701,0.6518953011625557,2456198765,2455503737.8,60.92677414989984,79.83438597783422,NaN,NaN,10.209171624911512,16.836546553058863
2006-01-24T09:30:00-05:00,126.63,127.14999,126.42,126.55,53013904,54047065.6,46.95048272602679,58.354040363919,NaN,NaN,-33.73621208268222,-0.036333521994033904,-0.28550072848958175,0.29501939055057846,0.5805201190401602,2509212669,2457059619.4,61.11279726005424,78.8811862176813,NaN,NaN,7.576347444156915,15.513660966072871
2006-01-25T09:30:00-05:00,127.03999,127.17999,125.84,126.66,87790624,57037732,47.69165406629977,57.55097207131653,NaN,NaN,-41.902983164947265,-18.16880333956967,-0.29023662610142176,0.21772433641338296,0.5079609625148047,2597003293,2491186925,65.04395168639863,78.08545679600755,NaN,NaN,5.690860129747595,14.110403703740689
2006-01-26T09:30:00-05:00,127.28,127.67,126.75999,127.36,71360816,58380737.6,52.26240690613845,57.04668845509364,NaN,NaN,-4.24219540466269,-31.300336124489085,-0.23794892990308958,0.21052480013594277,0.44847373003903235,2668364109,2523976557,68.35411809843984,77.38843613279737,NaN,NaN,5.451740491244884,12.873451816241289
2006-01-27T09:30:00-05:00,127.66,128.66,127.45,128.53999,65790880,60132066.4,58.79819500277709,56.66424047531685,NaN,NaN,49.40300290801216,-15.60088559758085,-0.12148678307196875,0.2966152511990714,0.41810203427104015,2734154989,2592986765,73.94605715853424,76.85800104400354,NaN,NaN,7.371729046832061,12.0874914206114
2006-01-30T09:30:00-05:00,128.44,128.81,128.35001,128.44,33710192,60165896,58.072637362655314,56.13193455967773,NaN,NaN,63.77003421452481,6.658329294048935,-0.052314912411835945,0.3527083937562452,0.40502330616808113,2700444797,2641835971.4,77.03895600870679,76.2958623989265,NaN,NaN,8.672715572313553,11.599666299425992
2006-01-31T09:30:00-05:00,128.32001,128.53999,127.49001,127.5,73131184,61590150.4,51.62337178870655,55.09961185783934,NaN,NaN,6.062202227428328,14.618012156071043,-0.06989801396776307,0.31765078870837726,0.38754880267614034,2627313613,2665456160.2,78.37569018404534,75.66194734550002,NaN,NaN,7.777533537916696,11.053647333496093
2006-02-01T09:30:00-05:00,127.82001,128.42999,127.72,128.39,63562896,61098854.4,56.54415005864373,54.29400244266967,NaN,NaN,28.70861432364891,28.74033165379028,-0.023990079648289142,0.3575612031157789,0.381551282764068,2690876509,2684230803.4,79.40216434272344,74.97214173436025,NaN,NaN,8.6065769244154,10.704065846484566
2006-02-02T09:30:00-05:00,128.10001,128.14,126.8,126.89999,83628624,62668125.6,47.78139135928629,53.17506981942925,NaN,NaN,-58.12593935358679,17.963582864005463,-0.09252576366261839,0.265894078185795,0.3584198418484134,2607247885,2672007558.6,76.84464529660065,74.02941816710629,NaN,NaN,6.30554451387423,10.07570565611166
2006-02-03T09:30:00-05:00,126.58,128.39,126.14,126.27,86042496,64604725.6,44.63198614659815,51.904090646022915,NaN,NaN,-87.14514131924754,-9.346045981446478,-0.17410438453349336,0.14078936118154672,0.3148937457150401,2521205389,2629417638.6,68.55849494796861,72.472904196688,NaN,NaN,3.3730365699933005,9.118181500951895
2006-02-06T09:30:00-05:00,126.44,126.8,126.17,126.60001,45513392,63735764.8,46.61694408777074,50.98936290171265,NaN,NaN,-107.7007045299329,-43.64019373033803,-0.19791980305902868,0.06749399189125427,0.26541379495028294,2566718781,2602672435.4,63.89881824017784,70.75358539612529,NaN,NaN,1.682024904536946,8.05587341574976
2006-02-07T09:30:00-05:00,126.38,126.66,125.39999,125.48,71227632,65120511.2,41.21635175571046,49.98676132191969,NaN,NaN,-141.49791551854423,-73.15221727953254,-0.2763677114441342,-0.08004584435488482,0.19632186708924937,2495491149,2576307942.6,59.598615936519046,69.33754206146256,NaN,NaN,-1.5921330997111953,6.677586770683909
2006-02-08T09:30:00-05:00,125.88,128.10001,125.60001,126.62,59426304,65843756.8,47.8400751269472,49.24090030741371,NaN,NaN,-61.56142036347335,-91.206224216957,-0.2400873807570604,-0.10378735885707613,0.13630002189998427,2554917453,2549116131.4,55.45357335190423,68.07642943030586,NaN,NaN,-2.123574733171879,5.420277984418797
2006-02-09T09:30:00-05:00,126.92,127.60001,126.37,126.41,62024304,66464776.8,46.79406579558159,49.49544840547115,NaN,NaN,-54.08606969983204,-90.39825028620604,-0.21940612580832514,-0.13795763536042216,0.08144849044790299,2492893149,2526245184.2,52.16717047291993,67.19441622392091,NaN,NaN,-2.876257496554606,4.2350586299940245
2006-02-10T09:30:00-05:00,126.42999,127.13,125.45,126.64,64509696,67664796.8,48.13170474139441,49.639672637466916,NaN,NaN,-81.29016842590286,-89.22725570753708,-0.18100637186484386,-0.14480947438315184,0.036196897481692025,2557402845,2533484675.4,53.11436599312196,66.63638706986535,NaN,NaN,-3.0690277863861395,3.191617713368287
2006-02-13T09:30:00-05:00,126.57001,126.78999,125.95,126.41,52309200,68037312,46.862906022633204,49.63341715865308,NaN,NaN,-77.18199617049567,-83.12351403564963,-0.16245755979095197,-0.16687505225699795,-0.004417492466045975,2505093645,2521159648.2,51.253555747098986,65.9321555332257,NaN,NaN,-3.5992920448706696,2.221487747905579
2006-02-14T09:30:00-05:00,126.46001,128.03,123.64,127.75,90992496,69977856.8,54.404231324645956,50.11288696282067,NaN,NaN,-63.237865991823654,-67.47150413030552,-0.05675928704935192,-0.07536660127773587,-0.018607314228383954,2596086141,2541278646.6,54.0815618828156,65.14912769011262,NaN,NaN,-1.6877153472114845,1.6630301628888557
2006-02-15T09:30:00-05:00,127.66,128.32001,127.24001,128.2,85473504,70498207.2,56.63025189795037,50.424875890807236,NaN,NaN,81.1708339178222,-38.92505327404641,0.04135334625660286,0.03308436859236963,-0.008268977664233238,2681559645,2566607085,57.42989650232477,64.36882614753297,NaN,NaN,0.5808763505377829,1.5084367611244167
2006-02-16T09:30:00-05:00,128.34,129.21001,128.17999,129.16,61035392,69647517.6,61.00412975973908,50.582442659161664,NaN,NaN,163.14762688524976,4.521686042969952,0.162020977267187,0.19425724391975052,0.03223626665256352,2742595037,2616547462.6,63.13750940446049,63.59678702224198,NaN,NaN,3.9530561841793572,1.8576681072751224
2006-02-17T09:30:00-05:00,129.09,129.16,128.58,128.81,40344400,65899137.6,58.680561129825655,50.62586578538812,NaN,NaN,137.99511746938214,48.378743222026955,0.20652962908293143,0.2903983030062278,0.08386867392329639,2702250637,2645517021,65.98640829347525,62.80731932829688,NaN,NaN,5.998808662271504,2.4492596151317483
2006-02-21T09:30:00-05:00,129.12,129.39999,128.28999,128.49001,46461808,64867487.2,56.55949204422059,50.978445803639126,NaN,NaN,110.39194329145216,85.89353111441652,0.20241453639855123,0.3368868444214854,0.1344723080229342,2655788829,2675656057.8,68.69692184961733,62.11597873298059,NaN,NaN,7.0585859060792675,3.1077347995528224
2006-02-22T09:30:00-05:00,128.77,129.64999,128.64999,129.27,42338400,64333712,60.32413878714966,51.2484449985324,NaN,NaN,126.66673409266498,123.87445113131426,0.23777555279180101,0.4316917490126855,0.19391619622088446,2698127229,2696064275.4,70.4160776399454,61.47411539706787,NaN,NaN,9.123129679534305,3.967076925264463
2006-02-23T09:30:00-05:00,129.27,129.64,128.28,129.08,43450192,62116690.4,58.983206151590984,52.048574626554164,NaN,NaN,100.2266548217033,127.68561531209048,0.23358131235657864,0.48589283666660776,0.2523115243100291,2654677037,2690687753.8,69.33572324996184,60.93776382230796,NaN,NaN,10.425036906653675,4.889642636891493
2006-02-24T09:30:00-05:00,129.11,129.48,128.75999,129.41,36782704,60387784.8,60.62051599869403,53.19061247313245,NaN,NaN,102.75294248079149,115.60667843119882,0.23746727839388893,0.5491456223023903,0.31167834390850135,2691459741,2680460694.6,67.22298232368618,60.842370063430636,NaN,NaN,11.988019318321824,5.903696448524397
2006-02-27T09:30:00-05:00,129.39999,130.03999,129.28,129.46001,35880096,58892245.6,60.875402388372514,54.20907378031829,NaN,NaN,116.26248967441785,111.26015287220596,0.2278045088931968,0.5964339800249974,0.36862947113180056,2727339837,2685478534.6,67.74234732374609,61.116907855114086,NaN,NaN,13.345176340858059,6.966765004572063
2006-02-28T09:30:00-05:00,129.2,129.91,128.13,128.23,74397008,60926586.4,51.966283507941604,54.9769260483348,NaN,NaN,61.73273174712398,101.52831056334033,0.12794909418832673,0.528565838867209,0.40061674467888225,2652942829,2684909334.6,67.61147241152608,61.689254746186016,NaN,NaN,11.983297810493466,7.683412548275121
2006-03-01T09:30:00-05:00,128.60001,129.49001,128.5,129.37,48646304,59702342.4,58.08847937279067,55.708954923037915,NaN,NaN,76.4539840692168,91.4857605586507,0.1277541421908518,0.560309422417447,0.4325552802265952,2701589133,2685601715.4,67.69323496449022,62.56351628994215,NaN,NaN,12.670402734584055,8.395839717747826
2006-03-02T09:30:00-05:00,128.89999,129.42,128.61,129.36,60644496,59556422.4,58.01862263903724,56.510708983284744,NaN,NaN,71.47313420822393,85.73505643595482,0.11635316625785164,0.5779967380489097,0.4616435717910581,2640944637,2682855235.4,66.97102036685948,63.62093413950926,NaN,NaN,13.195799696885969,9.081548286196131
2006-03-03T09:30:00-05:00,128.66,130.07001,128.64999,128.75999,73429808,59046481.6,53.835235498249645,56.91810403734583,NaN,NaN,66.60434156718601,78.50533625323374,0.06060787738567763,0.5374034185231551,0.47679554113747746,2567514829,2658066253,60.678524398484726,64.16123116846374,NaN,NaN,12.404843350125763,9.556304723900364
2006-03-06T09:30:00-05:00,129.14,129.17999,127.85001,128.17,57479104,57618312,50.016294067396785,57.14334604054323,NaN,NaN,20.26923350117774,59.30668501858571,-0.01950799220808247,0.45241055087737436,0.47191854308545683,2510035725,2614605430.6,51.53591893491306,64.18139996759332,NaN,NaN,10.581294349477693,9.702731813268555
2006-03-07T09:30:00-05:00,127.92,128.06,127.39999,127.97,61784704,58431877.6,48.753727642884336,56.73973863470311,NaN,NaN,-19.583276952989692,43.043483278562974,-0.08576635001968974,0.36471060556084467,0.4504769555805344,2448251021,2573667069,44.70323787067447,63.51151968101181,NaN,NaN,8.711664732531256,9.561150801734655
2006-03-08T09:30:00-05:00,127.7,128.44,127.17999,128.24001,66705120,58205752,50.5679313420806,56.306715737855264,NaN,NaN,-19.5206089553346,23.848564673652692,-0.10967529627623135,0.31338283523524524,0.4230581315114766,2514956141,2536340470.6,39.55398720931377,62.234669017225315,NaN,NaN,7.64600092645967,9.287557962409657
2006-03-09T09:30:00-05:00,128.33,128.67999,127.38,127.38,56523600,58060616.8,45.092296734528645,55.170156236054524,NaN,NaN,-35.698026792646935,2.414332473478514,-0.17765236962608955,0.20099266947886463,0.3786450391049542,2458432541,2499838051.4,35.27483300541361,60.24447784586482,NaN,NaN,5.062199362188513,8.683935305235208
2006-03-10T09:30:00-05:00,127.72,128.84,127.44,128.59,60491104,57983956.8,52.831218892365634,54.752346076235945,NaN,NaN,-5.3356673256890454,-11.9736693050965,-0.13717891281976452,0.20717139808024854,0.34435031090001306,2518923645,2490119814.6,34.21358529230291,57.97499048863823,NaN,NaN,5.137211093058804,8.177260417781437
2006-03-13T09:30:00-05:00,128.84,129.16,128.53,128.83,45713296,57044136.8,54.20979375371526,54.58451048405699,NaN,NaN,36.17900216333139,-8.791715572665776,-0.09244292564485568,0.22879665384394343,0.3212395794887991,2564636941,2501040057.8,36.52451813162183,55.67696165163854,NaN,NaN,5.618219434203545,7.811683134413166
2006-03-14T09:30:00-05:00,128.71001,130.23,128.61,130.17999,69879184,57922636,61.09726540718499,54.63973381405952,NaN,NaN,118.7946673691091,18.883873291753982,0.02366726340351688,0.3508236587431952,0.32715639533967833,2634516125,2538293078.6,43.77984542910886,53.774373636578794,NaN,NaN,8.32733531404067,7.88534773150281
2006-03-15T09:30:00-05:00,130.14999,130.86,129.85001,130.75999,53407504,56043386.4,63.62849000269231,54.9715398034239,NaN,NaN,218.22012660506684,66.43202040383427,0.12923382602156686,0.4886986778666369,0.35946485184507004,2687923629,2572886576.2,49.54692931096227,52.36088835522168,NaN,NaN,11.389987295200767,8.386010526316804
2006-03-16T09:30:00-05:00,130.98,131.47,130.84,131.03,67083632,55123892.8,64.77745762481393,55.2684642052896,NaN,NaN,247.3824843665364,123.04812263567094,0.2025804865664938,0.6126904600531873,0.4101099734866935,2755007261,2632201520.2,57.5816741770101,51.67222348760196,NaN,NaN,14.221893729235624,9.219708126733778
2006-03-17T09:30:00-05:00,130.67999,130.89999,130.38,130.62,47286800,54436463.2,61.595571455404226,55.31990485293472,NaN,NaN,159.97227051705676,156.1097102042201,0.20802901207050922,0.67014623857483,0.4621172265043208,2707720461,2669960883.4,61.75692449963742,51.24469328587992,NaN,NaN,15.615278664875017,10.133361060753955
2006-03-20T09:30:00-05:00,130.64,130.89999,130.21001,130.41,45541200,54696303.2,59.97069646607787,55.89164863565873,NaN,NaN,126.32017054830467,174.13794388121477,0.1829240737912169,0.6907723187433419,0.507848244952125,2662179261,2689469347.4,63.74260205230295,50.96834540307827,NaN,NaN,16.285866640453285,11.012290429282432
2006-03-21T09:30:00-05:00,130.34,130.99001,129.45,129.59,87404128,56743419.2,53.98241735137079,55.598358491271604,NaN,NaN,70.05685405837144,164.39038121906725,0.10063916278536766,0.6336471984338345,0.5330080356484669,2574775133,2677521149,61.6319067115973,50.53539338501448,NaN,NaN,15.068815380335662,11.591793993718607
2006-03-22T09:30:00-05:00,129.50999,130.50999,129.45,130.38,51606896,57206844,58.302309154404966,55.618621813797866,NaN,NaN,70.36734032358716,134.8198239627713,0.08934552537623197,0.6446899423687569,0.5553444169925249,2626382029,2665212829,59.448097173893515,49.99804172837406,NaN,NaN,15.336867280635941,12.126804463278226
2006-03-23T09:30:00-05:00,130.24001,130.39349,129.66,130.11,46836400,57376154.4,56.3551388012527,55.798614906869524,NaN,NaN,58.708946750228094,97.08511643950963,0.055289513891023656,0.6244563093563045,0.5691667954652808,2579545629,2630120502.6,53.61506882388012,49.49350918733088,NaN,NaN,14.974366583116522,12.533599051826554
2006-03-24T09:30:00-05:00,129.99001,130.57001,129.74001,130.21001,43213696,57697704,56.92894866796858,56.292375949767504,NaN,NaN,61.768576692879975,77.44437767467427,0.03223891751541541,0.60946544235955,0.5772265248441346,2622759325,2613128275.4,51.00534444079697,49.455611009179734,NaN,NaN,14.841390125731142,12.863283490955782
2006-03-27T09:30:00-05:00,130.03,130.28,129.74001,130.02,32523200,57529859.2,55.43767410453814,56.76980069702849,NaN,NaN,46.50196461154987,61.48073648732331,-0.0012872254031540686,0.5756174930901921,0.5769047184933461,2590236125,2598739648.2,48.83756298269729,49.75091994575279,NaN,NaN,14.316448091652612,13.070878433912473
2006-03-28T09:30:00-05:00,129.92999,130.53,129.05,129.22,82081680,57914092.8,49.552149770203926,56.697244870465866,NaN,NaN,12.183485091304226,49.90606269390987,-0.07854694504373516,0.4787210371886772,0.5572679822324124,2508154445,2585415510.6,46.851786337645905,50.27219131206222,NaN,NaN,12.125857639621673,12.935875463299501
2006-03-29T09:30:00-05:00,129.41,130.5,129.28999,130.03,61532704,58558412.8,54.78612435376745,57.38966112898293,NaN,NaN,35.65608322238236,42.9638112736689,-0.07624247802168194,0.46196488470530994,0.5382073627269919,2569687149,2574076534.6,45.16859903914706,50.978888885900325,NaN,NaN,11.745344619853297,12.765799628521473
2006-03-30T09:30:00-05:00,130.11,130.98,129.55,129.8,70572320,59054804,53.10142420198541,57.40896150824149,NaN,NaN,45.22585703115092,40.26719332985347,-0.09038612252389733,0.4252247095721202,0.5156108320960175,2499114829,2557990374.6,42.81842404341805,51.59352022526569,NaN,NaN,10.938228504359564,12.504718039355486
2006-03-31T09:30:00-05:00,130.02,130.24001,129.37,129.83,62925696,58529598.4,53.303129781548975,57.344199795943894,NaN,NaN,19.744363637847016,31.86235071884688,-0.09729909061153563,0.393986968831598,0.49128605944313364,2562040525,2545846614.6,41.08067665670572,51.91896011991454,NaN,NaN,10.334906756427145,12.194744998937152
2006-04-03T09:30:00-04:00,130.07001,130.87,129.49001,129.73,61627696,58737028,52.492690433515456,56.72958729782464,NaN,NaN,33.470441377201254,29.25604607197716,-0.10739215358090065,0.35704586746700784,0.4644380210479085,2500412829,2527881955.4,38.585881554820524,51.547962700322515,NaN,NaN,9.612407555509634,11.825839649876078
2006-04-04T09:30:00-04:00,129.72,130.73,129.36,130.56,54810192,58388302.4,58.17663180272303,56.34016885496969,NaN,NaN,46.256077872335304,36.07056462818338,-0.059354147582948824,0.39024533656922245,0.44959948415217127,2555223021,2537295670.6,40.620851572762696,50.91038571902255,NaN,NaN,10.567671924026092,11.64610140332608
2006-04-05T09:30:00-04:00,130.61,131.28,130.38,131.00999,50610704,57583581.6,60.907448936792086,56.063739662968125,NaN,NaN,118.73772765941472,52.68689351558985,-0.001515015714606327,0.4477057145089134,0.4492207302235197,2605833725,2544524985.8,42.20466267977975,49.81202775493467,NaN,NaN,12.183828533329745,11.722919564755175
2006-04-06T09:30:00-04:00,130.85001,131.21001,130.19,130.87,57911008,57652952,59.60360686794827,55.92145647814984,NaN,NaN,105.77735395649397,64.79719290065846,0.021787556830869637,0.47645517626210676,0.4546676194312371,2547922717,2554286563.4,44.36262369667388,48.56957769758014,NaN,NaN,13.16774182554422,11.929322744867896
2006-04-07T09:30:00-04:00,131.06,131.39999,129.35001,129.53999,80183312,58637562.4,48.89442085074917,55.1302939341978,NaN,NaN,-10.71521747347292,58.70527667839447,-0.05377223082685101,0.3874523308976734,0.4412245617245244,2467739405,2535426339.4,41.16456902513976,46.95686105278276,NaN,NaN,10.765430049120305,11.763052359761097
2006-04-10T09:30:00-04:00,129.71001,130.08,129.25999,129.74001,41537008,58428748,50.339521255602214,54.870087070214325,NaN,NaN,-103.76874472416006,31.2574394581222,-0.08957056369011951,0.329261357111875,0.4188319208019945,2509276413,2537199056.2,41.59078256830487,45.525352185404735,NaN,NaN,9.242121577234254,11.402919390828691
2006-04-11T09:30:00-04:00,129.85001,130.06,128.25,128.64,72805312,58575054.4,43.11846264264609,53.78552660508869,NaN,NaN,-225.46196198704405,-23.08616851375367,-0.18133130729292113,0.1921677866858431,0.37349909397876424,2436471101,2513448672.2,37.65503430324438,43.96870483750123,NaN,NaN,5.50463623822039,10.560307511884648
2006-04-12T09:30:00-04:00,128.77,129.13,128.61,128.88,43051904,58057274.4,44.97312943381926,52.972525935986305,NaN,NaN,-211.91435402890863,-89.21658485141833,-0.21742835754692968,0.1017136470451021,0.3191420045920318,2479523005,2488186528.2,33.97253686668081,42.56566684055842,NaN,NaN,3.0552358846571646,9.488154422280722
2006-04-13T09:30:00-04:00,128.59,129.25,128.31,128.71001,51076896,57256937.6,43.88175108163291,52.040583251248044,NaN,NaN,-197.025235420212,-149.77710272675955,-0.24241325695351812,0.01612543340013417,0.2585386903536523,2428446109,2464291206.6,30.894795721366208,41.129199074884795,NaN,NaN,0.7346082378891721,8.237647824510502
2006-04-17T09:30:00-04:00,128.78999,129.31,128.02,128.66,64169600,58101077.6,43.546941369839644,51.19124519876958,NaN,NaN,-171.5145338699013,-181.93696600604522,-0.2509141736220095,-0.05510402667385961,0.1958101469481499,2364276509,2443598627.4,28.487932180772447,39.67565401760444,NaN,NaN,-1.250625364739439,6.882180226046224
2006-04-18T09:30:00-04:00,128.95,130.94,128.84,130.7,92662192,60457127.2,57.71861882635179,51.774564417065854,NaN,NaN,45.81936965126699,-152.0193431309598,-0.11468617744723311,0.05245242513910853,0.16713860258634164,2456938701,2433131085,27.328112271611104,38.28110587003054,NaN,NaN,1.5493732902594912,6.120350663790977
2006-04-19T09:30:00-04:00,130.72,131.07001,130.24001,130.95,87273312,60450586.4,59.074502025846925,52.080877107928664,NaN,NaN,120.44884869141069,-82.83718099526885,-0.008858424469446236,0.15606557199953386,0.1649239964689801,2544212013,2454679267.4,33.344251013241646,37.43650958246586,NaN,NaN,4.211596411041742,5.847671484826801
2006-04-20T09:30:00-04:00,131,131.86,130.60001,131.13,86022496,62171366.4,60.067429573652745,52.578448920190624,NaN,NaN,161.65588682392348,-8.123132824702429,0.06792033301390324,0.24982441273635914,0.1819040797224559,2630234509,2484821568.2,40.73517669481593,37.287706200422846,NaN,NaN,6.654302830288608,5.962904534178488
2006-04-21T09:30:00-04:00,131.73,131.78999,130.62,131.14999,72359312,63447512,60.18296561152524,53.06986576518893,NaN,NaN,140.83516737445842,59.44894773423166,0.11210060499044067,0.3220298359605067,0.20992923097006605,2702593821,2539651110.6,51.311015931778215,38.01844472007088,NaN,NaN,8.643684896859224,6.345873157418593
2006-04-24T09:30:00-04:00,130.92999,131.07001,130.38,130.91,52547296,63914192,58.012866525549875,53.4641640574771,NaN,NaN,85.99021244897162,110.94989699800627,0.11668595873377038,0.35578667938727904,0.23910072065350865,2650046525,2596805113.8,59.436823302089095,39.50779770201864,NaN,NaN,9.69797757689281,6.824745217343481
2006-04-25T09:30:00-04:00,131.03999,131.12,129.92,130.37,84360368,66506050.4,53.35125659809182,53.11949440000344,NaN,NaN,46.13372583742684,111.01276823523824,0.07680172476437003,0.3351028766089712,0.2583011518446012,2565686157,2618554605,62.03353146518413,41.0372748371916,NaN,NaN,9.272611648739124,7.174440421828573
2006-04-26T09:30:00-04:00,130.5,131.14,130.3,130.39999,67266880,65765310.4,53.57437569660272,52.59570345427563,NaN,NaN,56.66249772535835,98.25549804202777,0.04733599571926922,0.3174711464936877,0.27013515077441846,2632953037,2636302809.8,64.05567301717358,42.598061289862585,NaN,NaN,8.985918770219124,7.433223043027223
2006-04-27T09:30:00-04:00,129.89999,131.63,129.59,131.03,124605376,68918944,58.10741624872191,52.48883269575946,NaN,NaN,65.1709093809318,78.95850255342944,0.06412901226160844,0.35029641610142903,0.2861674038398206,2757558413,2661767590.6,66.78883664854672,44.19993364356778,NaN,NaN,10.030333398885457,7.804238808149828
2006-04-28T09:30:00-04:00,130.78999,131.75,130.71001,131.47,55855104,68183083.2,60.97345386592732,53.351620768272184,NaN,NaN,109.95569852624537,72.78260878378683,0.09676363938814803,0.40712195307500565,0.3103583136868576,2813413517,2683931529.8,68.99842193541187,46.18806599430151,NaN,NaN,11.768585966934946,8.370574116547703
2006-05-01T09:30:00-04:00,131.47,131.8,130.32001,130.39999,65006608,68287128.8,51.70880282308141,53.449426594520695,NaN,NaN,57.80870720823891,67.14630773564028,0.04103086559696656,0.36164689568306585,0.3206160300860993,2748406909,2703603606.6,70.85205017964171,48.27815653796843,NaN,NaN,10.468818926663833,8.670323375135721
2006-05-02T09:30:00-04:00,131.00999,131.46001,130.74001,131.38,49087696,67660128.8,58.00291868118797,54.51260202584512,NaN,NaN,83.78411821598714,74.67638621135234,0.0635666905048885,0.40007439321720994,0.33650770271232144,2797494605,2749965296.2,74.69249781025357,50.923689645611944,NaN,NaN,11.400811500928828,9.06039310739188
2006-05-03T09:30:00-04:00,131.22,131.32001,130.45,130.89,60824608,67960849.6,54.19918769356869,55.1716061872558,NaN,NaN,50.5197904212736,73.44784475053538,0.0400209062478466,0.3865338355221297,0.3465129292742831,2736669997,2770708688.2,76.20326129398286,53.94016996184781,NaN,NaN,10.925239895250618,9.3267997913717
2006-05-04T09:30:00-04:00,131.08,131.62,130.34,131.36,42930496,67576839.2,57.104909274908884,56.11611748677551,NaN,NaN,69.22430348527327,74.25852357140369,0.05000011255784775,0.4090130699715928,0.35901295741374506,2779600493,2775117104.2,76.52400539355773,57.1993992241472,NaN,NaN,11.464896964709078,9.632242244705612
2006-05-05T09:30:00-04:00,132.05,132.8,131.85001,132.52,62589504,67810764,63.29443712492496,57.526652897853026,NaN,NaN,166.58503626093486,85.58439111834157,0.12438923464732843,0.5144995007229056,0.3901102660755772,2842189997,2780872400.2,76.96060375949396,60.6617329083416,NaN,NaN,14.064794133431485,10.265463943095023
2006-05-08T09:30:00-04:00,132.50999,132.77,132.36,132.36,30017296,65302463.2,61.966272286854476,57.83005671646037,NaN,NaN,156.1331457670036,105.2492788300945,0.15072681895143514,0.5785187897648711,0.427791970813436,2812172701,2793625558.6,77.93965447209482,64.276843065519,NaN,NaN,15.678974412404656,11.038822581567828
2006-05-09T09:30:00-04:00,132.42,132.77,132.31,132.62,29865008,64718863.2,63.31346935399383,58.13284009704229,NaN,NaN,148.6712717373107,118.22670953435923,0.1720258524887256,0.642824286424343,0.4707984339356174,2842037709,2802534179.4,78.62302728911314,67.51104137093839,NaN,NaN,17.406466434987568,11.94848598919922
2006-05-10T09:30:00-04:00,132.41,132.75,131.89,132.55,64406896,64298942.4,62.66984828191897,58.318727147632735,NaN,NaN,126.73433075998592,133.4696176021017,0.16759837871042804,0.6802964073236524,0.5126980286132243,2777630813,2810726342.6,79.25929759381492,70.26276429229547,NaN,NaN,18.6091792822415,12.900013602490974
2006-05-11T09:30:00-04:00,132.50999,132.55,130.52,130.95,80654688,66179081.6,50.12662315180189,57.600416971938216,NaN,NaN,31.885290404960013,126.00181498603904,0.04925510779573139,0.5742669133578886,0.5250118055621572,2696976125,2794201469,74.44580907539994,71.91524951683986,NaN,NaN,15.582576249592014,13.283236837791122
2006-05-12T09:30:00-04:00,130.48,130.72,129.19,129.24001,91733376,68211905.6,40.74139665215242,56.36674055240983,NaN,NaN,-130.3960777084356,66.60559219216495,-0.14141619523126014,0.34824156152308205,0.4896577567543422,2605242749,2746812019.4,62.68809270943901,72.1474830459363,NaN,NaN,9.323197102197733,12.717516875563495
2006-05-15T09:30:00-04:00,128.78999,129.74001,128.61,129.5,84040368,69205444,42.50402798767753,55.5919385088088,NaN,NaN,-184.55839629870778,-1.532716220977329,-0.24138416530332885,0.18792755012518114,0.42931171542851,2689283117,2722234102.6,57.606473657628,71.83126463111086,NaN,NaN,5.119918929743683,11.63214574044638
2006-05-16T09:30:00-04:00,129.75999,130,129.00999,129.31,62136400,67679154.4,41.53179048379135,54.73175385075084,NaN,NaN,-155.99037934449174,-62.46504643733781,-0.3074277045159864,0.045027084783527016,0.3524547892995134,2627146717,2679255904.2,49.9772976013534,70.82566638712369,NaN,NaN,1.5113960325982523,10.186324353610933
2006-05-17T09:30:00-04:00,128.67,129.10001,126.77,126.85001,144779632,70554470.4,31.488804129846557,52.83042441368831,NaN,NaN,-261.5494794601755,-140.1218084813701,-0.49291072499875016,-0.2636836169489243,0.22922710804982588,2482367085,2620203158.6,41.7881915657761,69.03990602406864,NaN,NaN,-5.857540491528038,7.894343661448223
2006-05-18T09:30:00-04:00,127.38,127.75,126.11,126.21001,87923872,70649539.2,29.49078403157641,50.58166228266324,NaN,NaN,-245.0984017623477,-195.51854691483166,-0.6262618187651008,-0.5536001654065501,0.07266165335855068,2394443213,2559696576.2,35.38957251946616,66.63927392292966,NaN,NaN,-12.334171587882565,5.004555768686682
2006-05-19T09:30:00-04:00,126.87,127.49001,125.8,127.10001,124320880,73247617.6,35.60949877607793,49.43171199359157,NaN,NaN,-185.10586692441004,-206.46050475802653,-0.6208787431356763,-0.7034367755610447,-0.08255803242536841,2518764093,2542400845,33.796535572625245,63.99245145099992,NaN,NaN,-15.382949015363797,2.0920550852509
2006-05-22T09:30:00-04:00,126.28,127.17,125.5,126.13,110877376,76164121.6,32.31775245039168,47.5970572628204,NaN,NaN,-167.52792411422695,-203.05441032113038,-0.6461083522071017,-0.8901934726842455,-0.24408512047714384,2407886717,2486121565,29.191790844373998,60.74240095343709,NaN,NaN,-19.04450584484062,-0.9274536190478884
2006-05-23T09:30:00-04:00,127.17999,127.63,125.17,125.17,91990624,76545634.4,29.419261369734357,45.82706252540367,NaN,NaN,-147.0311372706972,-201.26256190637145,-0.6870913947414871,-1.1029493639040027,-0.4158579691625156,2315896093,2423871440.2,25.115609680106928,57.093282981017374,NaN,NaN,-23.059771559203135,-4.089213324784351
2006-05-24T09:30:00-04:00,125.67999,126.89,124.75999,126.17,168394368,81602008.8,35.871296568128514,44.31037590349079,NaN,NaN,-126.69389872268339,-174.29144575887304,-0.6091513440093087,-1.1772971491741515,-0.5681458051648428,2484290461,2424256115.4,25.18513120716176,53.426220539131954,NaN,NaN,-24.089362518768578,-6.946377495353527
2006-05-25T09:30:00-04:00,126.92,127.73,126.42999,127.73,78992128,79321346.4,44.40871425518103,42.96139569850907,NaN,NaN,-72.68064746319254,-139.807894899042,-0.4236320777204837,-1.0976859023154475,-0.6740538245949638,2563282589,2458023990.6,31.221489376852332,50.15914094037184,NaN,NaN,-21.85293612471333,-9.075885870976355
2006-05-26T09:30:00-04:00,128,128.38,127.50999,128.38,62990704,79678126.4,47.542403315962204,41.93111934344534,NaN,NaN,-42.45108428231196,-111.27693837062239,-0.23751800064840145,-0.9709513254054656,-0.7334333247570641,2626273293,2479525830.6,34.8273508004697,47.0796906781129,NaN,NaN,-18.99002954932732,-10.49219211074078
2006-05-30T09:30:00-04:00,127.97,128,126.05,126.10001,72445504,80050071.2,39.196066010623554,40.208447676061745,NaN,NaN,-77.20639218840103,-93.21263198545724,-0.24723128040050812,-1.0424724252576993,-0.7952411448571912,2553827789,2508714045,39.46680059209613,44.282817342611686,NaN,NaN,-19.549748885198206,-11.786128792806126
2006-05-31T09:30:00-04:00,126.58,127.50999,126.2,127.50999,86932688,81942320.8,45.56094395449462,38.98638308124573,NaN,NaN,-59.56647481673014,-75.71969949466381,-0.1431274123735724,-0.9741504103241567,-0.8310229979505843,2640760477,2573686921.8,48.29102050940289,42.070797550867965,NaN,NaN,-17.614864211173757,-12.61880528114436
2006-06-01T09:30:00-04:00,127.38,128.94,127.27,128.73,73728000,82587490.4,50.39913255735257,39.00584803878506,NaN,NaN,-17.91586551473133,-53.96409285307341,0.015060316820279973,-0.8121976019252344,-0.8272579187455144,2714488477,2619726525,53.46737924374585,40.572338277178396,NaN,NaN,-14.28006470743112,-12.856128056328183
2006-06-02T09:30:00-04:00,129.25,129.42999,128.32001,129,91702688,85026100,51.42796248010476,39.769174169353086,NaN,NaN,5.153048894891268,-38.397353581456635,0.13819255594603252,-0.6545172238129737,-0.7927097797590063,2806191165,2668308240.2,58.22019288030343,40.25320257509728,NaN,NaN,-11.38851256382612,-12.64646870025646
2006-06-05T09:30:00-04:00,128.78999,128.86,126.77,127.12,86119184,86202584,44.50569093940174,39.91215009447624,NaN,NaN,-34.92559471505502,-36.89225566800525,0.09537495159698761,-0.6734910902627718,-0.7688660418597594,2720071981,2687067977.8,59.92247961612993,40.41863157213313,NaN,NaN,-11.333026818746735,-12.45883414575507
2006-06-06T09:30:00-04:00,127.21001,127.38,125.75999,126.81,130874816,91245460,43.466740303157835,40.05036079585956,NaN,NaN,-65.43693347489983,-34.538363925305006,0.05076412330005842,-0.7054108877346863,-0.7561750110347447,2589197165,2694141853,60.574791958219976,41.17559545476645,NaN,NaN,-11.634869232413774,-12.341124872420599
2006-06-07T09:30:00-04:00,126.91,127.64999,125.78999,125.86,108703120,95187365.6,40.35752707155917,40.68384100598189,NaN,NaN,-70.57406739755984,-36.739882441470954,-0.033591096240488616,-0.7981638813353555,-0.7645727850948669,2480494045,2662088566.6,56.1176726710572,42.199129819429395,NaN,NaN,-12.902466220272292,-12.42131649354227
2006-06-08T09:30:00-04:00,125.58,126.5,123.87,125.75,204960320,102215036.8,40.00073502091233,41.43455179093445,NaN,NaN,-121.35830846154012,-57.42837103083271,-0.08475189172709441,-0.870512649753735,-0.7857607580266406,2275533725,2574297616.2,46.11026079157262,42.96489326743699,NaN,NaN,-14.009040264409833,-12.648134175094778
2006-06-09T09:30:00-04:00,126.36,126.96001,125.28999,125.35001,94976320,102931118.4,38.66223402012868,41.65260430836664,NaN,NaN,-90.92707785713795,-76.64439638123855,-0.13073844948660263,-0.9491838198848939,-0.8184453703982912,2180557405,2449170864.2,36.20124117750363,43.13665795349974,NaN,NaN,-15.314549392332122,-13.029050634700113
2006-06-12T09:30:00-04:00,125.88,125.92999,123.82001,123.99001,95878192,103138359.2,34.44219897232291,41.804350488504596,NaN,NaN,-161.38776634967616,-101.93683070816277,-0.23203882000301734,-1.108493895402063,-0.8764550753990455,2084679213,2322092310.6,29.311820849017693,43.14523152526,NaN,NaN,-17.776000916081422,-13.707186389183157
2006-06-13T09:30:00-04:00,123.78,124.84,122.55,122.55,185695872,108221134.4,30.629907630833316,41.89082522144024,NaN,NaN,-220.48047882224577,-132.94553977763195,-0.3672756718100726,-1.3355496651616363,-0.9682739933515637,1898983341,2184049545.8,23.97438401748073,43.06371540650099,NaN,NaN,-21.157487137387555,-14.77151506749807
2006-06-14T09:30:00-04:00,122.84,123.63,122.34,123.5,163652000,113296914.4,35.68738729559341,41.87768884483059,NaN,NaN,-199.14452798053244,-158.6596318942265,-0.36333196314204397,-1.4224389472791188,-1.0591069841370748,2062635341,2100477805,21.430209752184524,42.79550673114547,NaN,NaN,-22.390255631063262,-15.859906576578812
2006-06-15T09:30:00-04:00,123.92,126.36,123.86,126.12,134446320,112780248.8,47.134513589039706,42.07238879724906,NaN,NaN,-53.26701284373171,-145.0413727706648,-0.16495570565482387,-1.2653016162056048,-1.100345910550781,2197081661,2084787392.2,20.9800511588205,42.063975429857486,NaN,NaN,-19.527375394388386,-16.38383069340875
2006-06-16T09:30:00-04:00,125.19,125.56,124.46001,124.64999,94263008,113097205.6,42.55751990384621,41.71632569638364,NaN,NaN,-77.57843871304907,-142.37164494184702,-0.11575102034143292,-1.245034685977572,-1.1292836656361391,2102818653,2069239641.8,20.520074359226513,41.04202711262583,NaN,NaN,-18.745908494374014,-16.721270379260933
2006-06-19T09:30:00-04:00,125.39999,125.48,123.55,123.67,95817376,111672030.4,39.78397324661488,41.75831907038302,NaN,NaN,-101.73347528413353,-130.4407867287385,-0.13108782583070555,-1.2931434479245212,-1.1620556220938156,2007001277,2053704054.6,20.047112618453184,39.6549065430799,NaN,NaN,-19.057715974626287,-17.055048321455985
2006-06-20T09:30:00-04:00,124.00999,124.81,123.72,124.09,65518304,109404076.8,41.54235359257432,41.47127690167442,NaN,NaN,-91.84977685567091,-104.71464633542351,-0.09643113985250795,-1.2825945469094506,-1.1861634070569427,2072519581,2088411302.6,24.24779228405076,37.9375330984119,NaN,NaN,-18.736443863063712,-17.295247684542804
2006-06-21T09:30:00-04:00,124,125.7,123.96001,125.00999,75038688,108556480,45.309651102487145,41.10774251204118,NaN,NaN,-52.12938250415702,-75.31161724014844,-0.00012828289788635594,-1.1863237606793007,-1.1861954777814143,2147558269,2105395888.2,26.288771220651427,35.99620395390515,NaN,NaN,-17.270961461455325,-17.291778224101737
2006-06-22T09:30:00-04:00,124.95,125.06,124.03999,124.46001,74994128,103886468,43.504668861946705,40.541792967887034,NaN,NaN,-63.84107572727652,-77.42642981685741,0.03595508594609398,-1.1412516203487968,-1.1772067062948908,2072564141,2080492384.2,25.21599408569068,33.63876118286139,NaN,NaN,-16.626613267537863,-17.196754658878326
2006-06-23T09:30:00-04:00,124.33,125.3,124.03,124.44,54112496,102642486.4,43.436869499721716,40.46544857933846,NaN,NaN,-55.00719217559262,-72.91218050936611,0.06614199484755101,-1.094529212735452,-1.160671207583003,2018451645,2063618982.6,24.48687338974787,31.107646452405525,NaN,NaN,-16.13073081495309,-17.044465538317578
2006-06-26T09:30:00-04:00,124.53999,125.06,124.25,124.99001,37905200,101388211.2,45.93114869727384,40.641477750346745,NaN,NaN,-41.67938897751285,-60.90136324804199,0.12727726298826036,-1.0015746288476777,-1.128851891835938,2056356845,2073490096.2,25.83786834177252,28.626437622659278,NaN,NaN,-15.00228591137565,-16.752725591611586
2006-06-27T09:30:00-04:00,125.00999,125.28999,123.77,123.91,69780880,101254980,42.01336075945099,40.75975158519616,NaN,NaN,-59.74655072085416,-54.480718021078644,0.10029139234965401,-1.0034876513988706,-1.1037790437485246,1986575965,2056301373,24.99914527838125,26.403685666039568,NaN,NaN,-15.143746975550226,-16.522871503602822
2006-06-28T09:30:00-04:00,124.19,124.77,123.64999,124.75,62368096,100026750.4,45.87994968159552,41.17969548953067,NaN,NaN,-51.761340287338186,-54.40710957771489,0.14178951138175688,-0.9265421545213286,-1.0683316659030855,2048944061,2036578531.4,24.0350552700273,24.826885271643473,NaN,NaN,-14.137309123872557,-16.18207687792707
2006-06-29T09:30:00-04:00,125.2,127.35001,125.17,127.27,110696624,101875181.6,55.47250414141672,42.38042906962268,NaN,NaN,82.62494419389299,-25.11390559348098,0.3309271766482178,-0.6546726950928132,-0.985599871741031,2159640685,2053993840.2,26.722320337507085,24.149819497358003,NaN,NaN,-10.048887111511473,-15.30590691129627
2006-06-30T09:30:00-04:00,127.47,127.66,126.96001,127.23,54229904,100001542.4,55.304938824608136,43.87062477335734,NaN,NaN,141.96812058157226,14.281156957951998,0.43856007094412985,-0.4373997830608687,-0.8759598540049985,2105410781,2071385667.4,29.40798374824095,24.156688275873954,NaN,NaN,-6.886465939069003,-14.103129629549517
2006-07-03T09:30:00-04:00,127.42999,128.00999,127.31,127.8,23936192,96892392.8,57.285033598476204,45.77456234247469,NaN,NaN,168.54224907603523,56.325484568661615,0.5273942674471033,-0.21671701969611945,-0.7441112871432227,2129346973,2085983693,31.67166010712714,24.706493710848697,NaN,NaN,-3.6627448996088203,-12.611646096700847
2006-07-05T09:30:00-04:00,127.28999,127.45,126.52,127.07001,69653504,93831327.2,53.98637516161081,47.08163290433307,NaN,NaN,118.86574283325797,92.04794327948403,0.5156246059898049,-0.09958052965596664,-0.6152051356457715,2059693469,2100607193.8,33.95637273534729,25.60121963821746,NaN,NaN,-1.8961869809303784,-11.08086622301935
2006-07-06T09:30:00-04:00,127.2,127.85001,127.08,127.44,51289504,90960646.4,55.38854406730571,47.6712065099235,NaN,NaN,136.15245109994308,129.6307015569403,0.5104383215546064,0.022842766297486605,-0.48759555525711984,2110982973,2113014976.2,35.91439970019469,26.667958819744193,NaN,NaN,-0.027143503869637386,-9.501762977426536
2006-07-07T09:30:00-04:00,127.19,127.56,126.28999,126.61,81628368,84794048.8,51.59052922754076,48.316421461615974,NaN,NaN,85.95272688146365,130.29625809445443,0.4319062933052498,0.052287311374442424,-0.3796189819308074,2029354605,2086957760.2,33.6576174928873,27.606354757862817,NaN,NaN,0.4996607161724652,-8.07298816405525
2006-07-10T09:30:00-04:00,126.94,127.42999,126.41,126.85001,60956400,83093052.8,52.60263712692502,49.23204031020955,NaN,NaN,83.01936471947397,118.50650692203476,0.3788204891186551,0.0939066294675115,-0.28491385965114363,2090311005,2083937805,33.395697454276245,28.559825103278747,NaN,NaN,1.2175840402995903,-6.74576356343313
2006-07-11T09:30:00-04:00,126.61,127.41,125.94,127.41,73640816,81981184,54.968287507500825,50.19103558984716,NaN,NaN,74.73691125635256,99.74543935809822,0.3640236983210706,0.17011576325019462,-0.19390793507087598,2163951821,2090858774.6,34.6507930390226,29.30289658577674,NaN,NaN,2.4879129833377083,-5.426666913894438
2006-07-12T09:30:00-04:00,127.21001,127.39999,125.72,126.05,82561376,76824459.2,48.62131777532416,50.42758320933552,NaN,NaN,40.94025487939462,84.16034176732555,0.25064243156223887,0.11939510438192258,-0.13124732718031626,2081390445,2095198169.8,35.47184512706728,29.95883043623501,NaN,NaN,1.7870898901434735,-4.396130227603308
2006-07-13T09:30:00-04:00,125.5,125.67999,124,124,102454192,73764568.8,40.94646177006849,50.24485413134422,NaN,NaN,-63.97084418080692,44.13568271117556,0.036808505691270074,-0.08523669506622866,-0.12204520075749874,1978936253,2068788825.8,32.77310497785443,30.498624071389568,NaN,NaN,-1.3432332363707766,-3.960002085998661
2006-07-14T09:30:00-04:00,124.16,124.25999,122.83,123.52,103243184,72204412,39.37905797765563,49.95501045119664,NaN,NaN,-108.38915515579383,5.267306303724081,-0.12866783491815484,-0.2828799944051923,-0.15421215948703745,1875693069,2038056518.6,29.920339663439535,30.88672880522469,NaN,NaN,-4.383058523991287,-4.020438719997608
2006-07-17T09:30:00-04:00,123.5,124.10001,123.14999,123.34,81289632,71555743.2,38.77956595503005,49.44418311246494,NaN,NaN,-100.32700728380021,-31.401968096930755,-0.23572147554842265,-0.44886400392256576,-0.2131425283741431,1794403437,1978875005,25.345062493969593,30.851528387524475,NaN,NaN,-7.019545525504732,-4.448882549355768
2006-07-18T09:30:00-04:00,123.74001,124.05,122.39,123.97,123697008,72949724.8,42.101840883315845,49.45050312131242,NaN,NaN,-98.86792380916916,-66.12293511003509,-0.24831540631129695,-0.5235367862632643,-0.2752213799519673,1918100445,1929704729.8,22.294685643049675,30.658352699286507,NaN,NaN,-8.296669200020396,-4.998566356593572
2006-07-19T09:30:00-04:00,124.17999,126.25999,123.724,125.69,134399184,76393768.8,50.068660154256044,49.749696726502464,NaN,NaN,-16.15793982379693,-77.54257405067341,-0.1309164116556229,-0.43886689452149596,-0.30795048286587307,2052499629,1923926566.6,21.960206988394546,30.510149250598456,NaN,NaN,-6.982899552651882,-5.282042527459045
2006-07-20T09:30:00-04:00,126.12,126.3,124.66,124.83,112337808,78258724.8,46.6148446208571,49.117006760748204,NaN,NaN,-15.34202026533184,-67.8168092675784,-0.10254580668728608,-0.4361327412249807,-0.3335869345376946,1940161821,1916171680.2,21.494130436537304,30.136707114814897,NaN,NaN,-6.947627268906468,-5.5199832048086765
2006-07-21T09:30:00-04:00,125.14999,125.19,123.82001,123.95,101722192,79595128,43.32172283245953,48.26106276130901,NaN,NaN,-62.70816051217016,-58.68061033885366,-0.13250633624113356,-0.4992198548391116,-0.366713518597978,1838439629,1908720992.2,21.032268093289773,29.538441710889817,NaN,NaN,-7.9407487949187825,-5.865806860538692
2006-07-24T09:30:00-04:00,124.44,126.32001,124.44,126.21001,92889872,81533996.8,52.585839022352076,47.92540600587158,NaN,NaN,2.652431320885776,-38.08472261791646,0.0032330009226955725,-0.36267226744460856,-0.36590526836730414,1931329501,1936106205,27.22233335456005,29.22063265713502,NaN,NaN,-5.724755434320877,-5.84565665679329
2006-07-25T09:30:00-04:00,125.98,127.3,125.72,126.66,95483872,84412930.4,54.19134554128623,47.94004674727696,NaN,NaN,45.41559540902468,-9.228018774277695,0.12019550752621988,-0.21566088395952931,-0.3358563914857492,2026813373,1957848790.6,31.79373700236127,29.066158676207447,NaN,NaN,-3.4411837924462945,-5.5021605333151475
2006-07-26T09:30:00-04:00,126.59,127.45,126.17999,126.83,84528128,85150292.8,54.81384663318092,47.898996930553764,NaN,NaN,53.57147428434982,4.717864047351654,0.20111543506767537,-0.08446209765115498,-0.28557753271883035,2111341501,1969617165,34.202803585815076,28.943901810894623,NaN,NaN,-1.43301217177844,-4.92085362452419
2006-07-27T09:30:00-04:00,127.33,127.69,126.2,126.71001,87257184,86394747.2,54.253443307053416,48.08920507909038,NaN,NaN,51.248447388392805,18.035957578096586,0.2362377489097735,0.009719653418386542,-0.22651809549138696,2024084317,1986401664.2,37.58863125580642,29.224688508245986,NaN,NaN,0.03143501510586205,-4.213383818862754
2006-07-28T09:30:00-04:00,126.99001,128.14,126.86,127.98,82137184,84966775.2,59.02804396255251,48.548162710206626,NaN,NaN,89.2214326098055,48.42187620249172,0.3289806787413804,0.18470775293533848,-0.14427292580604187,2106221501,2039958038.6,46.96633606218969,30.194019837382662,NaN,NaN,2.775524646123093,-3.2149683238647757
2006-07-31T09:30:00-04:00,127.66,127.96001,126.55,127.85001,49589104,84734735.2,58.35667156488485,48.79019014287692,NaN,NaN,77.24986897315554,63.34136373294567,0.3628840902419195,0.30933218699635745,-0.053551903245562,2056632397,2065018617.8,50.69927411448005,31.34033991420105,NaN,NaN,4.817028044213906,-2.067540271282107
2006-08-01T09:30:00-04:00,127.34,127.38,126.60001,127.22,65220896,86798970.4,55.08648639298151,49.25198790128102,NaN,NaN,59.53718005775232,66.16568066269119,0.32539356420219256,0.3531900520071787,0.027796487804986142,1991411501,2057938243.4,49.636238497871226,32.3520822978299,NaN,NaN,5.638297839280662,-0.966706255487426
2006-08-02T09:30:00-04:00,127.58,128.46001,127.55,128.08,64787504,86555670.4,58.50482531742619,50.506156726092286,NaN,NaN,105.75223812441862,76.60183343070496,0.33946733607958063,0.45213065790446194,0.11266332182488131,2056199005,2046909744.2,47.94977283011093,33.43613000156251,NaN,NaN,7.343806692564847,0.22050987994861293
2006-08-03T09:30:00-04:00,127.33,128.55,127.14999,128.42,63704496,87176420,59.80724518309548,51.965312955052276,NaN,NaN,102.84238072702185,86.92062009843076,0.3511639406360484,0.5516182476199418,0.20045430698389344,2119903501,2066073581,51.06135526435354,34.94620254448494,NaN,NaN,9.138949611276734,1.494572698709773
2006-08-04T09:30:00-04:00,129.06,129.42999,127.48,128.2,96296624,87909832.8,58.52715872552486,53.375855295801905,NaN,NaN,110.59267078489503,91.19486773344867,0.32421916203881523,0.6057282595324125,0.28150909749359726,2023606877,2049550656.2,48.376140393264464,36.59127953729172,NaN,NaN,10.292395450347469,2.7514045203723008
2006-08-07T09:30:00-04:00,127.89999,128.08,127.39999,127.95,45434400,87133732.8,57.03327825047931,54.44238653631358,NaN,NaN,78.5400670938617,91.45290735758991,0.27181371193942117,0.6212762374178737,0.3494625254784526,1978172477,2033858672.2,45.907024557187015,38.27787517401582,NaN,NaN,10.871762786088132,3.911455701188848
2006-08-08T09:30:00-04:00,128.09,128.46001,126.95,127.41,90898128,87996598.4,53.836769926176736,54.71153723430791,NaN,NaN,65.80260997767873,92.70599334157518,0.18707054554887897,0.5833007074145513,0.39623016186567234,1887274349,2013031241.8,42.785616402406106,39.76540441787379,NaN,NaN,10.518443964089075,4.855311167317452
2006-08-09T09:30:00-04:00,128.2,128.60001,126.61,126.98,78916128,87814336,51.367897366752764,55.051041001871894,NaN,NaN,52.03930325910151,81.96340636851177,0.09309467329250204,0.5125985034812999,0.41950383018879783,1808358221,1963463085,36.435920548494686,40.83267514015646,NaN,NaN,9.54697366439914,5.52554866690055
2006-08-10T09:30:00-04:00,126.53,127.5,126.28,127.37,69324320,86157842.4,53.45283811840206,55.77469209372492,NaN,NaN,32.27291023818496,67.84951227074438,0.05037659311703108,0.48247457158508666,0.4320979784680556,1877682541,1915018893,31.51353249202431,41.58133688292321,NaN,NaN,9.255923395549601,6.058459342421843
2006-08-11T09:30:00-04:00,127.17,127.2,126.39,127.00999,47489392,83370152.8,51.2678435479909,55.68054955984199,NaN,NaN,17.636979097889427,49.25837393334326,-0.005953448145230245,0.42465616828651775,0.430609616431748,1830193149,1876336147.4,28.2335478138465,41.65356648715796,NaN,NaN,8.422707259271979,6.396209044829005
2006-08-14T09:30:00-04:00,127.63,128.16,126.92,127.11,58044496,82207896,51.856592255678585,55.51378146801287,NaN,NaN,43.42171089551286,42.2347026936735,-0.03849131824325347,0.38249546862768113,0.4209867868709346,1888237645,1858349181,26.834925550757674,41.29936566918627,NaN,NaN,7.8666959634587394,6.606278604633253
2006-08-15T09:30:00-04:00,128.21001,128.87,127.89999,128.63,68149808,79430536,59.80486364360828,55.8702826830434,NaN,NaN,116.81385017129014,52.43695073239578,0.03629714647503812,0.46635821996473226,0.43006107348969413,1956387453,1872171801.8,29.716344944032812,40.9789043376304,NaN,NaN,9.603944284252428,7.034516558864564
2006-08-16T09:30:00-04:00,129.32001,129.89,129.03999,129.78999,71759184,76298536,64.60713717382991,56.60983224495601,NaN,NaN,186.100526102936,79.24919530116267,0.15137741800699767,0.6192828459984412,0.4679054279914435,2028146637,1916129485,38.06925905953873,41.013234895039844,NaN,NaN,12.64820168561952,7.836471576972415
2006-08-17T09:30:00-04:00,129.58,130.37,129.49001,130.03,70994816,74231386.4,65.52491694886412,57.07389460112112,NaN,NaN,197.53903921743944,112.30242109701358,0.2266231213578036,0.751184329688698,0.5245612083308944,2099141453,1960421267.4,45.143571727623204,40.88303744257081,NaN,NaN,15.41858316193613,8.919630374824374
2006-08-18T09:30:00-04:00,130.19,130.69,129.59,130.69,58288400,72059696.8,67.9835580547035,57.76152935039388,NaN,NaN,199.899407116426,148.7549067007209,0.29924304568127114,0.8986150154324832,0.5993719697512121,2157429853,2025868608.2,53.58128263978224,41.08889519437811,NaN,NaN,18.541970156428057,10.294250343624899
2006-08-21T09:30:00-04:00,130.17999,130.28,129.8,130.13,42133696,69521888,63.82440082481689,58.385666095524975,NaN,NaN,154.2105802186869,170.9126805653557,0.287870740859107,0.9592103958250959,0.6713396549659889,2115296157,2071280310.6,58.366488421404696,41.71248447463051,NaN,NaN,19.982833832538212,11.678333699183943
2006-08-22T09:30:00-04:00,129.94,130.52,129.67999,130.12,60840496,67789719.2,63.7493985913474,58.76027847223363,NaN,NaN,132.70581067815675,174.09107266672902,0.25889348846999505,0.9949565155534827,0.7360630270834877,2054455661,2090893952.2,60.27144628399852,42.592604007051044,NaN,NaN,21.13322178155047,13.029031996664875
2006-08-23T09:30:00-04:00,130.17999,130.44,129.19,129.75999,66610128,66893819.2,60.97151719292408,58.843440758649955,NaN,NaN,97.10804598682877,156.29257664350757,0.1974739403215049,0.9829054524853689,0.785431512163864,1987845533,2082833731.4,59.075199145148986,43.16502142710787,NaN,NaN,21.347556429207316,14.217392629885223
2006-08-24T09:30:00-04:00,129.99001,130.10001,129.39999,129.64999,57982896,65430104.8,60.109641662572415,58.95647525415336,NaN,NaN,81.08699862495449,133.0021685250106,0.1344448749839019,0.9534876058937414,0.8190427309098395,1929862637,2048977968.2,54.20837102491322,43.58160932936848,NaN,NaN,21.295681972989886,15.228576821757319
2006-08-25T09:30:00-04:00,129.64,130.25,129.55,129.81,41757904,63411140.8,60.973838182651235,59.23794382073707,NaN,NaN,79.85827096271822,108.99394129426904,0.09063606355114429,0.9323378103487698,0.8417017467976255,1971620541,2011816105.8,49.39778650857674,43.830949468753474,NaN,NaN,21.47483187781861,16.120898972623216
2006-08-28T09:30:00-04:00,129.64999,130.82001,129.64,130.42999,52679504,63565660.8,64.2093050007379,59.97883918320572,NaN,NaN,93.09862925021595,96.77155110057484,0.09031893627394505,0.9546004171400568,0.8642814808661118,2024300045,1993616883.4,47.18920127834117,44.14549124560597,NaN,NaN,22.50433022834299,17.032817723440328
2006-08-29T09:30:00-04:00,130.49001,130.83,129.81,130.58,61817008,63395466.4,64.96611970370645,60.95014077870241,NaN,NaN,89.43755048483249,88.11789906191,0.08707929762097111,0.9731306028923257,0.8860513052713546,2086117053,1999949161.8,48.05937447493454,44.975737954637395,NaN,NaN,23.577089809011003,17.96771373566471
2006-08-30T09:30:00-04:00,130.87,131.03999,130.55,130.66,50053104,62658746.4,65.38647805448687,61.8025436312799,NaN,NaN,98.04541492611972,88.30537284976818,0.07751136669006409,0.9829405136339346,0.9054291469438706,2136170157,2029614086.6,52.04574827047572,46.44232479595535,NaN,NaN,24.594856338670557,18.914448393236974
2006-08-31T09:30:00-04:00,130.85001,130.99001,130.58,130.64,38523008,61399672,65.17593380123499,62.79597864936876,NaN,NaN,88.84493679337007,89.85696048345129,0.05792012104300537,0.9778292982476273,0.919909177204622,2097647149,2063170989,56.14593811207027,48.43606696011419,NaN,NaN,25.407867300883584,19.842079665757918
2006-09-01T09:30:00-04:00,131.14,131.58,130.84,131.42,48800000,59024840.8,69.32448622368247,64.04368536136904,NaN,NaN,108.48946378214625,95.58319904733689,0.08399558076778901,1.0249036531643583,0.9409080723965693,2146447149,2098136310.6,59.98512018606896,50.80393800549357,NaN,NaN,27.28048915544478,20.90470959285604
2006-09-05T09:30:00-04:00,131.50999,131.85001,131.2,131.67,52348896,59370565.6,70.53602824399375,64.81019711853943,NaN,NaN,117.36930732209655,100.43733466171301,0.10331232327963402,1.0700484764961118,0.9667361532164778,2198796045,2133035510.6,63.42668417075574,53.21181937883092,NaN,NaN,29.222804747280083,22.093008900630903
2006-09-06T09:30:00-04:00,131.11,131.16,130.33,130.50999,53795600,57515439.2,58.90976092727257,64.40324167235676,NaN,NaN,64.05473423035464,95.36077141081743,0.027161203376393717,1.0006876574369699,0.9735264540605761,2145000445,2144812189,64.53515538618768,55.10224054502013,NaN,NaN,27.645066593904566,22.886159999669996
2006-09-07T09:30:00-04:00,130.06,130.57001,129.35001,129.91,86300624,57884664,53.95598989175552,63.57688973970615,NaN,NaN,14.253407854623479,78.6023699965182,-0.06915809341513801,0.8870788372916536,0.9562369307067916,2058699821,2129318121.8,61.8779606778055,56.29755404146173,NaN,NaN,24.753802305290264,23.152966043330036
2006-09-08T09:30:00-04:00,130.08,130.46001,129.83,130.28,45107696,56673832.8,56.391352756787256,62.74887507556927,NaN,NaN,25.431308828604962,65.91964440356517,-0.11100907504920587,0.8174755868952843,0.9284846619444902,2103807517,2130550195.4,62.01190688255942,56.899741487374385,NaN,NaN,23.0348146818089,23.136087277398445
2006-09-11T09:30:00-04:00,129.86,130.69,129.48,130.41,68497184,57724222.4,57.246978154340624,62.279059170535255,NaN,NaN,14.632679713922247,47.14828758992037,-0.13158970153586635,0.7639975350246573,0.8955872365605236,2172304701,2135721705.8,62.605821101747686,57.202550964541736,NaN,NaN,21.86322938600149,22.95425043577031
2006-09-12T09:30:00-04:00,130.56,131.84,130.3681,131.69,69888128,58316404,64.60981512614059,62.34051749444905,NaN,NaN,138.917477907953,51.45792170709167,-0.0640693781050975,0.8155005139291518,0.8795698920342493,2242192829,2144401062.6,63.63344274266581,57.44269356873226,NaN,NaN,23.08526997896063,22.972967513368925
2006-09-13T09:30:00-04:00,131.64,132.45,131.52,132.22,62913008,58054564,67.13375518672979,62.78067735114946,NaN,NaN,204.74367311292917,79.59570948360658,0.007414166217976859,0.8888375998067204,0.8814234335887435,2305105837,2176422141,67.21325787982545,58.02398347835201,NaN,NaN,24.916450403883733,23.25060792629961
2006-09-14T09:30:00-04:00,131.96001,132.24001,131.75,132.23,57812192,57357214.4,67.1813134750011,63.28579676632294,NaN,NaN,169.89345986460364,110.72371988560262,0.044432411531869276,0.9369639480035801,0.8925315364717108,2362918029,2237265782.6,72.71021610264955,59.34554384104746,NaN,NaN,26.38428640413798,23.69827628027652
2006-09-15T09:30:00-04:00,132.31,132.39,131.67999,131.96001,76715680,57643257.6,64.46888286928714,63.535442815368356,NaN,NaN,138.90023070354982,133.41750426059158,0.039938339395585,0.942454460716192,0.902516121320607,2286202349,2273744749,75.37583297248143,61.20111858846922,NaN,NaN,26.821157372043103,24.14440215052889
2006-09-18T09:30:00-04:00,131.78999,132.39,131.64999,132.14,64155504,57936612.8,65.46979215750034,63.62547761227996,NaN,NaN,122.9825406755243,155.087476452912,0.03828638240673443,0.9503740993290251,0.9120877169222906,2350357853,2309355379.4,77.66896138300308,63.37824431023079,NaN,NaN,27.4681789317508,24.619227404989164
2006-09-19T09:30:00-04:00,132.12,132.13,131.07001,131.81,92097808,60434818.4,62.02018860818135,63.415053962599586,NaN,NaN,75.74260491795582,142.45250185491255,0.005868773666039884,0.9194236840048404,0.9135549103388005,2258260045,2312568822.6,77.86924192895468,65.50752055694652,NaN,NaN,27.048432616759527,24.96625672095636
2006-09-20T09:30:00-04:00,132.25,132.77,132.06,132.50999,75212816,61153434.4,66.10042274865515,63.46605001218303,NaN,NaN,126.0117329228657,126.70611381689987,0.021585414488005994,0.9405366784488081,0.9189512639608021,2333472861,2318242227.4,78.24029890138513,67.37855988772576,NaN,NaN,27.868826311518262,25.38090951960806
2006-09-21T09:30:00-04:00,132.61,132.75,131.42,131.87,88947008,62270278.4,59.7772605026656,63.08043049085665,NaN,NaN,80.61093781697245,108.84960940737362,-0.01891581255022934,0.8953064982730154,0.9142223108232448,2244525853,2294563792.2,72.75733954748647,68.56508856168406,NaN,NaN,26.65952246007936,25.56356851110396
2006-09-22T09:30:00-04:00,131.67,131.67999,131,131.47,65969184,62669592.8,56.161182277209534,62.14019449468002,NaN,NaN,21.755533949445272,85.42067005655272,-0.07717145469302678,0.8177579924569613,0.8949294471499881,2178556669,2273034656.2,68.08540412440836,69.14368027156544,NaN,NaN,24.535749743542272,25.41673725859515
2006-09-25T09:30:00-04:00,131.73,132.85001,131.05,132.48,92298320,65196613.6,62.35373569479053,61.555745026879784,NaN,NaN,83.94453165942281,77.61306825333243,-0.05334256790085634,0.8282512372739177,0.881593805174774,2270854989,2257134083.4,64.77704964719065,69.24013494845364,NaN,NaN,24.592853192916415,25.29903953492676
2006-09-26T09:30:00-04:00,132.5,133.60001,132.39999,133.58,74016624,66263469.6,67.70442722433731,62.18393547667012,NaN,NaN,165.90498658960598,95.64554458766244,0.026551330011090668,0.9147829676886374,0.8882316376775468,2344871613,2274456397,66.67674203466737,69.39310542334506,NaN,NaN,26.480948156802874,25.467883623766205
2006-09-27T09:30:00-04:00,133.49001,133.97,133.27,133.74001,82433872,67294312.8,68.40783400970446,63.21621005652362,NaN,NaN,182.2613588211768,106.89546976732467,0.07734903892236589,0.9849179363305041,0.9075688974081382,2427305485,2293222921.8,68.64946094699161,69.87678401400122,NaN,NaN,28.19093313692597,25.856890697074743
2006-09-28T09:30:00-04:00,133.74001,133.99001,133.28,133.69,58601600,67721737.6,67.90999187151245,64.03896999328971,NaN,NaN,158.19593790255817,122.41246978444183,0.09366764055371435,1.0246534481002811,0.9309858075465668,2368703885,2318058528.2,71.08873420268598,70.52512882258169,NaN,NaN,29.394535649798264,26.362268547463817
2006-09-29T09:30:00-04:00,133.8,133.94,133.48,133.58,47991696,68195172,66.75914616684575,64.7184105656115,NaN,NaN,141.4108160160953,146.34352619777184,0.08347804849833795,1.0353333681694892,0.9518553196711512,2320712189,2346489632.2,73.61923493196163,71.31180123902553,NaN,NaN,30.042167664545666,26.88796842133265
2006-10-02T09:30:00-04:00,133.53999,133.83,132.34,133.08,52444496,68377396.8,61.645324615991534,64.506661243458,NaN,NaN,87.2800225699038,147.01062437986803,0.03212863719491188,0.9920161161647911,0.9598874789698792,2268267693,2345972173,73.49315286742109,72.01606624793662,NaN,NaN,29.098713795394175,27.203789189055726
2006-10-03T09:30:00-04:00,132.89,133.87,132.64999,133.36,73108688,69415386.4,63.33893155252478,64.23560241244336,NaN,NaN,93.86592299357743,132.6028116606623,0.00737741969107597,0.9691092535837242,0.9617318338926483,2341376381,2345273126.6,73.31049317291995,72.45158305458624,NaN,NaN,28.789831003659643,27.430366591142
2006-10-04T09:30:00-04:00,133.23,135,133.08,134.92,80893312,70770272,71.01751603608203,64.50961688109199,NaN,NaN,147.10216799898882,125.5709734962247,0.08226472954402864,1.064562745822684,0.9822980162786554,2422269693,2344265968.2,73.02887096862148,72.47434411644137,NaN,NaN,31.041906166778865,27.94630081623298
2006-10-05T09:30:00-04:00,134.92,135.41,134.75,135.17999,60640000,69487240.8,72.0675464147168,65.0523785629084,NaN,NaN,172.587402881623,128.44926649203768,0.13252672239858,1.1479564192768805,1.0154296968783005,2482909693,2367107129.8,75.34231084080415,72.47194967846443,NaN,NaN,33.184933410687286,28.694676901155024
2006-10-06T09:30:00-04:00,134.95,135.10001,134.39999,135.00999,65001808,70481946.4,70.27470348748477,65.39558651505014,NaN,NaN,135.68646733233177,127.30439675528496,0.13697621443804975,1.1866499649258628,1.049673750487813,2417907885,2386546269,77.13947909473902,72.434129515017,NaN,NaN,34.36599527925171,29.504865240883124
2006-10-09T09:30:00-04:00,134.85001,135.3,134.64,135.09,41177904,69115982.4,70.64484425995884,66.01163334731996,NaN,NaN,132.740802918597,136.3965528250236,0.1281209264080414,1.2098249084978647,1.0817039820898233,2459085789,2424709888.2,80.19185111590784,72.60003017122794,NaN,NaN,35.430907769295736,30.35144274494207
2006-10-10T09:30:00-04:00,135.11,135.45,134.84,135.27,56428496,68443000.8,71.50451030684675,66.39763960147651,NaN,NaN,129.6008770183736,143.54354362998282,0.11747978351573662,1.2285537114844942,1.1110739279687576,2515514285,2459537469,82.48961535554272,72.90355277509634,NaN,NaN,36.56262302756054,31.238754213887564
2006-10-11T09:30:00-04:00,134.84,135.42999,134.3,135.11,104076320,70501166.4,69.55464904997169,67.09602449771265,NaN,NaN,102.19742314564057,134.5625946593132,0.08431136179922549,1.2164631302177895,1.132151768418564,2411437965,2457371123.4,81.85356966456416,73.55328349774474,NaN,NaN,36.97887373824558,32.05877128879585
2006-10-12T09:30:00-04:00,135.45,136.39,135.39999,136.28,59172896,70569201.6,74.93681511421309,68.4371411289272,NaN,NaN,146.16735301175518,129.2785846853396,0.12344735184572264,1.2864609582257174,1.1630136063799947,2470610861,2454911357,81.08902663985926,74.4821136774198,NaN,NaN,39.04001039809673,33.05609116155312
2006-10-13T09:30:00-04:00,136.16,136.71001,136.03999,136.63,53945296,69430682.4,76.28728309437781,69.432394514612,NaN,NaN,149.81776168979115,132.1048435568315,0.15323892733249211,1.35456226554561,1.2013233382131179,2524556157,2476241011.4,82.60619424034388,75.7556240055022,NaN,NaN,41.17442754346524,34.21585350182628
2006-10-16T09:30:00-04:00,136.52,137.05,136.42,136.84,42275904,68336702.4,77.08509769044731,70.10244240504842,NaN,NaN,142.87712239814041,134.13210745274017,0.16632814574240662,1.4092335203911261,1.2429053746487195,2566832061,2497790265.8,84.00257209110171,76.9931832952475,NaN,NaN,43.17300750023117,35.495446930169834
2006-10-17T09:30:00-04:00,136.47,136.7,135.67,136.41,90785376,68271080.8,71.76103456131975,70.3419567301638,NaN,NaN,105.32433610446424,129.2767992699583,0.1270400915249028,1.401705489054848,1.2746653975299451,2476046685,2489896745.8,81.4239732957067,77.90564846301287,NaN,NaN,43.31235902696828,36.6121486582839
2006-10-18T09:30:00-04:00,137.03999,137.37,136.10001,136.59,87371184,68878999.2,72.61373085282327,70.67793808597172,NaN,NaN,114.14190303755687,131.6656952483416,0.09562174712601634,1.3941925814374656,1.2985708343114493,2563417869,2520292726.6,83.52163496296942,78.79371280303312,NaN,NaN,43.67088196814159,37.620539131120715
2006-10-19T09:30:00-04:00,136.39,136.88,136.23,136.81,64081808,67635739.2,73.66058592396206,71.17089806862289,NaN,NaN,102.56546840535925,122.94531832706238,0.07311775115829189,1.3899680232593141,1.3168502721010222,2627499677,2551670489.8,85.3595579448521,79.63230730395385,NaN,NaN,44.26628372841351,38.56993121644826
2006-10-20T09:30:00-04:00,136.81,136.95,136.33,136.84,48099504,66742255.2,73.80761795055305,72.03963330680584,NaN,NaN,100.53972096431431,113.08971018196704,0.04508878647186454,1.3732112551908529,1.3281224687189883,2675599181,2581879094.6,86.87708635310867,80.58830255293154,NaN,NaN,44.797956289078364,39.459649083966845
2006-10-23T09:30:00-04:00,136.56,137.8,136.39,137.47,66234000,65439039.2,76.74359342199995,72.9971091546255,NaN,NaN,118.48922011378468,108.21212972509588,0.053254034899213654,1.3946900123430055,1.3414359774437918,2741833181,2616879318.6,88.3799374272257,81.66469142823908,NaN,NaN,46.118415701369436,40.4109014578815
2006-10-24T09:30:00-04:00,137.28,137.92999,137.22,137.88,53355392,64405977.6,78.43755451480939,73.52711190310603,NaN,NaN,126.6107222852929,112.4694069612616,0.06951581633526471,1.4283307478628728,1.3588149315276081,2795188573,2680707696.2,90.51355601750858,82.9135975031596,NaN,NaN,47.75812252392794,41.4605044673167
2006-10-25T09:30:00-04:00,137.74001,138.41,137.50999,138.35001,80750816,64321824.8,80.21653469762794,74.10918249474254,NaN,NaN,131.55800475105644,115.9526273039615,0.0936711357497384,1.475903851214781,1.3822327154650427,2875939389,2743212000.2,92.05249063717443,84.1071817743289,NaN,NaN,49.71799470817655,42.64014593029668
2006-10-26T09:30:00-04:00,138.66,139,137.98,138.78,66848368,64734163.2,81.7037413765782,74.9255423439635,NaN,NaN,141.44210238834282,123.72795410055821,0.11874023171524839,1.5306580051091032,1.4119177733938548,2942787757,2806269616.2,93.24334994751067,85.2574582638126,NaN,NaN,51.85547672002677,43.95662175740098
2006-10-27T09:30:00-04:00,138.61,138.75,137.63,137.91,80239376,66346547.2,70.20426560473527,74.89407244001895,NaN,NaN,107.95925880993988,125.21186166968332,0.05983494389187016,1.4867114532586925,1.4268765093668223,2862548381,2843659456.2,93.833383974569,86.23185346800268,NaN,NaN,50.12190544520112,44.83737656994386
2006-10-30T09:30:00-05:00,137.66,138.2,137.39999,137.81,49718096,66210227.2,69.0021012538479,74.71532893623332,NaN,NaN,87.29842517447608,118.9737026818216,0.00038727688695283646,1.4273606054755135,1.4269733285885606,2812830285,2857858877,94.04602844493782,87.0573115458166,NaN,NaN,48.36472695610312,45.34128376796661
2006-10-31T09:30:00-05:00,138.07001,138.25999,137.25,137.78999,71297184,66119652,68.74841623894083,74.65774087830255,NaN,NaN,80.3116669016817,109.71389160509936,-0.05118010569792775,1.362998196466151,1.4141783021640788,2741533101,2847127782.6,91.47867810841812,87.74481929180618,NaN,NaN,46.87349144181893,45.56017057851694
2006-11-01T09:30:00-05:00,138.22,138.31,136.72,136.86,83006496,66225311.2,58.063906002517676,73.45253308461001,NaN,NaN,44.98364221094131,92.39901909707632,-0.15306117917583917,1.2228518281942797,1.375913007370119,2658526605,2803645225.8,81.74130154465675,87.79141035643458,NaN,NaN,42.09477189516048,45.06511362375173
2006-11-02T09:30:00-05:00,136.50999,137.00999,136.36,136.78,60703904,66228506.4,57.23979374525865,72.0919981311015,NaN,NaN,-1.7202994039565211,63.766538738616454,-0.2265438916883593,1.0927331427596698,1.3192770344480291,2597822701,2734652214.6,69.16180856514464,86.83109709392035,NaN,NaN,38.000654518787925,44.05590518018547
2006-11-03T09:30:00-05:00,137.27,137.39,135.62,136.53999,71346368,66545734.4,54.73004655518209,70.49520876429685,NaN,NaN,-25.679910644604035,37.038704847707706,-0.28807010153428303,0.9591894075301752,1.2472595090644583,2526476333,2667437805,59.54732775769913,85.08429392724874,NaN,NaN,33.824122630429606,42.59422195879178
2006-11-06T09:30:00-05:00,136.96001,138.28,136.95,138.08,63312704,67652474.4,65.25654271371371,70.03060220375356,NaN,NaN,70.43063300368722,33.66514641354994,-0.22462361357667815,0.9664799920936105,1.1911036056702886,2589789037,2622829555.4,54.165613454962376,83.13726822433843,NaN,NaN,33.22070108426771,41.25514754814548
2006-11-07T09:30:00-05:00,138.2,138.98,138,138.61,63363200,67999209.6,68.01319309473962,69.70199236389044,NaN,NaN,123.70040231643439,42.34289349650048,-0.15011714547883592,1.0034571738217437,1.1535743193005796,2653152237,2605153382.6,52.15418198890491,80.89673586904811,NaN,NaN,33.66877010760942,40.17137934235461
2006-11-08T09:30:00-05:00,138,139.05,136.86,138.91,87519632,67171375.2,69.48888859430005,69.4040139832003,NaN,NaN,93.96062425115771,52.13828990454376,-0.08692016360825372,1.0449241147902626,1.1318442783985163,2740671869,2621582435.4,53.86886819366289,78.64740088682031,NaN,NaN,34.5152089722424,39.363355003767154
2006-11-09T09:30:00-05:00,139.00999,139.14,137.89999,138.17999,95917680,69008614.4,61.993960287982226,68.56018129301667,NaN,NaN,96.45417247956404,71.77318428124786,-0.09965936209532522,1.0072700757793598,1.106929437874685,2644754189,2630968733,54.864111226807104,76.3607598063702,NaN,NaN,32.72455045477631,38.41495435391132
2006-11-10T09:30:00-05:00,138.14,138.34,137.72,138.24001,48992000,68760949.6,62.35348501179182,67.53231640657323,NaN,NaN,60.60654684072906,89.03047577831448,-0.1086810646759333,0.9710781070297685,1.0797591717057018,2693746189,2664422704.2,58.31589483037335,74.2133281923093,NaN,NaN,31.436807333745882,37.4180762081734
2006-11-13T09:30:00-05:00,138.17999,139.03999,138.07001,138.58,59403504,69617329.6,64.40743679480462,66.5301651408586,NaN,NaN,98.20280022287513,94.58490922215206,-0.096785042815974,0.9587778681857344,1.0555629110017084,2753149693,2697094835.4,61.41908608745066,72.13515176873373,NaN,NaN,30.99926548613436,36.501103247882114
2006-11-14T09:30:00-05:00,138.97,139.74001,138.12,139.62,96704192,69913270.4,69.82987333409366,65.788260757749,NaN,NaN,149.32847642921652,99.71052404470849,-0.027508210104310038,1.0211776483713209,1.048685858475631,2849853885,2736435165,64.81560017669764,70.18965959298535,NaN,NaN,32.40842581971663,35.91643504385847
2006-11-15T09:30:00-05:00,139.57001,140.45,139.53,140.02,76518192,69370620.8,71.62067934552856,65.06804204124546,NaN,NaN,204.86834731984388,121.89206865844571,0.03332158908477112,1.0903378448315948,1.0570162557468237,2926372077,2773575206.6,67.70608493167835,68.36556923471163,NaN,NaN,34.14784448258522,35.66377924939086
2006-11-16T09:30:00-05:00,140.44,140.67999,139.49001,140.38,76740128,70003536.8,73.16453847967296,65.27949010374101,NaN,NaN,195.78895744927047,141.75902565238704,0.08303949952364187,1.160815630151376,1.077776130627734,3003112205,2845246809.8,72.41557502548217,66.83572573834827,NaN,NaN,36.07046217651316,35.72187681040833
2006-11-17T09:30:00-05:00,139.92999,140.42999,139.73,140.42,56357296,70416426.4,73.33809424276744,65.58920388866383,NaN,NaN,169.14746878788995,163.4672100418192,0.10257548210857292,1.2059954832634503,1.1034200011548774,3059469501,2918391472.2,76.22601691044606,65.56286777159886,NaN,NaN,37.652498664493024,35.99767993242043
2006-11-20T09:30:00-05:00,140.3,140.74001,139.94099,140.5,69185504,70564001.6,73.7043866821009,65.94320177746098,NaN,NaN,158.46592466694602,175.51983493063338,0.10448882482706634,1.2340310321887102,1.129542207361644,3128655005,2993492534.6,79.37615233008039,64.69840164457473,NaN,NaN,39.04988468220274,36.433709182389336
2006-11-21T09:30:00-05:00,140.49001,140.67,140.28999,140.64,51371392,70464801.6,74.36804006589487,67.10778278198792,NaN,NaN,143.45504427351818,174.3451484994937,0.09884724635895248,1.2531012653103346,1.1542540189513821,3180026397,3059527037,81.67533195774777,64.6936895312241,NaN,NaN,40.40373956541179,37.00085637996397
2006-11-22T09:30:00-05:00,140.75,141.16,140.5,140.92,45508704,68702696,75.68953630066827,68.42562153594575,NaN,NaN,137.7904523347164,160.9295695024682,0.0974753105850783,1.2760981571827301,1.1786228465976518,3225535101,3119359641.8,83.47314718197067,65.71592800385453,NaN,NaN,41.93909026309684,37.706318363268664
2006-11-24T09:30:00-05:00,140.24001,140.84,140.2,140.35001,30998192,66910187.2,68.00339128372758,69.37371758798471,NaN,NaN,97.2004935340198,141.21187671941806,0.04438488125706175,1.234103948168979,1.1897190669119173,3194536909,3157644582.6,84.5197043163104,67.49966918661248,NaN,NaN,41.11450224680332,38.19320177520218
2006-11-27T09:30:00-05:00,140.28,140.35001,138.38,138.42,84547376,67125587.2,49.626767522424906,68.25730507432124,NaN,NaN,12.950668275432603,109.9725166169266,-0.12523307111161808,1.0331777280223946,1.1584107991340127,3109989533,3167748589,84.79339212133436,69.68736766278191,NaN,NaN,33.67961870168887,37.54840419327171
2006-11-28T09:30:00-05:00,138.24001,139.16,138.11,139.02,106667680,69973066.4,53.80600500216014,67.24250592485126,NaN,NaN,-6.925202722006048,76.89429113913617,-0.1972518049289722,0.9118460429727975,1.1090978479017697,3216657213,3185349030.6,85.28154195353815,72.05360766025572,NaN,NaN,29.078646286311027,36.33843877799161
2006-11-29T09:30:00-05:00,139.47,140.53,139.08279,140.47,91542000,70985307.2,62.00910785496152,66.70823587204137,NaN,NaN,63.08746896210574,60.82077607685369,-0.14962730732899354,0.9220637137405276,1.0716910210695212,3308199213,3210983593.8,85.98710481237003,74.34776741873479,NaN,NaN,28.0759490783096,35.158083106608466
2006-11-30T09:30:00-05:00,140.44,141.05,139.75999,140.53,83997680,71034866.4,62.307382857892044,66.7306231984635,NaN,NaN,80.29821563046046,49.3223287360025,-0.11787482681780448,0.9243474875472657,1.0422223143650702,3392196893,3244315952.2,86.86857962285201,76.63380087559514,NaN,NaN,27.432487637458664,34.054426611015636
2006-12-01T09:30:00-05:00,140.53,140.66,138.97,140.22,126156688,74307505.6,59.69941307790233,66.54104663175711,NaN,NaN,42.894063420601114,38.46104271331875,-0.12107901166128299,0.8908735497884663,1.0119525614497493,3266040205,3258616611.4,87.23945330093983,78.69976933777846,NaN,NaN,26.058486178417002,32.91214940635869
2006-12-04T09:30:00-05:00,140.25,141.55,140.23,141.28999,87814496,75130912,65.12535941123622,66.59232681864508,NaN,NaN,107.9474386809272,57.46039679441768,-0.05768168701069065,0.939850452686386,0.9975321396970767,3353854701,3307389645,88.438752141527,80.6297454844982,NaN,NaN,26.741227405106265,32.030589120465486
2006-12-05T09:30:00-05:00,141.56,141.96001,141.25999,141.89999,73380688,75634311.2,67.7880230185608,66.44648036753559,NaN,NaN,146.24300975900124,88.09403929061915,0.01491276204088332,1.0161730922481809,1.0012603302072975,3427235389,3349505280.2,89.36797993252547,82.38348689562875,NaN,NaN,28.213540801020315,31.48529650340189
2006-12-06T09:30:00-05:00,141.87,142.07001,141.5,141.78,53324000,75132351.2,66.70909734421798,66.09565308172769,NaN,NaN,140.85756090406562,103.64805767901112,0.042846023901657926,1.0548178600843698,1.011971836182712,3373911389,3362647715.4,89.64760461316622,83.95073830144932,NaN,NaN,29.018646561908596,31.13291794033142
2006-12-07T09:30:00-05:00,142.03,142.3,141.11,141.16,62850304,73898884.8,61.281595922074715,65.24687147047067,NaN,NaN,115.20166990802454,110.62874853452395,0.009315086277136286,1.0236156940291323,1.014300607751996,3311061085,3346420553.8,86.61844945725078,84.96522933228994,NaN,NaN,27.961934891033312,30.679920361860262
2006-12-08T09:30:00-05:00,141.13,141.89999,140.78,141.42,79624624,73084232,62.65382723588467,64.48370954140762,NaN,NaN,96.18411570672814,121.28675899174934,-0.004844360474127507,1.0082451571593367,1.0130895176334642,3390685709,3371349654.6,87.3269075537793,85.75815009252803,NaN,NaN,27.527520117025837,30.22957746974106
2006-12-11T09:30:00-05:00,141.42,142.09,141.34,141.83,39779296,72623596.8,64.77398687304728,63.84582384076095,NaN,NaN,119.92626265927028,123.68252378741798,0.003463820411954366,1.0174192931484072,1.0139554727364528,3430465005,3386671715.4,87.75597654868103,86.35670896528521,NaN,NaN,27.809198471782715,29.883809041461294
2006-12-12T09:30:00-05:00,141.69,141.87,140.89,141.72,77453504,73526096.8,63.7286632118274,63.08586835118471,NaN,NaN,88.35939047119653,112.10579992985701,-0.0077743334723643365,1.0042375558959975,1.0120118893683618,3353011501,3371826937.8,84.76174343776786,86.5771669281438,NaN,NaN,27.73571121193682,29.576937922957796
2006-12-13T09:30:00-05:00,142.23,142.34,141.56,141.87,55568400,71469307.2,64.56836410210991,62.29149890843054,NaN,NaN,112.9517853894637,106.52464482693662,-0.014064316847414604,0.9944314933090936,1.0084958101565082,3408579901,3378760640.2,85.01885994196888,86.68757498242938,NaN,NaN,27.910179713227922,29.3388296072821
2006-12-14T09:30:00-05:00,141.86,143.24001,141.84,143.12,64779200,70882357.6,70.66337676674317,62.48149787150309,NaN,NaN,158.78938224566068,115.24218729446386,0.053308334135439006,1.075131227825807,1.021822893690368,3473359101,3411220243.4,86.19334086927992,86.80712045049863,NaN,NaN,29.989643341568044,29.43180299789438
2006-12-15T09:30:00-05:00,142.64,142.89,142.24001,142.34,70858816,70588292,63.34121875903572,63.461101531261,NaN,NaN,122.00368401023569,120.40610095516539,0.03364815353238715,1.0638830856058519,1.0302349320734647,3402500285,3413583158.6,86.2776779038104,86.91314086353263,NaN,NaN,29.451400890872222,29.434602696891215
2006-12-18T09:30:00-05:00,142.53999,142.88,141.75,141.95,48956800,70218267.2,59.99383122758162,63.90308911879111,NaN,NaN,89.32755581857374,114.28635958702607,-0.01471970270780143,1.0118353036887129,1.0265550063965143,3353543485,3398198854.6,82.73420417156922,86.73118816482057,NaN,NaN,27.957523063804462,29.223591320735963
2006-12-19T09:30:00-05:00,141.55,142.56,141.19,142.22,65077504,70012867.2,61.510348624052824,63.867463459440486,NaN,NaN,67.022414546397,110.01896440206615,-0.03639224362939952,0.9810647018597649,1.0174569454891644,3418620989,3411320752.2,83.36188430654255,86.54367241440433,NaN,NaN,27.19217768046057,28.93338937212519
2006-12-20T09:30:00-05:00,142.28,142.66,142.00999,142.14,41473200,69517957.6,60.77522912113195,63.758023906814756,NaN,NaN,80.49493258707025,103.52759384158746,-0.06244980472779882,0.9393946895794159,1.0018444943072147,3377147789,3405034329.8,81.8271236188852,86.18356841412097,NaN,NaN,26.359468057627527,28.565686327196953
2006-12-21T09:30:00-05:00,142.27,142.42999,141.32001,141.62,48698400,69677442.4,56.08340055530594,63.49973729805787,NaN,NaN,41.25720222091735,80.02115783663879,-0.11782726745270278,0.8545604099913362,0.972387677444039,3328449389,3376052387.4,74.97394400326323,85.30746060714408,NaN,NaN,24.260091961861264,27.950601417863282
2006-12-22T09:30:00-05:00,141.64,141.64999,140.67,140.75,62073200,71231192.8,49.23498738722885,62.364710724914495,NaN,NaN,-18.800940479359,51.860232938719854,-0.210746528552891,0.7089545167529252,0.9197010453058162,3266376189,3348827568.2,69.11785983470526,83.92739687094252,NaN,NaN,20.240490843700673,26.84915705012577
2006-12-26T09:30:00-05:00,140.81,141.61,140.78,141.58,32697600,68638704,54.89391654473814,61.44370311964144,NaN,NaN,-5.195947987479397,32.955532177509234,-0.2133549179023151,0.6530073979279223,0.8663623158302374,3299073789,3337933629,66.86717565308712,82.32019656526835,NaN,NaN,18.513879426510307,25.658403103894987
2006-12-27T09:30:00-05:00,141.87,142.60001,141.83,142.50999,39732496,65291944.8,60.24179357707471,60.98175285055978,NaN,NaN,86.60234636271564,36.87151854077297,-0.1523540591505539,0.6759197418920451,0.828273801042599,3338806285,3321970688.2,63.599130173846596,80.45959124817409,NaN,NaN,18.78601288711619,24.676633072926588
2006-12-28T09:30:00-05:00,142.41,142.7,141.99001,142.21001,37291104,62579400,57.85884453472709,60.73727060860638,NaN,NaN,80.65686012754483,36.903904048867886,-0.13282848806672987,0.6622381909591866,0.7950666790259164,3301515181,3306844166.6,60.57779156342365,78.59954425575788,NaN,NaN,18.246265141923747,23.758009082783325
2006-12-29T09:30:00-05:00,142.10001,142.53999,141.42999,141.62,45466704,60652851.2,53.385884105269014,60.07527467070526,NaN,NaN,18.110149648738798,32.27449353443218,-0.15852868052831592,0.5969058283655215,0.7554345088938375,3256048477,3292363984.2,57.74955016866629,76.48687587110695,NaN,NaN,16.366642030377996,22.70209950386828
2007-01-03T09:30:00-05:00,142.25,142.86,140.57001,141.37,94808496,59085441.6,51.56676754317293,59.131901861428524,NaN,NaN,-40.558475645002616,27.922986501303455,-0.18916829605049867,0.5189741388307141,0.7081424348812128,3161239981,3271336742.6,53.82002656991836,74.06287944405246,NaN,NaN,14.281402179146403,21.499142743193726
2007-01-04T09:30:00-05:00,141.23,142.05,140.61,141.67,69634624,58176448,53.6095792115303,58.40911014712159,NaN,NaN,-76.80631363866199,13.600913371066937,-0.18576679906807558,0.47593393604611833,0.6617007351141939,3230874605,3257696905.8,51.37784079685983,71.6783149697019,NaN,NaN,13.163582554560849,20.308348430531886
2007-01-05T09:30:00-05:00,141.33,141.39999,140.38,140.53999,76688880,58341857.6,45.777413911216,57.066899419200595,NaN,NaN,-175.10953573371148,-38.741463048218485,-0.25204380167029883,0.34664598302632044,0.5986897846966193,3154185725,3220772793.8,45.37524205513334,68.84662797778508,NaN,NaN,9.619358548901534,18.781349876013266
2007-01-08T09:30:00-05:00,140.82001,141.41,140.25,141.19,69655808,59158448,50.277443135049616,55.610761302651056,NaN,NaN,-124.69350144139146,-79.81153536200574,-0.2443484111654145,0.2932542707398511,0.5376026819052656,3223841533,3205238064.2,43.09406373327379,65.76810818235606,NaN,NaN,8.078140259156303,17.252319930747987
2007-01-09T09:30:00-05:00,141.31,141.60001,140.39999,141.07001,75681120,59799988.8,49.46140352125406,54.6193459285238,NaN,NaN,-102.96462827347565,-104.02649094644862,-0.2392746445146453,0.238509376261959,0.4777840207766043,3148160413,3183660451.4,40.08000036634016,62.46827407253676,NaN,NaN,6.601135407867311,15.730722141765034
2007-01-10T09:30:00-05:00,140.58,141.57001,140.3,141.53999,72447376,59441126.4,52.699730376647466,54.09833872488564,NaN,NaN,-82.5189426528732,-112.41858434802275,-0.19791417370052578,0.23039130365094707,0.42830547735147284,3220607789,3195534013,42.46468905103623,59.59188013535583,NaN,NaN,6.337286598928113,14.388802778502617
2007-01-11T09:30:00-05:00,141.56,142.62,141.5,142.16,55532496,60228786.4,56.646365837727934,53.750911383005295,NaN,NaN,48.967801270282266,-87.26376136623391,-0.125952433393764,0.27086493560926783,0.39681736900303183,3276140285,3204587149,44.28536192139466,56.80069996498812,NaN,NaN,7.3297766447914565,13.380370473686737
2007-01-12T09:30:00-05:00,142.12,143.24001,142.11,143.24001,57631200,59237671.2,62.51380416030693,53.87509531437494,NaN,NaN,136.22535171873565,-24.996783875744477,-0.008939567122775327,0.38564291009956264,0.39458247722233797,3333771485,3240504301,50.92097311194462,54.59311778592094,NaN,NaN,10.153468976792361,12.91938454555897
2007-01-16T09:30:00-05:00,143.07001,143.44,142.73,142.96001,44988304,58708666.4,60.2376282308292,54.17182586262659,NaN,NaN,138.6894829182702,27.679812996187856,0.04340417842584393,0.44883770025464287,0.40543352182879894,3288783181,3253492630.6,53.09644497217688,53.03043928370048,NaN,NaN,11.725382774355268,12.74881286395844
2007-01-17T09:30:00-05:00,142.85001,143.46001,142.73,143.02,51597008,58049556.8,60.568892343559945,54.98139050236453,NaN,NaN,135.8784170259055,75.44842205606408,0.07406906693813531,0.4980198555014681,0.4239507885633328,3340380189,3291936585.8,58.90310011576444,52.300813589490424,NaN,NaN,13.08166460699082,12.796363112963066
2007-01-18T09:30:00-05:00,143.17,143.25999,142.31,142.53999,68234368,57918334.4,56.51195285812731,55.096964524749474,NaN,NaN,91.21342642775058,110.19489587218884,0.054908206874437315,0.49258604715637944,0.4376778402819421,3272145821,3302244192.2,60.32147250085724,51.83326336433115,NaN,NaN,13.048005389815481,12.832312009656269
2007-01-19T09:30:00-05:00,142.53999,143.10001,142.46001,142.82001,56983904,58319689.6,58.26802085929802,54.955980759194,NaN,NaN,93.23467258603371,119.04827013533914,0.05390016895589189,0.505053051476807,0.4511528825209151,3329129725,3312842080.2,61.78195337210934,51.70346502134992,NaN,NaN,13.52919509595036,12.93186673626971
2007-01-22T09:30:00-05:00,143.07001,143.10001,141.92999,142.38,60261696,58078899.2,54.5410732970273,54.7189970993583,NaN,NaN,54.147249702779504,102.63264973214791,0.018249329426157868,0.47396454430361246,0.4557152148774546,3268868029,3299861389,58.92123349982736,51.58513944537875,NaN,NaN,12.864375102240247,12.922225074265501
2007-01-23T09:30:00-05:00,142.25999,143.08,142.06,142.8,54077200,58709099.2,57.345592124334516,55.0018333864344,NaN,NaN,68.36176756810401,88.56710666211467,0.017596164054102914,0.47771041994508323,0.4601142558909803,3322945229,3306693798.6,59.971840000366534,51.74387443335734,NaN,NaN,13.107269646282148,12.948660013125023
2007-01-24T09:30:00-05:00,142.97,143.98,142.91,143.95,56469392,59097648.8,63.91081520384384,55.88355107648232,NaN,NaN,141.8893721754673,89.76929769202702,0.08545989220425981,0.5669391211463051,0.48147922894204526,3379414621,3314500685,61.19313314403935,52.27052490293742,NaN,NaN,15.41835993065812,13.301474287058323
2007-01-25T09:30:00-05:00,143.84,143.92,142.00999,142.25999,73607312,59674354.4,51.392139583261304,55.72516253160596,NaN,NaN,56.1525549709826,82.75712340067342,0.011273569252288118,0.4955711905074054,0.48429762125511727,3305807309,3321232982.6,62.26243015030824,53.04799557104087,NaN,NaN,13.168266208383834,13.282444561533396
2007-01-26T09:30:00-05:00,142.57001,142.64999,141.58,142.16,74585632,61768756,50.758640503824395,56.08096443107799,NaN,NaN,-4.857186274562194,63.138751628554246,-0.04661233704883394,0.4260321999440748,0.47264453699290876,3231221677,3301651373,57.31554358928492,53.90087425205171,NaN,NaN,11.231035982838506,12.98938619314841
2007-01-29T09:30:00-05:00,142.19,142.8,141.74001,142.05,66216000,63092931.2,50.02803401356523,56.06314949382911,NaN,NaN,2.4991997323383055,52.809141634466,-0.09177955899447676,0.3579200882498128,0.44969964724428957,3165005677,3280878902.6,52.54606879006126,54.576017470393666,NaN,NaN,9.472821382429746,12.487019791617174
2007-01-30T09:30:00-05:00,142.35001,142.86,142.06,142.78999,70410624,64748907.2,54.746920514103444,56.44068642188977,NaN,NaN,38.48489688345061,46.83376749753532,-0.07215365532989787,0.35950757808191725,0.4316612334118151,3235416301,3263373117,48.85631814314187,55.20289731159379,NaN,NaN,9.443486468650319,12.052229316907622
2007-01-31T09:30:00-05:00,142.63,144.13,142.39999,143.75,91887872,67069965.6,60.021353429609334,56.96365949710134,NaN,NaN,110.30707284297749,40.51730763103736,0.0012601170842466702,0.4332363797671235,0.4319762626828768,3327304173,3252951027.4,46.75152022425993,55.50909953825262,NaN,NaN,11.153409974693533,11.92382655373418
2007-02-01T09:30:00-05:00,144.14999,144.66,143.91,144.61,69316128,65795347.2,64.06231825915484,57.49337038434612,NaN,NaN,177.3153133805743,64.7498593129557,0.09815333570583401,0.5546679323151693,0.4565145966093353,3396620301,3271113625.8,50.734774293686044,55.96977185055915,NaN,NaN,13.96733909134707,12.215756916250307
2007-02-02T09:30:00-05:00,144.73,144.95,144.38,144.81,49607696,64794000.8,64.94960925579375,57.66735646259518,NaN,NaN,184.32947541102573,102.58719165007328,0.1623403442830773,0.6594400269631819,0.4970996826801046,3446227997,3314114889.8,58.626026929519135,56.520132837528756,NaN,NaN,16.48264153131629,12.825311861259733
2007-02-05T09:30:00-05:00,144.7,144.94,144.34,144.85001,45735200,63246316.8,65.13505982890635,58.01717300531497,NaN,NaN,167.36523311179187,135.560398325964,0.19208275045859602,0.7372031207533496,0.5451203702947536,3491963197,3379506393.8,67.22384518908761,57.529232853022386,NaN,NaN,18.53954636652077,13.641631076297024
2007-02-06T09:30:00-05:00,144.97,145.03,144.33,144.89,57082192,62617636,65.33249541519041,58.357430367574295,NaN,NaN,148.0274908980341,157.46891712888072,0.19823772927692307,0.7929175318909074,0.5946798026139843,3549045389,3442232211.4,73.0164050482529,58.53732606248585,NaN,NaN,20.266504589082746,14.588041578123557
2007-02-07T09:30:00-05:00,145.12,145.36,144.57001,145.21001,55694192,61618289.6,66.9456003230402,59.102690900782356,NaN,NaN,147.183211446575,164.8441448496002,0.2067043097697343,0.8530601898261523,0.646355880056418,3604739581,3497719293,76.90475494715363,59.72184623722131,NaN,NaN,22.194101415448365,15.674621554884244
2007-02-08T09:30:00-05:00,144.78,145.12,144.27,145.02,70646000,61528220.8,65.01128889046873,59.584352903008835,NaN,NaN,111.61897981679155,151.70487813684366,0.18315651943488598,0.8753015293500255,0.6921450099151395,3534093581,3525213949,78.55388621445343,60.91984144024588,NaN,NaN,23.297149814571398,16.76355416341098
2007-02-09T09:30:00-05:00,145.06,145.33,143.39,143.94,79084880,62705840,55.2411822546438,59.63436068569573,NaN,NaN,59.46255467664743,126.731493989968,0.08356262238931822,0.7965982879017872,0.713035665512469,3455008701,3526970089.8,78.65870740720669,62.329661005058696,NaN,NaN,21.423583278168255,17.429272608376305
2007-02-12T09:30:00-05:00,143.94,144.03999,143.19,143.45,65657056,63107132.8,51.46235376152258,59.2141293740663,NaN,NaN,6.3175349570595865,94.52195435902154,-0.021012658897363146,0.6867698418907651,0.7077825007881282,3389351645,3506447779.4,74.10070615125984,63.3388657301225,NaN,NaN,18.68254772141948,17.608311910239614
2007-02-13T09:30:00-05:00,143.77,144.89999,143.75999,144.66,64107072,64063071.2,58.933043620138804,58.85857426094451,NaN,NaN,67.80814573982734,78.47808532738017,-0.014690245683357972,0.6894196936839307,0.7041099393672887,3453458717,3487330445,70.02975394451032,63.97005293015614,NaN,NaN,18.56070291396755,17.744367767915033
2007-02-14T09:30:00-05:00,144.8,145.89999,144.78,145.61,66062368,64786339.2,63.662006032523436,59.73499329303466,NaN,NaN,123.68696139340281,73.77883531674574,0.044250152099206685,0.7594226294912971,0.7151724773920904,3519521085,3470286745.8,66.52099447570578,64.27423609625598,NaN,NaN,20.04080943237754,18.07243086283825
2007-02-15T09:30:00-05:00,145.67,145.95,145.42999,145.8,38721696,63310705.6,64.54145162444362,60.71947980165032,NaN,NaN,126.59900592707564,76.77484053880258,0.08447845063448989,0.8207705406852028,0.7362920900507129,3558242781,3475116585.8,67.02519900989554,64.96778291201386,NaN,NaN,21.49300708443019,18.561084608779954
2007-02-16T09:30:00-05:00,145.44,145.75999,145.23,145.73,39842800,62453650.4,63.92759700236831,61.71230572942197,NaN,NaN,104.84744565351954,85.85181873417699,0.09408439792202716,0.8538975874532468,0.7598131895312197,3518399981,3487794841.8,68.37174409214683,66.09818829073427,NaN,NaN,22.4680105198286,19.119216881786905
2007-02-20T09:30:00-05:00,145.56,146.2,144.06,146.03999,56923904,62286760.8,65.49280061602168,62.4798685938447,NaN,NaN,88.75945098486594,102.34020193973826,0.1080289257709941,0.8948493467449623,0.7868204209739682,3575323885,3524989289.8,71.98598690897691,67.75030748829391,NaN,NaN,23.742652439666603,19.779707675769718
2007-02-21T09:30:00-05:00,145.61,146.07001,145.35001,145.98,63973392,62781570.4,64.90585815967222,62.82876178884919,NaN,NaN,106.05058348349188,109.98868948847117,0.10010431763843075,0.9119508180220066,0.8118465003835759,3511350493,3536567645,73.01956768015998,69.62659659228677,NaN,NaN,24.622338490729025,20.471512077906763
2007-02-22T09:30:00-05:00,146.05,146.42,145.17,145.87,79079680,63912084.8,63.77719108133919,62.80839556186236,NaN,NaN,98.56768351803869,104.96483391339834,0.07546830044487196,0.9061818759396658,0.8307135754947939,3432270813,3519117590.6,68.89398764687662,70.92368326037182,NaN,NaN,25.053868291248765,21.12613439409848
2007-02-23T09:30:00-05:00,145.74001,145.78999,144.75,145.3,71971376,63830288,58.13572587053022,62.32168960577211,NaN,NaN,57.22903776161464,91.09084028030614,0.012121223657553415,0.8458651050667356,0.8337438814091822,3360299437,3479528921.8,60.537411024572556,71.06021069573278,NaN,NaN,23.863699900346543,21.517215180705346
2007-02-26T09:30:00-05:00,145.83,145.95,144.75,145.17,70074752,63604744,56.89952694371206,61.73343725682967,NaN,NaN,53.86558221773659,80.89446759314956,-0.04411629152481711,0.7785985170031609,0.822714808527978,3290224685,3433893862.6,52.614814747633844,70.01670852134322,NaN,NaN,22.52813123592205,21.66163176002202
2007-02-27T09:30:00-05:00,143.88,144.2,139,139.5,274909952,74039441.6,28.467134460800608,59.10019718865896,NaN,NaN,-284.7156466703063,6.199448062115101,-0.44639891535204135,0.26471616433792633,0.7111150796899677,3015314733,3321892032.2,39.09256312052302,67.5935769550768,NaN,NaN,7.514053100267196,19.64054909434276
2007-02-28T09:30:00-05:00,140.39,141.98,139.8,140.92999,177549680,79396394.4,37.01532627262887,56.96232047077245,NaN,NaN,-247.0918907861643,-64.42904679181613,-0.5903653810344449,-0.02684164660308852,0.5635237344313564,3192864413,3258194816.2,33.776018790564166,64.51295294389185,NaN,NaN,0.01710970876387655,16.837200610688633
2007-03-01T09:30:00-05:00,139.34,141.25,138.05,140.50999,212841120,85444056.8,35.66717590985684,54.86631240072874,NaN,NaN,-241.1693715985582,-132.37645781513552,-0.6815938009469162,-0.2884685167522889,0.39312528419462733,2980023293,3167745312.2,27.960919168932378,60.89916958349748,NaN,NaN,-5.85763177406132,13.595081698581497
2007-03-02T09:30:00-05:00,140.05,140.66,138.66,138.67,162600320,90108266.4,30.43707034507942,53.094590121474134,NaN,NaN,-200.7318726180709,-183.96863989107263,-0.824051645256727,-0.6369392723762815,0.18711237288044558,2817422973,3059170019.4,22.870688690098262,56.91431110370403,NaN,NaN,-12.80803153273281,9.823208379822312
2007-03-05T09:30:00-05:00,137.92999,139.58,137.33,137.35001,144137008,94834732,27.339814018439455,51.37155156839676,NaN,NaN,-190.7967726449361,-232.90111086360716,-0.9560878591275213,-1.007997451028956,-0.05190959190143474,2673285965,2935782275.4,18.70356733305708,52.95737261668954,NaN,NaN,-19.45349936372413,5.640821559315677
2007-03-06T09:30:00-05:00,138.78,140.12,137.717,139.7,143379312,99716937.6,39.20151826512837,49.96215690018174,NaN,NaN,-127.20590737031024,-201.39916300360795,-0.8382817729438898,-1.099761808081297,-0.2614800351374072,2816665277,2896052384.2,17.59208092683248,49.21182454399827,NaN,NaN,-20.0286125218649,1.9737595477184522
2007-03-07T09:30:00-05:00,139.59,140.46001,139.39999,139.56,115224496,102624052.8,38.79519172187595,48.18595587799263,NaN,NaN,-93.27404732269494,-170.6355943109141,-0.7270496940407292,-1.1702921526883188,-0.44324245864758954,2701440781,2797767657.8,15.187595876165759,45.545153215459685,NaN,NaN,-20.59155718094403,-1.2498571278047592
2007-03-08T09:30:00-05:00,140.53999,141.16,140.07001,140.74001,117892256,105733956,44.058388575482276,46.722879945923964,NaN,NaN,-62.049655799114426,-134.81165115102533,-0.5398719971840018,-1.1180824551275919,-0.57821045794359,2819333037,2765629606.6,14.490172329274017,41.792651309701014,NaN,NaN,-19.101888145479272,-3.800147273186832
2007-03-09T09:30:00-05:00,141.31,141.42,140.08,140.78,107765632,107589937.6,44.2334089340043,45.3161522267551,NaN,NaN,-53.08879112252876,-105.28303485191688,-0.3864281580897291,-1.0612456555557515,-0.6748174974660224,2927098669,2787564745.8,17.282152553556884,38.143394771230305,NaN,NaN,-17.924443879331537,-5.817903931207504
2007-03-12T09:30:00-04:00,140.42,141.34,140.16,140.99001,80371808,107654284,45.202989093747625,43.8668799751641,NaN,NaN,-46.36804972712292,-76.39729026835425,-0.2504407999658502,-0.9878684974233352,-0.7374276974574849,3007470477,2854401648.2,25.287000413367068,34.80775287868674,NaN,NaN,-16.69239442459759,-7.371402573120374
2007-03-13T09:30:00-04:00,140.17999,140.77,138.03999,138.25,190080624,113875462.4,36.32832616504932,41.825627689833894,NaN,NaN,-83.39077624051917,-67.63426404239603,-0.3202160873205735,-1.1376978066082017,-0.8174817192876283,2817389853,2854546563.4,25.303878927722565,31.399489396369784,NaN,NaN,-18.642048552514684,-8.98149485589099
2007-03-14T09:30:00-04:00,138.42999,139.36,136.75,139.28,231826880,122261452.8,41.016313061758616,40.199850688435276,NaN,NaN,-88.55409788568666,-66.69027415499436,-0.273978610709832,-1.1599549826749183,-0.8859763719650863,3049216733,2924101753.8,33.11425426163018,28.843794154566467,NaN,NaN,-18.593996500722817,-10.354709376581251
2007-03-15T09:30:00-04:00,138.97,139.99001,138.8,139.47,132413680,125579018.4,41.86660269765404,39.03777046180126,NaN,NaN,-60.723211164140956,-66.42498522799966,-0.21043281104682543,-1.1490173857736181,-0.9385845747267927,3181630413,2996561229,40.13664848856652,27.38659683056604,NaN,NaN,-18.281704428102916,-11.487137241084346
2007-03-16T09:30:00-04:00,139.31,139.63,138.12,138.53,122046192,129745243.2,38.88036585928586,37.75068752719938,NaN,NaN,-73.7710352613808,-70.56143405577006,-0.2110040068068061,-1.2023395832353003,-0.9913355764284942,3059584221,3023058339.4,42.513518206442804,26.66507564905239,NaN,NaN,-18.970624709772835,-12.556206879468416
2007-03-19T09:30:00-04:00,139.25999,140.33,138.5466,140.2,96213120,132563759.2,46.2196462966911,39.01872408690584,NaN,NaN,-45.182159663138314,-70.32425604297313,-0.08468752674234814,-1.0971949848564293,-1.0125074581140812,3155797341,3052723712.2,45.1397791792454,27.097019653246843,NaN,NaN,-17.131704788410044,-13.209849437888648
2007-03-20T09:30:00-04:00,140.08,141.05,139.96001,140.97,83351248,133885126.4,49.24588337054904,39.89233530818586,NaN,NaN,-9.734994581262942,-55.59309971112189,0.057295094261083035,-0.9408885902877273,-0.9981836845488103,3239148589,3137075459.4,51.872551701030034,28.389629146851554,NaN,NaN,-14.65019729348823,-13.415613417260017
2007-03-21T09:30:00-04:00,141.10001,143.64999,140.82001,143.28999,153296944,138351304,57.081968700482726,41.421963364659135,NaN,NaN,74.67599638410897,-22.947080857162756,0.30044013892462884,-0.6226335108930243,-0.9230736498176532,3392445533,3205721219.4,56.5463208895221,30.431443555465105,NaN,NaN,-9.690462184693024,-12.883448955464733
2007-03-22T09:30:00-04:00,143.48,143.67999,142.78999,143.17999,118950624,140344851.2,56.63548280307176,43.29327854023002,NaN,NaN,116.94996059344514,12.587553494354458,0.43848471712743775,-0.374967753408356,-0.8134524705357937,3273494909,3224094118.6,57.729526435175764,32.921360537256355,NaN,NaN,-6.0103546115858775,-11.90157833491061
2007-03-23T09:30:00-04:00,143.28,143.81,143.14999,143.39,74425744,140467569.6,57.321834200496326,45.434851410376936,NaN,NaN,140.43206374864036,55.42817329635868,0.5228407294214097,-0.15990155875903156,-0.6827422881804412,3347920653,3281761405,61.292144467418964,35.963401761139345,NaN,NaN,-2.867936358280136,-10.611058052534828
2007-03-26T09:30:00-04:00,143.5,143.64999,142.09,143.2,113811504,142654407.2,56.451303107251924,46.666978899100044,NaN,NaN,134.55978594529967,91.37656241804628,0.5424043436821014,-0.004736858577814473,-0.5471412022599159,3234109149,3297423766.6,62.223396995347834,39.151352908890445,NaN,NaN,-0.5670120010602439,-9.176194330895601
2007-03-27T09:30:00-04:00,143.12,143.16,142.39,142.86,100535184,133935668.8,54.84613602494768,47.81347492074803,NaN,NaN,111.77880052024638,115.67932143834814,0.5095228823169411,0.08976240063626051,-0.4197604816806806,3133573965,3276308841.8,60.12335239891024,42.36104980337219,NaN,NaN,0.9032331680984348,-7.736276116753596
2007-03-28T09:30:00-04:00,142.14,142.47,141.25999,141.82001,152962064,132706288,50.14889771091214,48.24851128756445,NaN,NaN,60.529621793961404,112.85004652031864,0.399660531907862,0.07981518320414693,-0.31984534870371506,2980611901,3193942115.4,52.65746104701081,45.08728471178197,NaN,NaN,0.854369756097206,-6.5090409920606245
2007-03-29T09:30:00-04:00,142.53999,142.61,141.19,141.97,139480064,129038235.2,50.803308246858656,48.71778980991119,NaN,NaN,58.10863375871749,101.0817811533731,0.3223380539555758,0.08307721874075469,-0.2392608352148211,3120091965,3163261526.6,50.158937901898646,47.43562652237781,NaN,NaN,0.9938532618135342,-5.437198955792888
2007-03-30T09:30:00-04:00,142.24001,142.84,140.56,142,128208496,127318644,50.94202495306948,49.12772094271988,NaN,NaN,46.86423077532839,82.36821455871072,0.26107215461199723,0.08707935805017541,-0.17399279656182182,3248300461,3143337488.2,48.54794841253589,49.09712280803273,NaN,NaN,1.1458179023306085,-4.49676797606096
2007-04-02T09:30:00-04:00,142.16,142.46001,140.89,142.16,79428368,124083212,51.72384881009707,50.22740113165187,NaN,NaN,41.810782643630276,63.81841389837683,0.22078312739987696,0.10198611268802438,-0.11879701471185258,3327728829,3162061424.2,50.16774101529177,50.87311295714481,NaN,NaN,1.474312599561081,-3.6437564652578116
2007-04-03T09:30:00-04:00,142.97,143.98,142.91,143.69,82499312,121039212,58.529836776412196,51.478367111269975,NaN,NaN,111.07226955108419,63.67710770454439,0.28268100465418844,0.23455424110588297,-0.04812676354830547,3410228141,3217392259.4,54.705647403249365,52.41535532440333,NaN,NaN,3.696255210497501,-2.5951833687213384
2007-04-04T09:30:00-04:00,143.69,143.95,143.16,143.85001,64006528,118478313.6,59.17801294093585,52.71489641436153,NaN,NaN,105.39980600356243,72.6511445464646,0.3173090164879754,0.3485095070616637,0.031200490573688372,3474234669,3316116813,61.450947840926474,53.93780527814332,NaN,NaN,5.724175578604564,-1.4067035191033523
2007-04-05T09:30:00-04:00,143.67,144.44,143.61,144.24001,46843232,114925862.4,60.78677579367434,54.27963998110357,NaN,NaN,113.01201166810799,83.6318201283427,0.3469837604487168,0.46493019113458445,0.1179464306858676,3521077901,3396314000.2,65.89422862947666,55.60785602264574,NaN,NaN,7.899597519094209,-0.07723194221798635
2007-04-09T09:30:00-04:00,144.64999,144.8,144.14999,144.44,51137744,112094468,61.62201037418976,55.379808843782044,NaN,NaN,117.27072471996259,97.71311891726953,0.3590814524741018,0.5667982462784948,0.20771679380439306,3572215645,3461097037,69.0024001177404,57.312328946823946,NaN,NaN,9.966219290099279,1.3575468052559085
2007-04-10T09:30:00-04:00,144.33,144.85001,144.27,144.61,56632064,110907480.8,62.3560117397702,56.316246584440705,NaN,NaN,110.15389523898462,111.38174143634039,0.35679569686124163,0.6537114148809451,0.29691571801970346,3628847709,3521320813,71.59405791234681,58.72100796191801,NaN,NaN,11.919005255259895,2.8663265838279064
2007-04-11T09:30:00-04:00,144.82001,144.86,143.53999,144.02,106552256,106731062.4,58.19599106566433,56.39581961052511,NaN,NaN,84.48154300419354,106.06359612696227,0.2962998639417727,0.6672905479469193,0.3709906840051466,3522295453,3543734275.4,72.51507932728605,59.86163356461543,NaN,NaN,12.584013029928473,4.254567504699416
2007-04-12T09:30:00-04:00,143.74001,144.92,143.34,144.66,116447120,100962074.4,61.21841486746031,56.72317190083857,NaN,NaN,86.92704534076785,102.36904399440334,0.28031077297984275,0.72137915022995,0.4410683772501073,3638742573,3576635856.2,73.8551836956498,61.01346622607787,NaN,NaN,13.983369253291716,5.644396325926888
2007-04-13T09:30:00-04:00,144.89999,145.32001,144.36,145.32001,85181568,98600468.8,64.10095614793829,57.20739489708443,NaN,NaN,114.38276223028355,102.64319410683845,0.29369392670734906,0.8081857856342936,0.5144918589269445,3723924141,3617205104.2,75.44500688719184,62.024384970347356,NaN,NaN,16.016642415026574,7.126145767226843
2007-04-16T09:30:00-04:00,145.83,146.86,145.82001,146.7,83206816,96658500,69.24775212563642,58.121426969826175,NaN,NaN,180.40290918382678,115.26963099961131,0.37006352106651597,0.9770712602600895,0.6070077391935735,3807130957,3664188166.6,77.17595813175808,63.09242505151951,NaN,NaN,19.46722567876943,8.889157183161497
2007-04-17T09:30:00-04:00,146.97,147.39999,146.64999,147.09,108442368,97269962.4,70.53350045738476,59.24195300071454,NaN,NaN,194.6654203348715,132.17193601878867,0.417886077208905,1.1293653357047049,0.7114792584957998,3915573325,3721533289.8,79.11145739919458,64.44871826582555,NaN,NaN,22.733752135761204,10.866956462104312
2007-04-18T09:30:00-04:00,146.60001,147.7,146.57001,147.27,88348256,97519812.8,71.13338482794788,60.74084493764566,NaN,NaN,175.53745644233308,150.38311870641658,0.430954809127695,1.2501727699054186,0.8192179607777236,4003921581,3817858515.4,81.88961216001778,66.53672905961176,NaN,NaN,25.60797239370805,12.972815880904847
2007-04-19T09:30:00-04:00,146.55,147.39999,146.36,147.23,103342944,95022112.8,70.7885001661728,62.168358646168095,NaN,NaN,143.5518559164947,161.70808082156196,0.40653331357126254,1.3273846027418017,0.9208512891705392,3900578637,3870225728.2,83.1979353920683,68.89665745176673,NaN,NaN,27.892222921340377,15.104159743824209
2007-04-20T09:30:00-04:00,148.22,148.62,147.0439,148.62,124128320,95280997.6,75.27472494098564,63.906408645304964,NaN,NaN,164.46702499151675,171.7249333738086,0.45022657249585607,1.4836345047903592,1.0334079322945031,4024706957,3930382291.4,84.57635826652756,71.47011529848042,NaN,NaN,31.401838043704426,17.432399500949955
2007-04-23T09:30:00-04:00,148.37,148.73,147.97,148.06,77569312,95438176,70.57232555053608,65.25272841247917,NaN,NaN,143.4567341214415,164.33569836133154,0.40885176521989464,1.5444726388193715,1.1356208735994768,3947137645,3958383629,85.18559284143471,73.97139042891921,NaN,NaN,33.00229019570992,19.65666960020138
2007-04-24T09:30:00-04:00,148.23,148.39999,147.32001,148.12,114473504,95471276,70.78292391470038,66.12794892235691,NaN,NaN,112.88862916117189,147.98034012659164,0.35496197354961057,1.5793233405364902,1.2243613669868796,4061611149,3987591193.8,85.81499518486518,76.19348669903461,NaN,NaN,34.36644386398866,21.75806592359956
2007-04-25T09:30:00-04:00,148.73,149.66,148.0233,149.48,109158944,95902464,75.12786982157412,67.26722441383107,NaN,NaN,130.4921992830116,138.97128869472732,0.37820695686829464,1.6971200630722478,1.3189131062039532,4170770093,4020960896.2,86.51966617691832,77.98410943731974,NaN,NaN,36.96667024605383,23.93072368395017
2007-04-26T09:30:00-04:00,149.49001,149.8,149.10001,149.64999,88749440,92691832.8,75.615984642452,68.3264536173152,NaN,NaN,127.07144564265724,135.67520663995984,0.3717743140873362,1.7836309988131234,1.4118566847257872,4259519533,4092749075.4,87.91100353171585,79.55673621605112,NaN,NaN,39.22640671900224,26.11582126038618
2007-04-27T09:30:00-04:00,149.09,149.74001,148.84,149.53,108191744,91127416.8,74.50451408742404,69.24663245397478,NaN,NaN,109.88169800373,124.75814124240246,0.32772432496445014,1.8215120909313498,1.4937877659668997,4151327789,4118073241.8,88.36713030546862,80.93993122946029,NaN,NaN,40.77147659118181,28.2094863076427
2007-04-30T09:30:00-04:00,149.64,149.74001,148.21001,148.28999,101012752,89767629.6,64.03002519761579,69.3662048438209,NaN,NaN,83.11796560369314,112.69038753885279,0.19018167528500962,1.7315148600731618,1.5413331847881522,4050315037,4138708720.2,88.73995070947986,82.16463785782693,NaN,NaN,38.996855834740515,29.750539097228103
2007-05-01T09:30:00-04:00,148.42,149.47,147.67,148.67,134434624,92517942.4,65.6249777322819,69.89684674857929,NaN,NaN,72.98388436946476,104.70943858051137,0.10420227942734539,1.6715860340723339,1.5673837546449885,4184749661,4163336422.6,89.18541875409413,83.35537638831322,NaN,NaN,37.983858184268215,30.926727538233834
2007-05-02T09:30:00-04:00,148.89999,149.95,148.75,149.53999,87181808,92752067.2,69.01261200745455,70.45357511572173,NaN,NaN,94.71466901120435,97.55393252614991,0.08608079496860155,1.6749847483557403,1.5889039533871387,4271931469,4183568697.8,89.55114040172815,84.4765161530331,NaN,NaN,38.11682058889144,31.953883688327778
2007-05-03T09:30:00-04:00,149.97,150.39999,149.05,150.35001,87844064,93943944,71.79924882919275,71.00345316438278,NaN,NaN,106.54807193567865,93.44925778475417,0.10741795206496896,1.72317639346835,1.615758441403381,4359775533,4203619897.8,89.91513211924736,85.51009652675135,NaN,NaN,39.093447017020864,32.9738213067125
2007-05-04T09:30:00-04:00,150.75,151.12,150.22,150.92,96412256,96422395.2,73.59845495910834,71.31421765248791,NaN,NaN,125.90138463387477,96.65319511078313,0.13680551112682204,1.7867653303119084,1.6499598191850864,4456187789,4264591897.8,90.94778043882746,86.49379812011345,NaN,NaN,40.466833748520244,34.044251655542176
2007-05-07T09:30:00-04:00,150.88,151.2,150.81,150.95,63688656,97049940.8,73.69358563967717,71.53993802265165,NaN,NaN,125.36739477237955,105.10308094452041,0.13492565405410817,1.8186168867527215,1.6836912326986133,4519876445,4358504179.4,92.26205086249385,87.43312622463483,NaN,NaN,41.5947026553783,35.12288751266162
2007-05-08T09:30:00-04:00,150.58,150.92,150.13,150.75,81533936,98295034.4,71.83525777207302,71.59007180437489,NaN,NaN,103.9142631985398,111.28915671033542,0.09856094597655018,1.806892415169301,1.708331469192751,4438342509,4409222749,92.8645805519132,88.21705253834163,NaN,NaN,42.00535418537456,36.1060970373349
2007-05-09T09:30:00-04:00,150.64,152.82001,150.37,151.16,102947872,98114815.2,73.32053755899533,71.77093161814791,NaN,NaN,130.9997385683381,118.54617062176217,0.08119223405504306,1.8098217617615546,1.7286295277065116,4541290381,4463094531.4,93.44815371530248,88.94921099000122,NaN,NaN,42.771281234462926,37.05826620835319
2007-05-10T09:30:00-04:00,150.73,151.02,149.27,149.58,153698560,99977387.2,60.155160709245806,70.69096274445222,NaN,NaN,59.33875266233179,109.1043067670928,-0.05054186343215461,1.6654521984163182,1.7159940618484728,4387591821,4468657789,93.50720913049888,89.58712890885633,NaN,NaN,39.31857990690394,37.38116816528901
2007-05-11T09:30:00-04:00,149.75,150.92999,149.72,150.86,113413120,101388964.8,65.55167498943769,70.33234484723091,NaN,NaN,80.69917309753853,100.06386445982555,-0.0644185362468046,1.635470891539967,1.6998894277867715,4501004941,4477621219.4,93.60719015395617,90.18867157403642,NaN,NaN,38.020151719167266,37.472451530128765
2007-05-14T09:30:00-04:00,150.86,151.3,149.78999,150.53,108062320,102631740,63.17602633755028,69.78899502029161,NaN,NaN,76.24463765719257,90.23931303678815,-0.10629663630721753,1.5670186324027497,1.6733152687099673,4392942621,4452234454.6,89.40786336845825,90.44530501572164,NaN,NaN,36.21371207115064,37.292631607417604
2007-05-15T09:30:00-04:00,150.7,151.66499,150.19,150.57001,180931808,106256212,63.34945391683118,68.94767959852426,NaN,NaN,85.5858397054305,86.57362833816629,-0.13967472395710034,1.498721863763592,1.6383965877206923,4573874429,4479340838.6,89.92745095199045,90.68871821394109,NaN,NaN,34.83320613198937,36.94128511092786
2007-05-16T09:30:00-04:00,150.8,151.63,150.38,151.60001,114667008,107572149.6,67.58221887681887,68.37383918669332,NaN,NaN,100.73001616900852,80.51968385830038,-0.10247823803935074,1.510298790171504,1.6127770282108547,4688541437,4508791049.8,90.47418824187909,90.87180283609561,NaN,NaN,34.923436478744705,36.65302102061598
2007-05-17T09:30:00-04:00,151.38,151.96001,151.11,151.3,101566000,107483302.4,65.21954038929029,67.71062677968376,NaN,NaN,109.35413887894367,90.52276110162276,-0.10764144034261358,1.4782252277825876,1.5858666681252012,4586975437,4548667773,91.17286277946911,91.0722122985242,NaN,NaN,34.27887033171348,36.31385663648705
2007-05-18T09:30:00-04:00,152.00999,152.62,151.81,152.62,99182256,106235999.2,70.16221132592213,68.14864007456279,NaN,NaN,152.93803377554772,104.9705332372246,-0.035453620805340647,1.5415496421185253,1.577003262923866,4686157693,4585698323.4,91.77608446929172,91.28907899565363,NaN,NaN,35.29153188416174,36.16781024329772
2007-05-21T09:30:00-04:00,152.58,153.23,152.4993,152.53999,174706432,111092855.2,69.51733781803135,68.42666579497346,NaN,NaN,161.73116115656296,122.06783793709867,-0.007832445649602615,1.5672127058618628,1.5750451515114654,4511451261,4609400051.4,92.146040616588,91.50055198583176,NaN,NaN,35.896270458323244,36.12901884544423
2007-05-22T09:30:00-04:00,152.7,153.16,152.38,152.42,82254320,109481896,68.5005028022097,68.3900865660274,NaN,NaN,145.781022856089,134.1068745672304,-0.01212630590778585,1.5598872691267331,1.572013575034519,4429196941,4580464553.8,87.00052266624746,91.318365004726,NaN,NaN,36.09155120272432,36.12366632505567
2007-05-23T09:30:00-04:00,152.95,153.5,152.36,152.44,133950624,110721480,68.58299100147721,68.16035386404772,NaN,NaN,136.54091296411835,141.26905392625235,-0.027237327754517926,1.5379669153413715,1.5652042430958895,4563147565,4555385779.4,82.69060829088458,90.80232758841437,NaN,NaN,36.27373684931815,36.145104971378885
2007-05-24T09:30:00-04:00,152.53,153.21001,150.74001,151.06,187770320,115672524,57.411290492594595,67.00412783072531,NaN,NaN,57.07004757655023,130.81223566577367,-0.13761884215196973,1.3931806904059272,1.530799532557897,4375377245,4513066141,75.86114612908852,89.72471085200445,NaN,NaN,33.020031147306526,35.69866585365426
2007-05-25T09:30:00-04:00,151.49001,152.02,151.17999,151.69,83309120,114428392.8,60.56909846194788,66.06666446088751,NaN,NaN,48.32119489658565,109.88886788998124,-0.17334050875033746,1.314123896619975,1.4874644053703125,4458686365,4467571875.4,69.24064567855402,88.08032476743732,NaN,NaN,31.204515335757076,35.05664435109752
2007-05-29T09:30:00-04:00,151.94,152.5,151.45,152.24001,83960816,113575796,63.13875984468573,65.4454860375027,NaN,NaN,71.38573639352416,91.81978293737347,-0.16510393720567018,1.281084483863225,1.4461884210688951,4542647181,4473811059.4,69.63206521293709,86.42085938608189,NaN,NaN,30.45076022043961,34.39866090386067
2007-05-30T09:30:00-04:00,151.46001,153.53999,151.34,153.48,131273376,113417733.6,68.17433376362867,65.07790005211939,NaN,NaN,116.28552788698563,85.9206839435528,-0.08533775134529731,1.3395162318872735,1.4248539832325708,4673920557,4522755782.6,72.57986287451746,84.93026718316867,NaN,NaN,31.40644102931236,33.97120092178234
2007-05-31T09:30:00-04:00,153.66,153.89,153.12,153.32001,115777808,114847533.6,66.90436561406254,65.55998611674916,NaN,NaN,151.56058188023974,88.92461772677709,-0.054068615255008945,1.3572682141638097,1.4113368294188187,4558142749,4521754819.4,72.42502827930873,83.42439712236936,NaN,NaN,31.77780284511511,33.65785833940131
2007-06-01T09:30:00-04:00,153.88,154.39999,153.50999,154.08,107774432,115844052,69.78382608501968,65.86228262357643,NaN,NaN,167.496949705563,111.00999815257964,0.003998537469825925,1.4163350012561011,1.4123364637862752,4665917181,4579862806.6,75.66990412387318,82.14316240593487,NaN,NaN,32.99850511936992,33.563665022253964
2007-06-04T09:30:00-04:00,153.53999,154.39,153.48,154.10001,78047568,114925817.6,69.8581851128658,66.33957967895613,NaN,NaN,142.3183199497018,129.80942316320287,0.02858528341256461,1.448068068051981,1.4194827846394165,4743964749,4636918483.4,78.36231598770152,81.35419473588082,NaN,NaN,33.994361788550734,33.625193131724934
2007-06-05T09:30:00-04:00,153.74001,153.89999,152.86,153.49001,127943056,118138537.6,64.63617943791212,66.43148864474762,NaN,NaN,92.43562544049816,134.01940097259768,-0.009372636867319928,1.4077669885552666,1.4171396254225865,4616021693,4651593385.8,79.00582916666062,80.57407889407155,NaN,NaN,33.30941905552985,33.58008254941135
2007-06-06T09:30:00-04:00,152.91,152.95,151.75,151.84,164138128,122268747.2,53.07829321958337,65.39549395494508,NaN,NaN,6.921169349257451,112.14652926505202,-0.1508921717520999,1.2285244107324615,1.3794165824845614,4451883565,4607185987.4,72.02517993366428,79.25629258634193,NaN,NaN,28.82778370550647,32.901182714567796
2007-06-07T09:30:00-04:00,151.56,152.5,149.06,149.10001,232486192,128745663.2,40.2175642478691,63.609638516272135,NaN,NaN,-117.7596309208762,58.28248670482884,-0.4191194959070077,0.8555172126008017,1.2746367085078094,4219397373,4539436912.2,62.89488637517309,77.2364371288922,NaN,NaN,19.457686009279406,30.98068318524088
2007-06-08T09:30:00-04:00,149.5,151.19,149.09,151.03999,176982320,129909851.2,49.53998989133758,62.1366226995161,NaN,NaN,-107.75688420007829,3.2317199237005836,-0.4530838778346802,0.7082818612144592,1.1613657390491394,4396379693,4485529414.6,56.73232246317839,74.73331127131267,NaN,NaN,15.304086635363017,28.741169392401186
2007-06-11T09:30:00-04:00,150.92999,151.95,150.7,151.3,102527504,129365570.4,50.650732707833775,60.78900804878771,NaN,NaN,-53.90073585873968,-36.01209123798771,-0.444615407854287,0.6055964792312807,1.0502118870855677,4498907197,4436517904.2,51.76611070440789,71.84903056329982,NaN,NaN,12.654742141063682,26.443108356495827
2007-06-12T09:30:00-04:00,150.67,151.53999,149.55,149.64999,235736560,135749282.4,44.027481442809915,59.040935094544864,NaN,NaN,-126.04626406652046,-79.70846913939143,-0.5308744253428138,0.38661885540705043,0.9174932807498642,4263170637,4365947693,45.57925599853288,68.89036865846306,NaN,NaN,7.943823753599216,23.800353413224883
2007-06-13T09:30:00-04:00,150.5,152.07001,149.722,151.89,193250624,136365223.2,53.01070994206295,57.9286293045867,NaN,NaN,-61.01722845779745,-93.29614870080239,-0.422522997763245,0.3893395335458081,0.8118625313090531,4456421261,4366855232.2,45.669184894145715,66.24598127298172,NaN,NaN,7.473180133279134,21.46790008751835
2007-06-14T09:30:00-04:00,152.06,153.12,152.03,152.86,146645312,137964138.4,56.28273795357425,57.84801840894239,NaN,NaN,36.64310411764715,-62.41560169309772,-0.27795953016733943,0.46441311859987877,0.7423726487672182,4603066573,4443589072.2,52.77498679519203,64.59696989198912,NaN,NaN,8.350773989404976,19.59402493064501
2007-06-15T09:30:00-04:00,153.14,153.66,152.92999,153.07001,154416368,140606656.8,56.98117868799698,57.59173842508875,NaN,NaN,69.55901688130565,-26.952421476820927,-0.16614457361428303,0.5346919317493644,0.7008365053636474,4757482941,4515809721.8,58.30257018560254,63.815678785349725,NaN,NaN,9.253726251923517,18.116839405113367
2007-06-18T09:30:00-04:00,153.38,153.39,152.66,152.89,88635680,140079328,56.15306227730454,57.09276002741866,NaN,NaN,48.561424220602234,-6.4599894609525474,-0.10522876227806299,0.5693005525160686,0.6745293147941316,4668847261,4549797734.6,60.63760721428102,63.173217499731436,NaN,NaN,9.6860421430857,16.912439796252272
2007-06-19T09:30:00-04:00,152.55,153.38,152.36,153.27,111117440,136899878.4,57.55540449800487,56.33426507987411,NaN,NaN,48.76099974871701,28.50146330209494,-0.04343048902295821,0.6202412035154339,0.6636716925383921,4779964701,4653156547.4,66.73778003982802,62.75592586868218,NaN,NaN,10.4709746209131,15.992230485489534
2007-06-20T09:30:00-04:00,153.58,153.58,150.96001,151.14,177234432,141648884,48.24177942842263,55.001223209471256,NaN,NaN,-25.083188655538198,35.68827126254679,-0.14440202264681135,0.4831691642298779,0.6275711868766892,4602730269,4682418349,68.23850074848693,62.4568881879092,NaN,NaN,8.06801750957892,14.860200060359446
2007-06-21T09:30:00-04:00,151.08,152.11,150.25,151.98,205265680,145214636.8,51.57013893457331,53.70024555586794,NaN,NaN,-50.8174304338242,18.196164352252516,-0.152233840249536,0.4372788865647692,0.5895127268143052,4807995949,4723404224.2,70.26232803063257,62.070632752677724,NaN,NaN,7.202330693243838,13.766218722200074
2007-06-22T09:30:00-04:00,151.52,151.77,149.85001,150.55,205153120,146083776.8,46.131503627625264,52.005482592636476,NaN,NaN,-92.53971783143199,-14.22358259029501,-0.24579605659658876,0.2822676560685693,0.5280637126651581,4602842829,4692476201.8,66.80315681295184,61.24497852590989,NaN,NaN,4.6397315100024965,12.462434834743277
2007-06-25T09:30:00-04:00,150.24001,151.25,149.02,149.83,232036432,153520142.4,43.636220085587354,50.50548549604184,NaN,NaN,-122.69942744734219,-48.475752923883896,-0.3423169797746593,0.10016748794683394,0.44248446772149325,4370806397,4632868029,60.609740295644215,59.93097217798015,NaN,NaN,1.7499074006535251,10.932073772730455
2007-06-26T09:30:00-04:00,150.21001,150.46001,148.28,148.28999,198318256,159238014.4,38.801745490985,49.48573208685625,NaN,NaN,-153.9874128475103,-89.02543544312938,-0.4871834896550761,-0.16649489434735187,0.3206885953077242,4172488141,4511372717,50.36108718097598,58.38353698135956,NaN,NaN,-2.3564409058266627,9.033714532936582
2007-06-27T09:30:00-04:00,148.13,150.57001,148.06,150.39999,209169056,163132798.4,47.400360836458326,49.99878898604119,NaN,NaN,-104.84302718780137,-104.977403149582,-0.4207124340112576,-0.20520194720634777,0.2155104868049098,4381657197,4467158102.6,47.23109407404612,57.26469467413621,NaN,NaN,-2.935023164523555,7.323894861870848
2007-06-28T09:30:00-04:00,150.38,151.41,149.67,150.38,157701504,165228983.2,47.332508621246994,49.84111175246329,NaN,NaN,-58.129114802669044,-106.43974002335099,-0.3602357061774516,-0.23478414591690466,0.1254515602605469,4223955693,4350350051.4,40.13439174100141,56.07912819398071,NaN,NaN,-3.398153140007941,5.792173718745307
2007-06-29T09:30:00-04:00,150.89999,151.64999,149.14999,150.42999,199697632,169825143.2,47.534768156727054,49.618542855955674,NaN,NaN,-56.953543540731815,-99.32250516521096,-0.3013993867350703,-0.251297673158291,0.05010171357677931,4423653325,4314512150.6,38.23612630884275,55.112700737154626,NaN,NaN,-3.7014503616531136,4.435941707259818
2007-07-02T09:30:00-04:00,150.87,151.92,150.77,151.78999,103352000,171090364.8,52.84083739182603,50.2480682808854,NaN,NaN,11.893843487891685,-72.40385097816417,-0.16238681263308738,-0.15288180221457992,0.009505010418507459,4527005325,4345751936.2,40.86190285707959,54.775746941336536,NaN,NaN,-2.309319571824341,3.4723329531049387
2007-07-03T09:30:00-04:00,152.17999,152.5,151.99001,152.34,54047488,167395586.4,54.830427693283525,50.3780481202583,NaN,NaN,68.57740328297116,-27.890887752067886,-0.031730141346610966,-0.030157666264756244,0.0015724750818547177,4581052813,4427464870.6,47.18653598012904,54.88412916176391,NaN,NaN,-0.5565578032334153,2.896777130770888
2007-07-05T09:30:00-04:00,152.39999,152.56,151.63,152.17999,89254432,163651401.6,54.11514515831067,50.22322006345375,NaN,NaN,58.71296571221443,4.820310827935279,0.04160047507372399,0.053573068924009704,0.011972593850285715,4491798381,4449493107.4,48.776938789636795,54.59855430422425,NaN,NaN,0.6618546974680588,2.5775024974419125
2007-07-06T09:30:00-04:00,152.38,153.17,151.92999,152.98,81106368,156082410.4,57.12660344719443,50.23360754625357,NaN,NaN,87.31853711514532,33.90984121149815,0.13632753652898566,0.1823820145115178,0.046054477982532135,4572904749,4519282918.6,53.54948342762889,54.25904810722613,NaN,NaN,2.5877066808136164,2.5789602379235843
2007-07-09T09:30:00-04:00,153.16,153.36,152.62,153,72343568,150850472.8,57.202225409134336,50.3085477699557,NaN,NaN,96.08525188737666,64.51760029711984,0.18941059213720265,0.28281771815403545,0.09340712601683279,4645248317,4563601917,56.33195548003292,53.95150155477984,NaN,NaN,4.180512566928915,2.807753427781489
2007-07-10T09:30:00-04:00,152.28999,152.61,150.77,150.92,180356128,154741904,47.76602467553287,49.609306354064834,NaN,NaN,-4.431483430142959,61.25253491351291,0.07916049109795346,0.19235773988927463,0.11319724879132116,4464892189,4551179289.8,55.331447643754444,53.13676352648887,NaN,NaN,2.8476019033594806,2.813446067149773
2007-07-11T09:30:00-04:00,150.75,152.05,150.52,151.99001,175533632,151731757.6,52.13990584153541,49.88774395500146,NaN,NaN,-3.1206950040052477,46.91291525611763,0.07316168066784184,0.20464934962612347,0.13148766895828162,4640425821,4563053891.4,56.1334749928035,52.27211882965434,NaN,NaN,3.0479531328772005,2.8469470765394056
2007-07-12T09:30:00-04:00,152.37,154.75,152.34,154.39,133863120,148762382.4,60.19171768470888,50.503571008582576,NaN,NaN,132.4836599885038,61.66705411137551,0.21752949331861723,0.4033995356065532,0.18587004228793594,4774288941,4619552003.4,59.829182101192465,51.52689412040862,NaN,NaN,5.96093018610434,3.2918018064772534
2007-07-13T09:30:00-04:00,154.57001,155.46001,154.39,154.85001,111793872,147019810.4,61.52772983182214,51.60330145173949,NaN,NaN,174.17081561547852,79.03750981144215,0.3242754077653063,0.5912143019945688,0.26693889422926254,4886082813,4682187616.2,63.500510105263636,51.29099078414517,NaN,NaN,8.710935402550115,4.065963748773377
2007-07-16T09:30:00-04:00,154.99001,155.53,154.58,154.83,98370368,144217510.4,61.43114918556895,52.87436781602389,NaN,NaN,161.67673510303683,92.15580645457419,0.3704720038161726,0.7300288989994783,0.3595568951833057,4787712445,4710680441.8,65.064653070049,51.60919883945981,NaN,NaN,10.849490166042106,5.035038951240338
2007-07-17T09:30:00-04:00,154.92999,156,154.67999,154.75,126120752,146091764,61.01875725778295,54.46129722793803,NaN,NaN,150.4910852973136,123.1403202000655,0.3716229559426303,0.8240855901115935,0.45246263416896326,4661591693,4750020342.6,67.15736780110177,52.808933169468794,NaN,NaN,12.464102952909236,6.096333808621609
2007-07-18T09:30:00-04:00,154.23,154.8,153.3,154.47,237719120,152421848,59.51289475547354,55.326478222153405,NaN,NaN,97.38753345898768,143.24196589266407,0.33086929967235224,0.8660492587594035,0.5351799590870513,4423872573,4706709693,62.70402132305778,53.91414225868391,NaN,NaN,13.399143493898414,7.139592335089724
2007-07-19T09:30:00-04:00,155.2,155.53,154.75,155.07001,145213120,150820782.4,61.694462301552164,56.35233205646092,NaN,NaN,119.74523678057226,140.69428125107777,0.32139308496435437,0.9369213152924942,0.6155282303281399,4569085693,4665669043.4,58.72976996526295,55.242383560416876,NaN,NaN,14.81015641739995,8.235387203991184
2007-07-20T09:30:00-04:00,154.89,155.2484,152.28999,153.5,245501872,152832592,53.561751626906954,56.78283087575949,NaN,NaN,54.290981976149425,116.71831452321196,0.19279959682715897,0.8565277263620885,0.6637281295349295,4323583821,4553169245,49.47316314306047,56.04502904857528,NaN,NaN,13.707615483666293,9.017134101087628
2007-07-23T09:30:00-04:00,154.17999,154.72,153.3,153.97,121181808,148634026.4,55.45483538628099,56.96954501822056,NaN,NaN,60.4033830793424,96.46364411847307,0.12603603561259558,0.821273174050674,0.6952371384380784,4444765629,4484579881.8,44.83350560276775,56.328714958981585,NaN,NaN,13.331554990089053,9.633479942373546
2007-07-24T09:30:00-04:00,153.12,154.28,150.75999,151.3,256825632,149873486.4,44.385262193333794,56.22346176822414,NaN,NaN,-21.083290899246002,62.14876887916114,-0.0991485950582991,0.5713013946152046,0.6704499896735037,4187939997,4389849542.6,39.34534723804171,55.76863004883249,NaN,NaN,9.279899433936967,9.58296844116832
2007-07-25T09:30:00-04:00,152.02,152.39,150.25,151.61,265201056,153217626.4,45.739546940743736,55.62520475268365,NaN,NaN,-60.860016829102285,30.499258821543158,-0.22142131461805836,0.39367334640093077,0.6150946610189891,4453141053,4395703238.6,39.8354535984149,55.129952535173786,NaN,NaN,6.481082119886035,9.13984182384228
2007-07-26T09:30:00-04:00,150.19,150.8,146.39,148.02,467454208,166131884,35.084547882969034,54.05077221238183,NaN,NaN,-190.17298488241588,-31.484385511054466,-0.5211653289469519,-0.0363620001647007,0.4848033287822512,3985686845,4279023469,33.94727218416811,53.7297945892123,NaN,NaN,-0.20295205348891424,7.805156984223538
2007-07-27T09:30:00-04:00,148.21001,148.87,145.05,145.11,422916864,179392652,29.155723301740252,52.04745063328225,NaN,NaN,-239.6782846030169,-90.27823882688774,-0.8718479835105672,-0.6050066506059579,0.2668413329046094,3562769981,4126860701,28.111559799914545,51.71405204063241,NaN,NaN,-8.34506497326044,5.497982418868684
2007-07-30T09:30:00-04:00,145.92999,147.81,145.28999,147.38,282213376,183518439.2,37.96263445431214,51.34720847462363,NaN,NaN,-193.2733268526921,-141.01358081329462,-0.9035120102134139,-0.862548679862158,0.040963330351255905,3844983357,4006904246.6,24.53133652782377,49.514044103780215,NaN,NaN,-11.51277574425863,3.0678741098504965
2007-07-31T09:30:00-04:00,148.33,149.46001,145.03999,145.72,316607488,194181213.6,34.57747568048386,50.09274917740566,NaN,NaN,-163.6985471060777,-169.53663205466097,-0.982305592959354,-1.1869186608479367,-0.20461306788858266,3528375869,3874991421,21.316305366843565,47.02710341621165,NaN,NaN,-15.293402486713164,0.44483459605568765
2007-08-01T09:30:00-04:00,145.17999,147.00999,143.95,146.42999,467658496,214861764,37.1585341004132,48.447521778527395,NaN,NaN,-156.39563570969497,-188.64375583077953,-0.9330224803565367,-1.3708911683342535,-0.43786868797771683,3996034365,3783570083.4,19.4170137715265,44.140519964092654,NaN,NaN,-17.246663512955788,-2.0825222766602374
2007-08-02T09:30:00-04:00,146.75999,147.75999,145.25999,147.60001,294674176,225132751.2,41.27052719439102,47.000578732996594,NaN,NaN,-109.88929076176605,-172.58701700664955,-0.7745622917163322,-1.406071552623132,-0.6315092609067998,4290708541,3844574422.6,24.26618360847519,41.33806807146491,NaN,NaN,-17.37535939056948,-4.267213292932986
2007-08-03T09:30:00-04:00,147.28,147.58,143.2,143.8,359378688,239046367.2,33.58422381384872,45.01151263501658,NaN,NaN,-130.91695748297718,-150.83475158264162,-0.8713890914219489,-1.720745625184236,-0.849356533762287,3931329853,3918286397,29.76582677870597,38.81672333636897,NaN,NaN,-20.38725658388016,-6.570076620211154
2007-08-06T09:30:00-04:00,144.21001,146.83,142.53,146.21001,324726272,251665502.4,41.07911842129969,43.58725271812492,NaN,NaN,-106.44194631224147,-133.4684754745515,-0.724853968188429,-1.7554239939978231,-1.0305700258093942,4256056125,4000500950.6,35.400505183020925,36.54837600650605,NaN,NaN,-19.989751243831527,-8.487172995014063
2007-08-07T09:30:00-04:00,145.94,149,145.23,147.77,280677376,256681564.8,45.37611048776559,42.577482413288635,NaN,NaN,-58.27791940029168,-112.38434993339429,-0.4860601214401885,-1.6381451776096299,-1.1520850561694413,4536733501,4202172477,46.69719682617103,35.40503139958557,NaN,NaN,-18.09691464495336,-9.859993230719677
2007-08-08T09:30:00-04:00,148.41,150.59,147.34,149.83,274739968,261641881.6,50.50888989985299,41.778512956024414,NaN,NaN,-20.365453888533043,-85.17831356916192,-0.16894096275399217,-1.3632612596119316,-1.1943202968579394,4811473469,4365260297.8,53.74202489277064,35.04876389440754,NaN,NaN,-14.69000207656291,-10.549994494411568
2007-08-09T09:30:00-04:00,147.42999,149.95,145.28999,145.39,357626368,272830044,41.46505444047668,40.91446315699368,NaN,NaN,-58.64967443362515,-74.93039030353373,-0.2337826904588831,-1.4865486599315432,-1.25276596947266,4453847101,4397888009.8,55.02277035256991,35.4451644093725,NaN,NaN,-15.192930854086725,-11.213271117222304
2007-08-10T09:30:00-04:00,144.39,146.5,143.12,144.71001,411013376,287791019.2,40.27564449190311,39.8302352359667,NaN,NaN,-90.73133594264867,-66.89326599546803,-0.2941430992575209,-1.6204448435445613,-1.3263017442870404,4042833725,4420188784.2,55.9210781667852,36.23713387823089,NaN,NaN,-15.99684981701639,-11.896639502907172
2007-08-13T09:30:00-04:00,146.5,146.89,145.02,145.23,181944192,291969710.4,41.653926573666006,39.635139834561855,NaN,NaN,-67.76043525474553,-59.15696378396884,-0.2712801799630564,-1.665401969240861,-1.3941217892778046,4224777917,4413933142.6,55.58570202140924,37.397159219900004,NaN,NaN,-16.150690645374077,-12.504361094688159
2007-08-14T09:30:00-04:00,145.7,146.06,142.72,143.00999,264096560,298868500.8,37.65824112118245,39.05790370459319,NaN,NaN,-99.37859237365187,-67.37709837864088,-0.37169509938815937,-1.8587406635130037,-1.4870455641248443,3960681357,4298722713.8,49.676701826923406,38.10010552193632,NaN,NaN,-17.628717974041805,-13.236412077452966
2007-08-15T09:30:00-04:00,142.72,144.46001,140.62,141.03999,323735040,303169296.8,34.495966107072576,39.01586214917201,NaN,NaN,-134.2006954493062,-90.14414669079551,-0.5273120413812737,-2.1461856158514365,-1.6188735744701628,3636946317,4063817283.4,40.275597919155445,38.552128788721134,NaN,NaN,-19.917514413215674,-14.190855268276211
2007-08-16T09:30:00-04:00,139.78999,142.94,137,142.10001,546451200,323231200.8,37.53548931455354,39.61441686437296,NaN,NaN,-164.42370447466152,-111.29895269900278,-0.514800195907658,-2.2623738193547354,-1.7475736234470773,4183397517,4009727366.6,38.470257394399894,39.2920357597558,NaN,NaN,-20.772717913587705,-15.131121360463567
2007-08-17T09:30:00-04:00,145.5,148.35001,141.386,144.71001,388157184,330363966.4,44.37911775592678,40.07273710020258,NaN,NaN,-54.96976082841059,-104.14663767615517,-0.2974749389164264,-2.1194172970926104,-1.821942358176184,4571554701,4115471561.8,43.77619651240993,40.66666861579767,NaN,NaN,-19.231422190832237,-15.716878621944806
2007-08-20T09:30:00-04:00,145.17,145.47,143.28999,144.64,187079936,333658872.8,44.23910626555871,40.76285357056507,NaN,NaN,-58.65569456281698,-102.32568953776946,-0.13352312421471013,-1.9888462634445716,-1.8553231392298615,4384474765,4147410931.4,45.310239991488295,42.38052108898658,NaN,NaN,-18.07388375147616,-16.053593640449286
2007-08-21T09:30:00-04:00,144.60001,145.97,144.14,144.92999,157000816,328667632,45.01294963473556,41.32388325158809,NaN,NaN,-32.990137197755324,-89.04799850259016,0.011659311014529994,-1.8407490004616989,-1.8524083114762289,4541475581,4263569776.2,50.59031574339734,44.60718551554878,NaN,NaN,-16.913544879915385,-16.17644381751587
2007-08-22T09:30:00-04:00,146.00999,146.8,145.33,146.64999,172226192,324018888.8,49.49036777252981,41.91101472145515,NaN,NaN,29.467636837316398,-56.31433204526563,0.22870008316407708,-1.5665332075211325,-1.7952332906852095,4713701773,4478920867.4,58.57528333922629,47.05783549631672,NaN,NaN,-14.568199719213204,-15.94669466061549
2007-08-23T09:30:00-04:00,147.34,147.64999,145.61,146.52,203853744,310838865.6,49.16454201873459,43.02389459323272,NaN,NaN,51.522285684645624,-13.125134013404203,0.3608193392121555,-1.3442091166700152,-1.7050284558821707,4509848029,4544210969.8,60.65150701776836,49.2639555133926,NaN,NaN,-12.757298840388293,-15.49106668629732
2007-08-24T09:30:00-04:00,146.48,148.33,146.28,148.33,128886256,296137335.2,53.732231727039334,43.92768840078555,NaN,NaN,94.91214059239083,16.851246270756075,0.5557687738215455,-1.0103174886052386,-1.5660862624267842,4638734285,4557646886.6,61.083771918267864,51.09847456591024,NaN,NaN,-9.820315929025423,-14.680959435258478
2007-08-27T09:30:00-04:00,147.85001,148.33,146.73,146.95,112992128,287676272.8,50.040448109129095,44.26085537374008,NaN,NaN,78.2329386623811,44.228972915795694,0.5750343185950708,-0.8472933641829457,-1.4223276827780165,4525742157,4585900365,62.028419556518514,52.19356190379221,NaN,NaN,-8.360054465459973,-13.77797301100155
2007-08-28T09:30:00-04:00,146.16,146.25,143.46001,143.72,219626128,282827204.8,42.65351299018981,43.699757023049855,NaN,NaN,-46.20087604274396,41.58682514679798,0.3638013754979952,-0.9675759634055225,-1.3313773389035177,4306116029,4538828454.6,59.43966977306054,52.60053653809863,NaN,NaN,-9.340405591795388,-13.144034808257812
2007-08-29T09:30:00-04:00,144.37,146.74001,143.96001,146.53999,207614496,269825004.8,49.64282152353587,44.28388324326836,NaN,NaN,11.460406647738118,37.98537910888232,0.4044366766203973,-0.8258314931280211,-1.2302681697484183,4513730525,4498834205,57.253316095205854,52.7598612340012,NaN,NaN,-7.9038944801311795,-12.395443332811151
2007-08-30T09:30:00-04:00,145.45,147.19,145.31,146.14999,191681632,264675377.6,48.757761200783605,44.88974872247412,NaN,NaN,35.05974160228777,34.692870292410745,0.39503208841614823,-0.736478059228233,-1.1315101476443812,4322048893,4461274377.8,55.19982672007802,52.70834327352211,NaN,NaN,-7.041270932884849,-11.630561561393108
2007-08-31T09:30:00-04:00,147.64999,148.5,146.83,147.59,185474624,255980174.4,52.149981938998174,45.63946696285499,NaN,NaN,90.57195154270713,33.82483248247404,0.4706430759963982,-0.5432063026488834,-1.0138493786452816,4507523517,4435032224.2,53.74930174169168,52.577171824970854,NaN,NaN,-5.267738322394662,-10.721586812964759
2007-09-04T09:30:00-04:00,147.45,149.98,147.39999,149.08,120054688,245746595.2,55.43723812955691,46.909395320596026,NaN,NaN,125.34739527121492,43.2477238042408,0.5976940807855433,-0.26673177766335243,-0.8644258584488957,4627578205,4455399433.8,54.74330335968344,52.939071934453715,NaN,NaN,-2.755125022972542,-9.583520842965871
2007-09-05T09:30:00-04:00,148.2,148.36,147,147.78999,166256624,240025557.6,52.10004720012046,48.166829684385156,NaN,NaN,78.11026084485742,68.10995118176108,0.5715504588886681,-0.14998778483806063,-0.7215382437267287,4461321581,4486440544.2,56.28531121962048,54.08262288448693,NaN,NaN,-1.6566270279880415,-8.451107440826181
2007-09-06T09:30:00-04:00,147.95,148.61,147.12,148.13,127860432,232681580.8,52.904757942429704,49.26463458637631,NaN,NaN,94.0888813638018,84.6356461249738,0.55347929398571,-0.02968912624459108,-0.5831684202303011,4589182013,4501530841.8,57.05143273114475,55.409849694254426,NaN,NaN,-0.5300994510495177,-7.319534870858087
2007-09-07T09:30:00-04:00,146.48,146.89,145.25999,146.07001,235429056,226571715.2,47.678558976843426,49.50030895929893,NaN,NaN,16.379504291020275,80.89959866272031,0.38699122463172575,-0.09942938944064394,-0.4864206140723697,4353752957,4507871654.6,57.38935760318001,56.38221834359514,NaN,NaN,-1.1014399091066427,-6.431235590607881
2007-09-10T09:30:00-04:00,146.52,146.72,144.33,145.78999,192354688,215638780.8,46.998905450874204,49.697437472535746,NaN,NaN,-5.563985180352936,61.67241131810829,0.24891739036942012,-0.17527387611059453,-0.42419126648001465,4161398269,4438646605,52.52996881235958,56.89791325937166,NaN,NaN,-1.7625612479019874,-5.764282113078467
2007-09-11T09:30:00-04:00,146.24001,147.7,146.13,147.49001,162048256,214643984,51.5174595341502,50.16204532249394,NaN,NaN,55.94828399988598,47.7925890638425,0.26168530071765245,-0.09708464058294908,-0.3587699413006015,4323446525,4377820269,48.63327015791975,56.758124288980405,NaN,NaN,-1.0255699565906942,-5.087323233580214
2007-09-12T09:30:00-04:00,147.28999,148.44,146.98,147.87,149577680,208918040,52.49240541408372,50.37647658260493,NaN,NaN,77.6954459456796,47.709626084006935,0.28349091483607436,-0.004406297755508604,-0.28789721259158296,4473024205,4380160793.8,48.79068472577232,56.05922438801941,NaN,NaN,-0.14251933947482334,-4.380922677279444
2007-09-13T09:30:00-04:00,148.55,149.45,148.2,148.91,153905248,200426550.4,55.150662769623274,50.80405663623983,NaN,NaN,119.41163192840888,52.77417619692835,0.35129226342114234,0.15121811668484497,-0.20007414673629736,4626929453,4387710281.8,49.3300738800327,55.250550592466865,NaN,NaN,1.3660340515692657,-3.5599288588724853
2007-09-14T09:30:00-04:00,147.96001,149.09,147.74001,148.89999,121903056,179199143.2,55.118694559049494,50.90308969566913,NaN,NaN,101.7611831375427,69.85051196623284,0.3765587372425775,0.2706242748169245,-0.10593446242565298,4505026397,4417964969.8,51.53328778385015,54.56837315429417,NaN,NaN,2.5986706562153405,-2.680128928145653
2007-09-17T09:30:00-04:00,148.31,148.8905,147.63,148.10001,109853056,165283936.8,52.49958769120921,51.07874252296057,NaN,NaN,74.38733659723675,85.84077632175078,0.32256837187282067,0.2972760024153729,-0.025292369457447797,4395173341,4464719984.2,54.8038894568558,54.052335290032545,NaN,NaN,2.969598072575983,-1.873025070899705
2007-09-18T09:30:00-04:00,148.83,152.5,148.13409,152.46001,263372816,169098580.8,62.85834374580788,52.52194471979043,NaN,NaN,211.2350817248323,116.89813586674006,0.5502942897031984,0.6625754926715501,0.1122812029683518,4658546157,4531739910.6,59.06781362503363,54.025774136602045,NaN,NaN,6.61064196804892,-0.6610726367641873
2007-09-19T09:30:00-04:00,153.41,154.39,148.10001,153.36,193766752,170936877.6,64.5756509161694,53.588575390692824,NaN,NaN,227.85967583112946,146.93098184383,0.7205927601950598,1.0130221532121766,0.2924293930171168,4852312909,4607597651.4,63.289442322264506,54.456926009963375,NaN,NaN,10.143120040083966,0.8823834599284059
2007-09-20T09:30:00-04:00,153.34,153.42999,152.11,152.28,175178752,171084505.6,60.93464205222355,54.458352594367106,NaN,NaN,211.78833618955738,165.40632269605973,0.7179687791778513,1.189890366989431,0.47192158781157967,4677134157,4617638592.2,63.82133838147664,55.07274827149185,NaN,NaN,12.003789087695917,2.471155692466622
2007-09-21T09:30:00-04:00,152.71001,153.11771,151.74001,151.97,141459312,167964784,59.89079789552619,55.01126801983339,NaN,NaN,161.77828088475363,177.40974224550192,0.654601114101933,1.2901729804389959,0.6355718663370629,4535674845,4623768281.8,64.1627040048717,55.81656271886185,NaN,NaN,13.217727661580463,4.006380259482885
2007-09-24T09:30:00-04:00,152.42,152.82001,151.36,151.69,139314944,168486218.4,58.909195715175734,55.25926499023473,NaN,NaN,125.58019994561448,187.64831491517745,0.5569048839353714,1.3317029712562771,0.7747980873209057,4396359901,4624005593.8,64.17679681509603,56.49038367996275,NaN,NaN,13.947273517948355,5.426507867835095
2007-09-25T09:30:00-04:00,150.81,151.66,150.47,151.39,142289568,169951090.4,57.81581854683498,55.66753437214292,NaN,NaN,86.33616621281617,162.66853181277423,0.4402679198884222,1.3251329871814335,0.8848650672930113,4254070333,4543110429,56.08090116709261,56.47578296192504,NaN,NaN,14.263175666588504,6.688888981942725
2007-09-26T09:30:00-04:00,152.25,152.77,151.39,152.19,135546944,165747131.2,59.950520275134295,56.17080311019324,NaN,NaN,103.23364376199301,137.74332539894698,0.3870695437299747,1.3687019969554797,0.981632453225505,4389617277,4450571302.6,48.53773183039268,55.86766146901417,NaN,NaN,15.10960629836845,7.891848598574971
2007-09-27T09:30:00-04:00,152.91,153.10001,152.19,153.09,102704064,160501609.6,62.264075022133646,57.21262568485683,NaN,NaN,108.50860775292581,117.08737971162063,0.381921548830243,1.4590343892633086,1.0771128404330657,4492321341,4413608739.4,45.88304974803424,55.045782336503756,NaN,NaN,16.47557696235251,9.118095507686048
2007-09-28T09:30:00-04:00,152.85001,153.19,151.98,152.58,133367008,157585878.4,60.143828675380504,58.15154877232157,NaN,NaN,90.31507777180286,102.79473908903046,0.3163070859647017,1.4724966978889427,1.156189611924241,4358954333,4378264637,43.436641996464054,54.39625899251122,NaN,NaN,17.076831073744298,10.255057731408655
2007-10-01T09:30:00-04:00,152.60001,154.75,152.5,154.3,148120256,155718160,64.53060524187538,59.08105918001622,NaN,NaN,113.87040699195047,100.45278049829767,0.3578254934566356,1.6034714787450355,1.2456459852883999,4507074589,4400407574.6,45.40075367507386,54.16536495802223,NaN,NaN,18.864520065027605,11.484980921925647
2007-10-02T09:30:00-04:00,154.61,154.64999,153.81,154.09,112689008,155349876,63.610047177937574,59.87517644886292,NaN,NaN,109.61513775669123,105.10857480707269,0.3403325972050921,1.6710617317947651,1.330729134589673,4394385581,4428470624.2,47.87129564113211,54.099694309119364,NaN,NaN,20.100440976521114,12.715760929724999
2007-10-03T09:30:00-04:00,153.81,154.41,153.00999,153.78,119037872,152988938.4,62.19946249895279,60.37866214381504,NaN,NaN,89.20800510210034,102.30344707509417,0.27961211232017247,1.6802442749898887,1.4006321626697162,4275347709,4405616710.6,46.04408006495101,53.864980465184956,NaN,NaN,20.771604858906908,13.866595776750986
2007-10-04T09:30:00-04:00,154.11,154.25999,153.59,154.02,76764944,150434164,62.88566044343789,60.93344542127136,NaN,NaN,88.79640991010311,98.36100750652963,0.22944290302698933,1.6874357914534528,1.4579928884264635,4352112653,4377574973,43.83328905654385,53.314980556091655,NaN,NaN,21.5188308995762,14.959772222868873
2007-10-05T09:30:00-04:00,155.03,156.10001,154.63,155.85001,134583008,145391861.6,67.70042591773162,62.01921958030867,NaN,NaN,128.19148287123693,105.93628852641643,0.2894647585735217,1.8198238366433657,1.530359078069844,4486695661,4403123238.6,46.36026827838091,52.71186475762916,NaN,NaN,23.567829243006084,16.189494654317045
2007-10-08T09:30:00-04:00,155.39,155.49001,154.77,155.02,71270128,139337633.6,63.66622917535521,62.076925682419194,NaN,NaN,112.81941951686431,105.7260910313992,0.2449897831110026,1.8365963069585973,1.5916065238475947,4415425533,4384793427.4,44.80283508212211,51.69293771884976,NaN,NaN,24.20635673787616,17.334760666254063
2007-10-09T09:30:00-04:00,155.60001,156.5,155.03,156.48,94001120,135935276.8,67.35160455236283,62.275208085004444,NaN,NaN,138.30125068328996,111.46331361671896,0.2829343771642645,1.9452744953029253,1.6623401181386608,4509426653,4407801641.8,47.20057612826017,50.543732990706594,NaN,NaN,25.8550320699152,18.55194229534851
2007-10-10T09:30:00-04:00,156.03999,156.44,155.41,156.22,101668560,133539820.8,66.06644406369189,62.64176537153789,NaN,NaN,129.16901612467058,119.45551582123298,0.26013759589317065,1.987512113005124,1.7273745171119534,4407758093,4434283718.6,49.89826629508783,49.54922784167883,NaN,NaN,26.853291063580265,19.73784926223876
2007-10-11T09:30:00-04:00,156.92999,157.52,154.53999,155.47,233513568,137520236.8,62.36940838582393,62.81880897798773,NaN,NaN,109.64156132116744,123.62454610344587,0.16860078079679464,1.9381254931079468,1.7695247123111522,4174244525,4398710093,46.463953720968696,48.28503139282861,NaN,NaN,26.665467620335647,20.727509027681172
2007-10-12T09:30:00-04:00,155.46001,156.35001,155.27,156.33,124539376,137652052.8,64.80170328371375,63.23970237574046,NaN,NaN,105.01877220291662,118.99000396978181,0.14113971878180154,1.9459493607884042,1.8048096420066027,4298783901,4361127741,43.08976767275105,46.778815025518256,NaN,NaN,27.187196607020535,21.650321539015366
2007-10-15T09:30:00-04:00,156.27,156.36,153.94,155.00999,161094752,140214137.6,58.54652413442043,63.29189563199656,NaN,NaN,64.05140065189177,109.2364001967873,0.01583482042481177,1.8246031675376173,1.8087683471128055,4137689149,4305580464.2,38.62512909803633,45.531974163442804,NaN,NaN,25.79726434787123,22.24274194028049
2007-10-16T09:30:00-04:00,154.41,156.48,153.47,153.78,166428752,135366934.4,53.3762840580513,62.82230733077635,NaN,NaN,34.73669864270992,88.5234897886713,-0.15851923383478583,1.6106193048193234,1.7691385386541092,3971260397,4197947213,31.758540082023856,44.33346046713074,NaN,NaN,23.00452888053217,22.351568646030728
2007-10-17T09:30:00-04:00,154.98,155.09,152.47,154.25,216672560,136512224.8,55.01119830961012,62.304244708453226,NaN,NaN,-1.5447444186669825,62.380737680003776,-0.2456257334309082,1.4621063718654739,1.707732105296382,4187932957,4153982185.8,29.455098706556115,43.16003539273945,NaN,NaN,21.159477936407473,22.181269973227405
2007-10-18T09:30:00-04:00,153.45,154.19,153.08,153.69,148428368,135174705.6,52.642553739299295,61.768439355876005,NaN,NaN,-19.989147323774574,36.45459595101537,-0.33865325238524147,1.2844155398148303,1.6230687922000717,4039504589,4127034198.6,28.109328900182618,42.065227314433635,NaN,NaN,18.91447094032883,21.71458439709904
2007-10-19T09:30:00-04:00,153.09,156.48,149.66,149.67,297148672,142959173.6,39.49571169054349,59.98023267363801,NaN,NaN,-111.68207530738168,-6.885573551044294,-0.6505525528442255,0.8098781011447898,1.4604306539890153,3742355917,4015748601.8,23.362287929044427,40.491051189717254,NaN,NaN,11.977980516786694,20.323640985625847
2007-10-22T09:30:00-04:00,148.86,150.75999,148.66,150.53999,261945376,149090695.2,42.823639482019445,58.49548926678671,NaN,NaN,-196.3165651251987,-58.9591667064624,-0.769735690227157,0.498261041205069,1.267996731432226,4004301293,3989071030.6,22.38629485778094,38.67069399090645,NaN,NaN,7.520124724278432,18.494567234004787
2007-10-23T09:30:00-04:00,151.46001,151.95,150.25,151.75999,179986432,150975538.4,47.20874434164978,57.42472368412221,NaN,NaN,-130.6367964415797,-92.0338657233203,-0.7377890892717283,0.34576036984256575,1.083549459114294,4184287725,4031676496.2,27.58911630079926,37.35248229346705,NaN,NaN,5.286635213960802,16.60771980256993
2007-10-24T09:30:00-04:00,151.21001,151.74001,148,151.48,326582016,160527292,46.330534778706614,56.24221470806998,NaN,NaN,-160.65028057113585,-123.85497295381408,-0.7068362767827688,0.200004113135833,0.9068403899186018,3857705709,3965631046.6,24.81239978328952,35.99384734537745,NaN,NaN,3.2434530872944767,14.698538843244867
2007-10-25T09:30:00-04:00,151.64999,152.28999,149.88,151.84,237346064,167259392,47.67826362674654,54.812060258713906,NaN,NaN,-106.9273498120588,-141.24261345147093,-0.6356752597097416,0.11224631528142481,0.7479215749911664,4095051773,3976740483.4,26.158654325098325,34.55087492014298,NaN,NaN,1.9916480700988812,12.88326873279544
2007-10-26T09:30:00-04:00,153.06,153.62,151.89999,153.62,176488496,169415466.4,53.84927027051742,54.11084890836835,NaN,NaN,-32.8522932137479,-125.47665703274417,-0.4509729819469036,0.18420534755753692,0.6351783295044405,4271540269,4082577353.8,37.61822429659946,34.0376884354628,NaN,NaN,2.8263814150073445,11.446570544539998
2007-10-29T09:30:00-04:00,153.92999,154.44,153.55,154.13,106819248,167350416,55.46982291940834,53.26215022030017,NaN,NaN,11.465655239123274,-83.92021295987976,-0.2848082146499331,0.2791680611920242,0.5639762758419573,4378359517,4157388998.6,44.209179554678336,33.82401725163553,NaN,NaN,4.005284004634689,10.38352961026781
2007-10-30T09:30:00-04:00,153.45,153.75,152.87,153.06,132970816,168364506.4,51.39243481721482,52.21400670269467,NaN,NaN,-22.691834049560004,-62.33122048147586,-0.2391558047576423,0.2650315198949045,0.5041873246525468,4245388701,4169609193.8,45.227183192707365,33.49036845860835,NaN,NaN,3.772762484728391,9.439134306619323
2007-10-31T09:30:00-04:00,153.98,155.27,152.84,154.64999,220927568,173458991.2,56.508382876196485,51.79536202343555,NaN,NaN,21.537342707048314,-25.893695825839036,-0.10113194850418827,0.37777238902231147,0.47890433752649975,4466316269,4291331305.8,54.193079250911225,34.04244885360425,NaN,NaN,5.189296391391118,8.832014604443865
2007-11-01T09:30:00-04:00,153.28999,153.41,150.59,151.03,332966400,186269064,44.917097348197466,50.37503302804153,NaN,NaN,-80.88922300138385,-20.686070463704034,-0.2447051497915017,0.17302290028712264,0.41772805007862435,4133349869,4298990925,54.695642792918186,34.87143993361618,NaN,NaN,2.407574751695016,7.9142374826226005
2007-11-02T09:30:00-04:00,151.53,152,149.21001,151.2,331219456,196100886.4,45.48265857488832,49.441899773789245,NaN,NaN,-102.48586642122214,-34.612785105198896,-0.3148255466214224,0.0241961168018463,0.3390216634232687,4464569325,4337596736.2,57.24193428314828,36.20121173255275,NaN,NaN,0.4671784798498933,6.850371910797929
2007-11-05T09:30:00-05:00,149.64,151.16,148,150.05,226765936,203875676.8,42.31735799142501,48.651976483315934,NaN,NaN,-125.85858241734326,-62.0776326364922,-0.41875308670035,-0.1844196949521688,0.23433339174818119,4237803389,4309485510.6,54.82556640271468,37.848856469744945,NaN,NaN,-2.1728251979793147,5.5613437524011795
2007-11-06T09:30:00-05:00,150.86,152.11,149.89999,152.07001,177729632,208062102.4,49.02768706733109,48.22458282315314,NaN,NaN,-58.64296671118485,-69.26785916881717,-0.33516518036322035,-0.18462308370584424,0.1505420966573761,4415533021,4343514374.6,57.181857439730585,39.82933923640026,NaN,NaN,-2.1952971148045166,4.453252199943223
2007-11-07T09:30:00-05:00,150.44,152.10719,147.55,147.91,306449152,218301132,38.97264126668435,47.248160503680644,NaN,NaN,-125.5596191070206,-98.68725153163095,-0.532058570666505,-0.5145311166757551,0.01752745399074987,4109083869,4272067894.6,51.14939302227322,41.47505810226387,NaN,NaN,-6.002216238975193,2.9596138515263064
2007-11-08T09:30:00-05:00,147.99001,149.3,145.07001,147.16,374404352,225345671.2,37.48020373258285,47.1041956495406,NaN,NaN,-177.96926226290432,-118.10325938393503,-0.6755991861059198,-0.8269715286416499,-0.1513723425357301,3734679517,4192333824.2,45.393908739167045,43.048745302986916,NaN,NaN,-9.446040939749805,1.1873774527725762
2007-11-09T09:30:00-05:00,145.69,147.53999,144.89,145.14,277731328,233005268.8,33.733320143934904,46.454887125391714,NaN,NaN,-201.14307642647535,-137.8347013849857,-0.857683285468323,-1.2234764493711339,-0.36579316390281086,3456948189,3990809597,34.75069291176679,43.931916592557336,NaN,NaN,-13.626793190669398,-0.9289326391477057
2007-11-12T09:30:00-05:00,145.21001,146.61,143.7,143.7,243016816,237101372,31.328905902390844,45.32061295115892,NaN,NaN,-203.94255425245407,-153.45149575200784,-1.0154114657606987,-1.6350574961036841,-0.6196460303429855,3213931373,3786035193.8,27.655166067918216,43.936634433065834,NaN,NaN,-17.830989373929402,-3.343512172687948
2007-11-13T09:30:00-05:00,145.37,148.31,145.22,148.08,191073376,238333603.2,44.32727790471804,45.177523174445454,NaN,NaN,-108.67469165157698,-163.45784074008628,-0.7758723244422462,-1.5894864358957932,-0.813614111453547,3405004749,3583929539.4,22.723591252337883,43.78743382371214,NaN,NaN,-16.69917237046138,-5.251463629512724
2007-11-14T09:30:00-05:00,149.22,149.39999,146.78,147.67,230524880,239026219.2,43.497290260176435,44.878882219690446,NaN,NaN,-76.20057586108865,-153.5860320908999,-0.603808999609077,-1.5683753609648932,-0.9645663613558162,3174479869,3397008739.4,19.296325226042498,43.297267459493874,NaN,NaN,-16.138058942469737,-6.806691531363725
2007-11-15T09:30:00-05:00,146.57001,147.49001,144.52,145.53999,263051680,244757384.8,39.37272218155033,43.84484307047851,NaN,NaN,-122.61595468516174,-142.51537057535137,-0.5914488702289005,-1.7038774491419417,-1.1124285789130413,2911428189,3232358473.8,16.88108325578311,41.81604309943556,NaN,NaN,-17.10833737851703,-8.278355223814197
2007-11-16T09:30:00-05:00,146.31,146.47,144.57001,145.78999,308757248,245337813.6,40.090769500010374,42.74633925480723,NaN,NaN,-112.82433770618564,-124.85162283129344,-0.5266008385241308,-1.7706796270682048,-1.244078788544074,3220185437,3185005923.4,16.251092437354956,39.8190368767696,NaN,NaN,-17.62211449058783,-9.61317797621043
2007-11-19T09:30:00-05:00,145.28,145.36,143.19,143.75999,267712624,245626176,36.328317303601374,41.6703308609777,NaN,NaN,-130.06439906191213,-110.07599179318504,-0.5765578911530826,-1.9647761524854275,-1.3882182613323448,2952472813,3132714211.4,15.560485067881132,37.69998701071058,NaN,NaN,-19.28904363560913,-10.995444498981673
2007-11-20T09:30:00-05:00,144.02,145.53,142.11,144.64,414724608,257363084.8,39.00087126773706,40.41979431751632,NaN,NaN,-113.83152924417843,-111.10735931170534,-0.5088295833037901,-2.0242552404620824,-1.5154256571582922,3367197421,3125152745.8,15.458187567033661,34.93320903329076,NaN,NaN,-19.78947126503324,-12.251734036989038
2007-11-21T09:30:00-05:00,143.08,143.91,141.67,141.67999,259160320,253992000,33.8536183956748,39.62954582090755,NaN,NaN,-130.95997082396855,-122.05923830428132,-0.6147901811312952,-2.2839133835724112,-1.669123202441116,3108037101,3111864192.2,15.268216864932796,32.116964324148945,NaN,NaN,-21.940132933153365,-13.63579102215537
2007-11-23T09:30:00-05:00,143.07001,144.34,142.7,144.13,77684624,246008928,40.81610110452821,39.296220287310405,NaN,NaN,-93.47415882235117,-116.2308791317192,-0.4774049217051677,-2.2658793545725757,-1.788474432867408,3185721725,3166722899.4,19.657809928988215,29.43238401313751,NaN,NaN,-21.405931211429127,-14.745811049194478
2007-11-26T09:30:00-05:00,144.42999,144.88,140.66,140.95,214165440,247892775.2,35.58105190876307,38.81505556712027,NaN,NaN,-114.92542385976279,-116.65109636243464,-0.5529031387470542,-2.479603356301226,-1.9267002175541716,2971556285,3116997069,18.71155334150069,26.85281165162223,NaN,NaN,-22.773868028808877,-15.892676331996535
2007-11-27T09:30:00-05:00,141.74001,143.23,140.95,142.57001,293832192,257243422.4,39.81597691766755,38.15707627071573,NaN,NaN,-105.9965881290155,-111.83753417585531,-0.450289250713114,-2.4895617809455644,-2.0392725302324504,3265388477,3179580201.8,23.690229412997823,24.4605525068556,NaN,NaN,-22.42514996705954,-16.82588685129125
2007-11-28T09:30:00-05:00,144.19,147.47,144.14,147.13,259068752,263548319.2,49.81652313024141,38.9316392609698,NaN,NaN,-13.57524936895887,-91.78627820081141,-0.052768379837552004,-2.1052330050293904,-2.0524646251918384,3524457229,3211032163.4,26.138602992077935,22.674067504698794,NaN,NaN,-18.432850623312383,-17.055453104437127
2007-11-29T09:30:00-05:00,146.62,147.72,146.10001,147.17999,199180560,262460968.8,49.914778441285655,39.81982316873429,NaN,NaN,15.157875441661579,-62.562708947685394,0.2210583796560457,-1.7761416506217813,-1.997200030277827,3723637789,3334152301,34.93867951476611,21.927265417241582,NaN,NaN,-15.403041424802957,-16.819394293060817
2007-11-30T09:30:00-05:00,149.03999,149.87,147.33,148.66,222886496,256956973.6,52.85765895503566,41.185847369527195,NaN,NaN,69.23344873019903,-30.021187437175307,0.49375831412843585,-1.3800021376172822,-1.873760451745718,3946524285,3486312813,43.843523830960685,22.57675334004114,NaN,NaN,-11.969907873596256,-16.126610518851596
2007-12-03T09:30:00-05:00,148.19,148.45,147.28999,147.67999,145927872,247692394.4,50.73199075526278,42.57178200187519,NaN,NaN,53.11656042948519,3.587209420674293,0.5933384909077923,-1.1320873381109777,-1.72542582901877,3800596413,3652120838.6,51.614983867779046,24.288168897174064,NaN,NaN,-9.858181305522397,-15.23112063123314
2007-12-04T09:30:00-05:00,146.66,147.54089,146.31,146.36,136528560,243180525.6,47.93576622123415,42.829531167340626,NaN,NaN,25.439108024972086,29.874348651471802,0.5561413322514188,-1.0302491637044966,-1.5863904959559154,3664067853,3731856713.8,54.85081317334157,26.582970462960038,NaN,NaN,-8.965213343985058,-14.335991018769128
2007-12-05T09:30:00-05:00,147.92999,149.2,147.83,148.81,171036688,242845878.4,53.102541486036316,43.51562054061633,NaN,NaN,102.38333404091948,53.06606533344747,0.6744891219073375,-0.7432790935717435,-1.417768215479081,3835104541,3793986176.2,57.24987068926397,29.293937996047287,NaN,NaN,-6.555251557399093,-13.22445681000198
2007-12-06T09:30:00-05:00,148.63,151.21001,148.57001,150.94,154542560,235250548.8,57.08950127065786,44.78110476126687,NaN,NaN,156.41425165549663,81.31734057621448,0.8621665354991894,-0.3400600461050942,-1.2022265816042836,3989647101,3847188038.6,59.246816108051895,32.32006177120934,NaN,NaN,-3.231976362252252,-11.796959603180591
2007-12-07T09:30:00-05:00,151.42,151.5,150.55,150.91,148980064,223979334.4,57.01597958222618,45.990048338567995,NaN,NaN,159.99507067057678,99.46966496429002,0.9436488483144482,-0.02266552121122345,-0.9663143695256716,3840667037,3826016589,58.08404545698845,35.3081298440403,NaN,NaN,-0.6275855609872192,-10.20133474001011
2007-12-10T09:30:00-05:00,151.28,152.25,150.86,152.08,123914368,216288486.4,59.221638166773744,47.62528554308032,NaN,NaN,155.2886316003873,119.90407919847044,1.028729121798377,0.31959703272229945,-0.7091320890760775,3964581405,3858813587.4,59.41292313352484,38.44044684872914,NaN,NaN,2.216250238800909,-8.427394028751392
2007-12-11T09:30:00-05:00,152.14,152.89,147.83,147.91,250346368,216654964,49.476929286742326,48.37357540158069,NaN,NaN,82.79748967780978,131.375755529038,0.7684734722554019,0.2514597512431749,-0.517013721012227,3714235037,3868847024.2,59.83247056816426,41.610038491667034,NaN,NaN,1.7456843380315223,-6.974097119210976
2007-12-12T09:30:00-05:00,151.06,151.77,147.2,149.37,322435584,223223074.4,52.428394991191546,49.70034515840331,NaN,NaN,73.58779574024615,125.61664786890333,0.6629529284328504,0.311677439528836,-0.3512754889040144,4036670621,3909160240.2,61.552151014085545,44.91603378803509,NaN,NaN,2.2875634517641488,-5.651002751928815
2007-12-13T09:30:00-05:00,148.32001,149.39,147.3,149.06,237607056,223577183.2,51.737288160642265,50.48042994812574,NaN,NaN,48.47410201555257,104.0286179409145,0.5454806436475614,0.3305753156554374,-0.21490532799212403,3799063565,3871043533,58.98094444567947,47.7248291106559,NaN,NaN,2.5139006876342016,-4.484587974848385
2007-12-14T09:30:00-05:00,147.92999,149.10001,147.10001,147.17,159152880,218382243.2,47.61614546260641,51.340079487685976,NaN,NaN,24.495401034095014,76.92868401361815,0.3246001608945647,0.1908448731260819,-0.13375528776848283,3639910685,3830892262.6,56.3124473465973,50.41060725387708,NaN,NaN,1.4592059444336294,-3.635474557808097
2007-12-17T09:30:00-05:00,146.61,146.87,144.86,145.07001,177269312,211807846.4,43.47262086900065,51.60126834135263,NaN,NaN,-34.781939023892825,38.91456988876214,0.03634344224710957,-0.08832598495959587,-0.12466942720670544,3462641373,3730504256.2,50.19735439103755,52.30397332373707,NaN,NaN,-0.7341370662091624,-3.2209977732939636
2007-12-18T09:30:00-05:00,146.10001,146.48,143.96001,145.88,245569248,210700677.6,45.44459223610641,51.28898756320012,NaN,NaN,-42.1817704779425,13.918717857611682,-0.09340721095153914,-0.24142844089612936,-0.14802122994459022,3708210621,3729299373,50.126995637098446,54.017429941238525,NaN,NaN,-1.955414204386405,-3.0402001205928837
2007-12-19T09:30:00-05:00,145.94,146.89,144.94,145.88,198917120,199910303.2,45.44459223610641,50.96968854854447,NaN,NaN,-33.099068455306096,-7.4186549814987615,-0.1684863650437814,-0.35862918624931694,-0.19014282120553555,3708210621,3663607373,46.3153340925194,54.83004812536377,NaN,NaN,-2.9420412657358153,-3.026177427041874
2007-12-20T09:30:00-05:00,146.84,146.86,145.17999,146.8,214813744,197692974.4,47.84146339485773,50.61138886567461,NaN,NaN,-30.31153492475613,-23.1757823695605,-0.14626644411965076,-0.372975876355099,-0.22670943223544823,3923024365,3688399533,47.924722298763726,55.121562301635414,NaN,NaN,-3.1218635120910156,-3.03984686776318
2007-12-21T09:30:00-05:00,147.37,148.42,147.09,148.13,146090320,201113259.2,51.180698099083905,50.64343939023326,NaN,NaN,15.042364044030121,-25.06638976757348,-0.037727539965024925,-0.2738688571917294,-0.23614131722670445,4069114685,3774240333,53.16056164421957,55.231960714238305,NaN,NaN,-2.3463224555316136,-2.940771951730099
2007-12-24T09:30:00-05:00,148.82001,149.48,148.48,149.23,45601328,192685053.6,53.814326838183845,51.06333657715824,NaN,NaN,50.46620271227715,-8.01676142033949,0.1046325679110233,-0.10535060733792534,-0.20998317524894863,4114716013,3904655261,59.77730273054636,55.58385282546722,NaN,NaN,-0.9420435163421408,-2.6552393181032476
2007-12-26T09:30:00-05:00,148.64999,149.67999,148.5,149.55,67118064,181349347.2,54.58192458544268,51.16900679854441,NaN,NaN,50.16603124359175,10.45279892396736,0.2107121423952646,0.053407002745132104,-0.15730513965013249,4181834077,3999379952.2,63.779574583400446,56.05026024647697,NaN,NaN,0.4392232107945761,-2.2131732425464157
2007-12-27T09:30:00-05:00,149.02,149.03,147.32001,147.67,122981680,174544993.6,49.388597658494916,50.61894225481849,NaN,NaN,-10.570192002560356,14.958574214516508,0.14761179884351217,0.02720960890425772,-0.12040218993925444,4058852397,4069508307.4,66.4418247916499,56.56418943816251,NaN,NaN,0.23265677421062436,-1.8637689544382672
2007-12-28T09:30:00-05:00,148.53999,148.61,146.89999,147.3,116398064,170405868.8,48.412302547012416,50.00439389516037,NaN,NaN,-32.19566614212702,14.58174797104233,0.0778088197201658,-0.023141165289047194,-0.100949985009213,3942454333,4073394301,66.58837486303801,57.17164153859462,NaN,NaN,-0.2061810153772135,-1.6269706774295452
2007-12-31T09:30:00-05:00,147.10001,147.6062,146.06,146.21001,108126752,164667881.6,45.555373192530666,49.02823211128587,NaN,NaN,-72.65799839368752,-2.9583245165011958,-0.038661475829572675,-0.14927682979617884,-0.11061535396660617,3834327581,4026436880.2,63.00767446267983,57.42840949067712,NaN,NaN,-1.3739021497000685,-1.5908180306110484
2008-01-02T09:30:00-05:00,146.53,146.99001,143.88,144.92999,204935504,167618263.2,42.391619288150714,48.52213853995789,NaN,NaN,-121.25645864558717,-37.30285678807407,-0.19031552919991712,-0.3485097654665026,-0.15819423626658546,3629392077,3929372093,56.27168160261812,57.17406742170954,NaN,NaN,-3.285759444731621,-1.8329525183425588
2008-01-03T09:30:00-05:00,144.91,145.49001,144.07001,144.86,125133248,167048497.6,42.21896610071491,47.79289361920956,NaN,NaN,-129.19237044254336,-73.17453712530109,-0.27841706893820756,-0.5062155724393449,-0.22779850350113734,3504258829,3793857043.4,48.47922579281663,56.24028704876175,NaN,NaN,-4.917045911101474,-2.2735372887366894
2008-01-04T09:30:00-05:00,143.34,143.44,140.91,141.31,232330816,170113204,34.5357864602408,46.56421492632374,NaN,NaN,-200.74458899601993,-111.20941652399299,-0.5435182354987748,-0.9071962978746058,-0.363678062375831,3271928013,3636472166.6,41.32226375933743,54.97895271402303,NaN,NaN,-8.864684842328726,-3.2151297963926946
2008-01-07T09:30:00-05:00,141.81,142.23,140.10001,141.19,234990944,174135623.2,34.308500449218826,45.61366885393891,NaN,NaN,-186.8037720674472,-142.13103770905704,-0.6855289229932011,-1.2205892161173324,-0.5350602931241313,3036937069,3455368713.8,34.931675089644145,53.45175469566924,NaN,NaN,-12.126297091142607,-4.488153695642682
2008-01-08T09:30:00-05:00,142.08,142.89999,138.44,138.91,326366720,183004956,30.236786382894763,44.66825210493135,NaN,NaN,-189.3188439917871,-165.46320682867696,-0.8792281427302452,-1.6340954715369378,-0.7548673288066926,2710570349,3230617267.4,28.948368005725598,51.93396995386123,NaN,NaN,-16.330124255744455,-6.17986377565722
2008-01-09T09:30:00-05:00,139.09,140.78999,137.7,140.37,301910784,191904776.8,35.51443798408765,43.9589553726443,NaN,NaN,-175.90508203319206,-176.39293150619793,-0.8544886984673584,-1.8229782018908907,-0.9684895034235322,3012481133,3107235078.6,26.2864844861609,50.231076300222846,NaN,NaN,-18.33212198423654,-7.915900662597123
2008-01-10T09:30:00-05:00,139.67999,142.8,139.37,141.28999,335701248,196172520.8,38.663272070228096,43.47457536079584,NaN,NaN,-117.13879001143343,-173.98221541997594,-0.7266476380668407,-1.876799051007083,-1.1501514129402424,3348182381,3076019789,25.644017799298993,48.75455370784995,NaN,NaN,-19.062874799046973,-9.508325539232816
2008-01-11T09:30:00-05:00,140.78,141.8985,139,140.14999,267076560,193404569.6,36.29802398258731,42.650043974205104,NaN,NaN,-118.82766615685993,-157.59883085214395,-0.6706936940498882,-1.9885185305026027,-1.3178248364527145,3081105821,3037855350.6,24.844506384036606,47.10596685679802,NaN,NaN,-20.38595709854743,-11.06227290484919
2008-01-14T09:30:00-05:00,141.16,141.86,140.39999,141.28,170365632,190042498.4,40.20301045239576,41.86592342801309,NaN,NaN,-85.59427169376916,-137.3569307774083,-0.5163350184632809,-1.9632436095318155,-1.4469085910685346,3251471453,3080762227.4,27.57826542494439,45.27865998399265,NaN,NaN,-20.35093815263402,-12.389225083104165
2008-01-15T09:30:00-05:00,139.78999,141.4903,137.89999,138.17,240456496,194107679.2,34.021641351794884,40.45216017898531,NaN,NaN,-114.36991246184459,-122.36714447141983,-0.5778006011977599,-2.1691593425657345,-1.5913587413679746,3011014957,3140851149,31.344661622481027,43.24775704770226,NaN,NaN,-22.301698242342077,-13.80529267728101
2008-01-16T09:30:00-05:00,137.36,139.12,136.28,136.98,378956032,204192015.2,31.994549810338185,38.83877626647784,NaN,NaN,-129.9119641161024,-113.1685208880019,-0.6474716814461048,-2.4006983431756055,-1.7532266617295007,2632058925,3064766707.4,29.26902436549021,40.78271774642296,NaN,NaN,-24.55879235835989,-15.341506917435135
2008-01-17T09:30:00-05:00,137.81,137.88,132.92999,133.42999,398404864,211833796,26.854150900511314,37.229172926621864,NaN,NaN,-155.82076261731592,-120.90491540917841,-0.8677681412708682,-2.837936838318086,-1.9701686970472179,2233654061,2841861043.4,24.210714714415516,37.76620988376335,NaN,NaN,-28.381775373694996,-17.204402411186543
2008-01-18T09:30:00-05:00,134.74001,135.02,131.10001,132.06,348561408,219316010.4,25.17328445898515,35.56924306319136,NaN,NaN,-165.1785879438271,-130.17509976657186,-1.0298237638677703,-3.2574484018819305,-2.22762463801416,1885092653,2602658409.8,20.18026453836481,34.45134486057241,NaN,NaN,-32.047371810181126,-19.324826611042912
2008-01-22T09:30:00-05:00,127.21001,132.42661,126,130.72,435925248,230371585.6,23.616227869447144,34.002161254399674,NaN,NaN,-187.06088162873363,-150.46842175356474,-1.1426188660743515,-3.6558982206070993,-2.513279354532748,1449167405,2242197600.2,15.887957376979543,31.08565078302239,NaN,NaN,-35.55685431592998,-21.643687711741066
2008-01-23T09:30:00-05:00,127.09,134.19,126.84,133.86,511912960,248662717.6,33.929195229787155,33.39770239308799,NaN,NaN,-142.5797291905526,-156.11038509930637,-0.9301181293654346,-3.675927016239541,-2.7458088868741064,1961080365,2032210681.8,14.017478886720951,28.06749344617259,NaN,NaN,-35.09089618810788,-23.564717494079183
2008-01-24T09:30:00-05:00,134.48,135.46001,133.31,134.99001,259949248,259380113.6,37.21452556602128,33.04024235489559,NaN,NaN,-88.52809453534277,-147.83361118315443,-0.6510208413475271,-3.5595849385585154,-2.9085640972109883,2221029613,1950004819.4,13.354634051006016,25.558594036043257,NaN,NaN,-33.62137446852214,-25.001382776142464
2008-01-25T09:30:00-05:00,136.50999,136.75999,132.60001,133.03999,269603840,269504402.4,34.066498838635056,33.006721810495186,NaN,NaN,-85.52277164019722,-133.77401298773069,-0.5398893770859754,-3.5834258185684575,-3.043536441482482,1951425773,1893559161.8,12.903443474328355,23.528678301399754,NaN,NaN,-33.42266050983028,-26.20442245238358
2008-01-28T09:30:00-05:00,133.25999,135.52,132.06,135.24001,217934560,274252046.4,40.211421212416745,33.42835900786646,NaN,NaN,-73.58484476938708,-115.45526435284269,-0.27378495746014986,-3.3857676383076694,-3.1119826808475195,2169360333,1950412697.8,15.98244356937704,22.175161764237817,NaN,NaN,-31.19237914676745,-26.91698769443842
2008-01-29T09:30:00-05:00,136.10001,136.45,134.88,135.91,168968816,276880584,41.984708563787784,34.26749630650168,NaN,NaN,-43.02096947202026,-86.64728192150001,-0.021515054002406053,-3.138876498350527,-3.117361444348121,2338329149,2128245046.6,24.922798500068467,21.887621085262303,NaN,NaN,-28.848458388513702,-27.192912079306318
2008-01-30T09:30:00-05:00,135.58,138.53999,134.60001,134.91,334939136,288221203.2,40.07422888203764,34.59319565635525,NaN,NaN,-32.04209662982812,-64.53975540935512,0.10233341430603193,-2.989444676465581,-3.091778090771613,2003390013,2136706976.2,25.329967197713884,21.8192984218018,NaN,NaN,-27.507438027122973,-27.23784435756584
2008-01-31T09:30:00-05:00,133.39999,138.53999,133.2,137.37,343680768,295158466.4,46.52116025578824,35.15447338389526,NaN,NaN,-19.361728792850375,-50.70648226085664,0.3597733518988897,-2.642061400898001,-3.0018347527968907,2347070781,2161915209.8,26.606932326709554,21.88807803090256,NaN,NaN,-24.266429704692435,-26.813356550012497
2008-02-01T09:30:00-05:00,137.94,139.61,137.52,139.58,206843680,299243988,51.562678944465894,36.244805881172304,NaN,NaN,40.53993581511353,-25.493940769794484,0.6706759952163752,-2.1634897587764215,-2.8341657539927967,2553914461,2282412947.4,32.54528729510713,22.438133810264738,NaN,NaN,-19.848284264276643,-25.8183462234788
2008-02-04T09:30:00-05:00,139.21001,139.3,137.64,137.82001,124694256,293862160,47.70565875459359,36.7807093313293,NaN,NaN,32.22981735400038,-4.331008345116986,0.7439059029959858,-1.9042833752478145,-2.6481892782438003,2429220205,2334384921.8,34.98858148421097,22.967442100212356,NaN,NaN,-17.38396429774846,-24.61343451980304
2008-02-05T09:30:00-05:00,135.94,136.25,133.67,134.13,286882560,296456740.8,40.81258984585828,37.26577708090525,NaN,NaN,-45.32704613791308,-4.792223678295544,0.5394634323030081,-1.9738599878650405,-2.5133234201680485,2142337645,2295186621,33.98862797763071,23.156296839865906,NaN,NaN,-17.535500182691962,-23.602301043072885
2008-02-06T09:30:00-05:00,134.58,135.25,132.41,133.05,250792880,292678048.8,39.03481896606369,37.76865344917137,NaN,NaN,-66.44967026141595,-11.673738404613108,0.33703370078652517,-2.092031294184892,-2.429064994971417,1891544765,2272817571.4,33.40196263546474,23.451506716292652,NaN,NaN,-18.240884185357196,-22.8363843491135
2008-02-07T09:30:00-05:00,131.8,134.78999,131.73,133.92999,297541632,292459591.2,41.27927801010799,38.79901967128541,NaN,NaN,-62.91486821581694,-20.38436628920642,0.27079103114493064,-2.0905762060402537,-2.3613672371851844,2189086397,2241220694.6,32.54737985233996,24.046982797572973,NaN,NaN,-18.10392318269066,-22.160318468195953
2008-02-08T09:30:00-05:00,133.09,134.22,132.10001,133.07001,221643504,286756704,39.73953617852759,39.8394662226813,NaN,NaN,-66.3083828796543,-41.75403002815999,0.18172231565997077,-2.134214342610221,-2.315936658270192,1967442893,2123926381,29.5272687820636,24.71462595783717,NaN,NaN,-18.46053630741666,-21.631778159513196
2008-02-11T09:30:00-05:00,133.10001,134.23,132.03999,133.75,188576256,282831688.8,41.5946365195503,41.12363826911724,NaN,NaN,-55.40031769862669,-59.2800570386854,0.18087891193241834,-2.089838018354669,-2.2707169302870875,2156019149,2069286169.8,28.213890143755876,25.595049726892626,NaN,NaN,-18.209784554563253,-21.142921930234632
2008-02-12T09:30:00-05:00,134.91,136.31,133.98,134.99001,256654368,287146125.6,44.92431419134586,41.90900390922858,NaN,NaN,8.81864887221382,-48.45091803666001,0.27070454548598466,-1.932336248429607,-2.2030407939155916,2412673517,2123353344.2,31.46252399472472,26.841124377464322,NaN,NaN,-17.024783912311463,-20.55461649910275
2008-02-13T09:30:00-05:00,136.00999,137.10001,135.14,136.37,181967744,284221688,48.446733750035605,42.71130449380103,NaN,NaN,60.74158504528645,-23.01266697531954,0.42096717307963516,-1.6768318275660477,-2.097799000645683,2594641261,2263972643.4,39.17255083068511,28.68526129029854,NaN,NaN,-14.977405648787876,-19.757872091914912
2008-02-14T09:30:00-05:00,136.95,137,134.78999,135.17,215207120,276034242.4,45.709109014943245,43.54291950639447,NaN,NaN,44.631010007941335,-1.5034913305678856,0.43562511862952813,-1.5532676023587726,-1.9888927209883007,2379434141,2302042192.2,41.10420577179743,30.699601454403478,NaN,NaN,-14.024106063163924,-18.9387626592362
2008-02-15T09:30:00-05:00,134.55,136.10001,133.36,135.14,154110256,263819512,45.63967430234541,43.9306518699608,NaN,NaN,10.586190663972049,13.875423378157388,0.4381940717501924,-1.4411501313005601,-1.8793442030507526,2225323885,2353618390.6,43.71216484866763,32.68029583149566,NaN,NaN,-13.265731685708168,-18.12832966301791
2008-02-19T09:30:00-05:00,136.69,136.89,134.61,135.52,145190000,253650941.6,46.743233677843605,44.27054652096479,NaN,NaN,40.000970195171725,32.95568095691708,0.4582177190895236,-1.3065720541888481,-1.7647897732783717,2370513885,2396517337.8,45.85959943665493,34.17578161268041,NaN,NaN,-12.332575947847268,-17.300364846564964
2008-02-20T09:30:00-05:00,133.99001,137.60001,133.75999,135.92,220709376,242890148,47.941265460507616,44.83247770514122,NaN,NaN,35.49337039566889,38.29062526160809,0.48836394033707387,-1.1543348478570294,-1.6426987881941033,2591223261,2432227286.6,47.64999663137212,35.77006942937029,NaN,NaN,-11.226027091913345,-16.432602310186162
2008-02-21T09:30:00-05:00,136.66,137.00999,134.07001,134.78999,201051184,227347059.2,44.87040213969317,44.714566411134435,NaN,NaN,2.260170611198994,26.594342374790596,0.4245197360478359,-1.1120491181343084,-1.5365688541821443,2390172077,2391333449.8,45.78282670980917,37.139776171020266,NaN,NaN,-11.057437242660303,-15.664721586253897
2008-02-22T09:30:00-05:00,134.97,135.85001,132.86,135.62,205491008,224624147.2,47.529019840537785,44.426447903710994,NaN,NaN,-28.675570262477514,11.933026320706826,0.4292273037015959,-1.0000347245551495,-1.4292620282567454,2595663085,2434579238.6,48.09898106898239,38.250754297725635,NaN,NaN,-10.20653147083794,-14.884980141194475
2008-02-25T09:30:00-05:00,135.53999,137.64999,134.78,137.33,190107008,220649305.6,52.60057981332716,44.77608512219196,NaN,NaN,70.78535044956405,23.972858277825228,0.531835625599457,-0.7644674962574243,-1.2963031218568812,2785770093,2546668480.2,53.628491064945266,39.58217641063523,NaN,NaN,-8.024087084813328,-13.904852561711454
2008-02-26T09:30:00-05:00,136.75,138.95,136.5,138.36,212420624,220373608.8,55.39705955033579,45.81783295822607,NaN,NaN,133.1199145576019,42.59664715031126,0.6458191734525607,-0.4890291550411803,-1.134848328493741,2998190717,2672203846.6,58.90866104310517,41.36217877245484,NaN,NaN,-5.345752084566377,-12.6821239221193
2008-02-27T09:30:00-05:00,137.56,139.14,137.41,138.22,168395808,220344958.4,54.92274507656103,46.9526848232616,NaN,NaN,130.9435664377448,61.686686358726455,0.6848186674335655,-0.2788249942017842,-0.9636436616353496,2829794909,2719918176.2,60.73857290357804,43.31479379160579,NaN,NaN,-3.2449224339202996,-11.333952280948015
2008-02-28T09:30:00-05:00,137.24001,137.96001,136.55,136.87,170831056,212139554.4,50.43809316333886,47.60688590563523,NaN,NaN,67.26276888313657,74.68720601311398,0.59599497772496,-0.21864993947914968,-0.8146449172041097,2658963853,2773676531.4,62.75124695479494,45.47221287035257,NaN,NaN,-2.5986900326537343,-10.086057674048833
2008-02-29T09:30:00-05:00,135.60001,137.0249,132.78,133.82001,252715120,207591272,42.07848486529525,47.77395366897577,NaN,NaN,-53.88424396859905,69.64547127188966,0.32186269398996803,-0.41231654971664966,-0.7341792437066177,2406248733,2735793661,60.4014188414554,47.677509303166275,NaN,NaN,-4.55862491877396,-9.29642442329528
2008-03-03T09:30:00-05:00,133.14,133.81,132.24001,133.5,195613632,207029769.6,41.304951234115606,47.753261862873295,NaN,NaN,-111.16373167995336,33.25565484598618,0.11944039652200689,-0.5848787480541091,-0.704319144576116,2210635101,2620766662.6,53.81217102705536,49.50595793768766,NaN,NaN,-6.382933524624164,-8.880211437770834
2008-03-04T09:30:00-05:00,132.23,133.39999,130.99001,132.99001,282513152,214920714.4,40.04163041411589,47.4044987359283,NaN,NaN,-136.79095007775652,-20.726518081085505,-0.039820468082850224,-0.7540947296796787,-0.7142742615968285,1928121949,2406752909,44.15964731042547,50.412895317380574,NaN,NaN,-8.268707803575811,-8.792853775742973
2008-03-05T09:30:00-05:00,133.41,134.77,132.34,133.83,270681344,214110653.6,43.127051362706645,47.024521422547664,NaN,NaN,-69.33339820672559,-60.78191100997958,-0.07743653635417247,-0.811069932039544,-0.7336333956853716,2198803293,2280554585.8,39.64386558080385,50.44656065667477,NaN,NaN,-9.01547870542206,-8.8246573371257
2008-03-06T09:30:00-05:00,132.98,133.22,130.55,131.06,247912128,213966616,36.463402072599614,46.36411378380883,NaN,NaN,-155.13755747051096,-105.26197628070909,-0.26704074115354093,-1.0674343221272977,-0.8003935809737568,1950891165,2138940048.2,35.28354432337082,50.030799124644304,NaN,NaN,-11.800843514556107,-9.24982679104433
2008-03-07T09:30:00-05:00,129.63,131.74001,128.58,129.71001,326434560,215411262.4,33.72819079963155,45.51329353361498,NaN,NaN,-196.1304659014744,-133.71122066728415,-0.4507384390439405,-1.3638166297786825,-0.913078190734742,1624456605,1982581622.6,31.202843134268008,49.137276145044325,NaN,NaN,-15.030503578538173,-10.075637760686307
2008-03-10T09:30:00-04:00,129.81,129.92999,127.59,128,235683376,216113256,30.597289158909177,44.36001178226252,NaN,NaN,-212.03457841547544,-153.88539001438858,-0.6430526272123944,-1.716893974750235,-1.0738413475378406,1388773229,1818209248.2,27.590313278989797,47.83232713378253,NaN,NaN,-18.821548271205362,-11.325053547903314
2008-03-11T09:30:00-04:00,130.72,132.72,127.71519,132.60001,341875712,223778228.8,45.305633366692625,44.17175234699001,NaN,NaN,-110.83028286096435,-148.69325657103013,-0.4265296549737254,-1.6070034162549973,-1.180473761281272,1730648941,1778714646.6,26.787807733272103,46.34217078391824,NaN,NaN,-17.150183223916006,-12.157214930190841
2008-03-12T09:30:00-04:00,132.73,133.77,131.16,131.36,229161120,222403566.4,42.679836118409455,44.015283345469754,NaN,NaN,-66.90817815566166,-148.20821256081734,-0.33683024876255985,-1.6015115722344717,-1.2646813234719119,1501487821,1639251552.2,24.119886997581162,44.79481794733052,NaN,NaN,-16.73699561141515,-12.811469313222885
2008-03-13T09:30:00-04:00,129.61,132.64,128.60001,131.64999,351881472,230899252.8,43.504478259119836,43.72781608965419,NaN,NaN,-89.94271616192147,-135.16924429909946,-0.23291485793976685,-1.5558248958966203,-1.3229100379568535,1853369293,1619747177.8,23.763433927993034,43.056564580117005,NaN,NaN,-16.148006666963717,-13.288117506614432
2008-03-14T09:30:00-04:00,132.77,132.81,127.78,129.61,484687872,244373290.4,39.228908245439186,42.77269669194791,NaN,NaN,-103.02846150483592,-116.54884341977174,-0.27369960013757466,-1.6650345381288219,-1.3913349379912472,1368681421,1568592141,22.811257602870455,40.85533361854023,NaN,NaN,-17.054228066050005,-13.826133300819514
2008-03-17T09:30:00-04:00,126.57001,129.25999,126.07001,128.3,405310976,256933326.4,36.73237686234266,41.43950507137697,NaN,NaN,-141.34586564590484,-102.41110086585763,-0.3558315056629673,-1.8361243200699562,-1.480292814406989,963370445,1483511584.2,21.283751462225453,38.167840077048815,NaN,NaN,-18.611101997291296,-14.50970025745834
2008-03-18T09:30:00-04:00,130.62,133.69,129.98,133.63,334416384,266394645.6,50.5277404514577,41.12557616958387,NaN,NaN,-20.58291408409,-84.36162711048274,-0.03501322220225056,-1.524059342159802,-1.4890461199575515,1297786829,1396939161.8,19.828751332646917,35.24570996483945,NaN,NaN,-14.98911577513633,-14.578188188555195
2008-03-19T09:30:00-04:00,134.14,134.64999,130.03999,130.32001,345971456,272657749.6,44.097208683392715,40.67265584958772,NaN,NaN,-36.52332968075964,-78.28465741550234,-0.02975556626565634,-1.526240577789622,-1.4964850115239656,951815373,1287004672.2,18.133494740550006,32.058727663821955,NaN,NaN,-14.391205901974882,-14.551476433329436
2008-03-20T09:30:00-04:00,130.05,132.91,129.25999,132.08,245320624,274871221.6,47.89445814378933,41.088082512337294,NaN,NaN,-39.353089401296266,-68.16673206337731,0.10106128490875221,-1.3701584053880254,-1.4712196902967776,1197135997,1155758013,16.3376505485935,28.911315642903244,NaN,NaN,-12.539113871201685,-14.263996067311185
2008-03-24T09:30:00-04:00,133.31,135.81,133.24001,134.72,209110368,275052189.6,53.04652815636945,41.92676657821257,NaN,NaN,50.854318382786815,-37.39017608585276,0.35964841489449095,-1.0216591716786638,-1.3813075865731548,1406246365,1163271001.8,16.845322296720582,26.270826447879333,NaN,NaN,-9.152298004583184,-13.533753486921471
2008-03-25T09:30:00-04:00,134.86,135.55,133.77,134.85001,192947184,275194198.4,53.291463588011425,42.87318323349082,NaN,NaN,60.15251753491648,2.9095005503114906,0.5237625061760673,-0.7266044538530707,-1.250366960029138,1599193549,1290435622.6,25.12696722642461,24.911349299022127,NaN,NaN,-6.507515044478705,-12.530005138001076
2008-03-26T09:30:00-04:00,134.46001,135.08839,133.11,133.2,196934192,274419876.8,49.74475352086656,43.345876244787966,NaN,NaN,43.6120948713939,15.748502341408265,0.5052691165475818,-0.6187805643446609,-1.1240496808922427,1402259357,1311330128.2,26.423605703644284,23.967045022082154,NaN,NaN,-5.491906311483299,-11.524562448498537
2008-03-27T09:30:00-04:00,134.2,134.44,132.36,132.78,225153120,277257742.4,48.853480123646534,44.23088181986275,NaN,NaN,36.63247980946792,30.379664239453785,0.4506351037729823,-0.5607558011760148,-1.011390904948997,1177106237,1356388301,29.268288253477678,23.53738387423265,NaN,NaN,-4.961182632431782,-10.586936760489001
2008-03-28T09:30:00-04:00,132.99001,133.36,131.06,131.50999,180918688,277762124,46.160244826235775,45.118885678905905,NaN,NaN,-0.5478387613414147,38.140714367444744,0.3209401128214274,-0.6102157639222128,-0.9311558767436402,996187549,1316198611.4,28.22023885692171,23.32434071156505,NaN,NaN,-5.337900294239447,-9.837074408167636
2008-03-31T09:30:00-04:00,131.28999,132.73,131.09,131.97,166692128,273460974.4,47.29365346837621,46.31148312958213,NaN,NaN,3.520282608141772,28.67390721251573,0.2606715279790438,-0.6053164667698354,-0.8659879947488792,1162879677,1267525273.8,26.961073496388096,23.27939501280779,NaN,NaN,-5.316397656531756,-9.191263443648225
2008-04-01T09:30:00-04:00,133.71001,136.84,133.50999,136.61,254547248,276407655.2,57.10310438880836,47.15415963116182,NaN,NaN,165.82902935427694,49.80920957638782,0.5132405217199462,-0.22443734259894654,-0.7376778643188927,1417426925,1231171949,26.026994108197513,23.22505118244532,NaN,NaN,-2.0860768188491976,-8.17623678296265
2008-04-02T09:30:00-04:00,137.06,137.67,135.98,136.7,210910816,272827538.4,57.26922814238716,48.19625906144595,NaN,NaN,177.32141651912465,76.55107390593398,0.6571098157061862,0.08370940531384008,-0.5734004103923461,1628337741,1276387625.8,29.30756287154739,23.595599459157192,NaN,NaN,0.4993527582653428,-6.936866848501509
2008-04-03T09:30:00-04:00,135.94,137.44,135.71001,137.03999,175884752,268087708.8,57.932002997062156,49.226796542727534,NaN,NaN,152.89049152530973,99.80267624910233,0.7397624692139806,0.35130267612512966,-0.3884597930888509,1804222493,1401810877,37.57730715035844,24.58230468932615,NaN,NaN,2.789387392264464,-5.547401956963514
2008-04-04T09:30:00-04:00,137.12,137.96001,136.12,136.89,204473056,265915755.2,57.50822723781747,50.53246218504027,NaN,NaN,135.5068858951894,127.01362118040849,0.7467574825360958,0.5449870600812687,-0.201770422454827,1599749437,1522523254.6,44.32752914534746,26.119181228074513,NaN,NaN,4.545959410072934,-4.1054931902440215
2008-04-07T09:30:00-04:00,137.87,138.57001,136.74001,136.96001,154381312,257313092.8,57.663899371084185,52.02757093566466,NaN,NaN,128.67304222411414,152.044173103603,0.7183029372485056,0.696108249105805,-0.022194688142700564,1754130749,1640773469,50.028310740212135,28.172364033644993,NaN,NaN,6.04190581927516,-2.65586476031271
2008-04-08T09:30:00-04:00,136.19,137.1554,135.95,136.82001,148937248,252975786.4,57.212511710987464,52.50505459705965,NaN,NaN,95.04958896179716,137.888285025107,0.6540814244092272,0.7954070923688334,0.14132566795960624,1605193501,1678326784.2,51.71914066939949,30.45024898627018,NaN,NaN,7.1864801059958,-1.2498154936972086
2008-04-09T09:30:00-04:00,136.61,136.8,134.89,135.83,195610560,245662528.8,53.993773997111134,53.2119521194681,NaN,NaN,64.39928379641124,115.30385848056433,0.515072030758972,0.7851657064083213,0.2700936756493493,1409582941,1634575824.2,49.61296279203232,32.69878241851892,NaN,NaN,7.367550524990858,-0.018763205313199194
2008-04-10T09:30:00-04:00,135.39,136.67,134.89999,136.02,192967808,243852863.2,54.52257123683876,53.685388768971634,NaN,NaN,59.10099693070335,96.54595956164306,0.41060567255071856,0.7833507663377475,0.3727450937870289,1602550749,1594241475.4,47.68500413303316,34.937879103121745,NaN,NaN,7.653591663869344,1.0772874902843068
2008-04-11T09:30:00-04:00,134.45,135.9837,133.00999,133.38,222973312,237407455.2,46.52129324702908,53.21930056116161,NaN,NaN,4.284735698158485,70.30152952223686,0.1517266768787202,0.5624034398854292,0.41067676300670897,1379577437,1550207075.4,45.601550313669556,36.99189539004667,NaN,NaN,5.694989294295063,1.7369591765715575
2008-04-14T09:30:00-04:00,133.19,133.53999,132.55,132.92999,160521936,221199158.4,45.30091919129196,52.64854738996736,NaN,NaN,-37.73253192726577,37.02041469196089,-0.050950073958964004,0.34698917055800393,0.39793924451696794,1219055501,1443192025.8,40.92207502155063,38.12011737541282,NaN,NaN,3.706805375677073,2.018365776443774
2008-04-15T09:30:00-04:00,133.58,133.69,132.33,133.24001,172389120,209553065.6,46.34516391644017,52.40571956107976,NaN,NaN,-50.36911600494793,7.936673698611878,-0.15915623181053207,0.19899395475380288,0.35815018656433495,1391444621,1400442249.8,39.191909534295135,39.03213907760216,NaN,NaN,2.297985931582983,2.0583115128922325
2008-04-16T09:30:00-04:00,134.53999,136.92999,134.39999,136.85001,189268816,202295687.2,56.70902922119956,52.96683021090498,NaN,NaN,58.325967981278765,6.722010535585395,0.008482056910153024,0.3687527577020262,0.3602707007918732,1580713437,1434668349,41.330609291304405,39.893733437446926,NaN,NaN,4.019683675917301,2.338507536181528
2008-04-17T09:30:00-04:00,136.02,137.25,135.66,137.05,179707504,193982489.6,57.202225549842304,53.755543119734014,NaN,NaN,74.37143630194772,9.776098409834269,0.12258822052516444,0.5135059764483287,0.3909177559231643,1760420941,1466242387.4,43.31141325319479,40.971674465752145,NaN,NaN,5.559973119985067,2.798716905296319
2008-04-18T09:30:00-04:00,138.94,139.56,138.25999,138.48,218530560,192642986.4,60.65394979075982,54.70984999990427,NaN,NaN,146.25252997396052,38.16965726499468,0.2753768128860924,0.7351387720307798,0.4597619591446874,1978951501,1586117200.2,50.18763080825602,42.63071427374272,NaN,NaN,7.924940390841527,3.5310345460884913
2008-04-21T09:30:00-04:00,138.23,138.98,136.87,138.55,118587376,188116836.8,60.82052875730416,54.97538031193968,NaN,NaN,107.70379809407682,67.2569232692632,0.3569817094474488,0.9059890959539985,0.5490073865065497,2097538877,1761813875.4,58.19210122887399,44.9282219252196,NaN,NaN,9.899793841686618,4.4408573026025095
2008-04-22T09:30:00-04:00,138.19,138.37,136.64,137.94,162166064,186577780.8,58.4963770700503,55.063033806772765,NaN,NaN,81.37020396788185,93.60478726382915,0.34548253609371726,0.9808605566236963,0.635378020529979,1935372813,1870599513.8,62.23823633636992,47.280412886992636,NaN,NaN,10.943921883667645,5.3698665284689575
2008-04-23T09:30:00-04:00,138.09,138.78,137.12,137.72,193309008,186396521.6,57.64087246302831,55.04223876862749,NaN,NaN,84.1788769778997,98.77536906315333,0.3003318054166739,1.0107927773008214,0.7104609718841475,1742063805,1902869587.4,63.37069862757094,49.12279799250781,NaN,NaN,11.592518578153529,6.258816821281039
2008-04-24T09:30:00-04:00,138.08,139.74001,137.03999,138.32001,229381376,186607934.4,59.385470197902094,55.17632755149068,NaN,NaN,97.47120286815807,103.39532237639541,0.28810241203025144,1.0705889869219618,0.7824865748917104,1971445181,1945074435.4,64.8551967880627,50.58905996698748,NaN,NaN,12.614258978589174,7.166737129467915
2008-04-25T09:30:00-04:00,139.41,139.89,137.91,139.60001,190788064,187101403.2,62.896240223746155,55.55006618382368,NaN,NaN,123.3675148861347,98.81831935883024,0.339887289619909,1.2073456869165966,0.8674583972966876,2162233245,1981730784.2,66.13878327092038,51.73980800489521,NaN,NaN,14.49782588369819,8.214035522929382
2008-04-28T09:30:00-04:00,139.88,140.25,139.38,139.63,105616496,184047621.6,62.97699046906245,55.96181466654332,NaN,NaN,148.2557682099766,106.92871338201022,0.34853303340729513,1.3031246890558066,0.9545916556485115,2267849741,2015792957,67.33272930486996,52.85506433600024,NaN,NaN,16.086299784207235,9.338644703111932
2008-04-29T09:30:00-04:00,139.39,139.73,138.61,139.08,125514064,177595962.4,60.38160716605258,56.41808846432485,NaN,NaN,104.9690084041174,111.6484742692573,0.2918787955738158,1.3194401501157813,1.0275613545419655,2142335677,2057185529.8,68.77364378020934,54.22368440658432,NaN,NaN,16.789879115015385,10.403106761955282
2008-04-30T09:30:00-04:00,139.28999,140.59,138.25999,138.25999,208395808,177470212,56.63413012881673,56.568914099466134,NaN,NaN,89.07914573907016,112.62852802149139,0.17936904487167493,1.2517726606315591,1.0724036157598842,1933939869,2095560742.6,70.09081720216071,55.82409962580771,NaN,NaN,16.41462737906521,11.261895421542414
2008-05-01T09:30:00-04:00,138.39,141.12,138.27,141.12,187279504,178039949.6,64.83221506110318,57.876837086185695,NaN,NaN,121.28165742006027,117.39061893187184,0.27218954871628775,1.4126405516552438,1.140451002938956,2121219373,2125515581,71.11503965576942,57.646491721671985,NaN,NaN,18.520199743435196,12.298796038955668
2008-05-02T09:30:00-04:00,142.33,142.37,140.56,141.50999,181585504,176895572,65.78213682765791,59.33978120306898,NaN,NaN,150.69437509586564,122.85599097381801,0.33058999298987457,1.5536884941762992,1.2230985011864246,2302804877,2153629907.4,72.08137777714143,59.87215620421419,NaN,NaN,20.530903109500347,13.474811334747764
2008-05-05T09:30:00-04:00,141.05,141.61,140.41,140.83,118510368,175102024.8,62.60674246225035,60.501322527769716,NaN,NaN,115.49236249472243,116.30330983076719,0.2953180575636023,1.5922460731409274,1.296928015577325,2184294509,2136918861,70.5701190125555,62.113456881232786,NaN,NaN,21.31152192704522,14.594341419361687
2008-05-06T09:30:00-04:00,140.00999,142.2,139.69,142.05,179339808,176622152.8,65.79679935985448,61.150448966245065,NaN,NaN,114.8577754376242,118.28106323746854,0.32376293590320726,1.7016316854563343,1.377868749553127,2363634317,2181178589,72.23073753446533,64.32060889860144,NaN,NaN,22.938155305421088,15.786314831655886
2008-05-07T09:30:00-04:00,141.89,142.03999,139.13,139.52,199267248,176804987.2,55.2670754079958,61.012223956113175,NaN,NaN,73.01966000104892,115.0691660898643,0.1505989906482934,1.5661174878634938,1.4155184972152004,2164367069,2227264029,73.88323368284449,66.50431035786212,NaN,NaN,21.02294877643613,16.534405395195922
2008-05-08T09:30:00-04:00,139.74001,140.32001,138.98,139.16,178321184,176072656,53.94418604295458,60.532955116984226,NaN,NaN,44.00692184541273,99.6142189749348,-0.001710834351977386,1.4133799542752286,1.415090788627206,1986045885,2200229331.4,71.20630368809321,68.00564413499335,NaN,NaN,19.07268788831801,16.897017179927648
2008-05-09T09:30:00-04:00,138.60001,139.39,138.45,138.89999,152589632,172553472,52.95821844644957,59.97136152335175,NaN,NaN,17.927928801144937,73.06092971599064,-0.12658034053884704,1.256865362953647,1.383445703492494,1833456253,2106359606.6,62.710230794616095,68.3283676754035,NaN,NaN,17.194944821266123,16.93957827154743
2008-05-12T09:30:00-04:00,139.25,140.56,138.73,140.46001,150911440,172072947.2,57.92696288086894,59.93068908126737,NaN,NaN,53.457339195313324,60.653925056108825,-0.1112663557706779,1.2443627587791468,1.3556291145498247,1984367693,2066374243.4,59.455948073310445,68.12963279947068,NaN,NaN,17.037129859426837,16.95351421267306
2008-05-13T09:30:00-04:00,140.8,140.89,139.73,140.48,159141872,171410584.8,57.98819813416094,59.95549805777684,NaN,NaN,71.6358967328735,52.00954931515869,-0.10691837734156917,1.2219811428728633,1.3288995202144325,2143509565,2022349293,56.00957960881039,67.60383858384493,NaN,NaN,16.928005828843837,16.949870157840312
2008-05-14T09:30:00-04:00,141.07001,142.2,140.46201,140.77,181910752,171042681.6,58.9222567238669,59.922411381060044,NaN,NaN,108.47118298648532,59.099853912245976,-0.0921965114361436,1.213653880919253,1.3058503923553966,2325420317,2054559942.6,57.93096396855343,67.10925052530855,NaN,NaN,17.09704325085531,16.970894885413884
2008-05-15T09:30:00-04:00,141.03999,142.63,140.83,142.53,166927008,170403656.8,64.13402192676628,60.0108243598472,NaN,NaN,147.65029175335403,79.82852789383423,0.02227786193728809,1.3336977197770068,1.3114198578397187,2492347325,2155820230.6,63.350352620057926,66.91007690738981,NaN,NaN,18.80639970105499,17.233109859076897
2008-05-16T09:30:00-04:00,142.86,142.87,141.61,142.66,204236816,169688969.6,64.4923783694551,60.11906635273238,NaN,NaN,148.9002997833398,106.0230020902732,0.08920067087583838,1.4229206964345167,1.3337200255586783,2696584141,2328445808.2,70.36026674336725,67.12632958156821,NaN,NaN,20.302945186266342,17.671657762961104
2008-05-19T09:30:00-04:00,142.81,144.3,142.3,143.05,165704064,172044804,65.60273474788019,60.49200403714864,NaN,NaN,171.87348381069032,129.7062310133486,0.13920016244442057,1.507720228614204,1.3685200661697834,2862288205,2504029910.6,75.49445699500016,67.606387668339,NaN,NaN,21.873383077575895,18.271904236477504
2008-05-20T09:30:00-04:00,142.27,142.34,141,141.89,178552000,172864100.8,59.629869300958134,60.70598540658731,NaN,NaN,81.08449362367881,131.59595039150966,0.07673674633152472,1.4644409990841893,1.3877042527526646,2683736205,2612075238.6,78.01778966064364,68.17259998680206,NaN,NaN,21.560163233628277,18.741655521784757
2008-05-21T09:30:00-04:00,141.81,142.12,139,139.49001,252724816,175834891.2,49.57339831437273,59.616069924677994,NaN,NaN,-15.258137184088493,106.85008635739489,-0.13224996958343405,1.2223917907733721,1.3546417603568062,2431011389,2633193453,78.48413209424609,68.69896373240753,NaN,NaN,18.03646997800508,18.64091472981623
2008-05-22T09:30:00-04:00,139.42999,140.17,139,139.50999,170820320,172906838.4,49.64952834872392,58.46374074761127,NaN,NaN,-62.05610022249483,64.90880796222511,-0.26738096586291826,1.0204155530281582,1.2877965188910765,2601831709,2655090329.8,78.98202295282456,69.19186695924205,NaN,NaN,15.265484438649768,18.158710402506735
2008-05-23T09:30:00-04:00,139.05,139.6631,137.52,137.64,181436192,172439244.8,43.09224529204802,57.06984809259682,NaN,NaN,-138.82359316746033,7.364029372065085,-0.46914089255822544,0.7013704031932946,1.17051129575152,2420395517,2599852605,74.31044666319528,69.45903322000204,NaN,NaN,10.648934443000867,17.085885265434467
2008-05-27T09:30:00-04:00,137.8,139,137.53,138.66,168322816,175574560.8,47.18933971029235,55.74074383191381,NaN,NaN,-120.54587048942567,-51.11984148795811,-0.5165842760234991,0.5247809507221461,1.0413652267456452,2588718333,2545138630.6,69.9002201071689,69.29256768948086,NaN,NaN,8.05071989312642,15.795147355104746
2008-05-28T09:30:00-04:00,139.17,140,138,139.3,181288064,178363260.8,49.63930925326134,55.33876053514707,NaN,NaN,-77.9047050680398,-82.91768122630182,-0.4878912914340774,0.43150111245304856,0.919392403887126,2770006397,2562392669,70.49490274544812,69.0505440510954,NaN,NaN,6.662064247217743,14.490421196835173
2008-05-29T09:30:00-04:00,139.13,140.92999,139.08,140,173927184,176639829.6,52.24863117413252,55.21764947308835,NaN,NaN,-27.38299288125446,-85.34265236573502,-0.40804057724711473,0.40934168232823254,0.8173822595753473,2943933581,2664977107.4,73.80821553083717,69.2363948970057,NaN,NaN,6.292755610769449,13.319326113111499
2008-05-30T09:30:00-04:00,140.47,140.74001,139.94,140.35001,117361936,173143951.2,53.544729860169504,55.25954314549692,NaN,NaN,-6.755331153345225,-74.28249855190509,-0.3217166327689547,0.41523646861415386,0.7369531013831085,3061295517,2756869869,76.36824977696264,70.21196768145902,NaN,NaN,6.36847192559239,12.326346943465913
2008-06-02T09:30:00-04:00,139.83,139.86,138,138.89999,181069872,173118169.6,47.76104895085604,54.533406436210285,NaN,NaN,-88.6712141058478,-64.2520227395826,-0.3500010888837102,0.2994517402784709,0.6494528291621811,2880225645,2848835894.6,78.62046429980208,71.58086169763699,NaN,NaN,4.676690100971656,11.23353882310959
2008-06-03T09:30:00-04:00,139.3,139.62,137.23,138.09,272049920,180795147.2,44.84690867644407,53.59474290351623,NaN,NaN,-113.52972399549886,-62.84879344079722,-0.40699420957632404,0.14071006719177603,0.5477042767681001,2608175725,2852727373,78.71291325045338,73.20252838632577,NaN,NaN,2.3632659933234215,9.966356990282994
2008-06-04T09:30:00-04:00,137.7,139.16,137.46001,138.02,246726368,184164475.2,44.59367994732935,52.57127313376355,NaN,NaN,-107.54400850761573,-68.77665412871242,-0.43084163630518235,0.009152231386622134,0.4399938676918045,2361449357,2771015965,71.701806678447,74.18616000846103,NaN,NaN,0.4190591860185634,8.602457303959504
2008-06-05T09:30:00-04:00,138.58,140.89,138.32001,140.78,237867008,186094463.2,55.30882315164291,51.9409017926833,NaN,NaN,-1.6519236346652115,-63.63044027939458,-0.2510778988377925,0.1261464941445638,0.3772243929823563,2599316365,2702092521.8,66.33458476765422,74.39931944757505,NaN,NaN,2.0193859454999816,7.662018538465286
2008-06-06T09:30:00-04:00,139.55,139.8,136.22,136.28999,384276224,196392215.2,41.31179952040603,50.28514616060837,NaN,NaN,-136.08710285994826,-89.49679462071518,-0.4152245839548871,-0.14180633696125255,0.27341824699363454,2215040141,2532841446.6,55.3731408657336,73.32881045631551,NaN,NaN,-1.7812285043400027,6.31298324663596
2008-06-09T09:30:00-04:00,136.86,137.5,135.41,136.62,228263872,200175927.2,42.464305306716334,48.63240120052524,NaN,NaN,-162.6591680019961,-104.29438539994484,-0.4777740220499756,-0.323799280568835,0.1539747414811406,2443304013,2445457120.2,50.713640715568005,71.55875215064178,NaN,NaN,-4.211829053943207,4.809438632267508
2008-06-10T09:30:00-04:00,135.67,137.10001,135.35001,135.94,260234816,205642096,40.69110303151243,47.27963218127912,NaN,NaN,-152.03897069025462,-111.99623473889599,-0.536732864066884,-0.5169413386024644,0.019791525464419618,2183069197,2360435814.6,46.60453546297479,69.31494827937972,NaN,NaN,-6.723646303543597,3.161855070008779
2008-06-11T09:30:00-04:00,135.97,136.2592,133.92999,133.94,284064256,211888215.2,35.93783859032061,46.30566362956112,NaN,NaN,-178.1148603149669,-126.11040510036624,-0.6733664635722274,-0.8219165540008646,-0.14855009042863723,1899004941,2267946931.4,42.56423420031852,66.74924128695632,NaN,NaN,-10.522742145372437,1.2069126106686054
2008-06-12T09:30:00-04:00,134.60001,135.87,133.52,134.45,252791744,215432264.8,37.92899845846581,45.46848292311411,NaN,NaN,-158.07689726915862,-157.39539982726492,-0.6898054626379732,-1.0108069187261037,-0.3210014560881306,2151796685,2178442995.4,39.0372608021667,63.896043990480756,NaN,NaN,-12.854565245254232,-0.801869940177514
2008-06-13T09:30:00-04:00,135.17,136.52,134.418,136.14999,244727056,219322267.2,44.15939297763021,45.544707757798555,NaN,NaN,-107.31765712087088,-151.64151067944942,-0.5525324672603198,-1.0116670401635304,-0.4591345729032106,2396523741,2214739715.4,41.16634634003493,61.52860825311216,NaN,NaN,-12.754171684659168,-2.509341617960607
2008-06-16T09:30:00-04:00,135.55,136.92999,135.46001,136.23,185833376,218402095.2,44.442047289960236,45.34847258491768,NaN,NaN,-81.87969736616225,-135.48561655228266,-0.428235854684919,-0.9944293912593594,-0.5661935365744404,2582357117,2242550336.2,42.81429656713526,59.59389942882404,NaN,NaN,-12.587405654756854,-3.949065051788642
2008-06-17T09:30:00-04:00,137.07001,137.12,135.37,135.57001,191743808,219704082.4,42.529662884962605,44.840640701467784,NaN,NaN,-79.18674286538487,-120.91517098730871,-0.3648374563663124,-1.0222403570323308,-0.6574029006660185,2390613309,2284059158.6,45.27803374753794,57.792694500401886,NaN,NaN,-13.024694563943184,-5.245583553525005
2008-06-18T09:30:00-04:00,134.69,135.5235,133.71001,134.25,266970560,224125010.4,38.9221909229113,43.888752112094835,NaN,NaN,-123.32071232539958,-109.95634138939525,-0.3842217238610225,-1.1376800554922966,-0.7534583316312741,2123642749,2328986720.2,47.89468621009923,55.94172812034918,NaN,NaN,-14.504466894633678,-6.568281173683387
2008-06-19T09:30:00-04:00,134.14999,135.24001,132,134.42,304310784,226704308.8,39.632375916042044,42.89501254465716,NaN,NaN,-129.35402463469381,-104.21176686250229,-0.35851173089396693,-1.2015979952487328,-0.8430862643547659,2427953533,2384218089.8,50.996858546783706,54.12948588962212,NaN,NaN,-15.492438797552571,-7.843160834236127
2008-06-20T09:30:00-04:00,132.84,133.09,131.22,131.58,289275648,232627075.2,32.77595465324215,41.82464866625617,NaN,NaN,-171.89894136301317,-117.12802371093073,-0.4971593367425735,-1.4645354352829827,-0.9673760985404092,2138677885,2332648918.6,48.116372312956344,51.95062217627599,NaN,NaN,-18.641015437039368,-9.385711491779448
2008-06-23T09:30:00-04:00,132.09,132.23,131.32001,131.45,165115680,231811049.6,32.49879858839866,40.94264080282436,NaN,NaN,-157.26698406438595,-132.20548105057546,-0.5574759691508606,-1.6642210599789848,-1.1067450908281242,1973562205,2210889936.2,42.07370506195296,49.3335358770974,NaN,NaN,-21.217353410178426,-11.07594605155073
2008-06-24T09:30:00-04:00,131.05,132.44,130.19,131.19,267300624,236759940,31.91748249769448,40.03719812785043,NaN,NaN,-149.10043792833397,-146.1882200631653,-0.5725600631873047,-1.822445169812255,-1.2498851066249503,1706261581,2074019590.6,36.52136739405497,46.820647356783674,NaN,NaN,-23.48495075095911,-12.84866100860907
2008-06-25T09:30:00-04:00,131.72,133.39999,131.239,131.81,287853824,242088228,34.90753478241761,38.57996324433434,NaN,NaN,-110.01064680660853,-143.5262069594071,-0.5010380209769729,-1.8761826328461666,-1.3751446118691937,1994115405,2048114121.8,35.564721312016076,44.62279996709524,NaN,NaN,-24.546497053212597,-14.519780443552431
2008-06-26T09:30:00-04:00,130.57001,131.42,128.08,128.23,297775104,248280624,27.419352719551526,37.58764561570188,NaN,NaN,-167.21482772458197,-151.09836757738472,-0.645874455078884,-2.1824876807177986,-1.5366132256389147,1696340301,1901791475.4,30.676849594303476,42.858779161993084,NaN,NaN,-28.076008439460807,-16.456384442967913
2008-06-27T09:30:00-04:00,128.28,128.86,127.035,127.53,303423232,257583688.8,26.23432944469279,36.428361625557336,NaN,NaN,-179.5787395213049,-152.63432720904308,-0.7334606750416257,-2.4534390694409467,-1.719978394399321,1392917069,1752639312.2,26.655354487620045,41.14033014571108,NaN,NaN,-31.304339711988455,-18.577520909970847
2008-06-30T09:30:00-04:00,127.89,128.91,127.3,127.98,258888192,261474604.8,28.377315926178156,35.54880540374775,NaN,NaN,-148.15114373596666,-150.81115914335922,-0.7055101368905174,-2.6018660655124677,-1.8963559286219502,1651805261,1688287923.4,25.124987153919918,39.60607669506431,NaN,NaN,-33.25605659394682,-20.67445457911027
2008-07-01T09:30:00-04:00,126.52,128.47,125.92999,128.38,388621824,267303200,30.315232830222314,35.147190706597875,NaN,NaN,-136.669932383957,-148.32505803448382,-0.6081914933474257,-2.656595295306232,-2.0484038019588064,2040427085,1755121024.2,29.642896836234314,38.683124026201156,NaN,NaN,-34.281433057062465,-22.618308647389156
2008-07-02T09:30:00-04:00,128.78999,129.16,125.95,126.17999,291223296,269528046.4,26.127892282442176,34.30425455116761,NaN,NaN,-128.48895739527524,-152.02072015221717,-0.63703624199889,-2.844699104457419,-2.207662862458529,1749203789,1706138701,28.295337299492715,37.915843776010156,NaN,NaN,-36.52863693841123,-24.605498403249452
2008-07-03T09:30:00-04:00,127.11,127.11,124.99001,126.31,239359632,269602677.6,26.771607332338675,33.062269862218216,NaN,NaN,-133.91487394339023,-145.3607293959788,-0.5932973037956839,-2.949284492203134,-2.35598718840745,1988563421,1764583325,32.25272864777844,37.27915679799183,NaN,NaN,-38.13100840246759,-26.537714117423473
2008-07-07T09:30:00-04:00,126.78999,127.34,123.92,125.02,372427264,269010229.6,24.491159438596142,31.637206444263636,NaN,NaN,-132.6598714012046,-135.97695577195876,-0.5956266604981044,-3.10052051403008,-2.504893853531976,1616136157,1809227142.6,35.194927638228435,36.73491616021277,NaN,NaN,-40.2079164312177,-28.49060016225122
2008-07-08T09:30:00-04:00,124.99001,127.39,124.2,127.24001,376225280,276408300,34.786344459489015,31.084112271015528,NaN,NaN,-101.98302221304746,-126.74333146737493,-0.40135043140996274,-3.0065818927944292,-2.6052314613844665,1992361437,1877338377.8,39.511093100763475,36.32299182830031,NaN,NaN,-38.755525307698086,-29.9570180401722
2008-07-09T09:30:00-04:00,127.5,127.74001,124.39,124.78999,336789760,280236047.2,29.93545286732632,30.44220240990231,NaN,NaN,-101.44279073644095,-119.6979031378717,-0.39114555672689155,-3.094163407293081,-2.7030178505661895,1655571677,1800367296.2,36.548625239450544,35.5125589018254,NaN,NaN,-39.09707277604311,-31.26274014529662
2008-07-10T09:30:00-04:00,124.42999,125.78999,123.58,125.3,436475648,287856616.8,32.05936299505977,29.901272915546436,NaN,NaN,-103.48875270097305,-114.69786219901127,-0.3070542980492017,-3.0868357231276917,-2.77978142507849,2092047325,1868936003.4,40.80648897555975,34.78467536102369,NaN,NaN,-38.6768930720622,-32.32190484912027
2008-07-11T09:30:00-04:00,123.97,125.89999,122.49001,123.84,481124608,299273260,29.319359350119754,29.654373251037693,NaN,NaN,-107.61905906119485,-109.4386992225722,-0.30608228507641666,-3.1623842814240106,-2.856301996347594,1610922717,1793407862.6,37.79775208513243,34.04763105903626,NaN,NaN,-39.20330636647381,-33.304962208742204
2008-07-14T09:30:00-04:00,125.25999,125.5,122.39999,122.72,322720768,303172945.6,27.385741667245128,29.28915489952673,NaN,NaN,-109.31660915027717,-104.77004677238672,-0.33486313041052185,-3.2748809093607463,-2.9400177789502244,1288201949,1727821021,35.35963077816683,33.568054324480116,NaN,NaN,-40.25499755516335,-34.29782440108808
2008-07-15T09:30:00-04:00,121.8,123.49001,120.02,120.99001,502502400,319006396.8,24.678398213777356,28.77207745067551,NaN,NaN,-139.30639315730429,-112.23472096123808,-0.4189486673943037,-3.463703613193104,-3.0447549457988003,785699549,1486488643.4,28.161381913146116,32.97091250441519,NaN,NaN,-42.03553186985715,-35.403211182340804
2008-07-16T09:30:00-04:00,121.45,124.57001,121.10001,123.96001,371642880,328001350.4,36.31788576499756,28.872816806574075,NaN,NaN,-100.66004640577451,-112.07817209510479,-0.2323929603567536,-3.3352461462447422,-3.1028531858879886,1157342429,1386842793.8,25.823796281563503,32.275132145097146,NaN,NaN,-39.55523050494472,-35.99635679985565
2008-07-17T09:30:00-04:00,125.14,126.25999,124.09,125.2,375490560,333427350.4,40.45507585920046,29.803939887977574,NaN,NaN,-51.75629079484949,-101.73167971388008,0.004140350793290892,-3.097677747396375,-3.101818098189666,1532832989,1274999926.6,23.469056315657696,31.760289768051024,NaN,NaN,-36.13715152519493,-36.01647033204697
2008-07-18T09:30:00-04:00,126.17,126.41589,125.14999,125.98,267030000,331563311.2,42.965165833826255,30.998999630058535,NaN,NaN,-29.414132231650118,-86.09069434797114,0.23023426507426015,-2.8140252668468406,-3.0442595319211008,1799862989,1312787981,25.926681192760554,31.708241675561062,NaN,NaN,-32.580979922096354,-35.52568598776831
2008-07-21T09:30:00-04:00,126.50999,126.8,125.19,126.05,222863008,328242679.2,43.19658913163206,32.05751914473381,NaN,NaN,-18.879674741645896,-68.00330746624488,0.39209745928107065,-2.5541377078197627,-2.9462351671008333,2022725997,1459692790.6,34.705236421349525,32.39254519466318,NaN,NaN,-29.714343668030907,-34.695494227805824
2008-07-22T09:30:00-04:00,125.14999,127.8,124.85001,127.48,296904192,334832104.8,47.85169706949112,33.310123733253015,NaN,NaN,11.520014304398035,-37.83802597390441,0.5911152997638363,-2.2073410423960382,-2.7984563421598745,2319630189,1766478918.6,48.44592828466938,33.735618869551395,NaN,NaN,-25.808875278387376,-33.42597723503176
2008-07-23T09:30:00-04:00,127.89,129.14999,127.55,128.17,311698432,337051995.2,49.98170848452073,35.0139677476872,NaN,NaN,80.03987989440928,-1.6980407138676525,0.7544157661041999,-1.8554366345296245,-2.6098524006338244,2631328621,2061276157,57.665261368133486,35.83347058874002,NaN,NaN,-21.93816715911078,-31.78486150990019
2008-07-24T09:30:00-04:00,128.34,128.41,125.16,125.50999,248634496,335091028.8,42.73494963391856,36.15420648351433,NaN,NaN,19.476895387627582,12.548596522627758,0.671259515906443,-1.7707780057507705,-2.4420375216572134,2382694125,2231248384.2,61.896264317400814,37.950865993713045,NaN,NaN,-20.712670399498084,-30.203119922699887
2008-07-25T09:30:00-04:00,125.89,126.49001,125.17,125.48,219131008,331158824,42.659851364320126,37.45197019249462,NaN,NaN,-2.904934625437794,17.850436043870225,0.6042999544623404,-1.6866625785792877,-2.290962533041628,2163563117,2303988409.8,63.57405375261135,39.977946430454686,NaN,NaN,-19.76924326054892,-28.71256611382118
2008-07-28T09:30:00-04:00,125.50999,126.06,123.42,123.64,205202880,326247806.4,38.22187703936858,37.697365376771735,NaN,NaN,-64.86901522751592,8.652567946696237,0.4341143630832045,-1.7483195791876227,-2.182433942270827,1958360237,2291115257.8,63.044979607235064,41.65893832377408,NaN,NaN,-20.31946550127115,-27.513551740599745
2008-07-29T09:30:00-04:00,123.98,126.38,123.64,126.28,261505568,326378675.2,46.7771583292794,38.90034433833981,NaN,NaN,-1.8612024094251867,5.976324603931593,0.49306380533713057,-1.5661041855994142,-2.059167990936545,2219865805,2271162381,62.18120373941577,43.48983678805731,NaN,NaN,-17.994452385911135,-26.153680404215656
2008-07-30T09:30:00-04:00,127.11,128.60001,126.28,128.53,354710016,324683084.8,52.779165586050745,40.380330237696306,NaN,NaN,133.15758558434723,16.599865741919185,0.6665277393788878,-1.2260083167129352,-1.892536056091823,2574575821,2259811821,61.663625434372186,44.979632249401064,NaN,NaN,-13.957906183982278,-24.411426944182317
2008-07-31T09:30:00-04:00,127.39999,128.57001,126.63,126.83,277402112,323992025.6,48.343230215669415,41.73917815666414,NaN,NaN,105.13050178392764,33.730587021179204,0.6490749486783405,-1.0811923702438975,-1.730267318922238,2297173709,2242707737.8,60.84178765806058,46.625634790324504,NaN,NaN,-12.103343020948628,-22.65312924086322
2008-08-01T09:30:00-04:00,127.12,127.28,125.46001,126.16,248703568,324459222.4,46.67810657770208,43.11720422169678,NaN,NaN,45.25182333947673,43.3619386141621,0.5771269783385893,-1.0088585959990013,-1.5859855743375906,2048470141,2219689142.6,59.68882882431884,48.36343465076393,NaN,NaN,-11.162850933640225,-21.011660911259934
2008-08-04T09:30:00-04:00,126.03999,126.14,124.75999,124.99001,188251744,315250446.4,43.83849777188578,44.485782761561666,NaN,NaN,-10.829673447437347,54.16980697017782,0.4415705337850502,-1.0340224071062778,-1.475592940891328,1860218397,2200060774.6,58.667883890524195,50.54247050629094,NaN,NaN,-11.284479645105623,-19.622063587523606
2008-08-05T09:30:00-04:00,126.02,128.56,124.9736,128.36,251624320,309020398.4,52.7539250745763,45.659785569388724,NaN,NaN,94.69799305290884,73.48164606264461,0.561976111527005,-0.7731228014825717,-1.3350989130095767,2111842717,2178456157,57.502042137712806,52.80520235315874,NaN,NaN,-8.358022382310208,-18.012914843921692
2008-08-06T09:30:00-04:00,128.02,129.3,127.48,128.92999,209555376,302658679.2,54.08166462000771,46.633113338017814,NaN,NaN,140.40746124074593,74.93162119392434,0.6565315507656486,-0.514434474552516,-1.1709660253181646,2321398093,2127820611.4,54.75565502078261,55.039959403524804,NaN,NaN,-5.621042962457033,-16.242647432283885
2008-08-07T09:30:00-04:00,127.96001,129.0549,126.53999,127.00999,246312432,293150518.4,49.07837120143894,47.06977086427586,NaN,NaN,81.36419021636377,70.17835888041158,0.5695261586842657,-0.45905832696283255,-1.0285844856470983,2075085661,2083403001.8,52.39177219291063,56.93032304639267,NaN,NaN,-4.930299817837528,-14.626597773077263
2008-08-08T09:30:00-04:00,126.58,129.92999,126.38,129.37,260811632,282134869.6,54.63400556246671,47.88672918076405,NaN,NaN,117.05703928479315,84.53940206947485,0.6451250953690847,-0.22217811643574237,-0.8673032118048271,2335897293,2140888432.2,55.09380438588488,58.386649329573764,NaN,NaN,-2.48186298485109,-12.891635660473524
2008-08-11T09:30:00-04:00,129.47,131.50999,129.23,130.71001,249425808,278470121.6,57.471226194848526,48.57383840400387,NaN,NaN,181.00601897292958,122.90654055354825,0.7521138662911564,0.07283912105911838,-0.679274745232038,2585323101,2285909373,61.09301005128816,59.290012312903684,NaN,NaN,0.44880815686160214,-10.985857972282792
2008-08-12T09:30:00-04:00,130.28011,130.7028,128.73,129.35001,213200816,264005042.4,53.79406562107339,48.84614962804334,NaN,NaN,130.33448888472083,130.03383971991065,0.6991460989060917,0.19465787840057658,-0.5044882205055151,2372122285,2337965286.6,63.003614652372875,59.67132326177792,NaN,NaN,1.6823291779714156,-9.176116950817905
2008-08-13T09:30:00-04:00,128.78999,129.64999,127.67,128.57001,256467184,258246257.6,51.7490125780925,49.49001126691291,NaN,NaN,77.54615099124017,117.4615776700095,0.5841180797067584,0.22565937912793288,-0.3584587005788255,2115655101,2296816688.2,60.47552488793052,59.56984187395862,NaN,NaN,2.0476059885325872,-7.572727959482121
2008-08-14T09:30:00-04:00,127.84,130.28,127.75,129.53999,239556064,251449532.8,54.08657265819551,50.306205645046866,NaN,NaN,95.96560230671504,120.38186008807975,0.5465701678873556,0.3247540092803689,-0.2218161586069866,2355211165,2352841789,62.671750400329636,59.50539163450993,NaN,NaN,3.0560049859622778,-6.05433753870435
2008-08-15T09:30:00-04:00,129.92999,130.5,129.3,130.17,181005376,247148301.6,55.59142122113369,51.5468873723158,NaN,NaN,120.63415071382812,121.09728237388674,0.5366117747766701,0.44894855986385096,-0.08766321491281909,2536216541,2392905638.6,64.20356198027555,59.58814751829852,NaN,NaN,4.3276704759905975,-4.571193536605072
2008-08-18T09:30:00-04:00,130.42999,130.48,127.66,128.39,172275056,244618904,50.5502269169815,51.81639227143738,NaN,NaN,59.31691091931092,96.75946076316302,0.38944373815979527,0.399141457786925,0.00969771962712973,2363941485,2348629315.4,61.21390499095673,59.51905475055145,NaN,NaN,3.9230053943520256,-3.3577365464683444
2008-08-19T09:30:00-04:00,127.42,128.1181,126.53,126.99001,194673632,239507376,46.944444792038865,51.399626500436526,NaN,NaN,-21.080678466808184,66.47642729285721,0.18735387622059302,0.24389006490287102,0.05653618868227799,2169267853,2308058429,58.52466946007267,59.294843609530055,NaN,NaN,2.4829711444450253,-2.5233497334807202
2008-08-20T09:30:00-04:00,127.39,127.95,126.34,127.58,225498128,235197360.8,48.608144983260495,51.41854898383589,NaN,NaN,-15.035945095483179,47.96000807551253,0.08800281994463872,0.1665397136130764,0.07853689366843768,2394765981,2363880605,61.05954546690399,59.31039773873315,NaN,NaN,1.7757785280960008,-1.9091885532554744
2008-08-21T09:30:00-04:00,126.75,128.44,126.60001,127.8,180609808,231796126.4,49.24724167117693,51.602058633369815,NaN,NaN,-2.1030815618859644,28.346271301792335,0.034442129553068634,0.12158955560977347,0.08714742605670484,2575375789,2407913529.8,62.981491702278674,59.54558794430171,NaN,NaN,1.37209947107034,-1.4404331212089296
2008-08-22T09:30:00-04:00,128.67,129.64999,127.8,129.64999,167715248,229225338.4,54.38433724137193,52.35533288119025,NaN,NaN,64.63938280984404,17.147317720995517,0.11633334655223107,0.23256410924699367,0.1162307626947626,2743091037,2449288429,64.74240124718051,59.979482041205735,NaN,NaN,2.4960755323838497,-0.8780747421242469
2008-08-25T09:30:00-04:00,128.8,129.64999,126.75,127.02,171936880,227562038.4,47.08752373231655,51.95058992817169,NaN,NaN,-11.219700937643998,3.039995349604533,-0.007336682728015617,0.10705990928474307,0.11439659201275869,2571154157,2490730963.4,66.46321399295151,60.61956574515135,NaN,NaN,1.2518987726821005,-0.5737928114376258
2008-08-26T09:30:00-04:00,127.02,127.87,126.58,127.39,159117184,222442619.2,48.14169228644627,51.52630619006016,NaN,NaN,-52.830351245151995,-3.309939206064236,-0.0618964564428372,0.03702602145921219,0.09892247790204939,2730271341,2602931661,70.64108324573323,61.754239189790674,NaN,NaN,0.5554316459700113,-0.4124750318079634
2008-08-27T09:30:00-04:00,127.55,128.83,127.3,128.63,171032752,213258756,51.620407083892566,51.70788018166399,NaN,NaN,9.728124916535485,1.642874796339497,-0.014616705297543525,0.08065159628011997,0.0952683015776635,2901304093,2704239283.4,73.81318645941205,63.2843402088265,NaN,NaN,0.9886686182864814,-0.21231165322304274
2008-08-28T09:30:00-04:00,129.28,130.34,128.63,130.19,167537056,207765503.2,55.6510253109311,51.78052444941145,NaN,NaN,95.90129554136507,21.243750216989703,0.11447057123917663,0.2383565156266343,0.12388594438745766,3068841149,2802932355.4,76.47934473074854,64.8118788048882,NaN,NaN,2.580248821893658,0.18662555750791454
2008-08-29T09:30:00-04:00,129.73,130.14,128.50999,128.78999,189210000,204790824.8,51.503956247462355,51.35429088174101,NaN,NaN,53.4504944030911,19.005972535639117,0.09890442680967548,0.247516477899552,0.14861205108987652,2879631149,2830240377.8,77.17191062642023,65.96037170311192,NaN,NaN,2.6857837781690908,0.5436481604595111
2008-09-02T09:30:00-04:00,130.03,130.71001,127.52,127.99001,252469568,208001716,49.24572054546366,51.029409090626025,NaN,NaN,16.653482080403947,24.580609139248708,0.03155541315930516,0.18805631753900798,0.15650090437970282,2627161581,2841441862.6,77.46502611709016,66.99332966487744,NaN,NaN,2.1017970216870743,0.7662408549205916
2008-09-03T09:30:00-04:00,127.88,128.5,126.92999,127.88,251949680,208017984,48.92801558231709,50.827909305213495,NaN,NaN,-68.25112573404722,21.49645424146966,-0.02075920079860638,0.13055190338144484,0.15131110418005123,2375211901,2770429974.6,71.22162505116059,67.7609082479653,NaN,NaN,1.5368637756318488,0.8763298435936283
2008-09-04T09:30:00-04:00,126.97,127.23,123.96001,124.03,340438528,214562141.6,39.35819271644321,49.7758821665169,NaN,NaN,-228.77255573493994,-26.20368188882542,-0.2995382358681796,-0.22311169065517333,0.0764265452130063,2034773373,2597123830.6,58.772062827730565,67.4823591356368,NaN,NaN,-2.1142410161838536,0.44910543505398803
2008-09-05T09:30:00-04:00,123.28999,124.95,122,124.42,289514752,216722257.6,40.625079767561736,48.70685777697605,NaN,NaN,-249.80090841297,-95.34412267969245,-0.43437712224999486,-0.4665448575994873,-0.03216773534949241,2324288125,2448213225.8,50.58934444661325,66.50991502608949,NaN,NaN,-4.654754236008123,-0.28001737509774205
2008-09-08T09:30:00-04:00,128.03999,128.24001,124.42,126.99001,364148736,221889112.8,48.29134579424104,48.54550912535173,NaN,NaN,-82.57096620772778,-122.54841480185621,-0.33181545615734387,-0.44693705554617225,-0.11512159938882838,2688436861,2409974368.2,48.71373644214717,65.61704584403167,NaN,NaN,-4.463915988909583,-0.877717177070862
2008-09-09T09:30:00-04:00,127.10001,127.36,122.8,123.22,377326848,228284164.8,40.10998229171382,48.057333232471365,NaN,NaN,-169.2340206626482,-159.72591535046664,-0.4896811654116847,-0.7272230561534343,-0.23754189074174958,2311110013,2346764054.6,45.69764460785788,64.70082978315918,NaN,NaN,-7.166862342033234,-1.776166486351201
2008-09-10T09:30:00-04:00,123.89,124.89999,122.55,123.72,298916608,232569954.4,41.52492658435805,47.55138906112119,NaN,NaN,-171.92620112774267,-180.46093042920572,-0.5288839817706867,-0.8986468679551081,-0.3697628861844213,2610026621,2393726998.6,48.260743453956486,63.78662963937722,NaN,NaN,-8.803239849672646,-2.780034109682836
2008-09-11T09:30:00-04:00,122.12,125.74001,121.60001,125.50999,375369216,238515056,46.406525538387534,47.34848076592194,NaN,NaN,-125.7243125384631,-159.85128178991036,-0.40812653760718565,-0.8799210581934034,-0.47179452058621774,2985395837,2583851491.4,57.090817841403634,63.36586722074328,NaN,NaN,-8.564190830122728,-3.6063422126028204
2008-09-12T09:30:00-04:00,124.28999,126.21001,123.83,126.09,297851136,241429809.6,47.92358281848478,46.88699830714428,NaN,NaN,-69.84574769615382,-123.86024964654712,-0.2697272997900406,-0.8089536453237685,-0.5392263455337278,3283246973,2775643261,63.802082236388486,63.29870157711529,NaN,NaN,-7.895695663220584,-4.2191069912625006
2008-09-15T09:30:00-04:00,121.63,125.65199,119.89,120.09,483607040,256559892.8,36.43413853503494,46.12604222162417,NaN,NaN,-174.4190284030548,-142.22986208561252,-0.5468317472498194,-1.2227660295960021,-0.6759342823461827,2799639933,2797883875.4,64.4955689840458,63.158155505050594,NaN,NaN,-11.468335868247745,-5.2547111165461065
2008-09-16T09:30:00-04:00,117.2,122.32001,117,122.10001,581744128,277033346.4,41.49446301148788,45.65124013055571,NaN,NaN,-182.98715440955715,-144.9804888349943,-0.5574131164471119,-1.3727006779050726,-0.8152875614579607,3381384061,3011938685,70.3777175478558,63.139343669487914,NaN,NaN,-12.502570818299482,-6.2901196453680175
2008-09-17T09:30:00-04:00,119.64,121.8517,116,116.61,624095488,298504439.2,33.62160423894953,44.365611355916926,NaN,NaN,-203.0250337994131,-151.2002553693284,-0.8777515884816154,-1.91247704705998,-1.0347254585783645,2757288573,3041391075.4,71.0874905265006,62.944651102851374,NaN,NaN,-16.51314601875637,-7.750551984423496
2008-09-18T09:30:00-04:00,118.05,121.78999,113.8,120.07001,776114688,326035267.2,41.194301993281414,43.33298826179909,NaN,NaN,-162.2015709936146,-158.4957070603587,-0.8022771986014958,-2.0375719568302344,-1.2352947582287386,3533403261,3150992560.2,73.62055992570906,62.74045218820571,NaN,NaN,-16.776442674794158,-9.039964940190734
2008-09-19T09:30:00-04:00,126.7,128,116.52,124.12,501146880,342062120.8,48.5878205354763,43.124692853800084,NaN,NaN,-53.5904620482314,-155.2446499307742,-0.44319176995697473,-1.789284470674957,-1.3460927007179824,4034550141,3301253193.8,76.6419780130584,62.702599858679854,NaN,NaN,-14.07438581318902,-9.75916792204763
2008-09-22T09:30:00-04:00,124.4505,124.75,120.36,121.31,249966432,346174680,44.415274297261824,42.779660978928526,NaN,NaN,-64.10162625137687,-133.1811695004386,-0.3619467001242067,-1.7985260758732409,-1.4365793757490342,3784583709,3498241949,79.89334493226639,62.876051202621014,NaN,NaN,-13.54753577730129,-10.30036332994101
2008-09-23T09:30:00-04:00,120.85001,122.02,118.28,118.55,328230144,353989343.2,40.716704608394885,42.19313876650551,NaN,NaN,-111.96668251322666,-118.97707512117253,-0.4550897524094235,-2.0054415662608136,-1.55035181385139,3456353565,3513235849.8,80.12017486322151,63.511661903482505,NaN,NaN,-14.502684291557314,-10.900694895886197
2008-09-24T09:30:00-04:00,119.35001,120,117.78999,118.92999,311871232,361627045.6,41.43972794046706,42.34181985393578,NaN,NaN,-114.02495434900423,-101.17705923109075,-0.4512291206546952,-2.1143882146697592,-1.663159094015064,3768224797,3715423094.6,82.9185673727843,65.2364122281292,NaN,NaN,-14.974429205087567,-11.48265694005782
2008-09-25T09:30:00-04:00,119.39999,121.91,118.4369,120.78999,328252928,369488054.4,44.97716252991748,42.652682908389764,NaN,NaN,-72.98376184251458,-83.33349740087074,-0.2912916166463393,-2.027273614822988,-1.7359819981766489,4096477725,3828037987.4,84.24854265058802,67.64064067127025,NaN,NaN,-14.179748020194118,-11.867955665791577
2008-09-26T09:30:00-04:00,118.83,121.5,118.50999,120.85001,285917440,375407073.6,45.09242431240531,42.424188516830064,NaN,NaN,-67.62556124390437,-86.14051724000532,-0.15611894706714136,-1.9311306820105756,-1.7750117349434342,4382395165,3897606992.2,85.02427478940675,70.23425055321736,NaN,NaN,-13.52548291570196,-12.104745272921631
2008-09-29T09:30:00-04:00,119.17999,121.17999,110.97,111.38,459562240,388924685.6,33.25537758749192,41.93457389509992,NaN,NaN,-181.63818635029742,-109.64782925978943,-0.6513827946874351,-2.589240228302728,-1.937857433615293,3922832925,3925256835.4,85.33343320512,73.06537831016466,NaN,NaN,-17.263060546776725,-12.841647454900931
2008-09-30T09:30:00-04:00,113.50999,116.8,110.5321,115.99001,328510208,392726717.6,41.329505720228155,41.92061526194779,NaN,NaN,-162.42886456604063,-119.74026567035223,-0.6157908723701775,-2.707596024078015,-2.0918051517078373,4251343133,4084254749,86.9959134653516,75.83217616812146,NaN,NaN,-17.305520530068986,-13.479343608496368
2008-10-01T09:30:00-04:00,115.27,116.69,113.95,116.06,333084928,396783480,41.44531937915983,41.56624339343153,NaN,NaN,-123.40466425430502,-121.6162076514124,-0.5376645833477545,-2.7638858808925306,-2.226221297544776,4584428061,4247495401.8,88.44418559058317,78.07170243591999,NaN,NaN,-17.297238801557103,-14.024757207505045
2008-10-02T09:30:00-04:00,114.95,115.11,111.06,111.85001,365632512,398043179.2,36.746528600374404,40.76788237785221,NaN,NaN,-165.60624035314024,-140.14070335353753,-0.7088869649127836,-3.1123300036857557,-2.403443038772972,4218795549,4271958966.6,88.64822321876377,79.84642679180395,NaN,NaN,-18.93089751931745,-14.725634394906818
2008-10-03T09:30:00-04:00,112.86,115.45,109.67999,110.34,461832448,406659064,35.204840770759276,40.68007539468966,NaN,NaN,-155.87973026313935,-157.79153715738454,-0.8534983896017745,-3.4703160257751904,-2.616817636173416,3756963101,4146872553.8,80.79300014219258,81.01052901738585,NaN,NaN,-20.734993186962036,-15.584114222343278
2008-10-06T09:30:00-04:00,107.14999,107.62,100.64,104.72,610790912,418991172.8,30.137016397713452,39.86882920799149,NaN,NaN,-241.54709989624476,-169.773319866574,-1.2341944768586184,-4.159560732246689,-2.9253662553880706,3146172189,3991540406.6,72.2332421398186,81.14306648824035,NaN,NaN,-24.10588442771551,-16.80150996596788
2008-10-07T09:30:00-04:00,106.84,107.33,99.64999,100.03,540213504,427135505.6,26.68475549498622,39.37334001199411,NaN,NaN,-213.8341205505376,-180.0543710634734,-1.680743732713506,-5.026295921279953,-3.345552188566447,2605958685,3662463517,58.172031780297566,80.22053372065442,NaN,NaN,-28.172621581574553,-18.42595448248312
2008-10-08T09:30:00-04:00,97.52,102.17999,96.81,97.50999,725787904,448479070.4,25.025904981439254,38.21845451114824,NaN,NaN,-207.0752790698723,-196.78849402658685,-2.002845181724135,-5.849108665721616,-3.8462634839974807,1880170781,3121612061,43.26509112039317,78.05228594884613,NaN,NaN,-31.987240048790817,-20.363280991955648
2008-10-09T09:30:00-04:00,99.66,100.62,90.25,90.7,534758400,456448529.6,21.191973707357434,36.26160830913974,NaN,NaN,-212.0475963740294,-206.07676523076466,-2.4992716782763367,-6.970353081842902,-4.471081403566565,1345412381,2546935427.4,33.45513096353962,74.96751115959479,NaN,NaN,-36.73104706817065,-22.70153328855779
2008-10-10T09:30:00-04:00,86.75999,93.94,83.58,88.5,871546880,485133316.8,20.11962670769266,34.526204909884804,NaN,NaN,-206.50467697030774,-216.20175457219835,-2.779043102406791,-7.944885281575054,-5.165842179168263,473865501,1890315907.4,26.157251808490415,71.1292187936108,NaN,NaN,-40.81540478104583,-25.289229216056082
2008-10-13T09:30:00-04:00,93.87,101.35001,89.94791,101.35001,456904704,483798200,39.40628488584408,34.432603501131176,NaN,NaN,-111.47632740677948,-190.1876000743053,-1.9415627640907607,-7.592795634281714,-5.651232870190953,930770205,1447235510.6,22.578138154668437,67.01907331442843,NaN,NaN,-36.95519123166211,-26.955795218285516
2008-10-14T09:30:00-04:00,104.7,105.53,97.11,99.85001,546688512,482045419.2,38.245453376191676,34.204441032254365,NaN,NaN,-74.54645990201044,-162.33006794459988,-1.3590716687249245,-7.350072456097109,-5.991000787372185,384081693,1002860112.2,19.67102158744592,62.50139147261854,NaN,NaN,-34.52941916203935,-28.037741495964635
2008-10-15T09:30:00-04:00,97.46001,97.8,89.71001,90.02,484627456,475072017.6,31.662807403178192,33.25341566605869,NaN,NaN,-116.57385783531369,-144.22978369768816,-1.495442215150537,-7.860303556310356,-6.364861341159819,-100545763,606716803.4,17.506949162290724,57.73413479488302,NaN,NaN,-34.993881495096055,-29.03147578155484
2008-10-16T09:30:00-04:00,91.28999,94.77,86.53999,93.77,708811264,471706846.4,36.175833339843386,32.6165163108757,NaN,NaN,-106.66568446450758,-123.15340131578378,-1.2051796144757567,-7.871335859254515,-6.666156244778758,608265501,459287427.4,16.76762839946133,52.858660052744064,NaN,NaN,-33.65858744604838,-29.692491733625346
2008-10-17T09:30:00-04:00,91.99001,98.59,91.64999,93.21001,476770048,470488004.8,35.79566597688236,32.79796548154645,NaN,NaN,-79.82737699225196,-97.81794132017264,-0.9350343123729115,-7.834949135244898,-6.899914822871986,131495453,390813417.8,16.420777704028154,47.936327516951785,NaN,NaN,-32.78888819433613,-30.134834085155457
2008-10-20T09:30:00-04:00,95.35001,99.10001,94.08949,98.81,321294080,474054387.2,42.32319948891597,32.86894360788129,NaN,NaN,-55.532549286313994,-86.62918569607953,-0.2964129413088745,-7.270430999508079,-6.974018058199205,452789533,295217283.4,15.925483981516422,42.85986826810642,NaN,NaN,-29.79705351972623,-30.08657971866557
2008-10-21T09:30:00-04:00,96.97,98.64,95.22,95.86,356502016,475467980.8,40.015232679052666,32.76679455787364,NaN,NaN,-55.6263043780914,-82.84515459129572,-0.005280298743606693,-6.980618431628713,-6.975338132885106,96287517,237658448.2,15.619987555246553,37.65813983701095,NaN,NaN,-28.16797325485767,-29.812493080978726
2008-10-22T09:30:00-04:00,93.2,95.86,87.53,90.64,516167936,485682816,36.248425533684234,32.73121576739576,NaN,NaN,-86.35629771792584,-76.80164256781816,-0.09206257542031704,-7.090416352160503,-6.998353776740186,-419880419,173791517,15.269961658643098,32.41683543985947,NaN,NaN,-28.061011121569944,-29.562281372491757
2008-10-23T09:30:00-04:00,90.28999,92.45,85.81,91.69,634666496,501003494.4,37.5224435054047,32.896758819870435,NaN,NaN,-91.13084569725122,-73.69467481436689,-0.010818750336491156,-7.0118772146607995,-7.001058464324308,214786077,95095632.2,14.829008690708989,27.70512176475349,NaN,NaN,-27.574004537091934,-29.278241824577496
2008-10-24T09:30:00-04:00,84.06,89.92,84,87.03999,545812480,513998246.4,34.25740455247225,33.19107225949607,NaN,NaN,-109.68789991434603,-79.6667793987857,-0.19225501925251987,-7.241377238389958,-7.0491222191374385,-331026403,2591261,14.306048148823436,23.567465051110975,NaN,NaN,-28.199231473454013,-29.124097488702713
2008-10-27T09:30:00-04:00,85.97,89.50999,83.7,83.95,400238592,511032064,32.24921687495555,33.58853378663674,NaN,NaN,-114.30956033422659,-91.42218160836822,-0.4288278731158863,-7.585157060532296,-7.15632918741641,-731264995,-234219644.6,13.0383827009844,20.34363297401717,NaN,NaN,-29.34608804957955,-29.15581042597083
2008-10-28T09:30:00-04:00,87.34,94.24001,84.53,93.75999,639939328,526603520,43.56087536479898,34.912460242591,NaN,NaN,-63.69560300178351,-93.03604133310665,0.1366662420269158,-6.985496384882765,-7.122162626909681,-91325667,-271742281.4,12.844174527707878,18.17071036025393,NaN,NaN,-26.543522434743856,-28.78262642722412
2008-10-29T09:30:00-04:00,93.77,97.17,92.10001,93.08,531381504,536518348.8,43.024649264958825,36.471937068133954,NaN,NaN,-23.417551391315655,-80.4482920677846,0.5054787516686101,-6.490314187323918,-6.995792938992528,-622707171,-312307631.8,12.62523220604757,16.6828604490045,NaN,NaN,-24.534885539588117,-28.175806300418976
2008-10-30T09:30:00-04:00,95.78,96.53999,92.89999,96.3,414582016,538965824,46.39003539005952,38.34839483116016,NaN,NaN,-0.09055236536124463,-62.24023340140661,0.9794174425382538,-5.771521135819711,-6.750938578357965,-208125155,-396889878.2,12.159797741321796,15.683042301349596,NaN,NaN,-21.814906628662634,-27.26710634731093
2008-10-31T09:30:00-04:00,95.08,98.57001,94.48,96.83,411500032,536449203.2,46.94552329746908,38.886911860561945,NaN,NaN,36.26699559656772,-33.04925429922387,1.320500731710232,-5.1003126637201746,-6.4208133954304065,203374877,-290009622.2,16.356004582662337,15.238604189063448,NaN,NaN,-19.473608555361086,-26.153749519889523
2008-11-03T09:30:00-05:00,96.78,97.69,95.95,97.11,205566752,516187995.2,47.25645517440812,39.53055484614884,NaN,NaN,52.46534537617526,0.3057268428564939,1.5414685750713195,-4.493977676591257,-6.035446251662576,408941629,-61968297.4,24.62909968561152,15.592752624646705,NaN,NaN,-17.484092216124658,-24.915227047923114
2008-11-04T09:30:00-05:00,99.06,100.86,96.7142,100.41,346977536,506526196.8,50.90814004164722,40.905221463182336,NaN,NaN,104.57940056996411,33.96072755720602,1.8647829105797191,-3.7044676134379273,-5.569250524017646,755919165,107480669,30.15707055921922,16.496332724427315,NaN,NaN,-14.71374974021813,-23.4578731468224
2008-11-05T09:30:00-05:00,99.2,100.7114,95,96.19,390404096,489757006.4,46.47672256253496,41.64099926480316,NaN,NaN,67.8545311244852,52.2151440603662,1.7511383234972069,-3.3803276196461383,-5.131465943143345,365515069,305125117,36.04877918928195,17.87355778084307,NaN,NaN,-13.550314850170055,-22.042507675872066
2008-11-06T09:30:00-05:00,94.46001,95.44,90.06,90.86,477982720,486918222.4,41.55640789366309,42.0524808302875,NaN,NaN,-32.724000125331045,45.68845450837223,1.2947449807836886,-3.513034717163734,-4.8077796979474225,-112467651,324256617.8,36.60624011191347,19.31537652426345,NaN,NaN,-14.002900273508242,-20.893992332677236
2008-11-07T09:30:00-05:00,91.64999,94,90.5,93.86,380518656,462366811.2,45.08061770607937,42.2494392743706,NaN,NaN,-25.46607919206338,33.341839550646014,1.176098405256731,-3.337656691376509,-4.51375509663324,268051005,337191843.4,37.006068800257985,20.821132582744983,NaN,NaN,-13.332247087023724,-19.81374301186959
2008-11-10T09:30:00-05:00,95.21001,95.53,90.92,92.63,301903104,454616731.2,43.91146478380149,42.52774156756694,NaN,NaN,-16.45028404082575,19.55871366724582,1.0027353255888496,-3.2603359396471774,-4.263071265236027,-33852099,248633097.8,35.361687404969075,22.231254000582307,NaN,NaN,-13.118737454647409,-18.857313646552136
2008-11-11T09:30:00-05:00,90.75999,92.1377,88.64999,89.77,418596608,448212136,41.23365977527791,42.883829727680784,NaN,NaN,-71.52133257092285,-15.661432960931574,0.6978567516030507,-3.3907503257322134,-4.088607077335264,-452448707,6959523.4,31.277180858541357,23.37462680057504,NaN,NaN,-13.711058778823048,-18.122134379733694
2008-11-12T09:30:00-05:00,88.23,90.1516,85.12,85.82001,454330624,446697294.4,37.804706680861464,42.90399138307055,NaN,NaN,-127.46194908266307,-54.72472900236123,0.25537788021018404,-3.7693847270725342,-4.024762607282718,-906779331,-247499356.6,27.65512332464381,24.2907778458561,NaN,NaN,-15.244875990836476,-17.71109746703409
2008-11-13T09:30:00-05:00,86.13,91.73,82.09,91.17,753800960,448946779.2,44.53273859058424,43.637943814364256,NaN,NaN,-91.10922353102634,-66.4017736835003,0.34277022106775323,-3.596299830948027,-3.93907005201578,-152978371,-255601500.6,27.545740477301607,25.23647015503311,NaN,NaN,-14.55558822230261,-17.26031043207245
2008-11-14T09:30:00-05:00,89.41,92.06,86.52,86.62,540352256,452125889.6,40.518299757585346,44.22859259169496,NaN,NaN,-80.21840854045026,-77.35223955317767,0.1251188452485743,-3.7826714954550624,-3.9077903407036367,-693330627,-447877827,25.016919964745767,26.09207995958749,NaN,NaN,-15.213708542514611,-16.96793873356419
2008-11-17T09:30:00-05:00,86.38,88.56,85.16,85.47,415543808,456838376,39.54792329903234,43.94195315842591,NaN,NaN,-107.84160180055275,-95.63050310512305,-0.055623491909663425,-3.977319705590716,-3.9216962136810527,-1108874435,-662882294.2,22.52654628937931,26.783677942564022,NaN,NaN,-16.03850269980676,-16.83516215731313
2008-11-18T09:30:00-05:00,85.14999,87.22,82.91,87.08,524140544,465220302.4,41.65464909992182,43.844096003780415,NaN,NaN,-109.2853464132136,-103.1833058735812,-0.02749361737945133,-3.9560632354053666,-3.9285696180259153,-584733891,-689339331,22.233246359314094,27.469964667797342,NaN,NaN,-16.114641176228023,-16.732230588586685
2008-11-19T09:30:00-05:00,85.91,86.87,80.92,81.5,558809344,467352372.8,36.860114319240765,43.16338735586479,NaN,NaN,-137.40727817564553,-105.17237169217769,-0.32870764092898774,-4.3394541691871495,-4.010746528258162,-1143543235,-736692111.8,21.68893848817423,28.150617578286806,NaN,NaN,-17.647019373446497,-16.862914700709513
2008-11-20T09:30:00-05:00,80.13,82.50999,75.05,75.45,814180352,476328065.6,32.49314092185304,42.131074329035066,NaN,NaN,-191.12853428115633,-125.17623384220369,-0.8498030132861958,-5.073000294865906,-4.2231972815797105,-1957723587,-1097641155,18.05954797023604,28.272299248827782,NaN,NaN,-20.408555039354383,-17.36943474908735
2008-11-21T09:30:00-05:00,77.46001,80.89999,74.34,79.52,718768640,484975873.6,37.829351777321314,41.45770980067173,NaN,NaN,-159.30798204873625,-140.99414854386092,-0.8336274439786884,-5.265231586553071,-4.431604142574383,-1238954947,-1206766019,17.12645404776346,27.736395988981492,NaN,NaN,-21.044064912379465,-17.89438191527194
2008-11-24T09:30:00-05:00,81.92,86.985,80.3614,85.03,523461888,491137038.4,44.25388473782542,40.98240585039874,NaN,NaN,-76.91227682785522,-134.8082835493214,-0.3877513657077456,-4.916293349709065,-4.528541984001319,-715493059,-1128089743.8,20.32282497134848,27.033949875562154,NaN,NaN,-19.493795040500185,-18.12286950459026
2008-11-25T09:30:00-05:00,87.3,87.50999,83.82001,85.66,454188288,481849486.4,44.954296174812164,40.873661108418545,NaN,NaN,-51.215197969185375,-123.19425386051576,-0.006467329532724442,-4.536626145917225,-4.530158816384501,-261304771,-1063403919.8,22.953950875672277,26.098604996018604,NaN,NaN,-18.050776823679513,-18.11257055017444
2008-11-26T09:30:00-05:00,84.3,89.19,84.24001,88.97,370320384,473796430.4,48.60778736519349,41.377331070670714,NaN,NaN,-24.263896867074653,-100.56557759880158,0.4853902061776356,-3.9234210586624556,-4.408811264840091,109015613,-812892150.2,32.28057865323376,25.789629177541485,NaN,NaN,-15.709973697800805,-17.769342428406777
2008-11-28T09:30:00-05:00,88.63,90.13,88.48,90.09,119905312,459062595.2,49.8213939937351,41.715957948360405,NaN,NaN,8.045038859303935,-60.73086297070953,0.8799020982292021,-3.3089336420535886,-4.188835740282791,228920925,-375563247.8,44.835139463024966,26.34884851059627,NaN,NaN,-13.44046873704844,-17.15093190106987
2008-12-01T09:30:00-05:00,87.50999,87.55,81.86,82.11,370826752,457028931.2,42.17874626451828,41.592192339840174,NaN,NaN,-67.93968356491247,-42.45720327394476,0.609972445844102,-3.4263701829776636,-4.036342628821766,-141905827,-156153423.8,49.85769925717249,27.384277928610796,NaN,NaN,-13.763378124806117,-16.666995647317908
2008-12-02T09:30:00-05:00,83.47,85.49001,82.03799,85.27,469785344,470239860.8,45.729040458509616,41.913290960071016,NaN,NaN,-55.66648374561274,-38.20804465749626,0.6472723885335041,-3.2272521431548853,-3.8745245316883894,327879517,52521091.4,54.13474982935089,29.016961426525764,NaN,NaN,-12.917122172165286,-16.13129943658182
2008-12-03T09:30:00-05:00,83.39999,87.83,83.14,87.32001,520103680,478896168,47.961359976677954,42.638766195486475,NaN,NaN,-18.20260614600775,-31.60552629286073,0.8028703313940548,-2.870936617445821,-3.673806948839876,847983197,274378685,58.21554193280888,31.199848469966128,NaN,NaN,-11.541096357137384,-15.475556139518329
2008-12-04T09:30:00-05:00,86.06,88.05,83.74001,85.3,444341504,481593038.4,45.955464762792246,42.740389493501326,NaN,NaN,-17.277557428457985,-30.208258405137393,0.7628893956902352,-2.720195204227082,-3.483084599917317,403641693,333303901,59.252528048022505,33.46461901073191,NaN,NaN,-10.994651944554306,-14.835426968809182
2008-12-05T09:30:00-05:00,83.64999,88.42,82.24001,87.92999,472064256,481297115.2,48.94914254942273,43.34259255006115,NaN,NaN,0.12388499611177306,-31.792489177775828,0.8974326321124391,-2.361293809776768,-3.2587264418892072,875705949,462660905.8,61.51077182022098,36.071322714694425,NaN,NaN,-9.650931749402055,-14.094784794608165
2008-12-08T09:30:00-05:00,90.34,92.38,88.0815,91,413016832,482922024,52.27260928724949,44.25149869207666,NaN,NaN,111.62710770467731,4.120869076142123,1.1603468776852637,-1.8082928447826276,-2.9686397224678913,1288722781,748786627.4,65.99935192339177,39.176523117123885,NaN,NaN,-7.519521425715427,-13.155461456194917
2008-12-09T09:30:00-05:00,90.37,92.13,88.98,89.5,370862592,486369998.4,50.54131465556623,44.88626051747982,NaN,NaN,113.49028741612912,37.9522233084905,1.1956471585642077,-1.4740807742626316,-2.6697279328268393,917860189,866782761.8,67.67361053321144,42.42226341525941,NaN,NaN,-6.238268279797015,-12.167291002423788
2008-12-10T09:30:00-05:00,90.32001,91.36,89,90.11,396381184,485259227.2,51.248459542599655,45.91399946200546,NaN,NaN,112.3471571929026,64.06217597627257,1.2183630658600304,-1.1467741005018013,-2.3651371663618317,1314241373,960034397,68.97388807135616,45.79975981405812,NaN,NaN,-4.9831903317121995,-11.140990906607847
2008-12-11T09:30:00-05:00,89.53999,91,87.37,87.94,366329600,480859176,48.58711250688665,47.063568860936435,NaN,NaN,70.92468726505427,81.70262491497502,1.0518105249073626,-1.0503740102276282,-2.102184535134991,947911773,1068888413,70.46721843674584,49.54316484738025,NaN,NaN,-4.6292161132249685,-10.210737364696007
2008-12-12T09:30:00-05:00,85.55,89.07001,85.2,88.99001,415140864,463926171.2,49.94172464120437,47.92873835121379,NaN,NaN,45.90015311226245,90.85787853820516,0.978455373467326,-0.8791153183008333,-1.8575706917681594,1363052637,1166357750.6,71.77711841957347,53.44678373108096,NaN,NaN,-3.967152528341802,-9.318796673788263
2008-12-15T09:30:00-05:00,89.02,89.14999,86.28999,87.75,256846128,449750864.8,48.3224938959687,48.21935329108117,NaN,NaN,46.71537269654563,77.87553153657882,0.8189861142794366,-0.8338380489188637,-1.6528241631983003,1106206509,1129854496.2,70.51567520241322,57.031987319014156,NaN,NaN,-3.828237148954017,-8.534431027383372
2008-12-16T09:30:00-05:00,88.3,92.02,88.17999,91.88,377699840,447858666.4,53.70615825008216,48.844486296457596,NaN,NaN,110.41842889201399,77.26115983175579,0.9547367005989686,-0.45940328744958947,-1.4141399880485581,1483906349,1243063728.2,72.15036779011145,60.54601709861696,NaN,NaN,-2.206192771039347,-7.630396990762797
2008-12-17T09:30:00-05:00,90.84,92.42999,90.06,90.99001,288101888,436056733.6,52.43837385154962,49.11809961691161,NaN,NaN,106.41419050956503,76.07456649508828,0.9458690244195829,-0.23180370752407953,-1.1776727319436624,1195804461,1219376345.8,71.26011906445152,63.33026998513252,NaN,NaN,-1.1836393507285996,-6.709431613615055
2008-12-18T09:30:00-05:00,91.39999,91.67,88.21001,89.28999,374829312,426857732,50.00991355862516,49.13156530011804,NaN,NaN,67.34935715017706,75.35950047211284,0.7929722322071399,-0.18645744168473755,-0.9794296738918774,820975149,1193989021,70.25951443710083,65.14629676899507,NaN,NaN,-0.9550172622394641,-5.887372420561399
2008-12-19T09:30:00-05:00,89.10001,90.62,88.09,88.19,301523456,401224887.2,48.44653587019133,49.57926455766612,NaN,NaN,44.08390309446416,74.99625046855317,0.5943010515721243,-0.23655335942672195,-0.8308544109988463,519451693,1025268832.2,63.843471603970855,66.1452805080521,NaN,NaN,-1.1760874090481905,-5.214331704630941
2008-12-22T09:30:00-05:00,88.58,88.67,85.49001,87.06,244192192,377496064.8,46.827043398586575,49.65769333910019,NaN,NaN,-23.984526998411322,60.85627052956179,0.37408434224608433,-0.3632489831912409,-0.7373333254373252,275259501,859079430.6,58.20521351113744,66.436027913894,NaN,NaN,-1.7935107330538287,-4.725642994405639
2008-12-23T09:30:00-05:00,87.53,87.92999,85.8,86.16,221772560,362411598.4,45.52182081618487,49.483440541922114,NaN,NaN,-45.85862045679873,29.600860659799235,0.16573288552911447,-0.5301672185259321,-0.6959001040550465,53486941,572995549,50.01648659971984,65.85038110438764,NaN,NaN,-2.664155549458647,-4.431144787984641
2008-12-24T09:30:00-05:00,86.45,86.87,86,86.66,62142416,342809304.8,46.41541410495334,49.51629406636219,NaN,NaN,-52.77114906294965,-2.2362072547036944,0.06470745749922258,-0.6150157821810183,-0.6797232396802408,115629357,356960528.2,44.88152119217102,64.82388061468396,NaN,NaN,-3.1862490426024093,-4.253302538644322
2008-12-26T09:30:00-05:00,87.24001,87.3,86.5,87.16,74775808,328032076,47.345530373404245,49.40175033950373,NaN,NaN,-34.01077658826726,-22.508234002392555,0.03610034348902058,-0.6345978103189651,-0.6706981538079857,190405165,230846531.4,42.160370614776596,63.44170910000936,NaN,NaN,-3.408289202159884,-4.132586347717973
2008-12-29T09:30:00-05:00,87.24001,87.33,85.60001,86.91,128419184,328457769.6,46.907110001734466,49.018500390538364,NaN,NaN,-43.26912482034113,-39.97883958535361,0.006437730069475123,-0.6626509912211418,-0.6690887212906169,61985981,139353389,40.253594884124254,61.6027264543474,NaN,NaN,-3.7058135146866205,-4.0716188001420655
2008-12-30T09:30:00-05:00,87.50999,89.05,86.8766,88.97,168555680,318344216,50.938582717509995,49.04687668067721,NaN,NaN,12.084828719377471,-32.76496844179586,0.12507264380894578,-0.5127479165294346,-0.6378205603383804,230541661,130409821,40.06285389447057,59.630529551580196,NaN,NaN,-2.9721939456406776,-3.9145581066418673
2008-12-31T09:30:00-05:00,89.08,90.97,88.87,90.24001,194141808,304562039.2,53.29326064318587,49.19293390214765,NaN,NaN,74.2765101887388,-8.737942312688356,0.27973815426388227,-0.2881478675085276,-0.5678860217724099,424683469,204649126.6,42.4985652039998,57.739435061054735,NaN,NaN,-1.725199782983302,-3.6017926318335007
2009-01-02T09:30:00-05:00,90.44,93.44,89.85001,92.96001,227638496,289938780,57.94828137171085,49.86158882106366,NaN,NaN,142.16786025509526,30.249859550920625,0.5407765176009212,0.10808462522874152,-0.4326918923721796,652321965,311987648.2,45.92047837475102,55.98609648519796,NaN,NaN,0.6788047017550042,-2.990278727035143
2009-01-05T09:30:00-05:00,92.63,94.5533,91.89,92.85001,240697632,279756586.4,57.69783769464453,50.41559689630939,NaN,NaN,162.17092022563156,69.48619891370039,0.6729667343128338,0.40851652551886275,-0.2644502087939711,411624333,356231481.8,47.31229309564141,54.23860896205996,NaN,NaN,2.6362110639832697,-2.18649447117537
2009-01-06T09:30:00-05:00,93.64,94.45,92.67999,93.47,328481792,272577463.2,58.779179094847535,51.16250298194359,NaN,NaN,156.59694550573994,109.45941297891659,0.7625202284251007,0.6887000767374047,-0.0738201516876959,740106125,491855510.6,51.43813441737064,52.875927477414066,NaN,NaN,4.604940694882352,-1.2162894474528383
2009-01-07T09:30:00-05:00,92,92.25999,90.2,90.67,281047552,265978999.2,52.27952923309338,51.06060090930153,NaN,NaN,61.947999405202694,119.43204711608163,0.6006615987586522,0.6770068467606194,0.07634524800196718,459058573,537558893,52.78004980488635,51.49233333561227,NaN,NaN,4.68473938168243,-0.37328532900494293
2009-01-08T09:30:00-05:00,90.16,91.09,89.67,91.04201,263834368,260627588,53.02277942425943,51.10234416449509,NaN,NaN,44.514396129988995,113.47962430433168,0.49076885591711356,0.6898063178983591,0.19903746198124556,722892941,597200787.4,54.5452611413507,50.298414912533644,NaN,NaN,4.946753856367781,0.3867202689054463
2009-01-09T09:30:00-05:00,91.16,91.32001,85.36,89.09,331160832,257366570.4,48.73362997452947,51.011181051345396,NaN,NaN,-25.63417225335591,79.91921780264144,0.26977599479928593,0.536257455480353,0.26648146068106704,391732109,545082816.2,52.69158771646668,49.043563003916915,NaN,NaN,4.00895940023398,0.9041830019523797
2009-01-12T09:30:00-05:00,88.84,88.91,86.41,86.95,278008320,252950506.4,44.485091137298255,50.72822071328161,NaN,NaN,-63.549472071672255,34.7751393431807,-0.02187941381726244,0.239132193409489,0.26101160722675143,113723789,485502707.4,50.57558796421549,48.09585702964868,NaN,NaN,1.9574756256009371,1.0546533767593165
2009-01-13T09:30:00-05:00,86.73,87.88,86.2,87.11,356731648,250030045.6,44.8720577587563,50.58857888186516,NaN,NaN,-73.80753226265298,-11.30575621049789,-0.1957051853971187,0.016380125480353058,0.21208531087747176,470455437,431572569.8,48.67033104505194,47.414793996356856,NaN,NaN,0.356772845516262,0.9549561580103088
2009-01-14T09:30:00-05:00,85.53999,85.75,83.16,84.37,435967232,258986100.8,39.760732535046714,50.17707257606958,NaN,NaN,-148.04383699360466,-53.30412349025935,-0.47119056240870977,-0.37690289213341543,0.09428767027529432,34488205,346658496.2,45.74807502052306,47.10990745498565,NaN,NaN,-2.6025249636743153,0.4467445691982196
2009-01-15T09:30:00-05:00,84.12,85.25,81.72,84.39999,533808896,266791553.6,39.84150532350669,49.7075076631091,NaN,NaN,-147.5939641407634,-91.7257955444098,-0.6181045827480502,-0.6783430581597685,-0.06023847541171824,568297101,315739328.2,44.695742657370815,47.09663755964277,NaN,NaN,-5.0140152307124515,-0.333363973646162
2009-01-16T09:30:00-05:00,85.86,85.98759,83.05,85.06,399307008,272351809.6,41.694415144984454,49.303856575364826,NaN,NaN,-108.75651571693315,-108.35026423712527,-0.6351159019240447,-0.854133352816774,-0.2190174508927294,967604109,430913728.2,49.36791403964191,47.6114620899903,NaN,NaN,-6.58166231669977,-1.2259780226538202
2009-01-20T09:30:00-05:00,84.23,85.05901,80.05,80.57001,420108544,274615771.2,34.018184772501456,48.38321905899104,NaN,NaN,-165.06688946529277,-128.65374771584936,-0.8970283742330416,-1.3403029186840314,-0.4432745444509898,547495565,517668083.4,52.61519110197491,48.49443324840821,NaN,NaN,-10.495279187884899,-2.550163903401117
2009-01-21T09:30:00-05:00,81.94,84.24001,80.47,84.05,364767232,277777960,42.806999345942074,47.80239167530762,NaN,NaN,-121.89133770114795,-138.27050880354835,-0.7880402468252072,-1.4283248529824988,-0.6402846061572915,912262797,606029555.4,55.72951744918311,49.61348064517339,NaN,NaN,-11.178458687095647,-3.7827774439289072
2009-01-22T09:30:00-05:00,82.42,84.03999,81.17,82.75,427940352,286965368,40.629787763734015,46.897857898203924,NaN,NaN,-115.21565491045264,-131.70487238691797,-0.7555438385317326,-1.5847144043219572,-0.8291705657902246,484322445,695996403.4,58.70544288588218,50.77111476530785,NaN,NaN,-12.429949669122129,-5.0180877618136535
2009-01-23T09:30:00-05:00,80.89999,83.99001,80.57001,83.11,386800640,295216772,41.51686277075508,45.724185140992795,NaN,NaN,-105.73027729644748,-123.33213501805479,-0.6650351141326469,-1.6604644584560333,-0.9954293443233864,871123085,756561600.2,60.6243790022715,51.821393381559304,NaN,NaN,-13.169418645905287,-6.182563602398172
2009-01-26T09:30:00-05:00,83.59,85.36,82.81,83.67999,318269440,308023123.2,42.96979740153132,44.67218226291328,NaN,NaN,-68.70840932405694,-115.32251373947955,-0.5279931900025283,-1.6554208318265466,-1.1274276418240183,1189392525,800919283.4,62.016549802982276,52.87169743208365,NaN,NaN,-13.357098081350754,-7.207497099391398
2009-01-27T09:30:00-05:00,84.13,85.14999,83.3,84.53,274112000,317989932.8,45.15791594105551,43.69923489478528,NaN,NaN,-55.32590392059428,-93.37431663053982,-0.3498954963885428,-1.5647970123096968,-1.214901515921154,1463504525,984121075.4,67.17804056938772,53.995976442942045,NaN,NaN,-12.890737437458725,-8.019388576258159
2009-01-28T09:30:00-05:00,86.39999,87.95,86.07001,87.39,330317312,328084839.2,51.85172534252682,43.66867747403053,NaN,NaN,2.7438662788396715,-68.44727583454232,-0.02633066852651078,-1.2478148515792924,-1.2214841830527816,1793821837,1160432883.4,71.22993361102772,55.313825286237865,NaN,NaN,-10.42973690099404,-8.363724051220428
2009-01-29T09:30:00-05:00,86.11,87.4901,84.47,84.55,294591488,334386629.6,45.865140879970504,43.15741757800989,NaN,NaN,-28.43895703362526,-51.091936259176855,0.007747667132481428,-1.21179959913718,-1.2195472662696614,1499230349,1363414464.2,75.0488789811766,56.778369417654,NaN,NaN,-10.116309947373972,-8.61409346495665
2009-01-30T09:30:00-05:00,84.98,85.39999,82.21001,82.83,383464192,343852748.8,42.65323597997586,42.72310372125607,NaN,NaN,-64.27184673709951,-42.80025014730726,-0.06994683992790796,-1.3069808161795464,-1.2370339762516385,1115766157,1412343078.6,75.88001219109726,58.43468545155618,NaN,NaN,-10.861766741250792,-8.935189647284384
2009-02-02T09:30:00-05:00,81.57001,83.17999,81.31,82.58,288488960,346895272,42.19075540896734,42.55922259780386,NaN,NaN,-81.92958133066763,-45.4444845486294,-0.11965413615185949,-1.3866016464414628,-1.2669475102896033,827277197,1339920013,72.05407537869065,59.9688631240187,NaN,NaN,-11.598204329651491,-9.31562031619397
2009-02-03T09:30:00-05:00,83.10001,84.36,82.22,83.74001,278480640,348784422.4,45.16194235754508,42.57992864057449,NaN,NaN,-53.759242957343204,-45.13115235597918,-0.05895759208106677,-1.3406445003909369,-1.28168690830987,1105757837,1268370675.4,68.38557714482911,61.37709498828849,NaN,NaN,-11.346187040900395,-9.605701276866316
2009-02-04T09:30:00-05:00,84.3,85.37,83.03999,83.33,322993920,348510028.8,44.29536298215594,42.903830815367996,NaN,NaN,-36.02715251580612,-52.88535611490833,-0.03230450519656247,-1.3220675398055732,-1.2897630346090108,782763917,1066159091.4,59.21042928572373,62.338691721517115,NaN,NaN,-11.382589985691071,-9.859542520984139
2009-02-05T09:30:00-05:00,82.7,85.28999,77.73,84.57001,417679872,355341644.8,47.571901409173165,43.456001964344175,NaN,NaN,-77.36202107314392,-62.669968922812075,0.07698765355260173,-1.1935284676682585,-1.2705161212208602,1200443789,1006401779.4,56.785732196226476,63.202262402863944,NaN,NaN,-10.482816123363571,-9.948581607038344
2009-02-06T09:30:00-05:00,84.86,87.34,84.67999,86.979,366101504,360455001.6,53.31676067415653,44.28616950214218,NaN,NaN,80.48050716690027,-33.719498142012114,0.3067732082174264,-0.8870496109490773,-1.1938228191665037,1566545293,1096557606.6,59.48160237942474,63.92466871284843,NaN,NaN,-7.950585613990824,-9.663153608031555
2009-02-09T09:30:00-05:00,86.96001,87.74001,86.32001,87.10001,240075120,355900716,53.59185425093781,45.68428875060192,NaN,NaN,121.91952030791441,7.0503221857042915,0.4533232139621455,-0.6271688017138217,-1.0804920156759672,1806620413,1292426249.8,64.64233323975904,64.78375029411873,NaN,NaN,-5.810206676145394,-9.112732617762104
2009-02-10T09:30:00-05:00,86.27,87.03,82.45,83.11,536212736,368810936.8,44.31841038454038,45.792246681930365,NaN,NaN,-0.7483666369799635,17.65249744977694,0.2766314891105668,-0.7347026542877586,-1.0113341433983254,1270407677,1325356217.8,65.43932214841811,65.47730777263551,NaN,NaN,-6.6745797226225365,-8.764425061313595
2009-02-11T09:30:00-05:00,83.45,84.05,82.39999,83.60001,324674560,367208082.4,45.56419385704611,46.14470426002409,NaN,NaN,-39.25037103894025,17.00785374515011,0.19187449307606497,-0.7714910270532442,-0.9633655201293092,1595082237,1487819881.8,69.13568760869269,66.22232525283627,NaN,NaN,-6.998773835354324,-8.512189171890842
2009-02-12T09:30:00-05:00,82.17,83.82001,81.05,83.66,469302272,368874834.4,45.72429521426894,46.44523514884651,NaN,NaN,-63.229524805176,19.8343529987437,0.14130331320206524,-0.7867363786267276,-0.9280396918287929,2064384509,1660608025.8,72.50394601889946,67.07086575402397,NaN,NaN,-7.21532721654448,-8.326923178269933
2009-02-13T09:30:00-05:00,83.55,84.24001,82.74001,82.75999,293998336,356884306.4,43.65010398392366,46.49382847616024,NaN,NaN,-37.84221199227006,-3.8301908330903687,0.05322314932358796,-0.861510755174308,-0.9147339044978959,1770386173,1701376201.8,73.24582386703595,67.87295675859924,NaN,NaN,-7.98562733015717,-8.278166628539537
2009-02-17T09:30:00-05:00,80.16,82.95799,79.17,79.22,478910720,360864492,36.6145967652569,45.88359139217463,NaN,NaN,-170.17858113134147,-62.249811120941544,-0.22234827377163613,-1.1926692467124411,-0.970320972940805,1291475453,1598347209.8,68.23518333020917,67.94846695580077,NaN,NaN,-10.917155946510155,-8.65516510253534
2009-02-18T09:30:00-05:00,79.78999,79.94,78.28,79.03,362970112,358007570.4,36.276630524339936,44.77108461944699,NaN,NaN,-215.24819020571894,-105.14977583468935,-0.38669436417090375,-1.4536889281544347,-1.066994563983531,928505341,1529966742.6,65.05432832582625,67.5073522925721,NaN,NaN,-13.375473554646042,-9.329494881408298
2009-02-19T09:30:00-05:00,79.84,80.14999,78.02,78.181,316869632,355612690.4,34.733827500584354,43.9759908066337,NaN,NaN,-193.8006425447697,-136.05983013585524,-0.5138857629810079,-1.7093517677097907,-1.1954660047287828,611635709,1333277437,56.845767656384496,66.20713005508694,NaN,NaN,-15.894254213996486,-10.26731764320661
2009-02-20T09:30:00-05:00,76.73,78.34,75.77,77.42,477176576,358074501.6,33.364128997386956,43.312483165020204,NaN,NaN,-208.37833830884168,-165.08959283658837,-0.6043345335913752,-1.9508841717180019,-1.3465496381266266,134459133,947292361.8,44.87831308176481,63.992722975848906,NaN,NaN,-18.41270097656123,-11.430943833685841
2009-02-23T09:30:00-05:00,78.27,78.27,74.59,74.64999,379644672,357716703.2,28.89719629433951,42.36294322826108,NaN,NaN,-200.1105135456128,-197.54325314725693,-0.7938451867942078,-2.3388561216193864,-1.5450109348251786,-245185539,544178019.4,36.2863986867787,61.43788892642663,NaN,NaN,-22.108387560144816,-12.956292937465694
2009-02-24T09:30:00-05:00,75.28999,77.95,74.7003,77.48,426412288,363123845.6,38.026304019804826,41.85325477556535,NaN,NaN,-143.82622347693584,-192.2727816163758,-0.6763219197747445,-2.3904133345436094,-1.7140914147688648,181226749,322128278.6,32.58567360057833,58.880752958980146,NaN,NaN,-22.48752629022064,-14.317897702144972
2009-02-25T09:30:00-05:00,77.14,78.42,75.63,76.87199,462039552,372520223.2,36.92927081312586,41.32710533492035,NaN,NaN,-115.49805753824118,-172.32275508288026,-0.5903814337479685,-2.4520682069538253,-1.8616867732058568,-280812803,80264649.8,29.10391006104406,56.73028730007445,NaN,NaN,-23.130473260569946,-15.576837067634253
2009-02-26T09:30:00-05:00,77.82001,79.6667,75.53,75.62,363371264,374172920.8,34.70877593085429,40.40831065789757,NaN,NaN,-101.15085629397024,-153.79279783272037,-0.5684932657106092,-2.5723033553441184,-2.003810089633509,-644184067,-170899305.4,25.99739262473986,54.531120187825415,NaN,NaN,-24.346860237643575,-16.82969752049273
2009-02-27T09:30:00-05:00,74.00999,75.68719,73.81,73.92999,470568960,382971794.4,31.91881039302004,38.87988563781639,NaN,NaN,-134.22557789470287,-138.9622457498926,-0.6145569655849115,-2.7720062966146486,-2.157449331029737,-1114753027,-420741737.4,23.32975848131194,51.948845623674494,NaN,NaN,-26.250309965531855,-18.17549929835546
2009-03-02T09:30:00-05:00,72.52,73.9169,70.37,70.60001,426453248,385121247.2,27.267805808253357,36.99959646333893,NaN,NaN,-163.22018408900567,-131.58417985857116,-0.8040551990501297,-3.162518329842399,-2.3584631307922694,-1541206275,-679945884.6,20.93020523381142,48.82655076610681,NaN,NaN,-29.516591456985157,-19.795655321016845
2009-03-03T09:30:00-05:00,71.61,71.7,69.64,70.07001,443761152,392884856.8,26.603366084058024,35.73423615616162,NaN,NaN,-156.44058193895992,-134.107051550976,-0.8930008220737511,-3.474714158384458,-2.581713336310707,-1984967427,-1113184719.8,17.660597458255097,45.41378471680945,NaN,NaN,-32.32887074476908,-21.586114667267164
2009-03-04T09:30:00-05:00,71.23,72.87,70.07291,71.73,462763264,402098988,32.17769069574804,34.77805735892604,NaN,NaN,-122.94897602892027,-135.59723524911178,-0.772463965272737,-3.547293292901628,-2.774829327628891,-1522204163,-1361462991.8,16.107670837954828,41.62606923318532,NaN,NaN,-32.95806392048871,-23.210678846298816
2009-03-05T09:30:00-05:00,70.10001,71.73,68.17,68.8,485551104,410226847.2,28.1183722629751,33.520491433833634,NaN,NaN,-137.03385652774747,-142.77383529586723,-0.818108126795086,-3.797464486122749,-2.979356359327663,-2007755267,-1634177231.8,14.590072703745733,37.489363996388626,NaN,NaN,-34.843735409462106,-24.87254406960786
2009-03-06T09:30:00-05:00,69.39999,70.45,67.10001,68.92,490495232,413867615.2,28.516117228337137,32.43949237986317,NaN,NaN,-131.5480642393852,-142.2383325648037,-0.7690100802197017,-3.94061895960229,-3.171608879382588,-1517260035,-1714678633.4,14.165799656906245,33.26936226709365,NaN,NaN,-36.201861683873005,-26.49101801450288
2009-03-09T09:30:00-04:00,67.95,70,67.73,68.11,379907328,414557906.4,27.413463492460878,31.78226857466345,NaN,NaN,-124.48843735124076,-134.49198321725072,-0.7207009516252589,-4.072485068914162,-3.351784117288903,-1897167363,-1785870851,13.784050056556637,29.379995604689896,NaN,NaN,-37.65144608084845,-28.085364881123677
2009-03-10T09:30:00-04:00,69.50999,72.37,69.37,72.17,406230784,422865689.6,39.94784852525321,32.04449843187154,NaN,NaN,-75.02207520360125,-118.20828187017898,-0.36298409984175173,-3.8055142420910926,-3.442530142249341,-1490936579,-1687064681.4,17.122245034456668,25.956275369592067,NaN,NaN,-34.850250108163124,-29.051777056415027
2009-03-11T09:30:00-04:00,73,73.75,71.83,72.64,356809984,413895552,41.21340568617953,32.50732544512834,NaN,NaN,-45.81409649215119,-102.78130596282517,-0.0583666887743548,-3.5154885032172842,-3.4571218144429294,-1134126595,-1609449167.8,19.750781750681966,23.306633519184743,NaN,NaN,-32.22556558496317,-29.505175417636192
2009-03-12T09:30:00-04:00,72.62,75.75,71.97,75.5,409818624,418152755.2,48.346901796492226,33.577523502207285,NaN,NaN,-12.083038905320123,-77.7911424383397,0.3496577195290351,-3.0200496650316353,-3.3697073845606704,-724307971,-1352759708.6,27.895610482643207,22.093583333533196,NaN,NaN,-27.552419982616183,-29.226210355490476
2009-03-13T09:30:00-04:00,76.00999,76.98,74.73,76.09,337474560,411561369.6,49.7028350024081,35.06364055278361,NaN,NaN,23.636226208644917,-46.75428434873368,0.6554432791245071,-2.5504032856550367,-3.2058465647795438,-386833411,-1126674383.8,34.22751581099095,21.946520270976926,NaN,NaN,-23.38343161542255,-28.391527678337916
2009-03-16T09:30:00-04:00,76.96001,77.97,75.81,75.86,360821248,414902515.2,49.16105419590649,35.85897985107658,NaN,NaN,46.895418508650515,-12.477513176755425,0.8272933525786543,-2.1717298740562256,-2.99902322663488,-747654659,-896771843,39.997784984269394,22.475956798383432,NaN,NaN,-20.18945610329533,-27.219803167617545
2009-03-17T09:30:00-04:00,76.07001,78.36,75.45,78.17999,357075200,408810739.2,54.54351930706064,37.117140457786206,NaN,NaN,70.29927849657524,16.586757563279882,1.067035428925366,-1.6652289404781726,-2.7322643694035387,-390579459,-676700419,44.97426480500633,23.609553565809303,NaN,NaN,-15.691034765290585,-25.57283625299941
2009-03-18T09:30:00-04:00,77.81,80.89999,77.07001,79.92999,473552384,414339852.8,58.143378218838805,38.79104062121367,NaN,NaN,114.60352413466413,48.670281688642945,1.297955801820354,-1.109819617128096,-2.40777541894845,82972925,-433280515,49.92171601120726,25.318433807699837,NaN,NaN,-10.71569774328852,-23.45038789446928
2009-03-19T09:30:00-04:00,80.92999,81,78.69,78.94,428597248,419926233.6,55.467268631738676,40.47307335255072,NaN,NaN,118.04664760794849,74.69621899129667,1.3334236098660455,-0.7409959066158933,-2.074419516481939,-345624323,-357543785.4,51.38628430220132,27.32247136633479,NaN,NaN,-7.386572092013041,-21.15555706554696
2009-03-20T09:30:00-04:00,78.75999,78.91,76.53,76.71001,371165696,414625689.6,49.89632246891339,42.08939597116929,NaN,NaN,69.05004344578884,83.77898243872546,1.1623532104394372,-0.6214780034326424,-1.7838312138720795,-716790019,-423535107,50.01377657062615,29.399869318964413,NaN,NaN,-6.1932986826368905,-19.018091582274096
2009-03-23T09:30:00-04:00,78.74001,82.28999,78.31,82.22,420247296,416655820.8,60.46280835584473,44.507927562011204,NaN,NaN,132.90284058596552,100.98046685418845,1.3620946604065376,-0.08121288836390761,-1.4433075487704452,-296542723,-333312719.8,51.905154384985316,31.84590909944514,NaN,NaN,-1.2962159890539944,-16.486395068956938
2009-03-24T09:30:00-04:00,81.24001,82.36,80.50999,80.60001,330843904,411877401.6,56.678181328800065,46.2579626072292,NaN,NaN,124.16049502637968,111.75271016014935,1.3256598609687757,0.2137672774405246,-1.1118925835282512,-627386627,-380674153.4,50.81812370980174,34.325227161719916,NaN,NaN,1.3230137025221977,-13.94219381588849
2009-03-25T09:30:00-04:00,81.23,82.7,79.06,81.45,441995008,410875174.4,58.15808184881407,48.40365614907484,NaN,NaN,111.79518541996745,111.19104241721001,1.2977112425903035,0.5102464697096281,-0.7874647728806753,-185391619,-434347062.2,49.55162659704975,36.822481011241635,NaN,NaN,3.8779171688679464,-11.396463675209
2009-03-26T09:30:00-04:00,82.25,83.3,81.32001,83.11,422025216,413807872,60.96276524813199,50.72127386477447,NaN,NaN,124.61921681698078,112.50555625901647,1.325281910300538,0.8691376149949974,-0.4561442953055407,236633597,-317895478.2,52.327673961644045,39.54832917586576,NaN,NaN,6.89706009518075,-8.783103136581893
2009-03-27T09:30:00-04:00,82.05,82.53,81.31,81.61,322343680,406396608,57.22973226678019,52.85100734865443,NaN,NaN,99.04076190019768,118.50369994989823,1.1815212877697652,1.0207573144066657,-0.1607639733630994,-85710083,-191679491,55.20483702573264,42.506956816521196,NaN,NaN,8.211064218923957,-6.3553649429382
2009-03-30T09:30:00-04:00,79.8,79.87,77.96001,78.78999,324108544,401279372.8,50.917172279076524,53.63453047392751,NaN,NaN,47.263764912201296,101.37588481514538,0.8509768207128756,0.9029570525279951,0.051980231815119515,-409818627,-214334671.8,54.56822359450759,45.18166957081054,NaN,NaN,7.279009606731317,-4.40759715012827
2009-03-31T09:30:00-04:00,79.56,81.08,79.05,79.52,364238336,397303232,52.38144790849558,54.432247775521525,NaN,NaN,58.67686691332198,88.27915919253385,0.645301980270019,0.8586077071526432,0.21330572688262428,-45580291,-97973404.6,57.29236578526832,47.863211287566706,NaN,NaN,6.984472870098292,-2.78015857581019
2009-04-01T09:30:00-04:00,78.53,81.42,78.33,81.06,377018368,393015987.2,55.40394763937636,54.93632247858467,NaN,NaN,60.16814370120577,77.95375084878151,0.5788957134312107,0.9369253686716377,0.35802965524042696,331438077,5392534.6,59.60925674730612,50.12847173504263,NaN,NaN,7.665306726919339,-1.2879492468488287
2009-04-02T09:30:00-04:00,83.08,84.61,81.12959,83.42999,476230912,392549977.6,59.64875070457753,55.64674502873964,NaN,NaN,103.97552889962041,73.82501326530944,0.6549100190481927,1.1766671790506678,0.5217571600024751,807668989,119599613,62.05840945100264,52.11639270932918,NaN,NaN,9.588027413811545,0.26576170467408167
2009-04-03T09:30:00-04:00,83.49001,84.28,82.67,84.25999,284646144,382257523.2,61.04710472385865,56.49574863787908,NaN,NaN,111.59475675742729,76.33581223675536,0.7164347483166844,1.4173005953983306,0.7008658470816462,1092315133,355204656.2,66.5628377270719,54.01389647667221,NaN,NaN,11.580719628321491,1.88218426519514
2009-04-06T09:30:00-04:00,83.34,84.2747,82.28999,83.60001,264866560,376505484.8,59.28771430269145,56.83461970899556,NaN,NaN,103.04232971870253,87.49152519805561,0.668932521420332,1.5370314988570613,0.8680989774367293,827448573,602658096.2,70.52129643873212,55.838684450509774,NaN,NaN,12.701457881078404,3.427794781749892
2009-04-07T09:30:00-04:00,82.25,82.64999,81.50999,81.64999,259071936,369147542.4,54.30747998523691,56.560626978024,NaN,NaN,64.27792953674162,88.61173772273953,0.4717324842718209,1.4577645827765053,0.9860320985046844,568376637,725449481.8,72.27527029302344,57.435366899210926,NaN,NaN,12.185662369661072,4.67891872288006
2009-04-08T09:30:00-04:00,82.06,82.94,81.53999,82.53,230402752,362827180.8,56.09967803138247,56.605799077998554,NaN,NaN,70.25687739277697,90.62948446105378,0.37057304097126775,1.449248399718769,1.0786753587475013,798779389,818917744.2,73.5646497788014,59.01953586182522,NaN,NaN,12.273638312814175,5.763878664299219
2009-04-09T09:30:00-04:00,84.67,85.82001,84.33,85.81,269653504,355818924.8,62.07115101837671,57.4754296886745,NaN,NaN,152.73101606455805,100.3805818940413,0.4872300705211745,1.6877129468989693,1.2004828763777948,1068432893,871070525,74.2833146405919,60.7530742953942,NaN,NaN,14.207421068441104,6.970099007748059
2009-04-13T09:30:00-04:00,84.92,86.53999,84.58,85.83,224847440,350187568.8,62.10499929187351,57.592729041247985,NaN,NaN,152.1036879075938,108.48236812407461,0.525138811259009,1.856906390451556,1.331767579192547,1293280333,911263565,74.85076029130008,62.392046145845256,NaN,NaN,15.757449300425844,8.225434763844886
2009-04-14T09:30:00-04:00,85.03,85.75999,84.08,84.35001,276598784,345976445.6,57.981465882396655,57.68582079507631,NaN,NaN,110.48985863507859,109.97187390734982,0.4147796562212396,1.8502421494690964,1.4354624932478568,1016681549,949110160.2,75.40116787868547,64.14797787219409,NaN,NaN,15.876176515670611,9.31839787124856
2009-04-15T09:30:00-04:00,83.84,85.42,83.61,85.25,250726064,340658988.8,59.73237095884096,57.79827001722109,NaN,NaN,102.84491388496755,117.685270776995,0.36821366259966704,1.8957295714974407,1.5275159088977737,1267407613,1088916355.4,77.37133375854457,66.13509981230087,NaN,NaN,16.476535809757,10.340989005321195
2009-04-16T09:30:00-04:00,85.92999,87.14999,84.77,86.5,335202816,333741510.4,62.09489594454457,57.87913649553627,NaN,NaN,134.3447964464869,130.50285458773698,0.3855706401009418,2.009479209023951,1.623908568923009,1602610429,1249682563.4,79.41321238837536,68.06978112849596,NaN,NaN,17.6670601784954,11.387570601488939
2009-04-17T09:30:00-04:00,86.83,87.64999,86.14,87.08,262648944,325444095.2,63.174517292085916,58.30376399734382,NaN,NaN,142.7797946279078,128.51261030040695,0.39844678782706433,2.1219670537068396,1.7235202658797752,1865259373,1409047859.4,81.2220622876093,69.92815436148716,NaN,NaN,18.964014812411403,12.469919774477862
2009-04-20T09:30:00-04:00,85.53999,87.0489,83.34,83.42999,293690112,321570316,52.9530055975903,58.44918066295195,NaN,NaN,58.55159750337558,109.80219221956331,0.13698195236527977,1.894747706336375,1.7577657539710951,1571569261,1464705645,81.82276369871953,71.87490722607372,NaN,NaN,17.030719303853704,13.121462564388697
2009-04-21T09:30:00-04:00,82.82001,85.13,82.75,85.06,300478464,315581874.4,56.349590086023376,58.73261938991823,NaN,NaN,43.12023076856885,96.32826664626135,0.05391825396692784,1.825163571429755,1.771245317462827,1872047725,1635778880.2,83.56323886224261,73.75139816014332,NaN,NaN,16.42945654385794,13.594033132884302
2009-04-22T09:30:00-04:00,84.28999,86.34,84.07001,84.53999,340395008,316059429.6,54.985739733701195,58.70274739665571,NaN,NaN,61.38501112106279,88.0362860934804,-0.050304875766720825,1.708364222754426,1.7586690985211468,1531652717,1688627901,84.07066992420219,75.49864195849304,NaN,NaN,15.533244115473167,13.87106327325414
2009-04-23T09:30:00-04:00,84.71001,85.42,83.63,85.37,324903680,310204863.2,56.78369906068049,58.49810085066307,NaN,NaN,49.72113844512026,71.11155449320708,-0.07605700095920787,1.6635978473221371,1.739654848281345,1856556397,1739417094.6,84.56386466635666,77.10617447387547,NaN,NaN,15.300244956688767,14.075232085173372
2009-04-24T09:30:00-04:00,86.03,87.31,85.69,86.66,287703040,303488754.4,59.491793640467655,58.38700720184943,NaN,NaN,104.96151034276001,63.54789763617752,-0.021746215315895823,1.7124720791364751,1.734218294452371,2144259437,1795217107.4,85.10934899258739,78.43092527855515,NaN,NaN,15.881743343348365,14.333305122055513
2009-04-27T09:30:00-04:00,85.67999,87.00999,85.53999,85.84,289581568,301850648.8,57.04475524679115,58.22679584071369,NaN,NaN,82.29247173468195,68.29607248243879,-0.05470631599653952,1.6658353994566966,1.720541715453236,1854677869,1851838829,85.66299919524327,79.5124754754488,NaN,NaN,15.674402433554347,14.524890452269632
2009-04-28T09:30:00-04:00,84.97,86.59,84.75999,85.57001,247927872,298041615.2,56.22472556057818,58.36374195323806,NaN,NaN,60.48713906915442,71.76945414255589,-0.10541325452888861,1.5887751472921252,1.6941884018210138,1606749997,1798779283.4,82.56498898319948,80.24745538188994,NaN,NaN,15.277021991225581,14.632337814977625
2009-04-29T09:30:00-04:00,86.52,88.36,86.3,87.39,311505664,295404981.6,60.36128636111067,58.668142548218654,NaN,NaN,134.94806491697645,86.48206490173864,-0.030967526550572888,1.6554789936327978,1.6864465201833707,1918255661,1876099872.2,83.50137236941954,80.95722128121982,NaN,NaN,16.091500431967162,14.8407896174047
2009-04-30T09:30:00-04:00,88.55,89.02,86.92,87.42,301419776,291625052,60.4276666487301,58.55075080752961,NaN,NaN,148.79189125812013,106.29621546433859,0.0038565013103120105,1.6912671468212608,1.6874106455109488,2219675437,1948723680.2,84.35147884223338,81.67637586705133,NaN,NaN,16.778668893246813,15.117629513953574
2009-05-01T09:30:00-04:00,87.44,88.21001,86.72,87.89,236110320,279619022.4,61.51502348691839,58.50860967860425,NaN,NaN,123.75522524677493,110.0549584451416,0.04009186438624024,1.737525475993749,1.6974336116075088,2455785757,2011028944.2,85.06258018058432,82.40579157342879,NaN,NaN,17.65214025710279,15.479702477260604
2009-05-04T09:30:00-04:00,88.55,90.94,88.38,90.88,287119872,279742708.8,67.61209515041392,59.19651176917692,NaN,NaN,209.70019652391218,135.53650340298762,0.2360414427761377,1.992485415077681,1.7564439723015433,2742905629,2188674496.2,86.89161385563627,83.22653771463956,NaN,NaN,20.29172455564392,16.167134202743934
2009-05-05T09:30:00-04:00,90.57001,90.92999,89.84,90.57001,243036256,278651193.6,66.43692493527095,59.675408481779066,NaN,NaN,190.5909415002903,161.5572638892148,0.3106891578397579,2.1448054196012407,1.8341162617614828,2499869373,2367298371.4,88.42620208288793,84.01617116637837,NaN,NaN,22.133900415574658,17.019529376005465
2009-05-06T09:30:00-04:00,91.67999,92.2,90.61,92.14101,291941120,280294652.8,69.34490993774345,60.19326662415041,NaN,NaN,202.83757843411925,175.13516659264334,0.4247263224326594,2.365024164802307,1.9402978423696475,2791810493,2542009337.8,89.69672699667116,84.7507079241138,NaN,NaN,24.611250339879657,18.104060942273208
2009-05-07T09:30:00-04:00,93.00999,93.14999,90.28,90.86,317800448,284664537.6,64.44193147808588,60.2837962088647,NaN,NaN,164.97187451473522,178.37116324396635,0.3744973616978866,2.4084195444920056,2.033922182794119,2474010045,2592876259.4,90.03956241436114,85.38052936173892,NaN,NaN,25.318345315058856,19.1346729955283
2009-05-08T09:30:00-04:00,92.03,93.22,90.911,92.98,299081728,286135948.8,68.42124717495096,61.388670607247604,NaN,NaN,163.2679644056179,186.27371107573498,0.44013361867273115,2.584089206135033,2.143955587462302,2773091773,2656337462.6,90.46580048748106,85.99788913236475,NaN,NaN,27.167367792447322,20.28220082365959
2009-05-11T09:30:00-04:00,91.7,92.11,91.03999,91.24001,247923568,287289755.2,62.26250018104662,61.81102132832069,NaN,NaN,115.66313460849064,167.46629869265067,0.3276124906699005,2.5534712007996774,2.225858710129777,2525168205,2612789977.8,87.69263120901519,86.29284572856277,NaN,NaN,26.838815502691286,21.218860063521262
2009-05-12T09:30:00-04:00,91.63,91.83,89.85001,90.97,282431232,287581377.6,61.33979810199139,62.26488264034141,NaN,NaN,86.70047032706724,146.68820445800606,0.20238830303068855,2.4788440889181373,2.276455785887449,2242736973,2561363497.8,84.40219046589625,86.31652576725521,NaN,NaN,26.298514778425584,21.944525022793307
2009-05-13T09:30:00-04:00,89.74001,90.00999,88.5,88.67999,269618944,288526021.6,54.02693435665473,62.06797087576815,NaN,NaN,30.102954048176745,112.14127958081755,-0.053606422243478224,2.209447758083101,2.2630541803265793,1973118029,2397625005,74.78095874671375,85.617746772995,NaN,NaN,23.51694205832258,22.16915602786892
2009-05-14T09:30:00-04:00,88.72,90.12,88.5,89.44,260098624,284770812,55.90578959831318,61.81182772989997,NaN,NaN,33.9608332846815,85.9390713348068,-0.18337858967390908,2.033830943234193,2.217209532908102,2233216653,2349466326.6,72.17497296680907,84.69386277115369,NaN,NaN,21.787672585899244,22.114658393301823
2009-05-15T09:30:00-04:00,89.37,90,88.14999,88.71001,271502592,285213494.4,53.638290758832724,61.56850883790293,NaN,NaN,19.76530774739794,57.238540003162804,-0.3219043939189321,1.8148290405094372,2.1367334344283693,1961714061,2187190784.2,64.0725284153329,83.15168628687438,NaN,NaN,19.673725067626,21.76595363249099
2009-05-18T09:30:00-04:00,89.55,91.34,88.57021,91.23,242217248,282639851.2,59.71295515438673,61.81766809460355,NaN,NaN,55.39960624355583,45.18583433017584,-0.2505152402892046,1.8235893840668638,2.0741046243560683,2203931309,2122943405,61.145795655437915,81.62174390632,NaN,NaN,19.652413654241485,21.46401934988392
2009-05-19T09:30:00-04:00,91.17999,91.97,90.81,91.12,206102192,277921037.6,59.34740820893056,61.74524822659068,NaN,NaN,77.96037298814387,43.43781486239118,-0.2185666379475384,1.8008963269216451,2.0194629648691835,1997829117,2073961833.8,58.935501041432104,79.86703881146374,NaN,NaN,19.526913251019334,21.18728990718898
2009-05-20T09:30:00-04:00,91.95,92.8,90.41,90.50999,285898240,275196199.2,57.254207119540624,61.5185725459343,NaN,NaN,70.29085863926193,51.47539578060823,-0.24442472009621308,1.7139320647489171,1.9583567848451302,1711930877,2021724403.4,56.58625608926515,77.88380861482317,NaN,NaN,18.817105000336404,20.848692063352896
2009-05-21T09:30:00-04:00,89.46001,89.8,88.25999,89.21001,258988368,271900433.6,52.96677620637332,60.90798345446679,NaN,NaN,-13.761723275693218,41.930884468533286,-0.34863456891227473,1.5225635737047867,1.8711981426170614,1452942509,1865669574.6,50.15434575589707,75.39036329877408,NaN,NaN,16.94175975767653,20.2905588768277
2009-05-22T09:30:00-04:00,89.46001,90,88.67999,89.02,166811872,265855875.2,52.34971460889805,59.817813415787086,NaN,NaN,-14.549535441537927,35.06791583074612,-0.424860633664196,1.3401223505368165,1.7649829842010125,1286130637,1730552889.8,45.348114055285976,72.42297045589191,NaN,NaN,15.227401161946668,19.567250631844693
2009-05-26T09:30:00-04:00,88.36,91.56,88.32001,91.3,236318432,263192718.4,58.584617923477815,59.25693434351615,NaN,NaN,28.990127963096764,29.7860201746543,-0.32095249729794695,1.3637923625785788,1.6847448598765258,1522449069,1594256441.8,41.072419600644814,69.04055742144598,NaN,NaN,15.505915207853867,18.98705985698886
2009-05-27T09:30:00-04:00,91.44,91.75,89.53,89.67,246313504,263112000,53.222942281436445,58.10536522520851,NaN,NaN,16.947757109798413,17.58349699898521,-0.35838231952229327,1.236766960473659,1.5951492799959524,1276135565,1449917731.4,37.08469539369122,65.28255516409027,NaN,NaN,14.103719323222647,18.289439780736544
2009-05-28T09:30:00-04:00,90.46001,91.34,89.10001,90.92,289094912,261991462.4,56.51004296175521,57.53880175975632,NaN,NaN,18.185415648245154,7.162408400781854,-0.29782620529475823,1.2228665233775047,1.520692728672263,1565230477,1420577651.4,36.312905682894424,61.44493682612836,NaN,NaN,13.919084872946927,17.665103365338027
2009-05-29T09:30:00-04:00,91.42,93.7,90.67999,92.53,258641376,259852542.4,60.37261073362283,56.96389915680431,NaN,NaN,132.98865712521345,36.51248448096319,-0.15537569083398095,1.3264731151297866,1.4818488059637676,1823871853,1494763520.2,39.72845953204799,57.82084104359743,NaN,NaN,14.967204465798067,17.27968923683232
2009-06-01T09:30:00-04:00,93.67,95.17,93.42999,94.77,276246784,261859365.6,65.02666088214781,57.16133920688294,NaN,NaN,237.73001699514217,86.96839496829921,0.07149641661226025,1.5712193267290928,1.4997229101168326,2100118637,1657561120.2,46.508135425149064,54.879091344749845,NaN,NaN,17.4113811584632,17.298502368493875
2009-06-02T09:30:00-04:00,94.39999,95.37,87.53,94.85001,230874432,259047093.6,65.18394904587859,57.4359214171606,NaN,NaN,103.96041689430209,101.96245275454027,0.201380861797825,1.751448987364114,1.550068125566289,2330993069,1819269920.2,52.25339289895976,52.58274866139725,NaN,NaN,19.387402967647173,17.59691673980149
2009-06-03T09:30:00-04:00,94.03999,94.13,92.75999,93.64999,235403936,258665477.6,60.7695284742782,57.91753528270514,NaN,NaN,137.3421751577072,126.04133636412203,0.18151905006544267,1.7769669381480924,1.5954478880826497,2095589133,1983160633.8,57.26328396055675,51.33148617667174,NaN,NaN,19.730488857610055,17.901712756631284
2009-06-04T09:30:00-04:00,94,94.67,93.3,94.53,210102256,254573534.4,62.761177401842005,58.407205840100055,NaN,NaN,150.73819837411983,152.55189290929698,0.201169311193095,1.8469095270740183,1.6457402158809233,2305691389,2131252816.2,61.22265587202476,50.54917781275857,NaN,NaN,20.613317385164645,18.289084846421765
2009-06-05T09:30:00-04:00,95.49001,95.67,93.8,94.55,284257792,252896401.6,62.80739133915567,59.06214159583741,NaN,NaN,148.96490160504456,155.7471418052632,0.18921254034213209,1.8822558913085885,1.6930433509664564,2589949181,2284468281.8,64.85088496234138,50.60477470897346,NaN,NaN,21.340529583994943,18.725005523217934
2009-06-08T09:30:00-04:00,93.84,95.10001,93.03999,94.16,238565120,249870571.2,61.21212292567101,59.169225008072,NaN,NaN,112.02264710319004,130.60566782687278,0.13147539204413095,1.8573875910216202,1.7259121989774893,2351384061,2334721366.6,65.9753729440967,50.94974451530623,NaN,NaN,21.513871429147986,19.1234149383508
2009-06-09T09:30:00-04:00,94.69,95.145,94.02,94.64,225125440,248730664.8,62.47540501192602,59.3926533511431,NaN,NaN,113.07381390019435,132.42834722805122,0.10329237530367585,1.855027668107084,1.7517352928034082,2576509501,2383824653,67.0834926732761,51.531743917580805,NaN,NaN,22.00143758149928,19.534561030229153
2009-06-10T09:30:00-04:00,95.48,95.49001,93.19,94.39999,296100352,249414120.8,61.398603629791154,59.688681673303854,NaN,NaN,91.34870382133018,123.22965296077582,0.04892593563000247,1.8128927123409113,1.7639667767109088,2280409149,2420788656.2,67.93021779844716,52.34202689680809,NaN,NaN,22.132043011242924,19.905629884659692
2009-06-11T09:30:00-04:00,94.58,96.11,94.56,94.82001,275414016,249703874.4,62.613032496126415,60.37769997971479,NaN,NaN,106.49401482358972,114.3808162506698,0.023008272868531687,1.7927271177965736,1.7697188449280419,2555823165,2470815011.4,69.0891144122373,53.69451037226098,NaN,NaN,22.55801934962561,20.28454266536911
2009-06-12T09:30:00-04:00,94.39999,95.14,94,95.08,184373008,245917593.6,63.381007032047805,61.1656494385112,NaN,NaN,84.02929343010634,101.39369461568215,0.006015217791407235,1.777237867167301,1.7712226493758938,2740196173,2500864409.8,69.79518237138527,55.44072953769665,NaN,NaN,23.1181049378512,20.689337275723695
2009-06-15T09:30:00-04:00,93.96001,94.02,92.39999,92.89999,224190432,243551985.6,53.46411688570421,60.79989936438452,NaN,NaN,22.30741915915058,83.45064902687426,-0.16022207167393998,1.5709450597834689,1.7311671314574089,2516005741,2533788745.8,70.58791510936767,57.548979216891134,NaN,NaN,20.856521066110385,20.713220674350364
2009-06-16T09:30:00-04:00,93.23,93.28999,91.58,91.64,227319008,242807073.6,48.71938714959657,60.478216854967386,NaN,NaN,-16.894427800497727,57.45700068673584,-0.3522096169281874,1.2909051102971745,1.643114727225362,2288686733,2476224192.2,67.2639552064062,59.70464063208506,NaN,NaN,17.455578818685467,20.247843266398235
2009-06-17T09:30:00-04:00,91.60001,92.33,90.83,91.55,223445312,243674229.6,48.38905086469177,59.89814599089142,NaN,NaN,-41.42762747421748,30.901734427626288,-0.47480383382725977,1.0496099349412873,1.524413768768547,2065241421,2433190646.6,64.80707209784921,61.73993823315326,NaN,NaN,14.573531576942395,19.437227310761685
2009-06-18T09:30:00-04:00,91.69,92.67,91.25,92.21899,211725056,239965570.4,51.04612306345887,59.23196830016543,NaN,NaN,-24.6821106472227,4.666509333463802,-0.4979579228170965,0.9019663652471763,1.3999242880642728,2276966477,2377419309,61.66353130888649,63.30672907435601,NaN,NaN,12.814595218703802,18.491137011896274
2009-06-19T09:30:00-04:00,92.58,92.7,91.52,92.03999,215655568,237798930.4,50.29993716009981,58.18005946287628,NaN,NaN,-32.081987399132245,-18.555746832383914,-0.510552884411791,0.7617331825495341,1.2722860669613252,2061310909,2241642256.2,54.70633411925473,63.89231469536355,NaN,NaN,11.139737829574822,17.440937128707496
2009-06-22T09:30:00-04:00,91.14,91.19,89.25,89.28,251913568,242054015.2,40.4753547141687,56.41515986775415,NaN,NaN,-134.4210461620151,-49.90143989661705,-0.6794184396594549,0.4230130173870066,1.1024314570464615,1809397341,2100320576.2,48.5645771171125,63.62882785380304,NaN,NaN,6.425120384075725,15.86724902233153
2009-06-23T09:30:00-04:00,89.47,89.88,88.85001,89.35001,188309680,239653577.6,40.79126928885253,54.98814135450946,NaN,NaN,-151.74145471019634,-76.87084527855677,-0.7552266434409356,0.158398152745292,0.9136247961862276,1997707021,2042124633.8,46.261323981219775,62.842973569564684,NaN,NaN,2.7247321955800907,13.989746618509896
2009-06-24T09:30:00-04:00,90.16,91.08,89.60001,90.118,211577632,237916784,44.28451347197387,53.668379645233166,NaN,NaN,-111.2894533426757,-90.84321045224843,-0.7224695435560541,0.010537866741159974,0.7330074102972141,2209284653,2070933280.2,47.586519297623184,61.86896381425028,NaN,NaN,0.567517330983585,12.072285291720423
2009-06-25T09:30:00-04:00,89.67,92.17,89.57001,92.08,279410944,237432585.6,52.065266525204706,52.90108501566523,NaN,NaN,-70.45210263569203,-99.99720884994228,-0.5455374128917998,0.05108564418246431,0.5966230570742641,2488695597,2113279104.2,49.55566455339508,60.776448070754114,NaN,NaN,1.0219304076377325,10.493663165422896
2009-06-26T09:30:00-04:00,91.77,92.24001,91.27,91.84,167579008,232879467.2,51.124734278156424,52.18055725512848,NaN,NaN,-45.27106518195625,-102.63502440650709,-0.426797346337079,0.06312637415291533,0.48992372048999433,2321116589,2165240240.2,51.941590070778126,59.77403500837422,NaN,NaN,1.1107860047380111,9.153252142467913
2009-06-29T09:30:00-04:00,92.11,92.82001,91.60001,92.7,168481248,227491190.4,54.30981472851213,51.59730080631319,NaN,NaN,-14.975044397466085,-78.74582405359729,-0.2795833010120961,0.1404445942248742,0.4200278952369703,2489597837,2301280339.4,57.59642504732301,59.09638732080615,NaN,NaN,2.1436331706646516,8.151878003638876
2009-06-30T09:30:00-04:00,92.72,93.06,91.27,91.95,228888192,227391878.4,51.17755134829133,50.86722564334893,NaN,NaN,-26.562118224322813,-53.709956756422585,-0.2243487327916912,0.13959197924735633,0.36394071203904754,2260709645,2353880864.2,59.57698094862615,58.499727545818935,NaN,NaN,2.0997346729482036,7.287286099254494
2009-07-01T09:30:00-04:00,92.34,93.23,92.21001,92.33,173041056,224273734.4,52.6670846691538,50.156800798565165,NaN,NaN,-1.507988687709275,-31.7536638254293,-0.15703530996168658,0.16764657458693932,0.3246818845486259,2433750701,2398774073.8,61.24090508526668,57.939141165321026,NaN,NaN,2.4937437279300716,6.6024943319224345
2009-07-02T09:30:00-04:00,91.13,92.3624,89.75999,89.81,212309808,224384112,43.24462248370826,48.71848761654091,NaN,NaN,-87.1967675776309,-35.102596813817065,-0.2703930857584293,-0.013309472649410736,0.25708361310901856,2221440893,2345323133,58.17069288466084,57.10882048769786,NaN,NaN,-0.1515439190555444,5.637631724639866
2009-07-06T09:30:00-04:00,88.94,89.92999,88.66,89.8,174499568,218896200.8,43.21158480987312,47.9861638968387,NaN,NaN,-133.84612267383125,-52.81760831219206,-0.3302510500298703,-0.15573019942831934,0.17452085060155098,2046941325,2290488080.2,55.117835326558506,56.00381478892577,NaN,NaN,-2.2497639737015915,4.510860910591086
2009-07-07T09:30:00-04:00,89.71001,89.82001,88,88.06,197088880,216822388.8,37.80023311081179,47.206224322639784,NaN,NaN,-153.04458710047712,-80.43151685279426,-0.46309036496177053,-0.4043421056006622,0.058748259361108335,1849852445,2162539001.8,48.69599989888933,54.677532266960284,NaN,NaN,-5.856528853586915,3.029805229994229
2009-07-08T09:30:00-04:00,88.59,88.8,87,88,248050496,217968641.6,37.62525982021339,46.43738210517704,NaN,NaN,-160.3002110353526,-107.17913541500022,-0.5264401683796437,-0.5993019511134463,-0.07286178273380262,1601801949,2030757462.6,43.12312446461539,53.12867886458644,NaN,NaN,-8.778004360448964,1.3429752885023443
2009-07-09T09:30:00-04:00,88.61,88.89999,87.91,88.17,163777568,211352502.4,38.49397477452558,45.54080008453895,NaN,NaN,-125.3614846940083,-131.94983461626003,-0.5270364645306416,-0.7316573633971046,-0.20462089886646304,1765579517,1897123225.8,38.33241263773795,51.46217038807583,NaN,NaN,-10.920667095842687,-0.4089736235469459
2009-07-10T09:30:00-04:00,87.7,88.49001,87.35001,87.96001,173520256,206257814.4,37.79377305258307,44.64750264828775,NaN,NaN,-126.01900425120802,-139.71428195097545,-0.5113176705975344,-0.843767987113381,-0.3324503165158466,1592059261,1771246899.4,34.45009345501492,50.015296054915844,NaN,NaN,-12.897459127155425,-2.1930429812053003
2009-07-13T09:30:00-04:00,88.31,90.17,87.59,90.10201,217413376,207909832.8,48.15364092873951,45.195951663614245,NaN,NaN,-61.542307291072525,-125.2535188744237,-0.3349329959048642,-0.7511165613969268,-0.41618356549206265,1809472637,1723753161.8,33.088404600392934,48.909855160864446,NaN,NaN,-11.608979265150564,-3.5381767360546235
2009-07-14T09:30:00-04:00,90.38,90.69,89.73,90.61,181555376,205778080,50.26892445955435,45.87292703295009,NaN,NaN,-7.8735422528082575,-96.21930990488994,-0.1706077566837504,-0.6294432613467507,-0.45883550466300027,1991028013,1751988275.4,34.73988412390969,48.08689517105659,NaN,NaN,-9.901172430291332,-4.447176120945581
2009-07-15T09:30:00-04:00,91.81,93.50999,90.6795,93.25999,220877808,205456020,59.54208151263621,46.962753321568826,NaN,NaN,95.21755385205718,-45.115756927407986,0.1146309469246492,-0.3155468210071888,-0.430177767931838,2211905821,1874009049.8,41.463841435484625,47.649561038046684,NaN,NaN,-5.121477125745139,-4.543504835916947
2009-07-16T09:30:00-04:00,93,94.50999,92.82001,94.14999,231174496,205842479.2,62.09825002424051,47.67939500007138,NaN,NaN,143.14516979808562,8.585573971010794,0.3481234660922157,0.004976564683431661,-0.34314690140878407,2443080317,2009509209.8,47.88522600620449,47.53024399896164,NaN,NaN,-0.3511441756777485,-3.9445961701684897
2009-07-17T09:30:00-04:00,94.06,94.32001,93.53999,94.13,138561680,202184310.4,62.00349340102536,48.456449223133454,NaN,NaN,136.6486905716396,61.119112935580326,0.47807553596479485,0.2544475185472095,-0.22362801741758537,2304518637,2152001085,53.64418115142553,47.65185764757932,NaN,NaN,3.3601361953485274,-2.9010629750946304
2009-07-20T09:30:00-04:00,94.67999,95.28999,94.19,95.131,164179376,199610500.8,64.8924234871561,49.21234984875088,NaN,NaN,152.7026323754085,103.96810086887653,0.6003857216227773,0.5268541346108861,-0.07353158701189105,2468698013,2283846160.2,58.242278145360835,47.697990011724876,NaN,NaN,7.433154032358449,-1.4247462597441904
2009-07-21T09:30:00-04:00,95.87,95.89999,94.42,95.57001,217718256,197900735.2,66.10944177294004,50.2789134505115,NaN,NaN,144.3689732587695,134.41660397119207,0.6742611308687447,0.7692948265740398,0.09503369570529513,2686416269,2422923811.4,62.47108630158905,47.9047118226508,NaN,NaN,11.155128152451542,0.3723786562837712
2009-07-22T09:30:00-04:00,94.96001,96.13,94.89,95.55,196067568,198288629.6,65.99714203553451,51.23106040525298,NaN,NaN,133.42112177748533,142.05731755627772,0.6830755280193684,0.9488781057295057,0.26580257771013727,2490348701,2478612387.4,64.04136878665572,48.104744944178556,NaN,NaN,14.138662395384646,2.3389906190124674
2009-07-23T09:30:00-04:00,95.61,98.08,95.53,97.661,258795504,200649523.2,71.49785118359497,53.249148169530606,NaN,NaN,158.76991569667942,145.18226673599648,0.7850880904379175,1.2471626907575342,0.46207460031961667,2749144205,2539825165,65.7383637377585,48.64529286225696,NaN,NaN,18.69629908396696,4.675748971148823
2009-07-24T09:30:00-04:00,97.2,98.14,96.69,98.06,154003008,194379126.4,72.4064662384939,55.33449684300353,NaN,NaN,149.56936781243678,147.7664021841559,0.8291225751871997,1.4984778193036163,0.6693552441164167,2903147213,2659550880.2,68.83619600799176,49.625175768073625,NaN,NaN,22.703150697561377,7.251092074922045
2009-07-27T09:30:00-04:00,97.88,98.39999,97.34,98.35001,159259376,193963144.8,73.07825131496163,57.85435528615709,NaN,NaN,137.76859686224435,144.77959508152307,0.8256639383787279,1.7014351670898265,0.8757712287110986,3062406589,2778292595.4,71.58069925315745,51.25979715052135,NaN,NaN,26.19777331810722,9.9577608239485
2009-07-28T09:30:00-04:00,97.66,98.37,97.06,97.89,186685680,194873366.4,70.16045862394711,60.17829805785235,NaN,NaN,113.59423792381276,138.62464801453174,0.7428724611824149,1.8043618051891173,1.0614893440067024,2875720909,2816153523.4,72.4148811562238,53.35206548563623,NaN,NaN,28.321120787998016,12.581097961669858
2009-07-29T09:30:00-04:00,97.44,98.088,96.98,97.65199,194399312,193148922.4,68.63354203683039,62.33112429087413,NaN,NaN,96.09833505663947,131.16009067036256,0.6271711273654204,1.8454532532134778,1.2182821258480574,2681321597,2854348102.6,73.26736147325099,55.847418973887166,NaN,NaN,29.67660175011807,15.023312788591031
2009-07-30T09:30:00-04:00,98.83,99.83,98.60001,98.67,225575376,195775638.4,71.49139800824078,64.73809750199254,NaN,NaN,111.03820035154949,121.6137476013366,0.5756346003398378,1.9378253762728548,1.362190775933017,2906896973,2885898656.2,73.98261992784634,58.6711708648037,NaN,NaN,31.698425360495207,17.405471727434485
2009-07-31T09:30:00-04:00,98.64999,99.47,98.38,98.81,207357936,195528044.8,71.87096666355087,66.4321921973362,NaN,NaN,98.37343442983769,111.37456092481679,0.5096724263373733,1.9992813088547337,1.4896088825173603,3114254909,2928120195.4,74.94859308104306,61.66118432770728,NaN,NaN,33.47944490464999,19.701753609893842
2009-08-03T09:30:00-04:00,99.85001,100.53,99.31,100.44,175776880,195591910.4,75.89503365423255,68.26262856838466,NaN,NaN,110.79250040678826,105.97934163372558,0.5320530549721174,2.154675201232507,1.6226221462603898,3290031789,2973645235.4,75.98398186426485,64.60719130916122,NaN,NaN,36.34686374929553,22.079626486951227
2009-08-04T09:30:00-04:00,99.99001,100.84,99.78,100.7,176714496,194573191.2,76.47318814149776,69.47199332758906,NaN,NaN,108.88580578758143,105.03765520647933,0.519989155314335,2.2726085904033084,1.7526194350889734,3466746285,3091850310.6,78.47195865211108,67.25062825320596,NaN,NaN,38.87888770441047,24.47952094658826
2009-08-05T09:30:00-04:00,100.77,100.855,99.58,100.41,184726368,191406984.8,74.33167557474954,70.3458094383397,NaN,NaN,99.21682740322407,105.66135367579625,0.4506836266112717,2.315973968353063,1.8652903417417914,3282019917,3211989974.6,80.66444517544333,69.59200105100874,NaN,NaN,40.40024379531088,26.753909924977204
2009-08-06T09:30:00-04:00,100.87,101.02,99.42,99.89,193203744,192878293.6,70.51835236465129,70.95401365002728,NaN,NaN,88.8048154822193,101.21467670193022,0.33342800228678504,2.2820753446002726,1.9486473423134876,3088816173,3248373814.6,81.2860365704166,71.56641929522239,NaN,NaN,40.644441217899086,28.73827153825176
2009-08-07T09:30:00-04:00,100.94,102.03,100.39,101.202,220684368,195236499.2,74.1251568035197,71.6134946011961,NaN,NaN,108.03364971695196,103.14671975935308,0.3084189308085268,2.334171005824146,2.0257520750156193,3309500541,3287422941,81.95647248946017,73.26029031980092,NaN,NaN,41.920466249239944,30.62144221125007
2009-08-10T09:30:00-04:00,100.74001,101.22,100.27,100.99001,130898624,190910761.6,72.58006454152263,72.07568194180914,NaN,NaN,96.12530037732758,100.21327975346092,0.24457879778247937,2.3314755722437184,2.086896774461239,3178601917,3265136966.6,80.19075671302703,74.52598106347504,NaN,NaN,42.52966429739385,32.322616794984896
2009-08-11T09:30:00-04:00,100.53999,100.61,99.46001,99.73,157301008,189698043.2,64.03614287773743,71.93561057339505,NaN,NaN,68.107863720782,92.05769134010104,0.09230708033744461,2.202280624883045,2.1099735445456003,3021300909,3176047891.4,73.38434136749679,75.19333624782084,NaN,NaN,40.48856580048724,33.48918093862809
2009-08-12T09:30:00-04:00,99.56,101.56,99.50999,100.8,219052368,189606771.2,67.53153667804169,71.65230239442697,NaN,NaN,82.7290216660417,88.76013019266456,0.041075902392546215,2.161318422536283,2.1202425201437367,3240353277,3167714563.4,72.76221479092071,75.69503989447527,NaN,NaN,39.76455388018779,34.38566278742233
2009-08-13T09:30:00-04:00,101.25999,101.61,100.25999,101.57001,176449504,186870521.6,69.80584820753934,71.4665439636445,NaN,NaN,92.8047579762109,89.56011869146289,0.03662231887014711,2.1660204187314207,2.1293980998612736,3416802781,3233311885,74.5884582877215,76.10591577159883,NaN,NaN,39.84560665226537,35.165654768114194
2009-08-14T09:30:00-04:00,101.52,101.60001,99.7,100.78999,199691248,189927000,64.85027287479735,70.87883121791849,NaN,NaN,72.12190238904971,82.37776922588245,-0.03728127361331168,2.082796507844634,2.1200777814579457,3217111533,3214834083.4,73.1016232449253,76.21455319958226,NaN,NaN,38.373283686713755,35.62388747077127
2009-08-17T09:30:00-04:00,98.85001,98.95,98.11501,98.31,237892624,193612662.4,52.169450694475856,69.59375922295625,NaN,NaN,-25.47290333932847,58.05812848255124,-0.25924378020174155,1.7960230562057689,2.0552668364075104,2979218909,3174957481.8,69.86492025863225,76.03241313546857,NaN,NaN,32.516427492757416,35.17996461676929
2009-08-18T09:30:00-04:00,98.53,99.44,98.35001,99.09,173461440,191399821.6,55.14056115124467,68.62997487398584,NaN,NaN,-12.923096037040054,41.851936530986826,-0.3537352895186916,1.6130977245091458,1.9668330140278374,3152680349,3201233369.8,70.78290775439345,75.85495215555018,NaN,NaN,28.78406200482033,34.26626424363373
2009-08-19T09:30:00-04:00,98.31,100.3,98.21001,99.96001,192812752,191237080.8,58.25534978256794,67.68454285786636,NaN,NaN,4.474260383948791,26.200984274568242,-0.356826584012921,1.520799784011686,1.877626368024607,3345493101,3222261334.6,71.53033898317103,75.67978923093051,NaN,NaN,26.751571087200148,33.1927366498575
2009-08-20T09:30:00-04:00,100.09,101.22,99.87,100.99001,174131248,187003868,61.650306955000026,66.95449573582701,NaN,NaN,69.68093947775301,21.576220574876658,-0.2914444758094188,1.5133207732628335,1.8047652490722523,3519624349,3242825648.2,72.27725561206411,75.48897941171774,NaN,NaN,26.179341067308048,32.19082299520758
2009-08-21T09:30:00-04:00,101.82001,103.13,101.62,102.97,224604944,190533964.8,67.17653011978906,66.33174548336676,NaN,NaN,172.99839679735427,41.75151945653757,-0.1252816001324093,1.6481632489067408,1.7734448490391501,3744229293,3348249200.2,75.78467885254508,75.47474348230917,NaN,NaN,27.612488045076976,31.536775145188926
2009-08-24T09:30:00-04:00,103.39,103.95,102.59,102.96001,191278880,192134940,67.123973024376,65.66394440357234,NaN,NaN,191.46444796951445,85.13898971830616,-0.031372156900339565,1.7342296529137258,1.7656018098140653,3552950413,3462995501,78.91200375177678,75.50617527514244,NaN,NaN,28.691018969319348,31.13023854863613
2009-08-25T09:30:00-04:00,103.37,104.25999,102.94,103.16,215310560,193566184,67.66929924704013,65.18806038016453,NaN,NaN,186.05702304710053,124.93501353513429,0.025799283004544815,1.7978509135697465,1.7720516305652017,3768260973,3586111625.8,81.65025738967886,75.57659043330212,NaN,NaN,29.718158384361736,30.928512810882644
2009-08-26T09:30:00-04:00,102.84,103.64,102.49001,103.17,194620624,193577249.6,67.69815157310165,64.9866174664824,NaN,NaN,148.82768952351822,153.80569936304818,0.04476351307288229,1.8280060219063046,1.7832425088334223,3962881597,3709589325,83.90723523232701,75.76381890915286,NaN,NaN,30.550429787501514,30.874500950399625
2009-08-27T09:30:00-04:00,103.11,103.72,101.94,103.39999,196230000,192109980.8,68.39669254881372,64.57744144828912,NaN,NaN,123.59975366139153,164.58946219977588,0.05272329069745374,1.8491466222052395,1.7964233315077858,4159111597,3837486774.6,85.8487872007625,76.0418413885316,NaN,NaN,31.43709682247588,30.95487178926766
2009-08-28T09:30:00-04:00,104.23,104.35001,102.67,103.38,147024368,189093302.4,68.2585237673993,64.26875996442317,NaN,NaN,127.54932023757664,155.49964688782035,0.03729511938049357,1.8430422307334027,1.805747111352909,4012087229,3891058361.8,86.57917718943511,76.49815713684646,NaN,NaN,32.13405543783146,31.123326596205345
2009-08-31T09:30:00-04:00,102.37,102.58,101.78999,102.46001,176051568,189107036.8,62.04631794656656,64.12662961219668,NaN,NaN,56.742396157989184,128.55523652551528,-0.04950429555586444,1.7438667419080787,1.793371037463943,3836035661,3947675411.4,87.3238183000165,77.49383406059788,NaN,NaN,31.0519695709357,31.113132735452538
2009-09-01T09:30:00-04:00,101.95,103.24001,99.99001,100.2,321276672,196335145.6,50.00633418899432,62.87482943440758,NaN,NaN,-4.718582166318025,90.40011548283158,-0.2618917701075827,1.4660063248294648,1.7278980949370475,3514758989,3896975014.6,82.88863413747299,78.21714972820874,NaN,NaN,26.16196315770829,30.40582279577479
2009-09-02T09:30:00-04:00,99.78,100.44,99.57001,99.82001,171805008,195689077.6,48.308935565404596,61.3393356742551,NaN,NaN,-67.49292383333551,47.13599281146076,-0.42128631636171665,1.2012901994849017,1.6225765158466183,3342953981,3772989491.4,73.10956643243789,78.11151459568849,NaN,NaN,21.65054081826249,29.155068227558747
2009-09-03T09:30:00-04:00,100.39999,100.77,99.59,100.64999,143572256,193207503.2,52.13096186211829,60.43081345906374,NaN,NaN,-47.51037700077074,12.913966679028311,-0.46093254087899216,1.0464108397478782,1.5073433806268703,3486526237,3638472419.4,64.25261277753657,77.47944241944643,NaN,NaN,18.95459020429416,27.697857081378093
2009-09-04T09:30:00-04:00,100.85001,102.09,100.55,102.06,142687808,189307675.2,57.83485108926185,60.835484915834165,NaN,NaN,16.986599410802658,-9.19857748632648,-0.3853777985987388,1.025621132378447,1.4109989309771858,3629214045,3561897782.6,59.81059292722354,76.76127618148867,NaN,NaN,18.37977321836089,26.366702243804205
2009-09-08T09:30:00-04:00,103,103.05,102.39,102.94,132909008,189408194.4,60.961337026706374,61.25125462122429,NaN,NaN,72.53754552862284,-6.0395476121997556,-0.2745236726251048,1.0678443401958049,1.3423680128209097,3762123053,3547115261,58.96313426449898,75.9170066464962,NaN,NaN,18.8965825895511,25.29954229319662
2009-09-09T09:30:00-04:00,103.12,104.08,102.8,103.73,154612496,189273768.8,63.572653343174736,61.63106201841049,NaN,NaN,97.80502763411289,14.465174347886421,-0.15247362803970388,1.1517759777712797,1.3042496058109836,3916735549,3627510573,62.10768389322654,75.24395985435731,NaN,NaN,20.158077766491882,24.56504736081023
2009-09-10T09:30:00-04:00,103.8,104.86,103.22,104.78999,162902368,186466268.8,66.78321829090766,61.997698542403874,NaN,NaN,117.84163496531367,51.53208610761626,-0.012226614290059556,1.288966337948409,1.3011929522384686,4079637917,3774847360.2,67.08547846915903,74.8731186298641,NaN,NaN,22.269036619646798,24.23704582635831
2009-09-11T09:30:00-04:00,104.99001,105.3,104.28,104.77,152383632,185262975.2,66.66389086058334,61.96108145246061,NaN,NaN,122.98132142509819,85.63042579279004,0.06317999334723745,1.3801679439225154,1.316987950575278,3927254285,3862992969.8,69.65388132374557,74.43520452066413,NaN,NaN,23.903891074869563,24.189452290431348
2009-09-14T09:30:00-04:00,103.88,105.46001,103.14999,105.28,149593744,182758100,68.22386049009516,62.039644842869116,NaN,NaN,105.5455865691456,103.34222322445862,0.12767167528677725,1.4765775446837495,1.3489058693969722,4076848029,3952519766.6,72.04029245403018,73.94436799939652,NaN,NaN,25.737966360516868,24.41066858615785
2009-09-15T09:30:00-04:00,105.45,106.11,104.75999,105.72,196795872,180703262.4,69.54785535811236,62.17382742223142,NaN,NaN,136.6052101391542,116.15575614656491,0.17718310668094572,1.5703847527481543,1.3932016460672085,4273643901,4054823936.2,74.50736444758903,73.43416136067582,NaN,NaN,27.664082872023876,24.875442055567284
2009-09-16T09:30:00-04:00,106.10001,107.34,105.72881,107.32001,206406256,182350503.2,73.819691889884,62.61108030200159,NaN,NaN,180.53057615433337,132.70086585060898,0.28833502826604684,1.7536204313997672,1.4652854031337204,4480050157,4167486857.8,76.92234296418944,72.93524048438027,NaN,NaN,30.779164322606047,25.718830950858536
2009-09-17T09:30:00-04:00,107.17,108.06,106.57001,107.16,229170880,184168409.6,72.7210254781326,62.91996122552437,NaN,NaN,182.38486625312248,145.60951210817075,0.31931770900280254,1.8644325393872236,1.545114830384421,4250879277,4201735129.8,77.61651726818809,72.3472212034821,NaN,NaN,32.97242552102432,26.755058746596504
2009-09-18T09:30:00-04:00,107.14999,107.16,106.36,106.72,153799056,183151800,69.65120832097189,63.019438693636694,NaN,NaN,139.55887687608094,148.9250231983673,0.2798316020489662,1.8949043329456288,1.6150727308966626,4097080221,4235700317,78.3132268558875,71.75679617965729,NaN,NaN,33.9293506289297,27.779957586929818
2009-09-21T09:30:00-04:00,105.89,107,105.66,106.45,151892000,179516152.8,67.76092199713791,63.42762469724892,NaN,NaN,106.00674422856976,149.01725473025215,0.20845816117598104,1.875645432366639,1.667187271190658,3945188221,4209368355.4,76.32963998990951,70.97149772893535,NaN,NaN,34.19776725668166,28.696787539751508
2009-09-22T09:30:00-04:00,107.08,107.37,106.60001,107.07001,143126624,177108540,69.788558049759,64.84064068730355,NaN,NaN,113.33404617444675,144.36302193731063,0.17716311153067021,1.8886411606039957,1.7114780490733255,4088314845,4172302544.2,73.50722348428114,70.30139696799307,NaN,NaN,35.000940505436695,29.59738082056368
2009-09-23T09:30:00-04:00,107.32001,108.03,105.99001,106.17999,225947312,177640377.6,63.60440354956074,65.93317411474327,NaN,NaN,91.22065552224939,126.50103781089388,0.0758585818122548,1.806301276338644,1.730442694526389,3862367533,4048766019.4,64.89446796424313,69.71460422026487,NaN,NaN,33.91497298412291,30.21417970107214
2009-09-24T09:30:00-04:00,106.41,106.64,104.55,105.00999,228636688,179341180.8,56.5146965796478,66.24629802313824,NaN,NaN,41.525542102509995,98.32917298077138,-0.08205654942958107,1.6278720077394127,1.7099285571689937,3633730845,3925336333,57.62902197201145,69.2414905912988,NaN,NaN,30.7725392598498,30.29394535232609
2009-09-25T09:30:00-04:00,104.78,105.36,104.09,104.45,204058944,179732628,53.44411871824523,65.93267428235133,NaN,NaN,12.980666241980703,73.01353085395132,-0.2280595002746968,1.4248541818256228,1.6529136821003196,3429671901,3791854669,50.98157988817512,68.61084680279534,NaN,NaN,27.20109498542727,29.85210958562626
2009-09-28T09:30:00-04:00,104.85001,106.55,104.83,106.32001,118285744,178295696.8,61.053883213716134,65.9392847242806,NaN,NaN,52.661438865359244,62.344469781309215,-0.20334569447297812,1.398731564009097,1.602077258482075,3547957645,3712408553.8,47.47176336461791,67.79003459566098,NaN,NaN,26.355813792967425,29.35263875810357
2009-09-29T09:30:00-04:00,106.50999,107.02,105.78,106,133733808,176179808.8,59.26852610927636,65.63184706471644,NaN,NaN,60.719822268836616,51.82162500018719,-0.21222396561959633,1.3367973014575796,1.549021267077176,3414223837,3577590352.2,42.1665837905766,66.36567030261456,NaN,NaN,25.117446025248352,28.74761122483854
2009-09-30T09:30:00-04:00,106.36,106.46001,104.62,105.59,254382944,172835122.4,56.96993094981252,64.93089796892393,NaN,NaN,29.97905298753443,39.5733044932442,-0.24695093638740362,1.2403325965929213,1.487283532980325,3159840893,3437085024.2,37.4671615825188,64.25007623928312,NaN,NaN,23.400844435676685,27.98378739781542
2009-10-01T09:30:00-04:00,105.34,105.73309,102.95,103,281840640,178336904,45.07689039009059,63.388969363888734,NaN,NaN,-50.73857783609409,21.120480505523382,-0.43461858209943527,0.9440103053560307,1.378628887455466,2878000253,3285938905.8,33.18287121048928,61.645004088336236,NaN,NaN,17.584805790882523,26.498218596825005
2009-10-02T09:30:00-04:00,102.02,103.10001,101.99001,102.49001,224748752,182395728.8,43.166000772389594,61.599122241195474,NaN,NaN,-129.08701778691236,-7.293056300255228,-0.5745766692386862,0.6604080509071082,1.2349847201457944,2653251501,3130654825.8,29.45621245864514,58.60328408866587,NaN,NaN,12.328888871756636,24.474028636100954
2009-10-05T09:30:00-04:00,102.89999,104.32001,102.60001,104.02,149874944,182755085.6,50.01230756061982,60.20372596994601,NaN,NaN,-85.69196437977365,-34.9637369492818,-0.5457981608657789,0.5527370190635708,1.0985351799293497,2803126445,2981688585.8,26.393866281383808,55.166605648222635,NaN,NaN,10.134755829550764,22.42556109230807
2009-10-06T09:30:00-04:00,104.77,106.11,104.71001,105.50999,202491008,186234185.6,55.61920556696118,58.903691232594376,NaN,NaN,5.85928826027788,-45.935843750993556,-0.4140761625005609,0.5809399768036485,0.9950161393042094,3005617453,2899967309,24.86656357112254,51.448335691575004,NaN,NaN,10.245427590148802,20.68554202057103
2009-10-07T09:30:00-04:00,105.27,105.91,105.07001,105.8,159200256,186463573.6,56.638680058898586,57.75495227407766,NaN,NaN,9.681877878924148,-49.99527877271561,-0.30037242066412995,0.6195506134740469,0.9199230341381769,3164817709,2900962672.2,24.923548101078907,47.68455217963864,NaN,NaN,10.668686935275273,19.254562722671636
2009-10-08T09:30:00-04:00,106.55,107.17,105.84489,106.61,183305744,187483742.4,59.4410455224747,57.02565493132786,NaN,NaN,67.99938292880724,-26.24768661973535,-0.17005355446757264,0.7073560910537111,0.8774096455212838,3348123453,2994987312.2,30.301212809472645,44.25512260489472,NaN,NaN,11.92949688605804,18.20812474601255
2009-10-09T09:30:00-04:00,106.64,107.25999,106.36,107.25999,135008256,186614973.6,61.586468151634065,56.58462251379187,NaN,NaN,86.99201725009206,16.96812038766554,-0.045976058456802416,0.8199395724502807,0.8659156309070831,3483131709,3160963353.8,38.654562395054974,41.564045633833686,NaN,NaN,13.647382327856924,17.556590114847463
2009-10-12T09:30:00-04:00,107.75999,108.09,107.28,107.67999,118031008,185036836.8,62.95023116287049,56.09617059329984,NaN,NaN,121.46112331846815,58.3987379273139,0.05311248450351447,0.9323062365364763,0.8791937520329618,3601162717,3320570608.2,45.427834606992946,39.55837499974167,NaN,NaN,15.468445498795608,17.25828374112577
2009-10-13T09:30:00-04:00,107.39,107.7132,106.75999,107.46001,157692688,183081677.6,61.71439824994262,55.96117021475568,NaN,NaN,87.60439746561322,74.74775976838097,0.09038096806448215,0.9921699621135645,0.9017889940490823,3443470029,3408141123.4,48.7700190745827,38.406628650480215,NaN,NaN,16.595841908562537,17.163649193616735
2009-10-14T09:30:00-04:00,108.72,109.42,107.4174,109.31,191421504,182332440,67.49398770256167,56.74540529496384,NaN,NaN,156.9218962958799,104.19576345177211,0.21884281362023517,1.1753425110743763,0.9564996974541411,3634891533,3502155888.2,52.15763898140854,38.01581557972286,NaN,NaN,19.48351126548211,17.495058061026075
2009-10-15T09:30:00-04:00,108.78,109.71001,108.73,109.71001,173873568,179567574.4,68.59783071775638,57.82781329492892,NaN,NaN,174.96741992579766,125.58937085117017,0.3046955863262215,1.337369180361918,1.0326735940356966,3808765101,3594284217.8,55.278461252376275,38.322735677165795,NaN,NaN,22.17585620279371,18.163743509850022
2009-10-16T09:30:00-04:00,108.8,109.27,108.23,108.89,192069376,181481090.4,63.81382818705023,58.02495222159564,NaN,NaN,128.53753627910692,133.89847465697318,0.2807879843490153,1.3836585744719656,1.1028705901229503,3616695725,3620997021,56.171205195404326,38.94412437936483,NaN,NaN,23.015306477800745,18.856823933842982
2009-10-19T09:30:00-04:00,109.07001,110.13,108.73,109.78999,159530368,181863008.8,66.56949774546672,58.54645019560924,NaN,NaN,141.8165649762157,137.96956298852268,0.29846439108575606,1.4759510789801453,1.1774866878943893,3776226093,3656009696.2,57.37234115607826,40.03024990547209,NaN,NaN,24.578818671274316,19.674251753476028
2009-10-20T09:30:00-04:00,109.95,109.985,108.67999,109.211,180921008,183752728,63.23332464306658,58.9938354594131,NaN,NaN,116.30547189199676,143.7097778737994,0.24621291326479677,1.4852528294753853,1.2390399162105885,3595305085,3686376707.4,58.436260470881955,41.52804268321232,NaN,NaN,24.88312884256319,20.41837705191705
2009-10-21T09:30:00-04:00,109.03999,110.31,108.14999,108.23,225787440,183744734.4,57.9354653030021,59.912305096049636,NaN,NaN,89.07236208364358,130.13987103135213,0.12665459287575076,1.397358157305277,1.2707035644295261,3369517645,3633301929.8,55.814257494748745,43.14457027494513,NaN,NaN,23.52908470005486,20.86276385879388
2009-10-22T09:30:00-04:00,108.19,109.67999,107.5,109.33,238443936,184235096.8,61.80023370739791,61.24332173426451,NaN,NaN,77.73717935267734,110.69382291672807,0.10369297919860276,1.4003197884277796,1.2966268092291768,3607961581,3593141225.8,53.84547475994745,44.88666043932387,NaN,NaN,23.55214316852832,21.246960903041657
2009-10-23T09:30:00-04:00,109.69,109.75999,107.63,108.08,240033184,186033808.8,55.55391595175373,61.63915090505979,NaN,NaN,58.75144672194836,96.73660500529635,-0.007727851615535242,1.2869669947097577,1.294694846325293,3367928397,3543387760.2,51.42535614639104,46.6746240011101,NaN,NaN,21.576661201344333,21.294060945656327
2009-10-26T09:30:00-04:00,108.2,109.31,106.61,106.91,242028192,192220931.2,50.41733245822797,61.26758854015028,NaN,NaN,21.94717241294351,72.76272649264193,-0.16362931548340542,1.090158201971036,1.2537875174544415,3125900205,3413322582.6,45.649151925913515,48.15909459788088,NaN,NaN,18.220786286054246,20.855021708570316
2009-10-27T09:30:00-04:00,107.03,107.39,106.16,106.42,253266320,198197556.8,48.39900776219989,60.67904051895751,NaN,NaN,-16.368336965239966,46.227964721194574,-0.295468810360592,0.8844515045037014,1.1799203148642934,2872633885,3268788342.6,40.24012722381338,49.253135963790484,NaN,NaN,14.85985030327844,19.998568650671476
2009-10-28T09:30:00-04:00,106.14999,106.4783,104.35001,104.41,248821376,197919478.4,41.126024883858946,59.37082475905639,NaN,NaN,-76.79626422695061,13.054239459075728,-0.5016449008731594,0.552864188772844,1.0545090896460034,2623812509,3119647315.4,35.5580815783201,49.62862659013673,NaN,NaN,9.357662021199635,18.4784391321755
2009-10-29T09:30:00-04:00,105.19,106.86,104.94,106.64999,198110560,193732974.4,50.12150158597189,58.5518985757948,NaN,NaN,-42.46952306586112,-10.987101024631958,-0.4712378547864542,0.46546177116293563,0.9366996259493898,2821923069,2962439613,31.409507926296897,49.11112269951116,NaN,NaN,7.672987634611092,16.93480320395201
2009-10-30T09:30:00-04:00,106.3,106.62,103.44,103.56,325607936,198775933.6,40.84933036872066,56.973262804784106,NaN,NaN,-123.14879452150852,-47.367149273323335,-0.6332118950596415,0.14518475712483792,0.7783966521844794,2496315133,2788116960.2,27.568553520478048,47.835459764760095,NaN,NaN,2.5837929765410985,14.884658885750452
2009-11-02T09:30:00-05:00,104.13,105.41,103.08,104.32001,254489744,204006673.6,43.61237613960776,55.68026122547447,NaN,NaN,-140.05211041255936,-79.76700583842391,-0.6601345026892629,-0.0467714761770992,0.6133630265121637,2750804877,2713097894.6,26.089943434319636,46.215454361884156,NaN,NaN,-0.29176110996987603,12.716598886361835
2009-11-03T09:30:00-05:00,103.74001,104.8,103.53999,104.64999,228362496,205300248,44.81763876218679,54.060522015447695,NaN,NaN,-129.1857632250031,-102.33049109037654,-0.6269370910478778,-0.17030833729768347,0.45662875375019424,2979167373,2734404592.2,27.28284805354673,44.4386835813226,NaN,NaN,-2.08331499033024,10.602325475405824
2009-11-04T09:30:00-05:00,105.50999,106.33,104.64999,104.92,247996688,209740069.6,45.837805272798796,52.434805912236435,NaN,NaN,-84.47795347206497,-103.8668289393994,-0.5601961080724203,-0.24361638134033115,0.3165797267320891,3227164061,2855074902.6,33.799607923198494,42.90447977209562,NaN,NaN,-3.162876587517875,8.635868037845295
2009-11-05T09:30:00-05:00,105.66,106.88,105.44,106.8501,180015184,209575541.6,52.58565202234262,51.63279332904305,NaN,NaN,-35.97756107611841,-102.56843654145086,-0.36870947127016684,-0.14430711235561944,0.2244023589145474,3407179245,2972126137.8,39.46657105734507,41.7112916193771,NaN,NaN,-1.8610615087184337,7.136306674050477
2009-11-06T09:30:00-05:00,106.25999,107.39999,106.05,107.13,170954064,211372832,53.49058743116661,50.698585449450185,NaN,NaN,-15.135802129673628,-80.9658380630839,-0.21354426665666465,-0.04252797440628342,0.17101629225038123,3578133309,3188489773,48.27993734619148,41.06183420438519,NaN,NaN,-0.546761963659993,6.038725440091839
2009-11-09T09:30:00-05:00,107.95,109.63,107.87,109.57001,159495632,213446063.2,60.55771950337178,50.50747079661483,NaN,NaN,73.38728794727757,-38.2779583911165,0.04906123586827449,0.23234283708572434,0.18328160121744985,3737628941,3385854585.8,54.751652690006566,40.798647934322666,NaN,NaN,3.0436782098795625,5.6108615500615135
2009-11-10T09:30:00-05:00,109.31,109.92999,108.97,109.59,171899744,214156416,60.61052612751989,50.698546569794686,NaN,NaN,83.49270114802135,4.257734483488394,0.2106901780096182,0.4466443237294726,0.2359541457198544,3909528685,3571926848.2,59.85222011902189,41.08707383605646,NaN,NaN,5.84328755137691,5.644065264535142
2009-11-11T09:30:00-05:00,110.31,110.82001,109.62,110.14999,169466192,213058650.4,62.139719392806015,50.72279554732383,NaN,NaN,104.11169120474143,41.97566341884968,0.33453744504500166,0.6541259520261065,0.3195885069811048,4078994877,3742293011.4,63.868201907652065,41.80298291803536,NaN,NaN,8.608085893488784,6.0674967829570905
2009-11-12T09:30:00-05:00,110,110.57001,108.75,109.03,157144496,212222196.8,57.34466260079407,50.85070602225529,NaN,NaN,75.47732610588888,64.26664085525114,0.3202367343231009,0.719884424884981,0.39964769056188004,3921850381,3845227238.6,66.07618639359447,42.8494707928356,NaN,NaN,9.527181467951564,6.561737452242015
2009-11-13T09:30:00-05:00,109.31,110.09,108.75,109.62,150962944,210166875.2,59.133672045771235,51.47330170707981,NaN,NaN,74.24733587330141,82.14326845584614,0.3284948970576788,0.8102663118839786,0.48177141482629976,4072813325,3944163241.8,68.09433647862514,44.452698260886436,NaN,NaN,10.822427717471049,7.170407490131877
2009-11-16T09:30:00-05:00,110.38,111.69,110.32001,111.21001,210922128,212736463.2,63.56824561943937,52.55681869688262,NaN,NaN,125.74361406454474,92.61453367929958,0.4135292137764949,0.9986829320469184,0.5851537182704235,4283735453,4053384544.2,70.20187446062573,46.59282306351589,NaN,NaN,13.34566320867083,8.052586878494585
2009-11-17T09:30:00-05:00,110.92,111.39,110.5,111.339,147134064,211047116,63.91038991928659,54.184273342270316,NaN,NaN,117.25684970980247,99.3673633916558,0.4480462970989685,1.1452115896441342,0.6971652925451657,4430869517,4157652710.6,72.09679412073461,49.20273110225978,NaN,NaN,15.475657486101857,9.113025536724196
2009-11-18T09:30:00-05:00,111.25999,111.42999,110.57001,111.27,156486752,207582081.6,63.56648754860857,55.14462948245865,NaN,NaN,107.8697993230159,100.1189850153107,0.435434267264713,1.241458126626057,0.8060238593613439,4274382765,4196730288.2,72.79504336660847,52.15884077656775,NaN,NaN,17.119072429714546,10.256746521437103
2009-11-19T09:30:00-05:00,110.50999,111.30589,109.13,109.82001,208734496,206096609.6,56.66589967671372,56.274384433029574,NaN,NaN,71.03318143064622,99.23015608026216,0.30481976746082373,1.1870485686873735,0.8822288012265498,4065648269,4225489865.8,73.32411533876473,55.427095192159655,NaN,NaN,16.601086967485134,11.163080870872536
2009-11-20T09:30:00-05:00,109.25,109.75999,109.00999,109.42999,134196000,200804750.4,54.93831337224266,57.08337994964636,NaN,NaN,46.97668114229406,93.7760251340607,0.17404069668573052,1.099779672083713,0.9257389753979824,3931452269,4197217654.6,71.8449226370071,58.695307992351616,NaN,NaN,15.678318608771304,11.808114833429503
2009-11-23T09:30:00-05:00,110.72,111.74001,110.60001,110.82001,148010128,196103847.2,59.65878890283857,58.14346210255006,NaN,NaN,87.50874135236353,86.12905059162446,0.16321545135578597,1.129758289592715,0.966542838236929,4079462397,4156363043.4,69.65809035403052,61.72211101381475,NaN,NaN,16.238836137150432,12.44107501967535
2009-11-24T09:30:00-05:00,111,111.20219,110.00999,110.99001,138420064,190361534.4,60.20780959056498,59.1698909823905,NaN,NaN,71.52201745161726,76.98208413998742,0.1499115899315855,1.153932325651411,1.0040207357198254,4217882461,4113765632.2,67.35599935419269,64.11899611602861,NaN,NaN,16.852985886945802,13.071348000713988
2009-11-25T09:30:00-05:00,111.17,111.5,110.82001,111.38,109564752,183398703.2,61.502198950234934,59.806787191525665,NaN,NaN,80.60787414859506,71.52969910510326,0.14944915938352343,1.1908321849492296,1.0413830255657062,4327447213,4124378521.8,67.64291578887101,66.13159216828046,NaN,NaN,17.728740936478932,13.736689848680408
2009-11-27T09:30:00-05:00,108.39999,110.32001,108.28999,109.57001,126001808,179793265.6,52.90135152796402,59.76469891272548,NaN,NaN,21.600138648050663,61.64309054858414,0.01632152139195675,1.061784927305652,1.0454634059136954,4201445405,4151537949,68.40815752118132,67.56932218077974,NaN,NaN,15.971636747931653,14.05596797714487
2009-11-30T09:30:00-05:00,109.48,110.2,108.12,109.94,160874816,171556609.6,54.30801157296475,59.318291203410695,NaN,NaN,17.02902136589035,55.6535585933034,-0.05389529698604889,0.9780942846811342,1.0319895816671831,4362320221,4237711539.4,70.7702285437221,68.71350617033086,NaN,NaN,14.923379235635744,14.179883871214995
2009-12-01T09:30:00-05:00,110.92,111.66,110.73,111.3,159613632,166812804,59.13887372950785,59.21317317498126,NaN,NaN,86.93185573222489,55.53818146927565,-0.017696987128368757,1.009868347756722,1.0275653348850908,4521933853,4326205830.6,73.00259633115195,69.65281875691157,NaN,NaN,15.440452870984151,14.359965156896303
2009-12-02T09:30:00-05:00,111.28,112.00999,110.92,111.25,132315056,162010432,58.89234970497116,58.98121819727877,NaN,NaN,92.14915371042996,59.66360872103819,-0.006639882683300513,1.0192654815309652,1.0259053642142657,4389618797,4360553097.8,73.83776983257457,70.3649307515489,NaN,NaN,15.787843077003547,14.563947716911624
2009-12-03T09:30:00-05:00,111.55,112.17999,110.28999,110.38,167324816,157976838.4,54.62542517336404,58.786986952462335,NaN,NaN,62.508714757958145,56.0437768429108,-0.06423578110551342,0.9456106378323739,1.0098464189378873,4222293981,4339522451.4,72.3616944066037,70.81389560962099,NaN,NaN,14.857541295758466,14.605889656746887
2009-12-04T09:30:00-05:00,111.84,112.38,110.03999,111.00999,274907904,162721474.4,57.05202338877022,58.638297762676544,NaN,NaN,69.95963398068714,65.71567590943809,-0.06597051563868828,0.927383274389527,0.9933537900282152,4497201885,4398673747.4,73.93969033217115,71.23142088487427,NaN,NaN,14.757235364930715,14.62751047220172
2009-12-07T09:30:00-05:00,110.91,111.53,110.49001,110.84,127973808,160572461.6,56.178984496330706,58.11049339674021,NaN,NaN,49.08587647465587,72.12704693119119,-0.08350411175732053,0.8889736503315646,0.9724777620888851,4369228077,4400055318.6,73.97706217188991,71.50107714996457,NaN,NaN,14.433116824068847,14.599739951039881
2009-12-08T09:30:00-05:00,110.03999,110.77251,109.27,109.61,169863632,161090861.6,50.1937816022336,57.130735659807854,NaN,NaN,-51.766141990599934,44.38744738662623,-0.1774780272229799,0.7506302280601602,0.9281082552831401,4199364445,4335541437,69.00100986131638,71.27994970286326,NaN,NaN,12.401917363951346,14.28576529574152
2009-12-09T09:30:00-05:00,109.58,110.17999,109.02,110.021,155063376,160249043.2,52.03273752622213,56.306896372494535,NaN,NaN,-67.64464933567326,12.428686777405588,-0.20930769137810734,0.6664736410605059,0.8757813324386132,4354427821,4328503241.8,68.4599846882165,70.9703026544067,NaN,NaN,11.211712040384123,13.846614830690463
2009-12-10T09:30:00-05:00,110.7,111.12,110.45,110.64,138014624,158676464.8,54.74297451823911,56.16954457546064,NaN,NaN,24.967650305226922,4.92047388685934,-0.18676685051364628,0.6423227692965554,0.8290896198102017,4492442445,4382532934.6,70.37999278359396,70.76000818618022,NaN,NaN,10.952396205719923,13.433155027123243
2009-12-11T09:30:00-05:00,111.11,111.36,110.61,111.11,124854000,157061940,56.741570348992546,56.29834864522849,NaN,NaN,48.53386623225957,0.6353203371738232,-0.14041241103718438,0.6535741060137212,0.7939865170509056,4617296445,4406551846.6,71.21878764258193,70.71528425800697,NaN,NaN,11.29099262729007,13.127131827147076
2009-12-14T09:30:00-05:00,111.87,112,105.476,111.87,107141504,154870868,59.830683592371614,56.310626837337985,NaN,NaN,-83.58620292880346,-25.899095543518037,-0.06273489481682915,0.7155678985298692,0.7783027933466984,4724437949,4477593821,73.60011454220071,70.99685741430486,NaN,NaN,12.467168501946672,13.032851352118447
2009-12-15T09:30:00-05:00,111.46001,111.92,111,111.35001,120408752,150345199.2,56.839916498821474,56.07006304507059,NaN,NaN,86.97747414803179,1.8496276842083006,-0.051039650673250336,0.7145032300051355,0.7655428806783858,4604029197,4558526771.4,76.03298464477407,71.6166420779178,NaN,NaN,12.633656522829645,12.975823519362905
2009-12-16T09:30:00-05:00,111.8,112.13,111.27,111.52,155358128,150756402.4,57.58632672497094,55.79035788612316,NaN,NaN,103.40538062661433,36.05963367666582,-0.03716465903277466,0.7190870568874175,0.7562517159201921,4759387325,4639518672.2,78.19824097062688,72.37059387661466,NaN,NaN,12.976128726295732,12.975867120353309
2009-12-17T09:30:00-05:00,110.72,110.92999,110.08,110.17999,183390064,152101568,50.21422354382235,55.59842017297018,NaN,NaN,-18.76998540487692,27.31210653464505,-0.11893076046820206,0.6075882653349396,0.7265190258031416,4575997261,4656229635.4,78.62728283890115,73.10053139930893,NaN,NaN,11.138115535596,12.713331179673693
2009-12-18T09:30:00-05:00,110.2,110.3,109.28,110.21001,174591120,150394399.2,50.36751761457522,55.316956318799505,NaN,NaN,-64.5865112819798,4.688031031797189,-0.16865335079797827,0.5157023373056688,0.6843556881036471,4750588381,4682888022.6,79.32623085179289,73.71167442131399,NaN,NaN,9.680367021999333,12.280050585720213
2009-12-21T09:30:00-05:00,110.75999,111.7,110.75999,111.33,118104256,149589812,55.8316295726292,55.08072459330817,NaN,NaN,65.05018240758744,34.41530809907537,-0.12574141467204936,0.5271789197635854,0.6529203344356348,4868692637,4711738960.2,80.0852803142509,74.21758042010676,NaN,NaN,9.949427450952438,11.947104423610531
2009-12-22T09:30:00-05:00,111.57001,111.97,111.425,111.73,91707440,146774677.6,57.62588695877054,54.99026296857956,NaN,NaN,106.00055565386812,38.21992440024263,-0.07267895624619325,0.5620716391278933,0.6347505953740865,4960400077,4783013136.2,81.85745147557101,74.79041482317793,NaN,NaN,10.692368535615152,11.767856439611192
2009-12-23T09:30:00-05:00,112,112.11,111.5,111.95,111783056,145442827.2,58.62151098179914,55.275697669182065,NaN,NaN,108.35075284384156,39.208998843688086,-0.02735749828772227,0.6005537225144337,0.627911220802156,5072183133,4845572297.8,83.2651112336581,75.56923031082466,NaN,NaN,11.590763472963198,11.742557444375764
2009-12-24T09:30:00-05:00,112.19,112.60001,111.9948,112.48,39677472,141948463.2,60.99894758380718,55.557620825970425,NaN,NaN,143.08888651275194,71.58077322721385,0.03058205388546631,0.6661387881589889,0.6355567342735226,5111860605,4952744966.6,85.3606639533654,76.38501414090999,NaN,NaN,13.036312882888398,11.927379649877569
2009-12-28T09:30:00-05:00,112.89999,112.99001,112.32001,112.72,87508432,140023794.4,62.061938393324006,55.9778318186128,NaN,NaN,162.3369443722666,116.96546435806313,0.07481627079980524,0.7290770727732792,0.6542608019734739,5199369037,5042501097.8,86.84622631986211,77.30424015147943,NaN,NaN,14.54916624366643,12.301920591847406
2009-12-29T09:30:00-05:00,113.00999,113.03,112.55,112.562,80572496,136008678.4,60.88542452595049,56.74152059887829,NaN,NaN,152.90419572989646,134.53626702252492,0.08257146673178484,0.757475135388205,0.6749036686564202,5118796541,5092521878.6,87.60134482908886,78.63283550632032,NaN,NaN,15.518310862921986,12.761404916286631
2009-12-30T09:30:00-05:00,112.23,112.64999,112.17,112.52,73138368,131684915.2,60.556791309963536,57.35038158343125,NaN,NaN,111.21221691871298,135.5785992754939,0.07427043077015538,0.7677417071191144,0.693471276348959,5045658173,5109573497.8,87.85725149162373,80.01835456370655,NaN,NaN,16.251797425374804,13.260032417584942
2009-12-31T09:30:00-05:00,112.77,112.8,111.39,111.44,90637872,129601056,52.68230811093375,57.20319112576658,NaN,NaN,56.34122597567308,125.17669390186022,-0.010071198637388479,0.6808822780522235,0.6909534766896119,4955020301,5086140931.4,85.25315899572585,81.08072357885884,NaN,NaN,14.765578802300904,13.475110472544365
2010-01-04T09:30:00-05:00,112.37,113.39,111.50999,113.33,118944560,127182043.2,61.99581708042834,57.57849446372627,NaN,NaN,114.84684978032628,119.52828655537508,0.05190914455310092,0.755839907380988,0.7039307628278871,5073964861,5078561782.6,84.38196735307383,82.02095070103681,NaN,NaN,16.249828423081663,13.87149875119255
2010-01-05T09:30:00-05:00,113.25999,113.67999,112.85001,113.63,111579872,119015641.6,63.23288480130755,57.821508835793125,NaN,NaN,143.03373951453597,115.66764558382897,0.10076375652199132,0.8298854584803763,0.729121701958385,5185544733,5075796921.8,84.04456324525754,82.76698275125516,NaN,NaN,17.83859789301272,14.438227200024004
2010-01-06T09:30:00-05:00,113.52,113.99001,113.42999,113.71001,116074368,118420669.6,63.57344032611853,58.3024748234572,NaN,NaN,144.4466427922148,113.97613499629263,0.12456146611426022,0.8848235346012103,0.7602620684869501,5301619101,5112361433.8,84.90422447750782,83.40064273930759,NaN,NaN,19.222935410054966,15.121756944314141
2010-01-07T09:30:00-05:00,113.5,114.33,113.17999,114.19,131091056,116482040.8,65.63017512470263,58.87703542343804,NaN,NaN,142.1601004726543,120.16571170708089,0.15664836786536562,0.9560725283186571,0.7994241604532915,5432710157,5189771830.6,86.55573012226841,83.99760625013911,NaN,NaN,21.004464040707038,15.962143672370269
2010-01-08T09:30:00-05:00,113.89,114.62,113.66,114.57001,126402752,115049009.6,67.20875154407605,60.09093028059902,NaN,NaN,148.48900532483273,138.59526757691282,0.18551120291684264,1.0313131640993447,0.8458019611825021,5559112909,5310590352.2,88.64392811180602,84.71308091248946,NaN,NaN,22.96987906117691,16.963248727914074
2010-01-11T09:30:00-05:00,115.08,115.13,114.235,114.73,106375680,113467062.4,67.8776770146692,61.34165595203431,NaN,NaN,151.8499111467352,145.9958798501946,0.19637623796490988,1.0912722586386394,0.8948960206737295,5665488589,5428895097.8,90.24216532758548,85.49279051790323,NaN,NaN,24.795475885032708,18.082138321788165
2010-01-12T09:30:00-05:00,113.97,114.21001,113.22,113.66,163333440,115391034.4,59.182320496127176,61.58099101799844,NaN,NaN,82.82452320041011,133.95403658736942,0.1164483680670948,1.040456480757598,0.9240081126905032,5502155149,5492217181,90.97436352448162,86.27058217577685,NaN,NaN,23.90847770388361,18.914472519230372
2010-01-13T09:30:00-05:00,113.95,114.94,113.37,114.62,161821936,118125056,63.67806422465882,62.013289394133324,NaN,NaN,110.5258947406577,127.16988697705798,0.113087663478596,1.0653676920387483,0.9522800285601523,5663977085,5564688777.8,91.73843637942964,86.97636681176674,NaN,NaN,24.49868448548201,19.71221708583775
2010-01-14T09:30:00-05:00,114.49001,115.14,114.42,114.92999,115783744,117893805.6,65.01792578306326,62.470176165652184,NaN,NaN,127.02226435788019,124.14231975410318,0.11615407912283993,1.097472627463702,0.9813185483408622,5779760829,5634098912.2,92.40187831047602,87.62899303153945,NaN,NaN,25.386520286687414,20.522831828816273
2010-01-15T09:30:00-05:00,114.73,114.84,113.2,113.64,212283120,120740055.2,55.79425548546477,62.098412444342024,NaN,NaN,63.044352449502085,107.05338917903705,0.02071641824302639,1.0072140711446451,0.9864976529016187,5567477709,5635771872.2,92.41768314485506,88.13306583093156,NaN,NaN,23.219722214854905,20.908101883964648
2010-01-19T09:30:00-05:00,113.62,115.13,113.59,115.06,139172624,118529183.2,62.15823444385149,62.105290733665406,NaN,NaN,95.08474298957661,95.70035554760534,0.04143932428713715,1.0382968082605402,0.996857483973403,5706650333,5644004221,92.50035304498243,88.53693202558303,NaN,NaN,23.44681731220762,21.270775516570787
2010-01-20T09:30:00-05:00,114.28,114.45,112.98,113.89,216490128,120624133.6,55.11744576251766,61.69329225056306,NaN,NaN,37.79694614125229,86.69484013577376,-0.031499103592900424,0.9574836044822774,0.9889827080751779,5490160205,5641605232.2,92.1849291784648,88.86433090768129,NaN,NaN,21.169450705436343,21.256300543551582
2010-01-21T09:30:00-05:00,113.92,114.27,111.56,111.7,344859392,131961890.4,44.871805164614365,60.57293609732384,NaN,NaN,-59.734409448610975,52.642779297920015,-0.22434131240583555,0.7085560675678835,0.932897379973719,5145300813,5537869977.8,79.55247589749898,88.2711326509581,NaN,NaN,15.183516593153081,20.38875997920894
2010-01-22T09:30:00-05:00,111.2,111.74159,109.09,109.21001,345942272,144673632,36.55221543383798,59.42078662038842,NaN,NaN,-219.2721463600533,-16.61610284566668,-0.5008611226807448,0.30682097662278807,0.8076820993035329,4799358541,5341789520.2,62.20158295066009,86.62459150488198,NaN,NaN,6.551503712477167,18.412009083961543
2010-01-25T09:30:00-05:00,110.21001,110.41,109.41,109.77,186937440,148431351.2,39.27890271328379,57.7981498798781,NaN,NaN,-200.23988323515326,-69.27294998259775,-0.6195486449625822,0.033246293100305024,0.6527949380628872,4986295981,5225553174.6,54.59924631488495,84.49725428786849,NaN,NaN,1.171214617844562,15.949038445944831
2010-01-26T09:30:00-05:00,109.34,110.47,109.03999,109.31,211168752,157005915.2,37.84031656537959,55.98439500588324,NaN,NaN,-182.10969269232206,-124.71183711897747,-0.6967694530437749,-0.21816687824183134,0.4786025748019435,4775127229,5039248553.8,45.08735678729404,81.71459668372823,NaN,NaN,-3.444086027346465,13.178592092617503
2010-01-27T09:30:00-05:00,109.17,110.08,108.33,109.83,271863552,166223671.2,40.49352253151445,54.335829449125804,NaN,NaN,-160.40132708702825,-164.3514917646336,-0.6798222965800194,-0.37117529592308074,0.3086470006569386,5046990781,4950614669,41.39277305367657,78.60663586774028,NaN,NaN,-6.175323105249085,10.413747064350847
2010-01-28T09:30:00-05:00,110.19,110.25,107.91,108.57001,316103936,178000243.2,36.43532437264307,52.25048296683583,NaN,NaN,-151.45878356812258,-182.6963665885359,-0.7167862331127868,-0.5873357907340448,0.12945044237874193,4730886845,4867731875.4,38.237415711276775,75.1553276955266,NaN,NaN,-9.859784078683031,7.5175283296317215
2010-01-29T09:30:00-05:00,109.03999,109.8,107.22,107.39,310677504,189877200,33.09063307247145,49.813474504578366,NaN,NaN,-149.60323527927594,-168.76258437238045,-0.7788650501029466,-0.8441308702499413,-0.06526582014699472,4420209341,4791902035.4,35.56612576435775,71.36405609928029,NaN,NaN,-14.069872678339493,4.433613899921548
2010-02-01T09:30:00-05:00,108.14999,109.07001,107.50079,109.06,187864880,194738550.4,41.302940724290444,47.9152790552656,NaN,NaN,-116.27445840569372,-151.96949940648852,-0.6697749423863308,-0.9024844981299083,-0.23270955574357746,4608074221,4716257683.4,33.08321423579298,67.28127387843797,NaN,NaN,-14.772919928049689,1.689823353068515
2010-02-02T09:30:00-05:00,109.25999,110.59,108.88,110.38,216327872,199607716,46.85533279290306,47.034779933606735,NaN,NaN,-64.10303134799548,-128.3681671376232,-0.4799277822269614,-0.8326192835272792,-0.3526915013003178,4824402093,4726112656.2,33.732282394416885,63.19255379771905,NaN,NaN,-13.389376314175133,-0.4643480279662917
2010-02-03T09:30:00-05:00,109.88,110.48151,109.50999,109.83,172730624,202665253.6,44.947489654910996,45.69688175005332,NaN,NaN,-57.67904411518202,-107.82371054325395,-0.36766094680758316,-0.8122676848097967,-0.44460673800221356,4651671469,4647048793.8,31.123981663988445,58.86294988947326,NaN,NaN,-12.932681034328283,-2.245538457446576
2010-02-04T09:30:00-05:00,108.98,109.03,106.42,106.44,356715520,214697311.2,35.384071707030714,43.58017788747957,NaN,NaN,-117.76698390455336,-101.08535061054012,-0.49030936055365315,-1.05749343869428,-0.5671840781406269,4294955949,4559862614.6,28.506353776718868,54.29898385134776,NaN,NaN,-16.09483226727553,-4.224009001707856
2010-02-05T09:30:00-05:00,106.56,106.88,104.58,106.66,493585664,232822041.6,36.330841666911006,42.18993404329716,NaN,NaN,-134.49629571120076,-98.06396269692507,-0.5222693883026527,-1.2200208135189428,-0.6977514252162901,4788541613,4633529069,33.58867062517464,50.09691152851343,NaN,NaN,-18.13554378726672,-6.21137111393055
2010-02-08T09:30:00-05:00,106.74001,107.33,105.80991,105.89,224166816,237710244.8,34.429383165650165,40.209301809139916,NaN,NaN,-115.80936444237128,-97.97094390426058,-0.557701424767952,-1.3948782061762302,-0.8371767814082781,4564374797,4624789184.2,33.2863408162285,45.86733922645957,NaN,NaN,-20.40030080526899,-8.238361069836042
2010-02-09T09:30:00-05:00,107.13,108.14999,106.27,107.22,337820416,249282481.6,40.24665323403817,39.14710234281995,NaN,NaN,-87.90876471254776,-102.73209057717104,-0.45816403475691625,-1.4098818248544234,-0.9517177900975071,4902195213,4640347808.2,34.41801874860006,41.74113133861209,NaN,NaN,-20.3411211816204,-9.96732680009095
2010-02-10T09:30:00-05:00,107.05,107.60001,106.11,107.00999,240511504,253141384.8,39.6485036891616,38.77400938028761,NaN,NaN,-91.55879122430021,-109.50803999899468,-0.37648392942852293,-1.4223227018831608,-1.0458387724546379,4661683709,4642350256.2,34.57185102406511,38.52822956193825,NaN,NaN,-20.481365086934716,-11.46933226964006
2010-02-11T09:30:00-05:00,106.87,108.25,106.25,108.13,223591568,256229866.4,44.394872226927454,39.33419915122257,NaN,NaN,-69.00810526474265,-99.75626427103253,-0.22454137801659546,-1.3265154949753821,-1.1019741169587867,4885275277,4760414121.8,43.05333186840715,37.16049734177733,NaN,NaN,-19.098910112678283,-12.559271961502663
2010-02-12T09:30:00-05:00,106.99001,108.1012,106.50999,108.03999,304622080,265671783.2,44.094739234845896,39.67818747419129,NaN,NaN,-63.18616996469059,-85.49423912173049,-0.11323364057957352,-1.2435161676832536,-1.13028252710368,4580653197,4718836438.6,41.035899520951624,36.191686856496375,NaN,NaN,-18.085868984644193,-13.348785821951454
2010-02-16T09:30:00-05:00,108.86,109.85001,107.821,109.74001,159317440,263023499.2,50.852876166868285,40.607656017154774,NaN,NaN,-1.0574521183697334,-62.54385665693019,0.08126366229661741,-1.0287029492329083,-1.1099666115295257,4739970637,4753955606.6,43.44647380017418,36.07448092884496,NaN,NaN,-15.057456997784453,-13.59288170421331
2010-02-17T09:30:00-05:00,110.27,110.41,109.74001,110.25999,168845056,264507120.8,52.73492944065234,41.48204222495034,NaN,NaN,53.369221407273045,-34.28825943296602,0.24221409079632106,-0.8071989980341243,-1.0494130888304454,4908815693,4755279702.6,43.540193774812884,36.22786812321185,NaN,NaN,-11.998612255276191,-13.365128925793721
2010-02-18T09:30:00-05:00,110.08,111.14,110.035,110.91,193708496,263368039.2,55.05211669791933,42.81181310532721,NaN,NaN,94.10128214838487,2.8437552415709972,0.3814468568462962,-0.5726045177725752,-0.9540513746188714,5102524189,4843447798.6,49.53702709256892,37.03498322187557,NaN,NaN,-8.7445088848165,-12.705040348511261
2010-02-19T09:30:00-05:00,110.62,111.57001,110.36,111.14,222684816,257259310.4,55.87641441920755,44.43936891580836,NaN,NaN,119.90183735524839,40.6257437655692,0.47209514962066845,-0.36393243759303573,-0.8360275872137042,5325209005,4931434544.2,54.707169785041884,38.40220065192444,NaN,NaN,-5.837486315036015,-11.72396120087194
2010-02-22T09:30:00-05:00,111.55,111.58,110.83,111.16,132346816,246579537.6,55.95206065005387,45.48573462479146,NaN,NaN,120.53330353080715,77.36963846466875,0.5130619927443811,-0.1947000962832277,-0.7077620890276088,5457555821,5106815069,62.872506861438836,40.53000726804199,NaN,NaN,-3.4321307311343605,-10.539413990909429
2010-02-23T09:30:00-05:00,110.86,111.2,109.52,109.81,207496944,247607512.8,49.75175171034478,45.69262169032301,NaN,NaN,68.51719412798558,91.28456771393981,0.43214234461221235,-0.1675841582623434,-0.5997265028745558,5250058877,5208832717,66.63997548676659,42.88055677463841,NaN,NaN,-2.9904965827523884,-9.460997218315566
2010-02-24T09:30:00-05:00,110.14,111,109.86,110.82001,176350624,245866606.4,53.870389673550314,46.3299716916544,NaN,NaN,82.45769400162662,97.10226223281052,0.4286939317326038,-0.06385908820880104,-0.4925530199414048,5426409501,5312351478.6,69.96993349048454,45.65526761938812,NaN,NaN,-1.4033938640556092,-8.309911024849857
2010-02-25T09:30:00-05:00,109.24001,110.75,108.94,110.67,259634688,245255163.2,53.1732732601267,47.600628945446964,NaN,NaN,58.39979521898549,89.96196484693064,0.3989769131753923,0.006168121527835524,-0.3928087916475568,5166774813,5325201603.4,70.36537727965359,48.645197869597744,NaN,NaN,-0.2925452994869119,-7.164573064083722
2010-02-26T09:30:00-05:00,110.77,111.12,110.11,110.74001,173589248,238129428.8,53.475865678312196,48.825273517689915,NaN,NaN,75.25627486448526,81.03285234877802,0.3674848700080388,0.06654729586249175,-0.30093757414554706,5340364061,5328232614.6,70.46417398564596,51.27916239534569,NaN,NaN,0.7090659263277304,-6.039767494024943
2010-03-01T09:30:00-05:00,111.2,112,111.17,111.89,147709632,229981035.2,58.24846877187055,50.52663677527708,NaN,NaN,108.69970329999752,78.66613230261609,0.40461536896045563,0.2048316370550225,-0.19978373190543314,5488073693,5334336189,70.6761784543437,53.949865083782505,NaN,NaN,2.962081412274713,-4.753789078839278
2010-03-02T09:30:00-05:00,112.37,112.74001,112,112.2,160992368,228637409.6,59.455885397505966,51.89872478695336,NaN,NaN,120.33644962846742,89.02998340271247,0.42828230606233353,0.33556915067248383,-0.09271315538984973,5649066061,5414137625.8,73.36780052354547,56.731992353421454,NaN,NaN,5.193975213748112,-3.3326798941839364
2010-03-03T09:30:00-05:00,112.49001,112.97,112.02,112.3,150784944,225360263.2,59.85915385706027,53.342342656088974,NaN,NaN,113.25708831938503,95.18986226626416,0.4278920320683522,0.4421518846955905,0.01425985262723832,5799851005,5488825926.6,75.62307300651906,59.66422249502531,NaN,NaN,7.167393059601119,-1.8326694722146428
2010-03-04T09:30:00-05:00,112.45,112.8,112.03,112.64101,135770368,223512250.4,61.273722374232456,54.5479748094679,NaN,NaN,104.6271156995293,104.43532636237292,0.4268490656947242,0.5478211847456436,0.12097211905091938,5935621373,5642595238.6,79.47648544685302,62.26587632205716,NaN,NaN,9.241593890817056,-0.25063184892440016
2010-03-05T09:30:00-05:00,113.37,114.34,113.10001,114.25,176118752,214482412,67.15506850318128,56.19514118577757,NaN,NaN,143.02109240643227,117.98828987076232,0.5053983244071439,0.7527200245598493,0.24732170015270538,6111740125,5796870451.4,82.47046070465092,65.22548783517854,NaN,NaN,12.938902621418405,1.633587361124572
2010-03-08T09:30:00-05:00,114.25999,114.52,114.07001,114.27,114631120,195534684.8,67.2217059985072,57.364343316608924,NaN,NaN,149.20952505813713,126.09025422239024,0.5271592312651177,0.9062707392341025,0.37911150796898485,6226371245,5944529961.8,84.76175731474612,68.17657951479082,NaN,NaN,15.983311153165818,3.68354790284475
2010-03-09T09:30:00-05:00,113.92999,114.99001,113.87,114.46001,154556688,192054178.4,67.88827495959708,58.4467251393907,NaN,NaN,143.63909855165642,130.75078400702805,0.5218336951624915,1.0314036269220992,0.5095699317596077,6380927933,6090902336.2,86.62770376625598,71.2542587998939,NaN,NaN,18.73061284274297,5.833128608544495
2010-03-10T09:30:00-05:00,114.50999,115.27499,114.41,114.97,186088816,184467598.4,69.67100912172683,59.49093174109123,NaN,NaN,142.62738945121302,136.62484423339362,0.5190410862872734,1.1583712896186995,0.6393302033314261,6567016749,6244335485,88.25169692507669,74.01959235935874,NaN,NaN,21.617899972829356,8.088095946299475
2010-03-11T09:30:00-05:00,114.7,115.48,114.35001,115.45,160875872,180485816.8,71.2867424279784,60.59166945600343,NaN,NaN,133.38465239883345,142.37635157325445,0.5148855689343005,1.2829371644993017,0.7680515955650012,6727892621,6402789734.6,89.64967843075004,76.51548583405217,NaN,NaN,24.575190690171382,10.443395195424033
2010-03-12T09:30:00-05:00,115.95,115.97,115.14,115.46001,162074752,177409976,71.32105493199222,61.68945476185617,NaN,NaN,132.71706328051013,140.31554574807004,0.47892645385779553,1.3667096628872457,0.8877832090294502,6889967373,6558435184.2,90.80687389454062,78.51079776498803,NaN,NaN,27.05492198739211,12.816470451419473
2010-03-15T09:30:00-04:00,115.25999,115.575,114.60001,115.49001,146816816,169519712.8,71.43124264188003,63.237989828394404,NaN,NaN,110.74589614564242,132.62281996557107,0.42510264093269845,1.4191615101953232,0.9940588692626248,7036784189,6720517773,91.83111097710967,80.31016458572682,NaN,NaN,29.184063331921795,15.154698005776947
2010-03-16T09:30:00-04:00,115.81,116.52,115.49001,116.41,168673008,169987491.2,74.64806864301056,64.72210975478443,NaN,NaN,127.199670654597,129.3349343861592,0.4187313024189667,1.5174729972863332,1.0987416948673665,7205457197,6885423625.8,92.71982764890171,81.93515702561375,NaN,NaN,32.03887862121944,17.566723807983017
2010-03-17T09:30:00-04:00,116.75999,117.48,116.4198,117.10001,177468064,170418641.6,76.76155855342763,66.4069872757345,NaN,NaN,136.5963951074274,128.12873551740208,0.4268050919884596,1.632248059852941,1.2054429678644814,7382925261,7048605328.2,93.47617721127594,83.58592844930106,NaN,NaN,35.18388309630714,20.083460849172177
2010-03-18T09:30:00-04:00,117.11,117.27,116.57001,117.03751,196509056,170558669.6,76.14236729060451,68.02602310518394,NaN,NaN,119.43271297720857,125.33834763307709,0.3945133612634921,1.6985846694438465,1.3040713081803543,7186416205,7140310045,93.86210433155601,85.25720918829464,NaN,NaN,37.645009523494586,22.59225351693252
2010-03-19T09:30:00-04:00,116.96001,117.293,115.52,115.97,226641120,170756484.8,66.30450595285326,68.60145433239698,NaN,NaN,87.7320601841388,116.34134701380283,0.2735775242466276,1.646043213488639,1.3724656892420113,6959775085,7154271587.4,93.92106428111326,86.91755817592103,NaN,NaN,37.11988611726125,24.667629602693765
2010-03-22T09:30:00-04:00,115.31,116.8,115.24001,116.5925,184477680,173363028,68.83332030027188,69.27127111116599,NaN,NaN,79.35176004603126,110.0625197938806,0.2106498866528297,1.6357780475580483,1.4251281609052187,7144252765,7175765302.6,94.0163583674065,88.39245516476826,NaN,NaN,37.381353924272496,26.483875934347868
2010-03-23T09:30:00-04:00,116.75999,117.50999,116.38,117.41,182941568,172135259.2,71.82392307339113,70.12589748376105,NaN,NaN,102.18685484619058,105.05995663219933,0.19934376614016736,1.6743078685804278,1.4749641024402604,7327194333,7200112729.8,94.12863864522846,89.71428128181893,NaN,NaN,38.49588045741103,28.199876580499748
2010-03-24T09:30:00-04:00,116.97,117.42641,115.58,116.84,196183312,173126893.6,66.99674132183759,70.53468455144713,NaN,NaN,80.13352080565816,93.76738177184546,0.13198434466560816,1.6399445332722706,1.5079601886066625,7131011021,7149729881.8,90.35045913923086,90.49099368841735,NaN,NaN,37.985618225733205,29.597839672675956
2010-03-25T09:30:00-04:00,117.63,118.1666,116.50999,116.64999,223396256,171314972,65.41836520504215,70.41063431586576,NaN,NaN,93.62317245190894,88.60547366678554,0.05697214731577338,1.5791753727513793,1.522203225435606,6907614765,7093969593.8,86.22546501943452,90.75920828233045,NaN,NaN,37.103670761690935,30.670101256820953
2010-03-26T09:30:00-04:00,116.87,117.42,116.12,116.582,205808496,172925934.4,64.82981318038219,70.23978482885684,NaN,NaN,72.82804337903718,85.62467030576522,-0.011247218065900011,1.5081442028532308,1.5193914209191308,6701806269,7042375830.6,82.47345458520003,90.59575808736288,NaN,NaN,36.212785880471685,31.461913345913914
2010-03-29T09:30:00-04:00,117.16991,117.53,116.6886,117.32001,134513504,172266128,68.17663896133789,70.2603822575526,NaN,NaN,88.34149494307917,87.42261728517481,-0.020170124386410304,1.4941787654361178,1.5143488898225281,6836319773,6980789232.2,78.10449320485326,89.98695733297697,NaN,NaN,36.35856599324972,32.16143515267617
2010-03-30T09:30:00-04:00,117.46001,117.83,116.91,117.39999,145772368,171505128,68.52619078724247,70.17860951937514,NaN,NaN,92.07895136345716,85.40103658862812,-0.0334073709654259,1.4725896761157458,1.5059970470811717,6982092141,6911768793.8,73.41094773379436,88.92690381931395,NaN,NaN,36.574230567308305,32.79183449762362
2010-03-31T09:30:00-04:00,116.95,117.52,116.61,117,161078688,172019815.2,64.69870543446149,69.70803544840966,NaN,NaN,69.54149130851094,83.28263068919867,-0.07920926604313516,1.4069854645272528,1.486194730570388,6821013453,6849769280.2,69.3778293415769,87.47891459865873,NaN,NaN,35.696362013269464,33.206766999858736
2010-04-01T09:30:00-04:00,117.8,118.25,117.10001,117.8,161215184,173292056,68.489558653467,69.50578571422928,NaN,NaN,109.34400994588172,86.42679818799323,-0.0662599485494968,1.4033697948835169,1.4696297434330137,6982228637,6864692054.6,69.80778248274626,85.97897949781627,NaN,NaN,35.985116989794975,33.6036741412782
2010-04-05T09:30:00-04:00,118.25,118.84,117.92,118.75999,105847632,169778500,72.32950123019275,69.5699470419659,NaN,NaN,153.92670715643723,102.64653094347322,-0.006804125977052156,1.4611245859616986,1.4679287119387507,7088076269,6941946054.6,71.99960505878863,84.56244336079332,NaN,NaN,37.418834703707745,34.14869707876813
2010-04-06T09:30:00-04:00,118.42,119.25,118.28999,119.03999,110384128,169566150.4,73.34961754940927,69.47720053528009,NaN,NaN,167.4785871352697,118.47394938191135,0.03530443529278071,1.5120592560547266,1.4767548207619459,7198460397,7014374179.4,73.91177244881227,83.21901084650122,NaN,NaN,38.90714517138238,34.828475377713026
2010-04-07T09:30:00-04:00,118.8,119.3567,117.81,118.36,184576320,171067132,66.899267979755,68.7727512085892,NaN,NaN,133.14239572109125,126.68663825343815,0.0029878838498755833,1.4804896755742902,1.4775017917244146,7013884077,7020732566.6,74.07912633399596,81.8335072124098,NaN,NaN,38.23039481069211,35.31446386813861
2010-04-08T09:30:00-04:00,117.95,118.97,117.60001,118.77251,158704000,169697891.2,68.69763835910486,68.24098485633922,NaN,NaN,121.1426892751847,137.0068778467729,-0.004568811631026293,1.4717907771856318,1.476359588816658,7172588077,7091047491.4,75.91885425765653,80.55184649284556,NaN,NaN,38.19647689798131,35.726180015259
2010-04-09T09:30:00-04:00,119.02,119.60001,118.8,119.55,133006496,168304422.4,71.80672022503214,68.63400016149485,NaN,NaN,168.67590113122,148.87325608384057,0.02709220957694214,1.5102248507878357,1.4831326412108936,7305594573,7155720678.6,77.50059883757817,79.37895610402163,NaN,NaN,39.122851782756634,36.21141883918723
2010-04-12T09:30:00-04:00,119.7,120.05,119.56,119.74001,110278944,165714632,72.52494430875818,68.89768759067245,NaN,NaN,170.30973569094462,152.14986179074205,0.044121063017581674,1.5382839699828708,1.494162906965289,7415873517,7221280128.2,79.0059931193322,78.30678715773058,NaN,NaN,40.09164976774356,36.76573754326671
2010-04-13T09:30:00-04:00,119.62,120.03999,119,119.83,125125056,164630044,72.87735484333732,68.97293271709717,NaN,NaN,136.38666099911762,145.93147656351164,0.04460247297521169,1.5499159981843036,1.505313525209092,7540998573,7289787763.4,80.47605381354737,77.33160252689622,NaN,NaN,40.984277706389975,37.368386137998606
2010-04-14T09:30:00-04:00,120.27,121.19,120.08,121.19,161609008,164276844,77.5615278136716,69.72756032365673,NaN,NaN,179.4359649113694,155.19019040156726,0.11563444279648638,1.6498565787047,1.5342221359082135,7702607581,7427532464.2,83.04655854904422,76.80989534188289,NaN,NaN,43.31712056650689,38.218205342071215
2010-04-15T09:30:00-04:00,120.99001,121.5654,120.95,121.28999,144615248,162634203.2,77.86421783037471,70.61654979689477,NaN,NaN,170.57764841057013,165.07718222864438,0.14648807464354463,1.7173322292126443,1.5708441545690996,7847222829,7562459414.6,85.11401709419563,76.73050620436582,NaN,NaN,45.27860371602431,39.226833681207374
2010-04-16T09:30:00-04:00,120.86,121.285,118.75,119.36,366879744,171152737.6,60.81211029704167,70.32957101951332,NaN,NaN,82.54649076603927,147.85130015560821,0.020658847117296597,1.5966677134657203,1.5760088663484237,7480343085,7597409117,85.60374835793726,76.9540986167042,NaN,NaN,41.24839902047017,39.51562872967349
2010-04-19T09:30:00-04:00,119.00999,119.92999,118.47,119.81,217947744,170718068.8,62.854722325156146,69.94943411692891,NaN,NaN,56.160167138966905,125.02138644521267,-0.0449416691648763,1.5198317798923284,1.5647734490572047,7698290829,7653892579.4,86.3834185215707,77.54545042504115,NaN,NaN,38.70017855733426,39.39913584791074
2010-04-20T09:30:00-04:00,120.56,120.98,119.871,120.88,157707936,169379581.6,67.22876275764435,69.85676068624333,NaN,NaN,109.06601156041873,119.55725655747287,-0.02968372587835555,1.5276687917092602,1.5573525175876157,7855998765,7716892617.8,87.21511074865407,78.53146206895971,NaN,NaN,38.01045363195478,39.20075267420275
2010-04-21T09:30:00-04:00,120.95,121.23,119.99001,120.66,192910064,169878006.4,65.5204030078683,69.9154533700581,NaN,NaN,99.85981319481795,103.64202621416257,-0.046802244331580756,1.49884971217314,1.5456519565047206,7663088701,7708988841.8,86.50127946422958,79.75456564914919,NaN,NaN,36.91018708091639,38.87352901801898
2010-04-22T09:30:00-04:00,119.81,121.17,119.12,121.02,239188560,172028268.8,66.99823766610537,69.80893044238941,NaN,NaN,81.6166751762553,85.84983156729962,-0.04619540394646182,1.4879077015716433,1.5341031055181051,7902277261,7719999728.2,86.66502459775307,80.95865437164967,NaN,NaN,36.47887370896605,38.53143540243999
2010-04-23T09:30:00-04:00,120.94,121.86,120.63,121.8125,177335440,169725228,70.04230029246222,69.64555894683723,NaN,NaN,123.65057530196435,94.07064847448461,-0.006804035343377812,1.5255980613388829,1.5324020966822607,8079612701,7839853651.4,88.32515289734155,82.12476493154632,NaN,NaN,37.07966703041487,38.324039920722115
2010-04-26T09:30:00-04:00,121.85001,122.12,121.23,121.35001,143457184,166607662.4,66.20442191549938,69.13518783012938,NaN,NaN,121.71530174197532,107.18167539508632,-0.025243258609440655,1.5008480234204598,1.5260912820299004,7936155517,7887426589,88.91504910754264,83.19642755002705,NaN,NaN,36.372413936529284,38.04523620869457
2010-04-27T09:30:00-04:00,120.64999,121.33459,118.25,118.48,355853824,177674678.4,48.45945843050865,67.81805857661179,NaN,NaN,-10.516559684973465,83.26516114600788,-0.23254772944309643,1.2354066202260299,1.4679543496691263,7580301693,7832287174.6,83.64001388563102,83.87934808942957,NaN,NaN,28.880924306214972,36.736048794054625
2010-04-28T09:30:00-04:00,119.05,119.67999,118.27,119.38,300677632,185419941.6,52.73753238519501,66.67805100704679,NaN,NaN,-33.90714562828819,56.51176938138666,-0.30623878152456285,1.0851558727634227,1.3913946542879856,7880979325,7875865299.4,84.42639024899215,84.48702923166783,NaN,NaN,24.516587736006187,34.990411500047706
2010-04-29T09:30:00-04:00,120.10001,121.11,120.07001,120.8575,193774880,187054751.2,58.785616002998985,65.74797213404443,NaN,NaN,65.14417623183412,53.21726959250243,-0.254767843551889,1.0729348498481244,1.3277026934000133,8074754205,7910360688.2,85.03940859456937,85.02551564288147,NaN,NaN,23.160979046433464,33.30049257810281
2010-04-30T09:30:00-04:00,120.88,121.00999,118.78,118.8125,270000896,192494036.8,49.36879296139449,64.09396132351846,NaN,NaN,-27.846678222841508,22.917818887541266,-0.35176303997221803,0.8879988934347409,1.239761933406959,7804753309,7855388809.8,79.65821089147857,85.07210262660622,NaN,NaN,18.278850098843797,31.154543652494382
2010-05-03T09:30:00-04:00,119.38,120.67999,119.2,120.35001,182747808,196339045.6,55.18175518477272,62.82998991933527,NaN,NaN,9.818269655453589,0.5384124702369203,-0.3073001267639188,0.8556367749520604,1.1629369017159792,7987501117,7865657929.8,79.91391130366625,85.03194959018614,NaN,NaN,16.659288357914583,29.08379289612584
2010-05-04T09:30:00-04:00,119.00999,119.03,116.92,117.52,360353280,208837503.2,44.951660313634534,60.500713669332626,NaN,NaN,-167.55412609648133,-30.86910081206465,-0.4545293542488471,0.5947752089049203,1.0493045631537674,7627147837,7875027158.6,80.158965359711,84.82569293380519,NaN,NaN,10.992616319489407,26.49933909946349
2010-05-05T09:30:00-04:00,116.56,117.8,115.97,116.82001,328973312,216057352.8,42.83629861068408,57.998719439354716,NaN,NaN,-218.55295505814584,-67.79826269803618,-0.5772206378117964,0.3277787658890219,0.9049994037008183,7298174525,7758466198.6,68.89729870711736,83.66735590615674,NaN,NaN,5.999851544424009,23.570840877314993
2010-05-06T09:30:00-04:00,116.25999,117,105,112.942,647356416,240489973.6,33.44590790926709,56.043990697370816,NaN,NaN,-405.43126833719333,-161.91335161184168,-0.879598543053832,-0.19449877511647173,0.6850997679373603,6650818109,7473678979.4,50.30247761555827,81.14583656741537,NaN,NaN,-2.460400083408308,19.852092168640237
2010-05-07T09:30:00-04:00,112.64,113.77,109.41,111.25999,637558784,265717588,30.33933134261433,53.721462770046394,NaN,NaN,-273.43117094426225,-211.03025015612585,-1.1366010194596934,-0.7356515063872564,0.4009495130724369,6013259325,7115380182.6,36.833325023444516,77.60654417469208,NaN,NaN,-10.139679732181662,15.567553325665681
2010-05-10T09:30:00-04:00,115.81,116.64999,114.91,116.16,396159488,280011615.2,46.05809624292593,52.209272304709366,NaN,NaN,-96.04920840137267,-232.20374576749109,-0.9290508784142874,-0.7603640849454223,0.16868679346886506,6409418813,6799763721.8,29.372446113677526,73.47492527219376,NaN,NaN,-9.747197247534793,11.951160386637042
2010-05-11T09:30:00-04:00,115.07001,117.36,114.91,115.83,317849600,289647842.4,45.31646425429895,50.766133822311566,NaN,NaN,-79.38903670614383,-214.5707278894236,-0.7728578030475888,-0.797385460340621,-0.024527657293032162,6091569213,6492647997,24.229415640503206,69.02693499907045,NaN,NaN,-9.770841735521737,8.848017226328645
2010-05-12T09:30:00-04:00,116.28999,117.62,116.09,117.45,235607008,293347742.4,49.60633469518427,49.52385503867434,NaN,NaN,-43.042448534197874,-179.468626584634,-0.5308362968934968,-0.688073028409903,-0.15723673151640633,6327176221,6298448336.2,21.64815973568976,64.38287322320878,NaN,NaN,-8.131698448011997,6.4223435585656965
2010-05-13T09:30:00-04:00,117.13,117.67999,115.89,115.99001,234456064,297839783.2,46.09658690665546,47.81344693968815,NaN,NaN,-51.39018210099871,-108.66040933739505,-0.44305424345305894,-0.71105453583273,-0.2680002923796711,6092720157,6186828745.8,20.30893948201215,59.52457226497096,NaN,NaN,-8.145055424722035,4.341286560953163
2010-05-14T09:30:00-04:00,115.12,115.33,112.87,113.89,345602048,296775898.4,41.54357485283034,46.05195786378322,NaN,NaN,-107.30669072794348,-75.43551329413128,-0.4963829421081956,-0.8884789700149156,-0.39209602790672,5747118109,6133600502.6,19.683591490226988,54.57946814944841,NaN,NaN,-9.817513564918496,2.3186008286857835
2010-05-17T09:30:00-04:00,114.2,114.52,111.77,113.95,325944064,302175714.4,41.72069134073752,45.570617357371,NaN,NaN,-108.34602031361935,-77.89487567658064,-0.4963833987464774,-1.0125752763398168,-0.5161918775933394,6073062173,6066329174.6,18.8918532360602,49.95459953162192,NaN,NaN,-11.012450727807039,0.414164892043952
2010-05-18T09:30:00-04:00,114.88,115.22,112.03,112.39999,360595968,312320116,38.477300629807026,44.552029374843286,NaN,NaN,-100.9245666822682,-82.20198167180551,-0.5645744412398841,-1.2219099291431945,-0.6573354879033104,5712466205,5990508573,18.012442425988297,45.210746115693084,NaN,NaN,-13.072816673789411,-1.512546760217957
2010-05-19T09:30:00-04:00,111.77,112.77,110.36,111.75999,394759424,322412584,37.191648830425976,43.00960314823093,NaN,NaN,-124.51954744100864,-98.49740145316767,-0.612569843144297,-1.4230477918336817,-0.8104779486893847,5317706781,5788614685,15.891181666148142,40.27158704937728,NaN,NaN,-15.123921110591668,-3.4570288102713445
2010-05-20T09:30:00-04:00,109.38,109.89,107.47,107.53999,530423552,336974333.6,30.059536090541414,41.63037051459857,NaN,NaN,-172.27198383814246,-122.67376180059641,-0.8724620763901929,-1.901055544177126,-1.028593467786933,4787283229,5527527299.4,13.652107172473691,35.55686535516265,NaN,NaN,-19.561757153694536,-5.757704287903229
2010-05-21T09:30:00-04:00,105.91,109.38,105.36121,109.11501,500909312,353153027.2,35.06463172755612,40.19343312479738,NaN,NaN,-153.73221243898837,-131.9588661428054,-0.8797300023491634,-2.1282559707233872,-1.2485259683742238,5288192541,5435742185.8,12.960733292868113,30.774495497248502,NaN,NaN,-21.41593753104621,-7.99459475120937
2010-05-24T09:30:00-04:00,108.52,109.39,107.61,107.71001,269822976,359471316.8,32.809079672006334,39.32610593610965,NaN,NaN,-129.28694699085852,-136.14705147825322,-0.9164497418618456,-2.394088145701531,-1.4776384038396853,5018369565,5224803664.2,11.517194937091489,25.871511895632814,NaN,NaN,-23.669995334490284,-10.233937691678072
2010-05-25T09:30:00-04:00,105.11,107.87,104.38,107.81799,396505088,361503880,33.16490741737776,38.635292279444904,NaN,NaN,-139.17733315537492,-143.79760477287456,-0.871060774768528,-2.566464372300345,-1.6954035975318171,5414874653,5165285353.8,11.14017010435154,21.74600270972096,NaN,NaN,-25.310345687869017,-12.387710262562493
2010-05-26T09:30:00-04:00,108.48,109.47,106.85001,107.17,349719296,363955963.2,32.06741180660295,38.53682827211175,NaN,NaN,-106.41120912574188,-140.1759371098212,-0.8228459413543572,-2.7239610242247636,-1.9011150828704064,5065155357,5114775069,10.816556935904103,18.925579804031372,NaN,NaN,-26.976809640221887,-14.471867316513835
2010-05-27T09:30:00-04:00,109.19,110.8,108.78011,110.75999,300870400,369310739.2,43.26844983888046,39.46033673613076,NaN,NaN,-58.992190090841405,-117.51997836036101,-0.5030539956642643,-2.5299325774507366,-2.0268785817864723,5366025757,5230523574.6,16.782374156995417,17.493369027856442,NaN,NaN,-24.833530886610408,-15.952104969384774
2010-05-28T09:30:00-04:00,110.64,110.724,108.85001,109.369,297933312,370707360,40.48316256193397,39.06212718748848,NaN,NaN,-60.83122501490853,-98.93978087554504,-0.346534744855834,-2.460047012856265,-2.113512268000431,5068092445,5186503555.4,16.334846093878014,16.562111883585047,NaN,NaN,-23.962028360335292,-17.09637973952056
2010-06-01T09:30:00-04:00,108.35001,109.95,107.37,107.53,277909248,375465432,37.08431759241924,38.47411671163992,NaN,NaN,-81.0765436523442,-89.29770020784218,-0.32835778263131754,-2.523959496289578,-2.1956017136582604,4790183197,5140866281.8,15.862571467109305,15.964480156914055,NaN,NaN,-24.321578672742827,-18.12855101569517
2010-06-02T09:30:00-04:00,108.08,110.34,107.50909,110.33,240243632,369459949.6,44.69744511103436,38.123481741343504,NaN,NaN,-52.68970175707829,-72.00017392818287,-0.10104541689480806,-2.3219084847767704,-2.2208630678819623,5030426829,5063976717,15.07192785266433,15.49474930812652,NaN,NaN,-22.070505256606793,-18.691687335825403
2010-06-03T09:30:00-04:00,110.64999,111.06,109.58,110.71001,226618256,364342196.8,45.658520222304645,38.092191263889866,NaN,NaN,-23.226923021469908,-55.36331670732848,0.09122507299157245,-2.106831726642497,-2.1980567996340694,5257045085,5102354662.6,17.287954312678437,15.278964653174112,NaN,NaN,-19.997898419203274,-18.878288919165097
2010-06-04T09:30:00-04:00,108.61,109.33,106.465,106.82001,398475520,351898152,38.31761149547685,37.8617653097932,NaN,NaN,-84.99224588359654,-60.5633278658795,-0.021257125895071116,-2.224628207002908,-2.203371081107837,4858569565,5000863424.2,16.092126561481606,15.022431443978013,NaN,NaN,-20.600421113132093,-19.124307804017526
2010-06-07T09:30:00-04:00,107.2,107.61,105.41,105.49001,264609056,333250665.6,36.17602527554665,37.46571773370813,NaN,NaN,-104.03593380369497,-69.2042696236368,-0.155434234667287,-2.397663874441946,-2.242229639774659,4593960509,4906037037,15.044992394774496,14.74765566960046,NaN,NaN,-21.79415352859999,-19.505714336100734
2010-06-08T09:30:00-04:00,105.57001,106.83,104.64999,106.62,357774336,331331408,39.28107697991503,37.52313033014442,NaN,NaN,-101.23017485837568,-73.2349958648431,-0.13883042601978923,-2.4157676722993955,-2.2769372462796063,4951734845,4938347366.6,17.026185526566138,14.677208748213163,NaN,NaN,-21.767564931675455,-19.828835849754267
2010-06-09T09:30:00-04:00,107.24001,108.28,105.60001,106.05,268023248,328840090.4,38.26967295163422,37.60013205308786,NaN,NaN,-82.52910601303687,-79.20287671603481,-0.13676342622118964,-2.4478915290560934,-2.3111281028349038,4683711597,4869004320.2,16.155417966293967,14.696082769652149,NaN,NaN,-22.054102270299055,-20.146731052689237
2010-06-10T09:30:00-04:00,107.86,109.28,106.0426,109.14999,317890560,332954268,46.3589333905392,38.76437471737342,NaN,NaN,-39.40553012644371,-82.43859813702957,0.09060572741764528,-2.1978709435628474,-2.2884766709804927,5001602157,4817915734.6,15.525427338843556,14.829891352964282,NaN,NaN,-19.69688020776329,-20.082466646271243
2010-06-11T09:30:00-04:00,108.19,109.75,108.12,109.67999,214128128,331937871.2,47.62266229823609,39.66137690099341,NaN,NaN,1.3414532404765565,-65.17185831221494,0.2830535728968293,-1.934659704859456,-2.2177132777562854,5215730285,4889347878.6,20.210497883782125,15.34773168088671,NaN,NaN,-17.41953118897047,-19.702047295228276
2010-06-14T09:30:00-04:00,110.52,111.12,109.39999,109.509,207196000,325017568.8,47.23602002166461,40.691872640254715,NaN,NaN,42.889042082917975,-35.78686313489236,0.3981443043866961,-1.7200328972729153,-2.1181772016596114,5008534285,4972262633.8,25.38355758691256,16.33818615587393,NaN,NaN,-15.699223877006336,-19.13021537833943
2010-06-15T09:30:00-04:00,110.28,112.10001,110.09,112,238268624,320633796.8,53.197479660959935,42.12277065765345,NaN,NaN,110.18160074284006,6.495491985350805,0.6276903806612428,-1.333564225833058,-1.9612546064943008,5246802909,5031276246.6,28.916027636619532,17.607890265321643,NaN,NaN,-12.33759358422361,-18.159840836322882
2010-06-16T09:30:00-04:00,111.42,112.42,111.2,111.96001,216373936,313422695.2,53.093769577967905,43.62465335560808,NaN,NaN,139.8619549329614,50.973704174550456,0.7539891627609965,-1.0187681530430552,-1.7727573158040517,5030428973,5100619721.8,32.933803539889155,19.18769359417772,NaN,NaN,-9.667388215121544,-16.946633319008406
2010-06-17T09:30:00-04:00,112.28,112.33,111.05,112.14,263185744,306844011.2,53.532863565547856,44.35782576465575,NaN,NaN,137.39912504360066,86.33463520855932,0.8212738661163215,-0.7461649831586499,-1.5674388492749713,5293614717,5159022233.8,36.204316847756374,20.57497521494636,NaN,NaN,-7.347710909675925,-15.575358689103766
2010-06-18T09:30:00-04:00,111.83,112.13,111.37,111.729,174006560,289023161.6,52.32826749469833,45.20390468842464,NaN,NaN,115.64792689706422,109.19592993987685,0.8084550624676297,-0.5568700211904343,-1.365325083658064,5119608157,5139797808.2,35.589089475685356,21.950278313646884,NaN,NaN,-5.70881810670113,-14.165852891617675
2010-06-21T09:30:00-04:00,113.12,113.2,110.78999,111.41,213140624,274634727.2,51.36222039343316,46.22375488849706,NaN,NaN,105.2689331691447,121.6719081571222,0.7501295078111867,-0.42766319889408067,-1.1777927067052674,4906467533,5119384457.8,34.91069946549865,23.310858884960407,NaN,NaN,-4.568305886853074,-12.794774748079876
2010-06-22T09:30:00-04:00,111.41,111.89999,109.41,109.57001,239355312,273111344,46.07817348793511,46.32237834398997,NaN,NaN,41.36273160601626,107.90813432975744,0.5675629998149294,-0.46833895693660565,-1.035901956751535,4667112221,5003446320.2,31.265474742341596,24.467540805651645,NaN,NaN,-4.962623733886453,-11.67589603176653
2010-06-23T09:30:00-04:00,109.64,110.03,108.48,109.23,254698752,266021027.2,45.15373615505334,46.286322339186306,NaN,NaN,-5.862071314449206,78.76332908027533,0.41112673572897995,-0.5219935370903102,-0.9331202728192901,4412413469,4879843219.4,27.91854726133552,25.22686887341286,NaN,NaN,-5.541784216661614,-10.7995943438944
2010-06-24T09:30:00-04:00,108.69,108.83,107.14,107.42,268691968,261969660.8,40.49608625283891,46.441927678997885,NaN,NaN,-68.68755982889725,37.545992105775746,0.18452068113268372,-0.7024694214034355,-0.8869901025361192,4143721501,4649864576.2,22.987718036501334,25.719411121628557,NaN,NaN,-7.3802222151386525,-10.311112611215007
2010-06-25T09:30:00-04:00,107.74001,108.42,106.77,107.86749,238726496,258862465.6,42.08661507241744,46.86411266448865,NaN,NaN,-66.16212171659222,1.1839823830444516,0.06945980302467814,-0.8001653487552716,-0.8696251517799497,4382447997,4502432544.2,20.489411843684778,26.10829822512215,NaN,NaN,-8.500042477311997,-10.05238830637172
2010-06-28T09:30:00-04:00,108.03,108.32001,107.14,107.53,169333248,252432462.4,41.19233272984572,47.00063093234085,NaN,NaN,-60.583014834116,-31.986407217607688,-0.019908940775081763,-0.8945113277488019,-0.8746023869737202,4213114749,4363761987.4,18.45752145357868,26.210536505623047,NaN,NaN,-9.685469922870885,-9.99997139444303
2010-06-29T09:30:00-04:00,106.02,107.5114,103.55,104.21001,373760512,257225025.6,33.62342575298106,46.668756132437046,NaN,NaN,-143.04923005746673,-68.86879955030429,-0.27878030113796504,-1.2230777633961765,-0.9442974622582114,3839354237,4198210390.6,16.370331156173492,26.225887447757295,NaN,NaN,-13.159696558652698,-10.451360703615839
2010-06-30T09:30:00-04:00,103.92,104.88,102.88,103.22,284101632,259417925.6,31.749953099729098,45.62525754023632,NaN,NaN,-162.80354719356788,-100.25709472612803,-0.4809928762367417,-1.5455385575541385,-1.0645456813173968,3555252605,4026778217.8,14.537126791405072,26.155294551511695,NaN,NaN,-16.65727433998571,-11.33791979452582
2010-07-01T09:30:00-04:00,103.14999,103.49001,101.13,102.75999,382924800,267233252.8,30.888725841266833,44.42997636473852,NaN,NaN,-173.05096219367798,-121.12977519908418,-0.6021728631847745,-1.817261760298365,-1.2150888971135905,3172327805,3832499478.6,12.78923120204226,25.625204074244557,NaN,NaN,-19.798929964169933,-12.546635533046407
2010-07-02T09:30:00-04:00,103.11,103.42,101.62,102.2,233385120,258978732.8,29.82801569242254,43.18654748407838,NaN,NaN,-150.76610387960574,-138.05057163168686,-0.671218754852019,-2.054112340678614,-1.3828935858265952,2938942685,3543798416.2,10.725463679437382,24.57819736656776,NaN,NaN,-22.74147596115487,-14.003041308490474
2010-07-06T09:30:00-04:00,103.64,104.37,101.88,102.87,256936432,258595101.6,32.80130247327244,41.729677684957835,NaN,NaN,-122.1837195156144,-150.37071256798654,-0.6239435742334183,-2.162823053618368,-1.5388794793849496,3195879117,3340351289.8,9.555295416831683,23.1952879222972,NaN,NaN,-24.42488486320098,-15.491876102020546
2010-07-07T09:30:00-04:00,103.13,106.24001,103.02,106.1075,253769680,253394868.8,44.94130125728598,41.14735851919484,NaN,NaN,-67.53268507365402,-135.267403571224,-0.3409648966379304,-1.9650856001823627,-1.6241207035444323,3449648797,3262410201.8,9.1437151776136,21.49599589642037,NaN,NaN,-22.242699270772896,-16.45627941184231
2010-07-08T09:30:00-04:00,107,107.28,105.91,107.16,210842064,250535809.6,48.21656057767201,40.76762259148943,NaN,NaN,-26.73246279083728,-108.05318669067788,-0.06375051082457239,-1.7038088420751478,-1.6400583312505754,3660490861,3283457853,10.267752673995332,19.643384169723156,NaN,NaN,-19.395661252246786,-16.876191103328665
2010-07-09T09:30:00-04:00,107.13,107.97,106.92999,107.96001,144999872,241891275.2,50.621032696803255,40.64567724878263,NaN,NaN,-5.347603550729018,-74.51251496208809,0.17935087076549805,-1.4158697427937028,-1.5952206135592009,3805490733,3410090438.6,16.926816792405077,18.310364692345992,NaN,NaN,-16.29758760298034,-16.793533460421763
2010-07-12T09:30:00-04:00,107.60001,108.24001,107.14999,108.03,131283568,237749047.2,50.83611284518231,40.608098138193284,NaN,NaN,1.023031281019143,-44.15468792996312,0.34133015820459156,-1.1685579158034614,-1.509888074008053,3936774301,3609656761.8,26.21933996743121,17.68955329962689,NaN,NaN,-13.73333958424589,-16.356362906682353
2010-07-13T09:30:00-04:00,109.14999,110.09,108.92999,109.66,213025872,238040540.8,55.67799301015507,41.29379953263757,NaN,NaN,46.737692234021964,-10.370405580035841,0.5427506999779721,-0.8314496990355877,-1.3742003990135598,4149800173,3800440973,33.83867157936017,17.873353073699644,NaN,NaN,-10.00042623106673,-15.448371953022978
2010-07-14T09:30:00-04:00,109.31,110.08,108.86,109.651,184426752,235348447.2,55.64540658407069,42.04320456328167,NaN,NaN,50.08844101469004,13.153819637632983,0.6524992686030258,-0.5585763132597776,-1.2110755818628034,3965373421,3903585897.8,37.591088320167025,18.564248863616182,NaN,NaN,-6.9842583124935755,-14.239212861518778
2010-07-15T09:30:00-04:00,109.61,110.06,108.17,109.67999,232337872,236146644,55.73527380902054,43.13171796015178,NaN,NaN,49.2685978736432,28.35403177052907,0.6999736743499647,-0.3361084889253476,-1.0360821632753123,4197711293,4011029984.2,41.324314942941356,19.874005785504753,NaN,NaN,-4.46965155016254,-12.843561245610744
2010-07-16T09:30:00-04:00,109.09,109.2059,106.45,106.66,282693376,237122025.6,45.41281565368704,43.369303715956754,NaN,NaN,4.013571646983198,30.226266810071518,0.509752992238204,-0.39889092297755724,-0.9086439152157613,3915017917,4032935421,42.08496197386502,21.41654508051763,NaN,NaN,-5.128488197826606,-11.741407953070153
2010-07-19T09:30:00-04:00,107.05,107.63,106.22,107.28999,186709008,237757148,47.593298392746064,43.82651554902107,NaN,NaN,-0.6814219026184177,29.885376173344003,0.41229268285620635,-0.3932780616455034,-0.8055707445017097,4101726925,4065925945.8,43.277581015413766,23.18940647779156,NaN,NaN,-5.030037026299617,-10.78264067781722
2010-07-20T09:30:00-04:00,105.87,108.56,105.82001,108.48,258162320,240008232.8,51.531711618401665,45.10567882512254,NaN,NaN,26.090595658870694,25.75595685831375,0.41288127816620934,-0.2894691467939481,-0.7023504249601574,4359889245,4107943760.2,44.835688846180844,25.22264631279209,NaN,NaN,-3.76666044455264,-9.780357787350852
2010-07-21T09:30:00-04:00,109.03999,109.07001,106.63,107.07001,264526944,241266814.4,47.022597989924435,46.196582031565065,NaN,NaN,31.115547326601565,21.961378120696054,0.30802720639929837,-0.3173164169610345,-0.6253436233603329,4095362301,4133941536.2,45.8272310936689,27.45765376295379,NaN,NaN,-4.048308310620716,-8.961493576389405
2010-07-22T09:30:00-04:00,108.34,109.94,108.33,109.461,274781440,242270948.8,54.321751032618955,47.870369545233075,NaN,NaN,90.53355535287172,30.214369616541756,0.3844479448844451,-0.1447836922547765,-0.5292316371392216,4370143741,4168428025.8,47.183421789938116,29.914381662089205,NaN,NaN,-1.9315133618176668,-7.957210688593442
2010-07-23T09:30:00-04:00,109.24001,110.57001,108.92999,110.41,222020816,239937391.2,56.8622136242919,49.80138368322374,NaN,NaN,108.62067525045568,51.13579033723626,0.477581453487587,0.06774517972026217,-0.40983627376732484,4592164557,4303857353.8,52.23995507801519,32.87970247627334,NaN,NaN,0.6198441134335697,-6.731917145446726
2010-07-26T09:30:00-04:00,110.60001,111.67,110.28999,111.56,182126496,237107391.2,59.781304706482324,51.72852669988159,NaN,NaN,135.6442952069389,78.4009337591477,0.5880468358937827,0.32522227109990354,-0.26282456479387917,4774291053,4438370179.4,56.67647142523243,36.245500762587675,NaN,NaN,3.6802382902829356,-5.244466368913917
2010-07-27T09:30:00-04:00,112.17,112.28999,111.11,111.55,204855568,238883507.2,59.74344590142771,52.78582274589172,NaN,NaN,134.46385994736087,100.07558661684575,0.6282159554272921,0.522445379490236,-0.10577057593705613,4569435485,4480279427.4,57.98596276716785,39.73423273327012,NaN,NaN,6.099015727622749,-3.6239689265515365
2010-07-28T09:30:00-04:00,111.32001,111.66,110.46001,110.83,163056192,228348291.2,56.94710359686441,53.40943296154832,NaN,NaN,105.33361482144785,114.91920011581502,0.5754766350868509,0.6135752179215075,0.038098582834656614,4406379293,4542482825.8,59.92225547603524,43.28098293341583,NaN,NaN,7.32372429252863,-2.060012752397227
2010-07-29T09:30:00-04:00,111.52,111.82001,109.41,110.28999,220149008,225150660,54.872621171141546,53.71311785257249,NaN,NaN,83.23866971550343,113.46022298834137,0.477443700541079,0.6349032085110053,0.15745950796992636,4186230285,4505700134.6,58.21375050609622,46.230049627250914,NaN,NaN,7.760240402380301,-0.657119444571866
2010-07-30T09:30:00-04:00,109.17,110.86,108.98,110.27,220070496,217007944.8,54.793049355892215,53.99575617476604,NaN,NaN,61.294121614057694,103.99491226106177,0.3882589252831668,0.6427831645738848,0.25452423929071805,3966159789,4380499181,52.705279885211425,48.12190247852093,NaN,NaN,8.09724625540521,0.5935042268534305
2010-08-02T09:30:00-04:00,111.99001,112.94,111.53999,112.75999,188263184,214751848,62.15483907093796,54.45838803625054,NaN,NaN,133.5324440910152,103.57254203787701,0.46859135734105084,0.8402634359670316,0.37167207862598073,4154422973,4256525565,47.87451238182182,49.12446253583961,NaN,NaN,10.626627449801033,2.026807544417373
2010-08-03T09:30:00-04:00,112.48,112.77,111.85001,112.22,146657248,209237888.8,59.87756590037293,54.76068513027213,NaN,NaN,125.52339759471535,101.78444956734792,0.45652847251500067,0.9423326692697316,0.4858041967547309,4007765725,4144191613,43.94417542864687,49.5782544721596,NaN,NaN,12.060927138624061,3.4602532007326143
2010-08-04T09:30:00-04:00,112.53,113.11,112.16,112.97,158171632,204457986.4,61.96213613644808,55.205461010802665,NaN,NaN,135.32276932829868,107.78228046871808,0.468469976829474,1.0713916677915734,0.6029216909620994,4165937357,4096103225.8,42.341642438933555,49.65092072187333,NaN,NaN,13.881973236274458,4.949070348667163
2010-08-05T09:30:00-04:00,112.25,112.91,112.08,112.85001,140473744,200939570.4,61.41240060532051,56.348288507347924,NaN,NaN,116.26505348699702,114.3875572230168,0.43824250664269404,1.1507248242654669,0.7124823176227728,4025463613,4063949891.4,41.258247203362046,49.591869666837404,NaN,NaN,15.225912477881312,6.417190652840613
2010-08-06T09:30:00-04:00,111.74001,112.57001,110.92,112.392,239728256,205675989.6,59.25146843772481,57.18101493913212,NaN,NaN,80.30996927313512,118.19072675483228,0.3605984240794209,1.163230347722049,0.802631923642628,3785735357,4027865005,40.02062775297166,49.359230148091534,NaN,NaN,15.780271494656445,7.754773630242875
2010-08-09T09:30:00-04:00,112.92,113.17999,112.32001,112.992,120800368,205151829.6,61.178624783933394,57.870080165241525,NaN,NaN,105.00331216830158,112.48490037028955,0.3240026083454104,1.207635184074391,0.8836325757289807,3906535725,3978287555.4,38.31986458996047,48.89381412979009,NaN,NaN,16.779030535786355,9.043953188177657
2010-08-10T09:30:00-04:00,112.03,112.98,111.3701,112.375,242916192,206646345.6,58.13386668735559,58.663742215058036,NaN,NaN,72.68557585175765,101.91733602169799,0.23664889980589177,1.1794437004863454,0.9427948006804536,3663619533,3909458317,36.03055582104788,48.19405161031715,NaN,NaN,16.816764435481456,10.154354794935342
2010-08-11T09:30:00-04:00,110.64999,110.69,109.12,109.3,273408256,211095420.8,45.878931518680936,58.06068367834818,NaN,NaN,-31.34277469280096,68.58422721747809,-0.03534283522914805,0.8986162566440186,0.9339590918731666,3390211277,3754313101,31.467160718273675,47.07146153376969,NaN,NaN,12.936021898002503,10.551735809659222
2010-08-12T09:30:00-04:00,107.64999,109.02,107.60001,108.63,239542560,211455655.2,43.71650381773536,57.12170440645128,NaN,NaN,-79.89432189866858,29.352352140344966,-0.2552418170909305,0.6149068205095034,0.8701486376004339,3150668717,3579354121.8,27.27226767482678,45.2880552906848,NaN,NaN,9.056875001539947,10.338184265642182
2010-08-13T09:30:00-04:00,108.28999,108.96001,108.17999,108.31,158698496,205255911.2,42.68176549164521,55.900308748248634,NaN,NaN,-82.13854199282952,-3.1373501128479604,-0.40804467240558095,0.36009279709345776,0.7681374694990387,2991970221,3420601094.6,24.129052804781296,42.96323967493829,NaN,NaN,5.582298915621693,9.658772072782112
2010-08-16T09:30:00-04:00,107.57001,108.61,107.17999,108.25999,147895248,203315223.2,42.51241267450036,54.669520660610964,NaN,NaN,-106.78846927022096,-45.495706400552464,-0.4926226498966234,0.15235915712825943,0.6449818070248828,2844074973,3208108944.2,20.691493373440437,40.29934900395777,NaN,NaN,2.7077197636377806,8.665764600047208
2010-08-17T09:30:00-04:00,109.19,110.39,108.88,109.59,172270256,199020620,48.37868049747329,54.05749043922589,NaN,NaN,-45.678964742426245,-69.16861451938925,-0.44081243927671987,0.09396625792898305,0.5347786972057029,3016345229,3078654083.4,18.922789028154824,37.37081568625202,NaN,NaN,1.8302241940254482,7.689258827758385
2010-08-18T09:30:00-04:00,109.53999,110.38,108.91,109.78999,182922064,194940376,49.21782577150332,53.65357648210887,NaN,NaN,-50.771320304868155,-73.05432364180268,-0.37734326723110084,0.06309961316682688,0.4404428803979277,3199267293,3040465286.6,18.422507525242168,34.52858404476245,NaN,NaN,1.3425033393214674,6.782579472267397
2010-08-19T09:30:00-04:00,109.22,109.49001,107.42999,107.88,265847568,194493682.4,42.16771951656688,52.751767207871346,NaN,NaN,-114.20281324588495,-79.91602191124596,-0.44368759557920884,-0.1141666140760833,0.32952098150312553,2933419725,2997015488.2,17.84445273380068,32.03852496251882,NaN,NaN,-1.2697812860811972,5.6322422210747405
2010-08-20T09:30:00-04:00,107.56,107.93761,106.74989,107.53,209714128,193878348,41.00849202575537,51.24131384750116,NaN,NaN,-136.45109273079632,-90.77853205883932,-0.4873524605898546,-0.2796695942341927,0.2076828663556619,2723705597,2943362563.4,17.129692868323133,29.842466425840346,NaN,NaN,-3.75887068725257,4.290654662742268
2010-08-23T09:30:00-04:00,108.03999,108.57001,107.07001,107.1236,163490256,192946536,39.64562293591228,49.7961750643254,NaN,NaN,-112.53740730819968,-91.92831966643504,-0.5170018343785336,-0.4385694266175051,0.0784324077610285,2560215341,2886590637,16.38195797880269,27.873736607994335,NaN,NaN,-6.230513534930845,2.787630634503252
2010-08-24T09:30:00-04:00,105.95,106.39,104.97,105.53,280795648,196743540,34.76640287630438,47.85362268860086,NaN,NaN,-165.1562206698087,-115.82377085191156,-0.6108982793522619,-0.6851904414292989,-0.07429216207703698,2279419693,2739205529.8,14.600153139135344,25.892201658008748,NaN,NaN,-9.974548020084592,0.9644622552764175
2010-08-25T09:30:00-04:00,104.95,106.34,104.28999,105.94,272330752,202207268,36.91746769582357,46.10398462363679,NaN,NaN,-146.62100635132512,-134.99370806120294,-0.6108839050944019,-0.8378970434450395,-0.2270131383506375,2551750445,2609702160.2,13.23770728805745,23.89073452120127,NaN,NaN,-12.436364194603549,-0.9499415232778634
2010-08-26T09:30:00-04:00,106.44,106.58,104.88,105.23,224492688,202424452,34.77874140960431,44.35593269305675,NaN,NaN,-126.18525319050761,-137.39019605012749,-0.6220922577064055,-1.0046284604836444,-0.3825362027772389,2327257757,2488469766.6,12.099427663948504,21.89636308627104,NaN,NaN,-15.163311080119646,-2.980422888540975
2010-08-27T09:30:00-04:00,105.89,106.97,104.31,106.86,272704000,205056127.2,42.950064793495194,43.05389269373974,NaN,NaN,-97.5880766808242,-129.61759284013306,-0.4889960303102666,-0.9937812406650721,-0.5047852103548055,2599961757,2463720998.6,11.874942678922636,20.00744009262548,NaN,NaN,-15.09496325284867,-4.711071512013502
2010-08-30T09:30:00-04:00,106.58,106.91,105.3,105.311,167238560,204004896,38.06891416954044,41.62068179961009,NaN,NaN,-94.40886343639589,-125.9918840657723,-0.47419144439004846,-1.097524515842366,-0.6233330714523176,2432723197,2438222569.8,11.635418695633334,18.26493029795301,NaN,NaN,-16.600513321783943,-6.409563199123565
2010-08-31T09:30:00-04:00,104.92,105.98,104.49001,105.31,273933056,210368686.4,38.06590651585344,41.062608585122405,NaN,NaN,-103.27093822593788,-113.61482757699814,-0.43443532670380935,-1.1663772298320794,-0.73194190312827,2158790141,2414096659.4,11.401093512587835,16.83163978326117,NaN,NaN,-17.788064800540525,-8.035063427897416
2010-09-01T09:30:00-04:00,106.73,108.61,106.66,108.46001,267834944,215851852,51.15653315936744,41.59403925238184,NaN,NaN,-17.619653780240498,-87.8145570627812,-0.17904389082821404,-0.9557467666635375,-0.7767028758353235,2426625085,2389071587.4,11.15025283071327,15.680067294395915,NaN,NaN,-14.391946476725204,-8.943189577729957
2010-09-02T09:30:00-04:00,108.72,109.49001,108.49001,109.47,156112128,216633771.2,54.47879762251943,42.43668440458715,NaN,NaN,33.44303194601545,-55.88890003547658,0.061952544176185786,-0.6992621956150913,-0.7612147397912771,2582737213,2440167478.6,15.250264947006258,15.045868161697696,NaN,NaN,-10.492965290854695,-9.164586108176348
2010-09-03T09:30:00-04:00,110.53999,110.99001,109.95,110.89,212197248,215257220.8,58.72916907104188,43.59502414719725,NaN,NaN,94.26030590384833,-17.519223518542063,0.30731771812335684,-0.37706759213708096,-0.6843853102604378,2794934461,2479162019.4,18.346996942212414,14.878404130895692,NaN,NaN,-5.764286931042964,-8.678829082871578
2010-09-07T09:30:00-04:00,110.37,110.50999,109.55,109.64,141973680,216315886.4,53.95345038934586,43.993221996616725,NaN,NaN,79.08342164255662,17.179233497248433,0.3714650835015385,-0.22005395588351462,-0.5915190393850531,2652960781,2523209536.2,21.821976554556855,15.085488954210124,NaN,NaN,-3.457336852392956,-7.932901621374633
2010-09-08T09:30:00-04:00,109.86,110.85001,109.81,110.41,150268944,211683524,56.31028695683443,44.49982636699752,NaN,NaN,108.62471599746652,59.55836434192931,0.44673096319612976,-0.03310533538989091,-0.47983629858602067,2803229725,2652097453,31.066525493578723,15.988633094805595,NaN,NaN,-0.8188868219437117,-6.916613792884501
2010-09-09T09:30:00-04:00,111.64999,111.67999,110.62,110.92,147017872,205364004.8,57.84915983250739,45.61992924670756,NaN,NaN,132.33854396808167,89.55000389159375,0.5074093676561903,0.15442541098421714,-0.35298395667197313,2950247597,2756821955.4,37.53036807768102,17.39476990508276,NaN,NaN,1.7942687306945524,-5.672202003801779
2010-09-10T09:30:00-04:00,111.12,111.61,110.87,111.48199,127818944,199777824,59.540336260446175,46.94363240632833,NaN,NaN,124.97338228034022,107.85607395845868,0.5579251547720981,0.3444224867931496,-0.2135026679789486,3078066541,2855887821,42.97749289246734,19.241041335378778,NaN,NaN,4.457683205013504,-4.225075545399596
2010-09-13T09:30:00-04:00,112.58,112.95,112.13,112.72,178503440,200768071.2,63.056735656861996,48.615854743539025,NaN,NaN,148.42337815612024,118.68868840891307,0.641293481994971,0.5881141845147653,-0.053179297480205806,3256569981,2948214925,47.56628970574481,21.468493601588932,NaN,NaN,7.850768172043589,-2.499955014336284
2010-09-14T09:30:00-04:00,112.5,113.28999,112.08,112.64999,209823568,203864487.2,62.724737715992006,50.612878660659575,NaN,NaN,129.3752646990103,128.7470570202038,0.6559464212321869,0.7667537290600279,0.11080730782784096,3046746413,3026972051.4,51.17568161707562,24.081031350013234,NaN,NaN,10.476127253538321,-0.6462289760684834
2010-09-15T09:30:00-04:00,112.32001,113.21001,111.98,113.08,168608320,203681390.4,63.97920785000839,52.545860100244205,NaN,NaN,118.20464559240415,130.66304293919134,0.6571768289144188,0.9322783439708644,0.27510151505644564,3215354733,3109397053,54.690977828440666,27.041979245754895,NaN,NaN,13.03053564274784,1.307594540905277
2010-09-16T09:30:00-04:00,112.73,113.12,112.35001,113.05,199962880,204533431.2,63.81784293195081,54.62008163755467,NaN,NaN,108.45021197107886,125.88537653979077,0.6190751513927262,1.0489454542973533,0.4298703029046272,3015391853,3122425904.2,55.23957277587507,30.12341818232108,NaN,NaN,15.087245435375843,3.276116097258215
2010-09-17T09:30:00-04:00,113.03999,113.14999,112.17999,112.49001,195836816,201032893.6,60.73836524058075,55.8906745266322,NaN,NaN,91.08151851419403,119.10700378656152,0.5230845166072795,1.0837259486637265,0.560641432056447,2819555037,3070723603.4,52.5219070941134,33.02677278340614,NaN,NaN,16.040079036387358,5.099539374276664
2010-09-20T09:30:00-04:00,112.88,114.46001,112.52161,114.21001,214786688,201286521.6,66.14246262539459,57.895927987764644,NaN,NaN,107.59399978475801,110.94112811228908,0.540153612501998,1.2358334476839445,0.6956798351819465,3034341725,3026277952.2,50.233953732446366,35.78381100032135,NaN,NaN,18.510862812631384,7.015442722613052
2010-09-21T09:30:00-04:00,114.3,114.84,113.50999,113.98,268632320,206543624.8,64.85683994063135,59.80956608953449,NaN,NaN,105.94833081354886,106.2557413351968,0.5015153650781274,1.322574041529606,0.8210586764514785,2765709405,2970070550.6,47.42061037991095,38.35663363370157,NaN,NaN,20.190091011431747,8.897535335301438
2010-09-22T09:30:00-04:00,113.8,114.44,113.10001,113.42,191322368,202069960.8,61.711791678896915,60.56351312664374,NaN,NaN,88.42070254331512,100.298952725379,0.40778406902304043,1.330788762730279,0.9230046937072386,2574387037,2841877011.4,41.68635985646284,40.53778413554083,NaN,NaN,20.747634439942583,10.590406635964458
2010-09-23T09:30:00-04:00,112.49001,113.67,112.17999,112.498,202354256,198571136,56.8258834708002,60.73116211580666,NaN,NaN,61.58254663756971,90.92541965867717,0.260403650156925,1.2485092564033948,0.9881056062464698,2372032781,2713205197,36.867393168694164,42.08186472280425,NaN,NaN,19.83604582649511,11.911212234611693
2010-09-24T09:30:00-04:00,113.75,114.89999,113.64999,114.82001,209671680,197830085.6,64.45788232670878,61.140355919782834,NaN,NaN,101.55533001262312,93.02018195836297,0.2935545525688277,1.3550487969575045,1.0614942443886768,2581704461,2665635081.8,35.24522562597035,43.28888105735839,NaN,NaN,21.378976468491445,13.2637499823088
2010-09-27T09:30:00-04:00,114.86,114.99001,114.16,114.27,128799440,190634857.6,61.6767141645471,61.6920176180115,NaN,NaN,96.36428525685984,90.77423905278333,0.2541664875583076,1.3792023538365612,1.1250358662782536,2452905021,2549347741,31.586440654708213,43.98634277879778,NaN,NaN,21.777287755562668,14.47996966420221
2010-09-28T09:30:00-04:00,114.42,115.03999,113.17999,114.67,209207440,192733301.6,62.92943558410651,62.16481394853093,NaN,NaN,86.420665010147,86.86870589210295,0.23142531249997056,1.4143175069032168,1.1828921944032462,2662112461,2528628352.2,30.969560474144984,43.97941670598107,NaN,NaN,22.476769467267804,15.622369636068724
2010-09-29T09:30:00-04:00,114.38,114.91,114.02,114.47,179665744,188019936,61.840950188335874,62.4499418310901,NaN,NaN,92.5097725976062,87.68651990296118,0.18149215214405534,1.4097573845833153,1.22826523243926,2482446717,2510240288.2,30.402084807700035,43.470253615268156,NaN,NaN,22.736599100747455,16.63868813102283
2010-09-30T09:30:00-04:00,115.05,115.78999,113.59,114.13,287106560,188983516.8,59.94276260067308,62.478686569677734,NaN,NaN,94.31083087324068,94.23217675009536,0.10778503071512313,1.362996520833164,1.255211490118041,2195340157,2474901763.4,29.291255618107726,42.492665238528176,NaN,NaN,22.42208574103003,17.464887789595284
2010-10-01T09:30:00-04:00,114.99001,115.12,113.92999,114.61,174638624,189909841.6,61.728766642325326,62.383831640067974,NaN,NaN,90.61876208402491,92.04486316437573,0.07512552060714084,1.349118390876967,1.2739928702698262,2369978781,2432556627.4,27.972353039391393,41.09309833378865,NaN,NaN,22.642715615032678,18.204577478943484
2010-10-04T09:30:00-04:00,114.37,114.85001,113.17999,113.75,166153184,187607638.4,56.838983045997885,61.96342059221125,NaN,NaN,50.021235292654964,82.77625317153475,-0.015780972235566848,1.2542666549753676,1.2700476272109344,2203825597,2382740742.6,26.4627633486067,39.327889886040865,NaN,NaN,21.44721696927297,18.667811691847696
2010-10-05T09:30:00-04:00,114.8,116.32001,114.67,116.03999,229634064,191990657.6,64.82838345091108,62.02407599227573,NaN,NaN,140.4755793882364,93.58723604715263,0.06263089402273847,1.3483362447393574,1.285705350716619,2433459661,2337010182.6,25.122423857328798,37.215850316675734,NaN,NaN,22.824394650643647,19.261609257389974
2010-10-06T09:30:00-04:00,116.02,116.33,115.56,116.03,148626496,191908535.2,64.77205513319245,62.09223400665013,NaN,NaN,151.54739568453166,105.39476066453771,0.09613564902135141,1.4058749119933083,1.3097392629719569,2284833165,2297487472.2,23.991429022528422,34.98384004857955,NaN,NaN,23.896502063854197,19.923736801170577
2010-10-07T09:30:00-04:00,116.5,116.53,115.19,115.89,164860000,192800641.6,63.93367974435313,62.32047075691958,NaN,NaN,136.38538761687232,113.80967201326408,0.09122107499341814,1.4237656067137294,1.3325445317203113,2119973165,2282414073.8,23.555869646943734,32.914837373781715,NaN,NaN,24.531997938998355,20.58205982086026
2010-10-08T09:30:00-04:00,116.05,116.86,115.61,116.53751,177760064,195297697.6,66.11803164135188,62.31872568663083,NaN,NaN,156.5083291269128,126.98758542184164,0.11253277708022269,1.4732105030705895,1.3606777259903668,2297733229,2267964963.4,23.1225174720268,30.97830621232317,NaN,NaN,25.702554835588508,21.31355910867858
2010-10-11T09:30:00-04:00,116.72,116.97,116.25,116.64999,103098320,191527441.6,66.49761745557407,62.43592408055531,NaN,NaN,157.3520938512553,148.4537571335617,0.11476455667467778,1.5041334218337141,1.3893688651590363,2400831549,2307366153.8,27.062941854161693,29.52418703191251,NaN,NaN,26.774569023033333,22.09370338215783
2010-10-12T09:30:00-04:00,116.27,117.35001,115.64999,117.00999,182210000,190146763.2,67.74320548343987,62.86673935230838,NaN,NaN,142.28860104086797,148.816361464088,0.12045499342526034,1.5399376069406117,1.4194826135153513,2583041549,2337282531.4,29.996845207456076,28.689221699840594,NaN,NaN,28.028200092848532,22.941488626542217
2010-10-13T09:30:00-04:00,117.66,118.55,117.38,117.92,194347120,191433703.2,70.70788535403854,63.85831091539683,NaN,NaN,181.30954520165963,154.76879136751361,0.1628407593593164,1.6230335627144967,1.4601928033551803,2777388669,2435793632.2,38.735900103865546,28.822686480924265,NaN,NaN,29.989753830419453,23.948383655667538
2010-10-14T09:30:00-04:00,117.80991,118.00999,116.72,117.46001,217764256,192323772,67.33882316063409,64.06409240353435,NaN,NaN,127.94440020570096,153.08059388527934,0.1382031683694127,1.6329467638169461,1.4947435954475334,2559624413,2523723881.8,45.2999570421618,29.540881582080797,NaN,NaN,30.73135666203179,24.91737979943386
2010-10-15T09:30:00-04:00,118.28,118.35001,116.75999,117.7,243704944,194717178.4,68.19040951900861,64.52935635742446,NaN,NaN,122.18869452234046,146.21666696436486,0.11720427429189417,1.6412489383124012,1.524044664020507,2803329357,2624843107.4,51.707950138740486,30.978132259511675,NaN,NaN,31.58752351203048,25.870257472661947
2010-10-18T09:30:00-04:00,117.74001,118.67,117.31,118.28,141502192,191052953.6,70.21184551701405,65.04952849548928,NaN,NaN,129.37359597629592,140.620967389373,0.12101835329790522,1.6753176056428885,1.5542992523449832,2944831549,2733643107.4,57.47973546015291,32.87171618708367,NaN,NaN,32.89234223593851,26.873412438844312
2010-10-19T09:30:00-04:00,117.19,117.85001,116.02,116.73,280604672,191651571.2,59.356184329583655,64.87204521986413,NaN,NaN,62.78719857874698,124.72068689694882,0.003977333563255581,1.5592709192990526,1.555293585735797,2664226877,2749880173,58.28110106828391,34.86307449141109,NaN,NaN,30.832210539000236,27.438955024580874
2010-10-20T09:30:00-04:00,116.94,118.44,116.87,117.87,200051744,192088040,63.7904968125105,65.14688337785252,NaN,NaN,96.91463171823159,107.84170420026321,-0.011017386532296669,1.5415218525704262,1.5525392391027228,2864278621,2767258163.4,59.16807586400866,36.99713308040401,NaN,NaN,30.39095543832006,27.860669369400757
2010-10-21T09:30:00-04:00,118.39999,119.09,117.21001,118.13,221546128,193047633.6,64.73547766089122,65.36164845060722,NaN,NaN,109.1481452828752,104.08245321569805,-0.017399848281463903,1.530789428750893,1.5481892770323569,3085824749,2872498230.6,64.14030646572712,39.580558325142285,NaN,NaN,30.315654482062982,28.211381528352504
2010-10-22T09:30:00-04:00,118.31,118.53,118,118.347,108212320,187974665.6,65.54371691075946,65.98341515523303,NaN,NaN,106.02038783385062,100.84879187800007,-0.020754235925181774,1.5222464821258797,1.5430007180510614,3194037069,2950639773,67.32222756428669,42.49909148340514,NaN,NaN,30.486863336424165,28.536450358077026
2010-10-25T09:30:00-04:00,119.14,119.75999,118.61,118.7,151145680,189091977.6,66.87378361123814,66.12951516668497,NaN,NaN,130.53819740606608,101.0817121639541,-0.013308337458954655,1.5263652962273682,1.5396736336863228,3345182749,3030710013,70.236564289185,45.72153008568058,NaN,NaN,31.007502288240286,28.889457776671776
2010-10-26T09:30:00-04:00,118.10001,118.84,117.87,118.72,158982880,186580749.6,66.95162222872838,66.28519853065183,NaN,NaN,94.4425203857744,107.41277652535958,-0.02070430485491892,1.513793252617674,1.534497557472593,3504165629,3198697763.4,75.22813432329153,49.3812947500208,NaN,NaN,31.457053677358616,29.25625719105561
2010-10-27T09:30:00-04:00,117.89,118.50999,117.25999,118.38,190023936,187098659.2,64.19024391413043,66.30352454277877,NaN,NaN,65.26842527552407,101.08353523681807,-0.05994232708195746,1.4595696486201462,1.5195119757021036,3314141693,3288670377.8,77.4130244302833,53.228234377402195,NaN,NaN,31.101457067816636,29.519857173450042
2010-10-28T09:30:00-04:00,119.06,119.11,117.83,118.39999,168576000,181172131.2,64.28351608063882,66.17248771701355,NaN,NaN,80.60648093533537,95.3752023673101,-0.09397106894488294,1.4020481395209998,1.4960192084658828,3482717693,3368048966.6,79.15947854581577,57.23087445410141,NaN,NaN,30.827536738697425,29.706668539913952
2010-10-29T09:30:00-04:00,118.28,118.72,118.07001,118.49001,144305504,179655475.2,64.7290479571466,66.04616132426874,NaN,NaN,74.45191665802326,89.06150813214461,-0.11826756184617682,1.3481847561581617,1.4664523180043385,3627023197,3454646192.2,80.89500527937673,61.076021841616765,NaN,NaN,30.70455907437118,29.849224330550697
2010-11-01T09:30:00-04:00,119.07001,119.75,117.85001,118.53,174074688,180051550.4,64.93828583528901,65.8458099208294,NaN,NaN,91.10628984391353,81.1751266197141,-0.13811364936163573,1.2938102563022937,1.4319239056639295,3801097885,3545829219.4,82.54345508631827,64.82935111867836,NaN,NaN,30.64994750650918,29.963613355687624
2010-11-02T09:30:00-04:00,119.42,119.75,119.10001,119.47501,158345872,176487140.8,69.53726738036006,65.76219435128094,NaN,NaN,139.33648036350795,90.15391861526082,-0.0960588932456008,1.3118502891069284,1.4079091823525292,3959443757,3636884845,84.02572540160699,68.0643386399456,NaN,NaN,31.818721193392502,30.228628761074035
2010-11-03T09:30:00-04:00,119.675,120.02,118.45,119.95,226702752,180390953.6,71.55675159025265,66.06347495339654,NaN,NaN,133.51111626750307,103.80245681365662,-0.047187108066909955,1.3489252972688917,1.3961124053358016,4186146509,3811285808.2,86.40654157627367,71.00052324952502,NaN,NaN,33.40350333748414,30.682182271989763
2010-11-04T09:30:00-04:00,121.28,122.32001,119.9724,122.25999,215039312,182899919.2,78.88716506989148,66.82752892131674,NaN,NaN,268.11276402806095,141.30371343220173,0.12060848119425405,1.5468730068286192,1.4262645256343651,4401185821,3994979433.8,88.37229334721849,73.61940490727343,NaN,NaN,37.543949468176876,31.66243472858792
2010-11-05T09:30:00-04:00,122.34,122.92,122.17999,122.72501,180654128,183044622.4,80.00436449809031,67.5269945628222,NaN,NaN,277.8286241802456,181.9790549366462,0.23613051852032707,1.721427673784774,1.485297155264447,4581839949,4185942784.2,89.9924824145045,75.94174397544141,NaN,NaN,41.2822348298291,33.03669188590809
2010-11-08T09:30:00-05:00,122.34,122.69,121.94,122.49001,155901632,185684788,77.76487743385046,68.84190121312696,NaN,NaN,203.00472548890696,204.3587420656449,0.26762081987108166,1.819823180103299,1.5522023602322172,4425938317,4310910870.6,90.88733371618233,78.27076059314845,NaN,NaN,43.597387540169436,34.54536269365971
2010-11-09T09:30:00-05:00,122.82001,122.95,121.12,121.61,186621568,185905366.4,69.87678123377363,69.27663581464576,NaN,NaN,145.3385636803118,205.55915872900565,0.20301789012405425,1.8059747228872851,1.6029568327632309,4239316749,4366885469,91.26413051069564,80.56333592505464,NaN,NaN,43.09101610723109,35.766170324169906
2010-11-10T09:30:00-05:00,121.58,122.16,120.66,122.10001,221387376,187257379.2,71.604002044449,69.76724469918561,NaN,NaN,111.8966642192319,201.2362683193514,0.16854093403440706,1.8136330003062398,1.6450920662718327,4460704125,4421796992.2,91.6297725969787,82.52686922014405,NaN,NaN,43.20585451531888,36.8289823514769
2010-11-11T09:30:00-05:00,121.05,121.82001,120.67999,121.63499,158017568,184270044.8,67.64027945700118,69.91699916677429,NaN,NaN,87.21272493440023,165.0562605006193,0.09342177124800322,1.7618692803318368,1.6684475090838335,4302686557,4402097139.4,90.17161632861603,84.15896841759616,NaN,NaN,42.072672335254865,37.57808092058804
2010-11-12T09:30:00-05:00,120.82001,121.35001,119.64999,120.198,239068816,184038238.4,57.11808361891614,69.22016345303702,NaN,NaN,37.88342433956946,117.06722053248404,-0.06547505049854885,1.5866036959606475,1.6520787464591964,4063617741,4298452697.8,82.713776862403,85.05019788711172,NaN,NaN,37.492508657889886,37.565856311631165
2010-11-15T09:30:00-05:00,120.58,121.05,119.98,120.03,163940688,185160163.2,56.02087033175224,68.43939546039586,NaN,NaN,30.99867446715366,82.66601032813337,-0.18741924378555286,1.4178046917272553,1.6052239355128082,3899677053,4193200445,75.85281585274205,85.09481799635819,NaN,NaN,33.519095693928385,36.98774765195934
2010-11-16T09:30:00-05:00,119.28999,119.49001,117.59,118.16,300332032,186146531.2,45.53548480429945,67.10691266683651,NaN,NaN,-62.04346098500239,41.189605395070565,-0.3880002267802276,1.1202236520375237,1.5082238788177513,3599345021,4065206099.4,68.42029541999891,84.4524802099093,NaN,NaN,26.074865447869023,35.42876447994644
2010-11-17T09:30:00-05:00,118.21001,118.71001,117.86,118.218,172308816,184759384.8,45.87387096311409,65.79193801558473,NaN,NaN,-71.42159294965417,4.525953961293354,-0.5034296527012709,0.8789368129411628,1.3823664656424337,3771653837,3927396041.8,61.439760100291245,83.18678603522899,NaN,NaN,20.463364560954997,33.2908502058048
2010-11-18T09:30:00-05:00,119.36,120.39,119.35001,119.9575,197723680,183568262.4,54.9200208221954,65.09129322023108,NaN,NaN,2.2528391556725396,-12.466023194452184,-0.4509799113422557,0.8186415764646142,1.26962148780687,3969377517,3860734233.8,58.339166397793385,81.57565468654445,NaN,NaN,18.528441567429514,31.181934686036904
2010-11-19T09:30:00-05:00,119.89999,120.34,119.25,120.28999,156852816,186000287.2,56.41932449631718,64.48279598173309,NaN,NaN,1.1900415297426965,-19.804699756417538,-0.3848204791294254,0.7885958888950881,1.1734163680245135,4126230333,3873256752.2,58.76019464074172,79.87685036900326,NaN,NaN,17.51282076919128,29.229204126487527
2010-11-22T09:30:00-05:00,119.69,120.24001,118.77,120.19,181592192,187522612.8,55.818090488635974,63.50285477518137,NaN,NaN,-12.897124495378202,-28.583859548923908,-0.3402590445849072,0.7480925622933796,1.0883516068782868,3944638141,3882248969.8,59.07999486663647,78.09501247364824,NaN,NaN,16.528002261751407,27.41474671723951
2010-11-23T09:30:00-05:00,118.77,119.015,117.99001,118.44749,222308944,190688916,46.515270799883254,61.71417757586927,NaN,NaN,-80.20125624377478,-32.215418600678376,-0.4156170705730995,0.5688302686619124,0.9844473392350119,3722329197,3906845805,59.993867835512624,76.20839292073673,NaN,NaN,12.452120708063251,25.277228715928615
2010-11-24T09:30:00-05:00,119.2,120.23,119.17999,120.2,140159056,188195672,54.69367184450439,59.98607091691304,NaN,NaN,-11.114922376537935,-20.154084486055133,-0.3381966121811111,0.5617015740086231,0.8998981861897342,3862488253,3925012688.2,60.692125306472725,74.23123806068347,NaN,NaN,11.816455622780396,23.354261131193155
2010-11-26T09:30:00-05:00,119.16,119.81,118.8,118.8,76007680,183567256,48.335179509272855,57.72398627485466,NaN,NaN,-56.39093182974148,-31.882838683137937,-0.3694910728233737,0.4380343451605171,0.8075254179838908,3786480573,3888433299.4,58.47888380953794,71.98026673175728,NaN,NaN,8.961396440257936,21.298137603916697
2010-11-29T09:30:00-05:00,118.5,119.48,117.74001,119.162,223642256,187534093.6,49.955274940811485,55.73758609678045,NaN,NaN,-78.56764324968142,-47.83437563902275,-0.35399656267778257,0.36502971463666256,0.7190262773144451,4010122829,3865211798.6,57.05642551403954,69.56377328874707,NaN,NaN,7.32126039614005,19.301440859948606
2010-11-30T09:30:00-05:00,117.98,119.17,117.81,118.49249,233930624,190526890.4,47.01864665150123,54.1048621980467,NaN,NaN,-95.17671123223961,-64.29029298639504,-0.3750096085527307,0.25026426662353174,0.6252738751762624,3776192205,3831522611.4,54.96746093521024,66.97115403335526,NaN,NaN,5.018902302962011,17.261078208950522
2010-12-01T09:30:00-05:00,120.2,121.24001,120.19,121.00999,221037120,193661452.8,57.205739131980366,53.07641484715608,NaN,NaN,37.33178180251373,-40.78368537713734,-0.21356108916720618,0.35832251371725476,0.5718836028844609,3997229325,3886502637,57.68996765829733,64.54688225202088,NaN,NaN,6.669093500025025,15.74793753624688
2010-12-02T09:30:00-05:00,121.2,122.64999,121.13,122.56,191213568,191886993.6,62.04467256446272,52.67672864054619,NaN,NaN,100.1756451210949,-18.525571877610773,-0.00746879635733444,0.5625476074377929,0.5700164037951273,4188442893,3951693565,60.72216185099404,62.443349789333595,NaN,NaN,9.84047756006166,14.904014682506133
2010-12-03T09:30:00-05:00,122.14,123.03,122.11,122.89,151288816,188699468.8,63.003819472517684,53.09713834437487,NaN,NaN,122.19257068149236,17.191128624635997,0.13796048506431657,0.7424670101255231,0.6045065250612065,4339731709,4062343792.2,65.27151195871741,61.19747372478463,NaN,NaN,12.589655825929805,14.573391988709515
2010-12-06T09:30:00-05:00,122.63,123.03999,122.5,122.75999,103050432,184819284,62.3354829127358,53.548182100159416,NaN,NaN,125.66296717719574,58.03725071001143,0.2080725195582923,0.8645971745090719,0.6565246549507796,4236681277,4107655481.8,66.95921033473235,60.56221618778394,NaN,NaN,14.501538068676965,14.563127142990579
2010-12-07T09:30:00-05:00,123.94,124.00999,122.75999,122.83,206580944,187353249.6,62.56576771317923,54.76463087936511,NaN,NaN,141.02835239339987,105.27826343513932,0.23959234386871298,0.9560150847866709,0.7164227409179579,4443262221,4241069485,71.37079032481383,60.77296582384215,NaN,NaN,16.082960211744208,14.780246152812525
2010-12-08T09:30:00-05:00,122.98,123.38,122.41,123.28,138019184,184923130.4,64.08574417278844,56.065478965770424,NaN,NaN,122.89919163979535,122.39174540259565,0.26897499187489715,1.0526414807615794,0.7836664888866822,4581281405,4357879901,74.57204360286781,61.710986074026195,NaN,NaN,17.8473015296497,15.218396920932122
2010-12-09T09:30:00-05:00,123.97,124.02,123.14999,123.75999,123705056,180039014.4,65.68619089364236,56.83449111373092,NaN,NaN,136.110093778324,129.57863513404146,0.29677865553993443,1.1546398083116003,0.8578611527716659,4704986461,4461188614.6,77.01947582728556,63.045293890418485,NaN,NaN,19.796357530266473,15.872391293694172
2010-12-10T09:30:00-05:00,124.14,124.60001,123.73,124.48,117571632,178016717.6,67.99051744948852,57.6610048961003,NaN,NaN,141.18858626610856,133.37783825096471,0.33677622549863273,1.2788314346449567,0.942055209146324,4822558093,4557753891.4,79.04933431505049,64.4945181528691,NaN,NaN,22.150882997601354,16.769318679966627
2010-12-13T09:30:00-05:00,125.05,125.2,124.52,124.56,133812624,172753908,68.24567832052779,58.548689741235435,NaN,NaN,134.36073553956265,135.1173919234381,0.34070843681620966,1.367940755166586,1.0272323183503764,4956370717,4701691779.4,81.65102918740526,66.10673489006689,NaN,NaN,24.151372617290438,17.82389781387003
2010-12-14T09:30:00-05:00,124.75,125.23,124.28999,124.67,147249568,171919352,68.61612808805253,60.1273224046761,NaN,NaN,114.5957472084873,129.83087088645559,0.322967433493496,1.4309416102172463,1.1079741767237503,5103620285,4833763392.2,83.65652589017625,67.79692475111429,NaN,NaN,25.91922267878716,18.980372794572478
2010-12-15T09:30:00-05:00,124.44,124.92999,123.89,124.09801,160823008,164943900.8,64.40838395101872,60.821230412284265,NaN,NaN,90.6748001473462,123.38599258796576,0.24831297516644257,1.4183653956818034,1.1700524205153608,4942797277,4906066566.6,84.6459141958324,69.50790967178284,NaN,NaN,26.34555817772834,20.032542135023316
2010-12-16T09:30:00-05:00,124.17999,124.91,123.75,124.82001,185035184,165580219.2,67.14700259194812,62.164932061046784,NaN,NaN,88.33384484878302,113.83074280205756,0.22391323921013995,1.4499439695280358,1.226030730317896,5127832461,4990635766.6,85.73376958643993,71.45468722727584,NaN,NaN,27.478265169727717,21.096216854266803
2010-12-17T09:30:00-05:00,124.08,124.46001,123.82001,124.3,141075248,162747797.6,63.36524118425967,63.12278679272166,NaN,NaN,72.20540551498338,100.03410665183253,0.15251874391422482,1.416679160210677,1.2641604162964521,4986757213,5023475590.6,86.14430332496717,73.53239278519925,NaN,NaN,27.41627336167771,21.99908206961122
2010-12-20T09:30:00-05:00,124.64,124.89999,123.98,124.60001,119085440,160859428.8,64.60384469260406,64.37887236708613,NaN,NaN,75.84778844337632,88.33151723259527,0.10739560093623757,1.398404917466749,1.2910093165305114,5105842653,5053369977.8,86.5244571863053,75.78646394599176,NaN,NaN,27.698147634611363,22.813234293182667
2010-12-21T09:30:00-05:00,124.99001,125.47,124.87,125.39,94965440,156528091.2,67.7005809981902,65.12850392895825,NaN,NaN,94.04662719903864,84.22169323070554,0.11212886496677577,1.4311703977389811,1.3190415327722054,5200808093,5072807539.4,86.7784665219168,77.86421386482172,NaN,NaN,28.817167537653177,23.67093904239274
2010-12-22T09:30:00-05:00,125.48,125.82001,125.41,125.78,78878064,149356547.2,69.13615586818841,65.63503845065294,NaN,NaN,104.94454124835168,87.07564145090664,0.12208104179428436,1.4716428350150608,1.3495617932207764,5279686157,5140185315.4,87.64765207377343,79.78746316644882,NaN,NaN,30.172466206062516,24.599728637202706
2010-12-23T09:30:00-05:00,125.64,125.78,125.28999,125.60001,70079248,145852556.8,67.64193225458746,65.9663322208008,NaN,NaN,94.85387386897098,88.37964725494423,0.09812894491318169,1.4722229743622535,1.3740940294490718,5209606909,5156540205,87.85633932633789,81.40066512127885,NaN,NaN,30.910205056725303,25.501225268563076
2010-12-27T09:30:00-05:00,125.13,125.77,125.03999,125.64999,58125968,144958471.2,67.84972368623313,66.36020656176488,NaN,NaN,87.56157049084446,91.45088025011644,0.06863440703716339,1.459887038245526,1.3912526312083626,5267732877,5212735337.8,88.57083046805525,82.94435227365906,NaN,NaN,31.58231065599107,26.36995175248136
2010-12-28T09:30:00-05:00,125.89999,125.95,125.5,125.83,55309008,136541808.8,68.63104587490214,66.79344071617366,NaN,NaN,97.20535972645987,95.72239450673315,0.04535390606259648,1.4479450137866081,1.4025911077240116,5323041885,5256175184.2,89.10449560000684,84.21104550760141,NaN,NaN,32.35892331542649,27.22551911861638
2010-12-29T09:30:00-05:00,125.98,126.2,125.89999,125.92,58033040,127746929.6,69.03620920644698,67.14704536143499,NaN,NaN,113.07842976160875,99.52875501924717,0.021341046715948053,1.4292674161189467,1.4079263694029986,5381074925,5292228550.6,89.54099798865846,85.28025653515787,NaN,NaN,33.12444693526859,28.06822309242384
2010-12-30T09:30:00-05:00,125.8,126.13,125.53,125.72,76616880,120525917.6,66.96626637960219,67.23847932471783,NaN,NaN,97.21693116827078,97.98323300323099,-0.020427809973305955,1.3823916069363662,1.4028194169096722,5304458045,5297182928.2,89.6026419089785,86.17905411242167,NaN,NaN,33.28349111980419,28.813261382049603
2010-12-31T09:30:00-05:00,125.53,125.87,125.33,125.75,91270256,115528752,67.12549333853325,67.17669188822103,NaN,NaN,80.63880100033478,95.14021842950376,-0.056411567529534024,1.3323049574977546,1.3887165250272886,5395728301,5334407206.6,90.07591555584392,86.96666705819264,NaN,NaN,33.45798366785478,29.47679313716463
2011-01-03T09:30:00-05:00,126.71001,127.60001,125.6969,127.05,138725184,114900570.4,73.1623425088879,67.52788218738962,NaN,NaN,150.37662532039593,107.70322939541407,-0.005706002572023916,1.3815840218122588,1.3872900243842827,5534453485,5387751328.2,90.72730436006727,87.61497242766849,NaN,NaN,35.30155648530744,30.308902186899317
2011-01-04T09:30:00-05:00,127.33,127.37,126.19,126.98,137409680,116618532.8,72.39147827263407,67.79755005771686,NaN,NaN,139.5883420768721,116.1798258654965,0.009259486487657842,1.398864382493855,1.389604896006197,5397043805,5402551712.2,90.90566212549854,88.13276787304865,NaN,NaN,36.635713941265124,31.212732437523005
2011-01-05T09:30:00-05:00,126.58,127.72501,126.46001,127.64,133975248,112988248,75.05970350122618,68.5583585970174,NaN,NaN,155.84713810828632,124.73356753483202,0.04760506305328294,1.4491112248228006,1.4015061617695177,5531019053,5432540537.8,91.27199197939828,88.60605914330336,NaN,NaN,38.59461074440299,32.267286481363
2011-01-06T09:30:00-05:00,127.69,127.83,127.00999,127.39,122519008,112213239.2,72.21279036616178,68.9202005808898,NaN,NaN,153.77503615517753,136.04518853221336,0.0404121113911633,1.4520213010084717,1.4116091896173084,5408500045,5453348937.8,91.52702765110139,89.01986329077917,NaN,NaN,39.48096925192152,33.29781259144279
2011-01-07T09:30:00-05:00,127.56,127.77,126.14999,127.14,156034560,113829714.4,69.37892244356102,69.34974924226847,NaN,NaN,114.51263124313513,142.81995458077344,0.004961451499309932,1.4178110039914458,1.4128495524921358,5252465485,5424696374.6,87.7258106965739,89.1328281030368,NaN,NaN,39.46740677252958,34.17918318874091
2011-01-10T09:30:00-05:00,126.58,127.16,126.2,126.98,122401632,114071214.4,67.55180241955459,69.56031765133636,NaN,NaN,86.14726076552873,129.9740816698,-0.04060992870515934,1.3620871416106866,1.402697070315846,5130063853,5343818448.2,77.89209001952625,88.51623044826685,NaN,NaN,38.96654336811354,34.86309178579414
2011-01-11T09:30:00-05:00,127.44,127.74001,126.95,127.42999,110286944,112894930.4,69.94880671402169,69.7209052024672,NaN,NaN,116.61243729948076,125.37890071432173,-0.051115158282988515,1.3388031224621102,1.3899182807450987,5240350797,5312479846.6,74.41140846677172,87.63286915861364,NaN,NaN,39.16685110192899,35.47791454524197
2011-01-12T09:30:00-05:00,128.21001,128.72,127.4621,128.58,107929120,110928908,75.02625340639587,70.14162645519629,NaN,NaN,155.42536273792234,125.29454564024891,0.005699240312169174,1.3970423311353102,1.391343090823141,5348279917,5275932019.4,70.4571708107402,86.40497763982556,NaN,NaN,40.9029468613866,36.252919161834065
2011-01-13T09:30:00-05:00,128.63,128.69,128.05,128.36749,129229120,109349213.6,72.5856519264311,70.4947492888994,NaN,NaN,141.60336091543468,122.86021059230033,0.014764139966178647,1.4097982657808643,1.3950341258146857,5219050797,5238042169.8,66.51111285961515,84.88031860648823,NaN,NaN,41.61293538734175,37.01863576547802
2011-01-14T09:30:00-05:00,128.19,129.33,128.10001,129.3,117677872,105981348,76.23838819672534,71.09393961107742,NaN,NaN,155.35451046757302,131.02858643718793,0.06646423268953461,1.478114416676604,1.4116501839870694,5336728669,5254894806.6,67.38603915139728,83.36711922672693,NaN,NaN,43.40847522201674,37.931469973554975
2011-01-18T09:30:00-05:00,129.17999,129.64,129.03,129.52,114401248,104647648,77.01644527853232,71.69289671133672,NaN,NaN,168.17340004271452,147.43381429262507,0.0965548250795405,1.532343715336495,1.4357888902569544,5451129917,5319108019.4,70.54386210778203,82.04135969156802,NaN,NaN,45.11141005069522,38.95717569886072
2011-01-19T09:30:00-05:00,129.41,129.53571,127.91,128.25,151958320,106291292,63.99031206756781,71.33247548713106,NaN,NaN,106.20324906115542,145.35197664496,0.016215215665059457,1.4560579098382789,1.4398426941732194,5299171597,5330872179.4,71.09601975337006,80.72386124619028,NaN,NaN,42.32522708236562,39.43832589650428
2011-01-20T09:30:00-05:00,127.96001,128.39999,127.13,128.08,175745632,110330301.6,62.46726124753026,71.01111797769735,NaN,NaN,55.00500398575632,125.26790489452681,-0.05896589732861668,1.3661353225124486,1.4251012198410653,5123425965,5285901389,66.00267465767953,79.03814929966893,NaN,NaN,39.62565651947105,39.465087414070965
2011-01-21T09:30:00-05:00,128.88,129.17,128.23,128.37,151462880,113959542.4,64.039642743146,70.79070007802684,NaN,NaN,92.15506891673084,115.37824649478603,-0.0974821259646641,1.3032485623852352,1.4007306883498993,5274888845,5297068998.6,66.641783785063,77.36428274461313,NaN,NaN,37.88747477749121,39.23971418027386
2011-01-24T09:30:00-05:00,128.285,129.25,128.25999,129.10001,113715440,116141352,67.70713905375533,70.40104268837452,NaN,NaN,100.26141720856768,104.35962784298496,-0.08269583931195568,1.2973608892099548,1.3800567285219105,5388604285,5307444121.8,67.25761027267731,75.68787602408528,NaN,NaN,37.52201499526724,38.99432858241577
2011-01-25T09:30:00-05:00,128.75999,129.28,128.11,129.17,167552128,121612660,68.04364657163539,70.09048328116032,NaN,NaN,88.88663914133433,88.50227566270893,-0.07720814422459865,1.283546548241162,1.3607546924657608,5556156413,5328449421,68.52452709319661,74.08922352177801,NaN,NaN,37.329950069214846,38.75656022338706
2011-01-26T09:30:00-05:00,129.49001,130.05,129.23,129.67,141281440,125911281.6,70.41541571165689,69.75874843904823,NaN,NaN,126.63761264430437,92.58914837933872,-0.050218093634680105,1.2979820754224107,1.3482001690570908,5697437853,5408102672.2,72.81944927251446,72.7711847570006,NaN,NaN,37.87800445524472,38.631052256509584
2011-01-27T09:30:00-05:00,129.7,130.21001,129.47,129.99001,123302624,129174760.8,71.85518159405004,69.73320495532597,NaN,NaN,128.6464970124984,107.31744698468712,-0.022537730353539898,1.320028006115166,1.3425657364687058,5820740477,5547565574.6,78.38163774508276,71.83222833514212,NaN,NaN,38.76526331813236,38.65022526531284
2011-01-28T09:30:00-05:00,130.14,130.35001,127.50999,127.72,295637248,140125779.2,52.38133078042878,68.51909126510223,NaN,NaN,34.26036502165977,95.7385062056729,-0.16111340042860345,1.1411739859329515,1.302287386361555,5525103229,5597608451.4,79.96589480286245,71.27794862844846,NaN,NaN,32.57932229767515,37.78295341279317
2011-01-31T09:30:00-05:00,128.07001,128.78,127.75,128.67999,149249120,143024722.4,57.61310478541512,67.80918429123513,NaN,NaN,18.24075661314615,79.33437408658861,-0.19013250152541938,1.0646217594547807,1.2547542609802,5674352349,5654758064.2,81.62224101917866,71.54438798556647,NaN,NaN,29.374882769949345,36.58180046381548
2011-02-01T09:30:00-05:00,129.46001,130.97,129.3801,130.74001,167194192,144448172.8,66.19592773815317,67.54112150724453,NaN,NaN,165.68263807090796,94.69357387250332,-0.07832774325865488,1.1568445819068813,1.2351723251655362,5841546541,5711836089.8,83.12301841398914,72.16664583893915,NaN,NaN,29.955327907116757,35.635161527144234
2011-02-02T09:30:00-05:00,130.39999,130.84,130.33,130.485,118323632,143493870.4,64.45599553548138,66.78610308789348,NaN,NaN,163.46604374527243,102.05926009269693,-0.031679589828127463,1.195572837880377,1.2272524277085044,5723222909,5716993101,83.25606236748467,73.0808523787066,NaN,NaN,29.738987154988795,34.7928509025506
2011-02-03T09:30:00-05:00,130.25999,130.98,129.57001,130.78,145886624,144089439.2,65.58299476439174,66.28591329060495,NaN,NaN,134.98415679628872,103.32679204945501,0.006856850168687423,1.2358234904193637,1.2289666402506763,5869109533,5726666912.2,83.5185328385234,74.29566809148575,NaN,NaN,29.96488662121333,34.10314171950242
2011-02-04T09:30:00-05:00,130.83,131.2,130.23,131.14999,134634688,144695223.2,66.99641415894575,65.62577228790641,NaN,NaN,146.09287114218495,125.69329327356004,0.043058939933336315,1.2827903151673468,1.2397313752340104,6003744221,5822395110.6,85.87768386397005,75.61649985666953,NaN,NaN,30.613412075275765,33.60460891318432
2011-02-07T09:30:00-05:00,131.44,132.39999,131.42999,131.97,112439008,142515445.6,69.94261907261031,65.12049898748342,NaN,NaN,185.39348756117553,159.1238394631659,0.10452121586695684,1.3703828950677064,1.2658616792007495,6116183229,5910761286.6,87.63689615606143,76.83743086011805,NaN,NaN,32.141796041965385,33.39563564586733
2011-02-08T09:30:00-05:00,132.09,132.64,131.73,132.57001,99072688,141348998.4,71.91801284638414,65.68676332882744,NaN,NaN,179.70463158722342,161.928238166429,0.16431602202081064,1.4712567067267628,1.3069406847059521,6215255917,5985503161.8,88.8967627303175,78.10891250132859,NaN,NaN,34.04714394728083,33.488708260354976
2011-02-09T09:30:00-05:00,132.21001,132.63,131.61,132.269,146436624,143156482.4,69.45200501345667,66.18567359782217,NaN,NaN,147.69418325653857,158.77386606868222,0.16205564697126906,1.5095102434200385,1.3474545964487694,6068819293,6054622438.6,89.91978847139231,79.81727777373665,NaN,NaN,34.81190287669379,33.67773606268909
2011-02-10T09:30:00-05:00,131.60001,132.47,131.3,132.321,162708496,145895451.2,69.64564049924,66.58610200897175,NaN,NaN,121.30921224048394,156.03887715752128,0.14317769505158884,1.5264267152632556,1.3832490202116667,6231527789,6127106089.8,90.86982757259854,81.54785232998918,NaN,NaN,35.4799064865089,33.93518898037764
2011-02-11T09:30:00-05:00,131.8,133.28,131.77,133.11,137716432,146319816.8,72.49455405820643,66.9280602235754,NaN,NaN,137.41306387119138,154.30291570332255,0.1615810686243644,1.5852253559921223,1.423644287367758,6369244221,6200206089.8,91.71761902986718,83.29499581264561,NaN,NaN,36.92990599676809,34.363005697004844
2011-02-14T09:30:00-05:00,133.03,133.53999,132.88,133.42999,101691120,145520479.2,73.57766628587032,67.32334734602075,NaN,NaN,143.49664610530021,145.92354741214749,0.17208752105668124,1.6387536886886096,1.4666661676319284,6470935341,6271156512.2,92.45037248243744,85.00398476901994,NaN,NaN,38.45427845890364,34.94747323441896
2011-02-15T09:30:00-05:00,133.02,133.22,132.3167,133.00999,119575376,145779185.6,69.69818378771348,67.27211649431051,NaN,NaN,108.75646709014991,131.73391451273278,0.12947691539070516,1.6285123118703098,1.4990353964796046,6351359965,6298377321.8,92.71660864945856,86.42521043880166,NaN,NaN,38.61623703816644,35.47158234924002
2011-02-16T09:30:00-05:00,133.46001,134.00999,133.19,133.85001,130183440,144690441.6,72.78851514061617,67.33878317620808,NaN,NaN,127.73989935139244,127.74305773170354,0.1359237137997249,1.6689400387292608,1.5330163249295359,6481543405,6380922144.2,93.46876840720283,87.50286262895311,NaN,NaN,39.69218971313791,36.074526258368294
2011-02-17T09:30:00-05:00,133.46001,134.42999,133.34,134.25,109810432,141393681.6,74.14088131216494,68.89303678561782,NaN,NaN,125.3511610294575,128.55144748949826,0.1443893066096833,1.71350295819164,1.5691136515819566,6591353837,6452887353.8,94.0460637678933,88.50858898359816,NaN,NaN,40.99639344017045,36.77765014148289
2011-02-18T09:30:00-05:00,134.37,134.69,134.06,134.53,130002320,140320653.6,75.07472792196018,70.14029558108533,NaN,NaN,126.6641908607525,126.40167288741047,0.1456898863575713,1.7512260095289207,1.6055361231713494,6721356157,6523309741,94.55340578966654,89.43224361006159,NaN,NaN,42.353777279885584,37.574239732683274
2011-02-22T09:30:00-05:00,133.12,134.56149,131.47,131.83,233116368,146290700,54.599082922011114,69.31194952278946,NaN,NaN,48.26604766316812,107.35555319898408,-0.04807729870964428,1.545439499784294,1.5935167984939382,6488239789,6526770630.6,94.57785862255507,90.250446482102,NaN,NaN,36.45066575645318,37.413729164650405
2011-02-23T09:30:00-05:00,131.75,132.07001,130.21001,131.02,227610128,149293600,50.17767769797372,68.2920696772532,NaN,NaN,-22.53390130033885,81.09747952088632,-0.23322662114187653,1.3019835220665925,1.535210143208469,6260629661,6508624569.8,92.23955628306655,90.89212461892927,NaN,NaN,30.09434509199229,36.36810286855639
2011-02-24T09:30:00-05:00,130.88,131.44,129.7,130.92999,260467056,155252880.8,49.69607656352042,67.15728980576239,NaN,NaN,-45.519703330119754,46.44555898458388,-0.35678895038501723,1.0892239552271974,1.4460129056122146,6000162605,6412348409.8,80.82226027442118,90.6995337214934,NaN,NaN,25.052204566093938,34.75154596820461
2011-02-25T09:30:00-05:00,131.48,132.41,131.39999,132.33,141693808,156172440,56.663273772301736,66.41920834957354,NaN,NaN,15.078190821831457,24.39096494305867,-0.3393696143290814,1.0218008877008629,1.3611705020299443,6141856413,6322448925,71.87578835431813,89.69939832794684,NaN,NaN,22.982542969816517,33.070259825577736
2011-02-28T09:30:00-05:00,132.82001,133.32001,132.38,133.14999,141600752,148470615.2,60.145048223722455,65.71938186036725,NaN,NaN,57.01635434423213,10.461397639754619,-0.2707408814816019,1.0227444001779418,1.2934852816595437,6283457165,6234869126.6,64.39720634491275,88.03942048429337,NaN,NaN,22.466947659067333,31.55550094464768
2011-03-01T09:30:00-05:00,133.57001,133.69,130.89,130.92999,258582256,153937272,48.730164053550716,64.06310694659344,NaN,NaN,-21.371702931460536,-3.4661524791711122,-0.3670007089904641,0.8347343954214637,1.2017351044119278,6024874909,6142196150.6,57.571072335581185,85.80187117038362,NaN,NaN,17.729065420879007,29.580295869823583
2011-03-02T09:30:00-05:00,130.75,131.82001,130.35001,131.21001,200277808,155591452.8,50.01870983678444,62.67501443397399,NaN,NaN,-76.3582825984601,-14.231028738795368,-0.4011814877387141,0.700258244738535,1.1014397324772491,6225152717,6135100761.8,57.07225608329637,83.45561885694819,NaN,NaN,14.57976015801606,27.43736219670822
2011-03-03T09:30:00-05:00,132.39999,133.62,132.39,133.47,176485184,158499530.4,58.97941055701148,61.913140866671945,NaN,NaN,63.57096638377381,7.587105203983344,-0.2673890749015324,0.7672033888503336,1.034592463751866,6401637901,6215395821,61.17218678244611,81.33435880050874,NaN,NaN,15.140347131498135,25.680645758821065
2011-03-04T09:30:00-05:00,133.37,133.63,131.60001,132.47,277371392,165073768.8,54.33734676309887,60.61619748844998,NaN,NaN,12.214489988933504,7.014365037403754,-0.2427634512024971,0.7311381497487446,0.9739016009512417,6124266509,6211877840.2,60.89775836346021,79.13294018147967,NaN,NaN,13.888861093413038,23.996105092334204
2011-03-07T09:30:00-05:00,132.86,133.15939,130.735,131.42999,216888944,169186481.6,49.93543146202855,58.92746642960413,NaN,NaN,-60.31276231979551,-16.451458295401764,-0.2898524096273756,0.6115860889170222,0.9014384985443977,5907377565,6136661920.2,55.19629907894195,76.47193493837285,NaN,NaN,11.308927545532976,22.183651157076888
2011-03-08T09:30:00-05:00,131.64,133,131.07001,132.58,174706432,172299852.8,54.34022729924913,57.83046953757097,NaN,NaN,-23.337894747588063,-16.84469665862727,-0.23899960538713305,0.6026889918104814,0.8416885971976145,6082083997,6148103737.8,55.87309559452387,73.84025543444895,NaN,NaN,10.773082473237304,20.553569916528375
2011-03-09T09:30:00-05:00,132.32001,132.8,131.60001,132.39,153903440,175041390.4,53.502683479244176,56.45291013318725,NaN,NaN,-18.893064030025148,-5.3516529449402785,-0.214396169031145,0.5736933859086832,0.7880895549398282,5928180557,6088709305.8,51.52224287932525,70.84407503960054,NaN,NaN,10.085860832988635,19.058182904594126
2011-03-10T09:30:00-05:00,131,131.17999,129.81,129.9375,301665792,182802848.8,44.06223352884431,54.30443529152149,NaN,NaN,-163.89167296413936,-50.844180814522915,-0.35143389286967985,0.34879718885272837,0.7002310817224082,5626514765,5933684678.6,42.270060882516276,67.14578911921646,NaN,NaN,6.072303487466504,17.203057273575894
2011-03-11T09:30:00-05:00,129.52,131.31,129.49001,130.84,225758496,185955348.8,47.718108214975935,52.350391026736915,NaN,NaN,-128.00326782189433,-78.88773237668848,-0.36769216944284244,0.2406158699188552,0.6083080393616976,5852273261,5879286029,39.583853237415646,63.2193925083414,NaN,NaN,4.146257747176204,15.337800198375938
2011-03-14T09:30:00-04:00,129.99001,130.48,129.06,130.05,235607744,190849914.4,44.94881470839126,51.661086154335486,NaN,NaN,-150.50050757940792,-96.92528142861096,-0.41456929381408447,0.09009642209409208,0.5046657159081765,5616665517,5821143619.4,36.88577110920605,59.098529114530756,NaN,NaN,1.6704610231460064,13.38532317334309
2011-03-15T09:30:00-04:00,126.59,129.33,126.5,128.56,359794688,203755092.8,40.20908261246863,50.949043648227985,NaN,NaN,-213.50665884779073,-134.9590342486515,-0.5219078198722188,-0.1477190589320969,0.3741887609401219,5256870829,5656100985.8,30.52535385898352,54.69037179852483,NaN,NaN,-2.0441917005162353,11.181106762791758
2011-03-16T09:30:00-04:00,128.14999,128.57001,125.28,126.175,469160704,221234359.2,34.02445534406908,49.829642132552884,NaN,NaN,-228.68688896914537,-176.91779923647556,-0.7174427938954353,-0.5226147314291723,0.19482806246626305,4787710125,5428006899.4,24.291191350392765,50.65243830395138,NaN,NaN,-7.55454742384353,8.504584736129575
2011-03-17T09:30:00-04:00,128,128.39,127.10001,127.85001,254521632,227451268.8,40.899765215721615,48.70367723565431,NaN,NaN,-151.40040696277075,-174.4195460362018,-0.6972717758821136,-0.6767616573863791,0.020510118495734614,5042231757,5311150297.8,21.831274578986438,47.07783017714197,NaN,NaN,-9.586865765566072,5.920091807315911
2011-03-18T09:30:00-04:00,128.84,128.88,127.50999,127.75999,230654368,233493465.6,40.65456272659262,47.311499700145035,NaN,NaN,-123.12470263172843,-173.44383299816863,-0.6540086868223616,-0.7970007400322174,-0.1429920532098558,4811577389,5103011123.4,18.28035057688659,43.783769050854396,NaN,NaN,-11.204037453172731,3.473787627246105
2011-03-21T09:30:00-04:00,129.35001,130.00999,129.2,129.74001,154065312,234696615.2,48.03422846661609,47.26179001536399,NaN,NaN,-48.97476251401036,-153.13868398508913,-0.4649441227170739,-0.7241722066061982,-0.25922808388912427,4965642701,4972806560.2,16.47506286227977,40.84833980276144,NaN,NaN,-10.044572319928951,1.5425933490782398
2011-03-22T09:30:00-04:00,129.72,129.89,129.17,129.28999,129743440,229527968.8,46.61541331491199,47.018697406658816,NaN,NaN,-51.42310384938973,-120.72197298540891,-0.3484248696412827,-0.6947591709407277,-0.346334301299445,4835899261,4888612246.6,15.414965617250232,37.872819055186724,NaN,NaN,-9.593656257971766,-0.04829945192890395
2011-03-23T09:30:00-04:00,128.92999,130,128.32001,129.66,148648752,225579900,47.97605755794038,46.232743621010876,NaN,NaN,-51.51410437195806,-85.28741606597146,-0.23035721425032252,-0.6342808191123481,-0.4039236048620256,4984548013,4927979824.2,18.06959763493188,34.79406268750714,NaN,NaN,-8.809410626968761,-1.2998867626488835
2011-03-24T09:30:00-04:00,130.39999,131.09,129.67,130.89999,159238320,220518463.2,52.35838277439625,46.09138905038926,NaN,NaN,1.7131613879413443,-54.664702395829046,-0.061463230023040105,-0.4807526423908257,-0.4192894123677856,5143786333,4948290739.4,19.473780256820092,31.835207108461415,NaN,NaN,-6.759407977521416,-2.079818364773531
2011-03-25T09:30:00-04:00,131.24001,131.87,130.89211,131.3,155770000,221222272.8,53.7129428239684,46.36121129052783,NaN,NaN,38.68218659678385,-22.303324550126593,0.07696853659235525,-0.3230787416273415,-0.40004727821969677,5299556333,5045886528.2,26.033701994016226,29.752164459538147,NaN,NaN,-4.684238136721172,-2.4518783321946223
2011-03-28T09:30:00-04:00,131.58,131.92,130.94,130.98,109839056,219634188,52.428707152575406,46.22467413719398,NaN,NaN,41.15160233500645,-4.2780515803232415,0.14292557041683968,-0.22139031519864716,-0.36431588561548683,5189717277,5090701443.4,28.898007267932527,27.825372436210195,NaN,NaN,-3.3488539885938953,-2.5800177116802328
2011-03-29T09:30:00-04:00,130.87,131.89999,130.44,131.86,129844560,213197303.2,55.57440098786188,46.37265395923811,NaN,NaN,48.41545568975571,15.689660327505845,0.23625470939029236,-0.06899749887762141,-0.30525220826791377,5319561837,5187433958.6,34.76977516070279,26.628767599165734,NaN,NaN,-1.2820771734913603,-2.394597634796108
2011-03-30T09:30:00-04:00,132.55,133.16,132.36,132.77,135895872,209978206.4,58.62152010895943,47.41260300067489,NaN,NaN,103.48342362079558,46.68916592605659,0.34322374354366997,0.1237774711616737,-0.21944627238199627,5455457709,5281615897.8,39.9679415174604,26.46433050166174,NaN,NaN,1.3947767238716489,-1.8532584407007144
2011-03-31T09:30:00-04:00,132.60001,132.96001,132.45,132.59,132756496,207791772,57.77735079551928,48.13112032785657,NaN,NaN,101.77463153740099,66.70145995594852,0.38279097631905945,0.2590424480168281,-0.12374852830223139,5322701213,5317398873.8,41.863527496745455,26.627164377328153,NaN,NaN,3.362646810955885,-1.108129119035486
2011-04-01T09:30:00-04:00,133.41,133.77,132.83,133.14999,154038944,201625149.6,59.72068293621819,49.186253772701356,NaN,NaN,124.16677906201265,83.79837844899427,0.4243898610395278,0.4067387979971784,-0.017651063042349438,5476740157,5352835638.6,43.75755692313623,27.118006221180313,NaN,NaN,5.58751320887907,-0.15160878647626375
2011-04-04T09:30:00-04:00,133.42999,133.67,132.88,133.25999,100773312,195819368,60.10907713546357,50.607681952915286,NaN,NaN,116.48350553556507,98.864759089106,0.43539688268373206,0.5265950403123156,0.09119815762858358,5577513469,5430394877,47.768398776148864,28.349652286692123,NaN,NaN,7.544068680680829,0.9477737088318924
2011-04-05T09:30:00-04:00,133,133.83,132.94,133.24001,121083808,193138236.8,59.995915347088804,52.46278623884526,NaN,NaN,112.6435277230423,111.71037349576332,0.4173651334413754,0.6129045744303028,0.1955394409889274,5456429661,5457768441.8,49.14678919434021,30.12505213268837,NaN,NaN,9.153586094164504,2.1200326210222653
2011-04-06T09:30:00-04:00,133.88,134,133.12,133.66,120453632,191465746.4,61.63110158051595,53.94359597918771,NaN,NaN,115.261285739018,114.0659459194078,0.40920429725959756,0.7070448125634243,0.29784051530382677,5576883293,5482053558.6,50.39744126715133,32.16549261041443,NaN,NaN,10.979870949460459,3.38572381079915
2011-04-07T09:30:00-04:00,133.42,133.97749,132.66,133.32001,170973184,184931116,59.51045624625522,55.29044551630647,NaN,NaN,92.2905761945968,112.16913485084697,0.3582253551554845,0.7456222092481823,0.38739685409269786,5405910109,5498695337.8,51.28165028384741,34.52272830376878,NaN,NaN,12.037272782593812,4.6216593781983875
2011-04-08T09:30:00-04:00,133.91,133.99001,132.31,132.86,148014816,181043932,56.66925854818298,55.90723337927553,NaN,NaN,74.3473930217226,102.20525764278895,0.27460539011029955,0.7306535917305723,0.45604820162027276,5257895293,5454926365,48.81690316954518,36.83285975428773,NaN,NaN,12.249633239012002,5.7113699297431895
2011-04-11T09:30:00-04:00,133,133.45,132.14,132.46001,121518496,175339469.6,54.24416900428565,56.45214449994508,NaN,NaN,56.227886966360394,90.15413392894803,0.1781146159417778,0.678691471547495,0.5005768556057172,5136376797,5366699030.6,44.204778097165644,38.88927493142455,NaN,NaN,11.817806372153346,6.58371799294464
2011-04-12T09:30:00-04:00,131.72,131.98,130.99001,131.47,161480688,165423769.6,48.690274770300384,56.50316001511364,NaN,NaN,9.018934457566814,69.42921527585293,0.04055521654476979,0.5512708762866794,0.5107156597419096,4974896109,5270392320.2,39.78602737838263,40.44044848452818,NaN,NaN,9.915742820257455,7.059721539703614
2011-04-13T09:30:00-04:00,132.08,132.17999,130.96001,131.46001,162172944,150074381.6,48.63616017500503,56.23728697229999,NaN,NaN,1.9980992449927606,46.776577977047886,-0.05308395713881653,0.4443607133183889,0.4974446704572054,4812723165,5117560294.6,33.98094664300848,41.47667465497021,NaN,NaN,8.313215342988341,7.238792083030003
2011-04-14T09:30:00-04:00,130.7,131.75999,130.27,131.56,161271248,145411862.4,49.24420222060033,55.91809121491656,NaN,NaN,-23.801899718251313,23.55808279447825,-0.10714640826274102,0.3635116601287791,0.47065806839152013,4973994413,5031177155.4,31.20916430401978,41.84635053425617,NaN,NaN,7.0976858792974244,7.218634053925349
2011-04-15T09:30:00-04:00,131.8,132.37,131.41,132.03999,170146624,142386475.2,52.171222385622286,55.899699445848476,NaN,NaN,5.003467224590349,9.689297635051801,-0.1090739728043032,0.3343156023861411,0.4433895751904443,5144141037,5008426304.2,30.503454697380363,41.9610253506453,NaN,NaN,6.753624863925256,7.152204169639622
2011-04-18T09:30:00-04:00,130.59,132.03011,129.50999,130.56,210908192,145228619.2,43.786453414926925,55.05770319063883,NaN,NaN,-74.52857386734958,-16.461994531690195,-0.20305609742010222,0.1895694534153165,0.3926255508354187,4933232845,4967797513.8,29.23221754185454,41.56548552072757,NaN,NaN,4.014129603077862,6.703907802987942
2011-04-19T09:30:00-04:00,130.75999,131.35001,130.44,131.31,124321872,144957540.8,48.31934434164799,54.321833492973724,NaN,NaN,-63.20185818964788,-30.906153061133136,-0.2070339805700086,0.13383307512290799,0.3408670556929166,5057554717,4984329235.4,30.501395460212976,40.88930365949561,NaN,NaN,2.923099153334393,6.163792281608863
2011-04-20T09:30:00-04:00,132.88,133.39,132.78999,133.10001,156473008,145348753.6,57.19173720458532,54.28000395076416,NaN,NaN,65.97810304461566,-18.110152301208558,-0.08754754076576765,0.231432629735707,0.31898017050147465,5214027725,5064590147.4,36.45950150650733,40.50330180305003,NaN,NaN,4.762792196901783,5.963649412364995
2011-04-21T09:30:00-04:00,133.78999,133.84,133.1046,133.78,136214496,144197562.4,60.00100765997318,54.30002714531809,NaN,NaN,92.3263767317907,5.115502988799847,0.032420923511768784,0.3595063248911856,0.32708540137941683,5350242221,5139839709,41.52140264324259,40.34357649734334,NaN,NaN,7.197957333005209,6.139979115313597
2011-04-25T09:30:00-04:00,133.67999,133.86,133.2,133.64,65231072,139670616,59.1404875162679,54.2308421725184,NaN,NaN,84.35459233228684,20.985728010339145,0.09399882625829459,0.44458393420228504,0.35058510794399045,5285011149,5168013731.4,43.34135000991662,40.02735872832675,NaN,NaN,8.886583676670554,6.532351195507448
2011-04-26T09:30:00-04:00,134.05,135.06,133.91,134.791,146658432,141511584.8,63.744235443151425,54.498579322237156,NaN,NaN,148.16887493402768,65.5252177706146,0.19792500248525602,0.5979913610505605,0.4000663585653045,5431669581,5267701078.6,49.34802497516846,40.041732712671624,NaN,NaN,11.843981371063647,7.29115550630119
2011-04-27T09:30:00-04:00,135.05,135.87,134.5,135.67,143104816,142174597.6,66.8189623858625,54.86914080833334,NaN,NaN,184.63013344516716,115.09161609757761,0.30513675854447786,0.7814873067459018,0.476350548201424,5574774397,5371145014.6,54.71325887965341,40.35000539927892,NaN,NaN,15.353037306727572,8.442852906362102
2011-04-28T09:30:00-04:00,135.42999,136.28999,135.41,136.11,124865744,141623091.2,68.26958269716746,55.49479269768422,NaN,NaN,190.36810964664159,139.9696174179828,0.38007621216718224,0.9514458134104018,0.5713696012432196,5699640141,5468267497.8,59.09428359876876,40.90805063605901,NaN,NaN,18.685594868078766,9.906101758035911
2011-04-29T09:30:00-04:00,136.16,136.57001,135.98,136.42999,115094368,140739984.8,69.32006008701113,56.39842137902908,NaN,NaN,183.77663942485867,158.25966995659638,0.42233453344679206,1.0992877680517097,0.6769532346049176,5814734509,5561165955.4,62.801154835949454,41.90692575508789,NaN,NaN,21.739621763962102,11.596604616025367
2011-05-02T09:30:00-04:00,137.07001,137.17999,135.95,136.22,126310064,139353540.8,67.73526666155396,57.36207121169111,NaN,NaN,161.1475698360578,173.61826545735056,0.40710903178112845,1.1858395243313282,0.7787304925501998,5688424445,5641848614.6,65.70769641955384,43.44284849240133,NaN,NaN,23.800620612694352,13.340035472692364
2011-05-03T09:30:00-04:00,135.96001,136.19,135.045,135.73,138445808,141237165.6,64.05524338298935,58.45956896974032,NaN,NaN,104.51692731206438,164.8878759329579,0.3378544616176522,1.201048569572265,0.8631941079546128,5549978637,5665510425.8,66.53356139149815,45.353386636195296,NaN,NaN,24.511490437768003,14.935957610560312
2011-05-04T09:30:00-04:00,135.67,135.73,134.23,134.83,182821184,144324034.4,57.83952213186427,59.11695196665884,NaN,NaN,63.69634108161492,140.70111746024747,0.21143067621827605,1.1274824532274579,0.9160517770091818,5367157453,5623987037,63.63719879996666,47.47169036169231,NaN,NaN,23.29449668719113,16.130034621507573
2011-05-05T09:30:00-04:00,134.08,134.95,133.02,133.61,227065680,149654636.8,50.66277241467419,59.21827840909269,NaN,NaN,15.306190361374245,105.68873360319401,0.03489813229603411,0.9596744423792245,0.9247763100831904,5140091773,5512077363.4,56.498652636443964,49.278082385436896,NaN,NaN,19.92903348141781,16.672748744351892
2011-05-06T09:30:00-04:00,134.94,135.63,133.22,134.2,222951248,152253540,53.65751363164736,59.32444206952305,NaN,NaN,34.055219813349076,75.74444968089209,-0.04835705143446034,0.8643299957901149,0.9126870472245753,5363043021,5421739065.8,51.47853542889914,50.77630243768824,NaN,NaN,18.027407876844777,16.86627147756516
2011-05-09T09:30:00-04:00,134.19,135.11,133.98,134.72,114134432,150559520.8,56.18200052138678,60.20983829141304,NaN,NaN,41.010366587789655,51.71700903123847,-0.07314043954110816,0.82126149779819,0.8944019373392982,5477177453,5379489667.4,49.273466384854196,52.20782021218821,NaN,NaN,17.200892511584698,16.914074482425093
2011-05-10T09:30:00-04:00,135.17,136.11,135,135.87,114887008,150227946.4,61.2140756340849,61.13089052658711,NaN,NaN,77.85605936912502,46.384835442650605,-0.019603822718865294,0.8698971589407165,0.8895009816595818,5592064461,5387906832.2,49.735409124994376,53.581678331101166,NaN,NaN,18.061374978182876,17.077974553247632
2011-05-11T09:30:00-04:00,135.67,135.69,133.82001,134.44,193745632,151841193.6,53.054954251913074,60.835406029967665,NaN,NaN,31.024484846637396,39.8504641956551,-0.08438911360888268,0.7840145896484785,0.8684037032573612,5398318829,5394139107.4,50.09776758904759,54.555840194139755,NaN,NaN,16.088774673530757,16.93666028471665
2011-05-12T09:30:00-04:00,134.08,135.36,133.39,135.08,171648128,152314952.8,55.88875943362562,60.541674013799984,NaN,NaN,24.35651633464988,41.66052939031022,-0.08764522801292618,0.7588471682412035,0.8464923962541296,5569966957,5480114144.2,54.92524313358621,55.51325737202144,NaN,NaN,15.400138145097793,16.717157121913957
2011-05-13T09:30:00-04:00,135.14999,135.34,133.56,134.03999,157499056,152126343.2,50.54885181902825,59.92798574971143,NaN,NaN,2.9874397339604175,35.44697337443249,-0.1591799079031333,0.647517511375213,0.8066974192783463,5412467901,5489999120.2,55.45876265825067,56.37878684690245,NaN,NaN,13.040236780786563,16.191882787467186
2011-05-16T09:30:00-04:00,133.56,134.61,132.97,133.19,141770624,150707543.2,46.62769505117755,58.7053757217133,NaN,NaN,-45.553134843823635,18.134273088109815,-0.2572708680516109,0.48510883421383255,0.7423797022654435,5270697277,5448703085,52.65479945993859,56.61498502438603,NaN,NaN,9.77731464231052,15.275515909587662
2011-05-17T09:30:00-04:00,132.69,133.35001,132.12,133.17,192852320,149804749.6,46.536221636331504,57.256608525318235,NaN,NaN,-106.90291600422779,-18.81752198656075,-0.3133103048258745,0.3507418212331004,0.6640521260589749,5077844957,5345859184.2,46.36741669034607,56.018853439435496,NaN,NaN,7.194267126259027,14.121051797683572
2011-05-18T09:30:00-04:00,133.24001,134.5,132.95,134.36,135228128,150350062.4,52.50640461488339,56.13066723372651,NaN,NaN,-53.551377319894584,-35.732694419867144,-0.26212151076585877,0.3364002376016515,0.5985217483675103,5213073085,5308810035.4,44.31454137015199,54.96315756596288,NaN,NaN,6.814046471572794,13.077193893953462
2011-05-19T09:30:00-04:00,134.8,135.03,133.94,134.67999,119584880,148505656,53.99410543476625,55.035956187137586,NaN,NaN,-10.393536562862371,-42.6827049993696,-0.20133211789827232,0.34685660099466986,0.5481887188929422,5332657965,5261348237,41.76361238389998,53.46047596224506,NaN,NaN,6.961212502853764,12.203482266653506
2011-05-20T09:30:00-04:00,134.33,134.6781,133.36,133.61,182638320,150826847.2,48.52094928095026,53.6635049456659,NaN,NaN,-71.10199751746525,-57.50059244965472,-0.22595833584772224,0.2657407990832894,0.49169913493101164,5150019645,5208858585.8,39.084038582228615,51.558786116721826,NaN,NaN,5.371065140157708,11.227422677154106
2011-05-23T09:30:00-04:00,131.98,133.64751,131.59,132.06,168800000,156005293.6,41.89576086839678,52.08068476605215,NaN,NaN,-184.4219899154932,-85.27436346398864,-0.33294856889919006,0.07551342380702408,0.40846199270621414,4981219645,5150963059.4,36.316298831039795,49.40041021954623,NaN,NaN,1.739098940914827,9.871947857691351
2011-05-24T09:30:00-04:00,132.44,132.73,131.7,131.95,147200320,156032388,41.46307163674705,50.910938302115206,NaN,NaN,-172.89534821876686,-98.47284990689646,-0.39329807311640297,-0.0831605986892896,0.31013747442711337,4834019325,5102197933,34.12430814917539,47.292346601632566,NaN,NaN,-1.2474862397745512,8.28345727233908
2011-05-25T09:30:00-04:00,131.42,132.94,131.38,132.39,151102192,156432256.8,43.956384757876066,50.43191061234391,NaN,NaN,-142.49647272554242,-116.26186898802602,-0.3852543303830811,-0.171430438551738,0.2138238918313431,4985121517,5056607619.4,32.16939306149868,45.554542346279334,NaN,NaN,-2.9561841784868763,6.677794207935372
2011-05-26T09:30:00-04:00,132.03,133.24001,131.78,133,164984624,158438200.8,47.307269127616706,49.97832171919886,NaN,NaN,-100.29173047246314,-134.24150776994617,-0.32303761634741796,-0.18997312860292936,0.1330644877444886,5150106141,5020097254.6,30.65481713628084,44.067133896806595,NaN,NaN,-3.391235591535693,5.239361379439505
2011-05-27T09:30:00-04:00,133.37,133.87,132.9588,133.50999,120921872,158729576,49.998981545728526,49.53667750665185,NaN,NaN,-42.448614197682005,-128.51083110598952,-0.2357739728492541,-0.16165297831707903,0.07412099453217506,5271028013,5044298928.2,32.90968915156829,42.8982926658576,NaN,NaN,-2.9567531593872896,4.0684878738928205
2011-05-31T09:30:00-04:00,134.77,134.92,133.84,134.89999,164731184,160650632,56.518562308584244,49.201283697687515,NaN,NaN,48.09306103287387,-82.00782091631609,-0.08068834467970486,-0.02673943631745601,0.053948908362248846,5435759197,5135206838.6,40.70866835955894,42.25352546832651,NaN,NaN,-0.4978646197386601,3.4161518033740377
2011-06-01T09:30:00-04:00,134.50999,134.9234,131.75999,131.87,233094256,165383054.4,43.27303497454934,48.50257517787582,NaN,NaN,-77.52815168819868,-62.934381610202465,-0.17311258618212066,-0.162441824365402,0.010670761816718673,5202664941,5208935961.8,46.17372150769701,41.97323646251574,NaN,NaN,-2.9247512355295426,2.510308512102098
2011-06-02T09:30:00-04:00,131.96001,132.24001,130.96001,131.73,200466752,166265332.8,42.77422875633851,47.565822986641024,NaN,NaN,-149.70903741701773,-64.37689454849752,-0.2309992186111624,-0.27807826144723435,-0.047079042836071935,5002198189,5212351296.2,46.420089348389844,41.36572547785886,NaN,NaN,-4.93077903480955,1.4472960054004338
2011-06-03T09:30:00-04:00,130.14999,131.42,130.08,130.42,234690128,166646555.2,38.32279768485303,46.69253340562851,NaN,NaN,-182.08799230890838,-80.73614691578658,-0.33834400657375646,-0.4700090510532675,-0.13166504447951105,4767508061,5135831680.2,41.803449308224025,40.390345952856954,NaN,NaN,-8.155952773066875,0.07540332276224682
2011-06-06T09:30:00-04:00,130.09,130.36,128.87,129.045,179951120,164496548.8,34.28921392165293,45.81121332494818,NaN,NaN,-208.06726323012492,-113.85987672227516,-0.47443801081443027,-0.7247125579975489,-0.2502745471831186,4587556941,4999137465.8,35.089743972848964,39.13569913235056,NaN,NaN,-12.27458731803388,-1.6888810544943427
2011-06-07T09:30:00-04:00,129.7,130.07001,128.85001,128.96001,161805936,166880124,34.050647638305364,44.91938661080345,NaN,NaN,-181.6144153845942,-159.80137200576877,-0.5380104295693449,-0.9227875841447997,-0.3847771545754548,4425751005,4797135827.4,27.94687278736359,37.81994599642324,NaN,NaN,-15.521961623752578,-3.6650354215312335
2011-06-08T09:30:00-04:00,128.75999,129.19,128.17999,128.42,198696320,171070589.6,32.50326683338656,43.49059105498225,NaN,NaN,-184.33668965726065,-181.16307959958118,-0.5806072310718076,-1.1105361934152143,-0.5299289623434067,4227054685,4602013776.2,23.063183573387562,36.30199186808293,NaN,NaN,-18.65827403711541,-5.806926652328974
2011-06-09T09:30:00-04:00,128.77,129.92999,128.46001,129.39999,160964368,169431526.4,38.00888166310713,42.348789357006595,NaN,NaN,-132.19071914936333,-177.65941594605027,-0.5094977569958005,-1.1668011585881573,-0.6573034015923568,4388019053,4479177949,20.620247715152175,34.791751534600934,NaN,NaN,-19.596092962286786,-7.776807553751518
2011-06-10T09:30:00-04:00,128.85001,128.92999,127.25999,127.60001,238629312,172780585.6,32.7283473803234,41.22074636410468,NaN,NaN,-157.34193202656715,-172.71020388958203,-0.5470970108119115,-1.3411746651072463,-0.7940776542953347,4149389741,4355554285,18.496760188943938,33.32123164936631,NaN,NaN,-22.187848163636417,-9.835527640877933
2011-06-13T09:30:00-04:00,127.89,128.24001,127.05,127.7,207599744,175285620,33.28285029238616,40.605538465818206,NaN,NaN,-141.02963173303922,-159.3026775901649,-0.528363182740305,-1.454531632720716,-0.926168449980411,4356989485,4309440793.8,17.76197861928722,31.995923062812558,NaN,NaN,-24.04248933859029,-11.865093597693983
2011-06-14T09:30:00-04:00,128.87,129.77,128.82001,129.32001,160570368,176225607.2,41.671606275054145,40.62043379712586,NaN,NaN,-73.5126689265426,-137.68232829855458,-0.377094556591838,-1.3975366457202085,-1.0204420891283705,4517559853,4327802563.4,19.139412292392464,30.925573358756633,NaN,NaN,-22.937053358878657,-13.44680213500608
2011-06-15T09:30:00-04:00,128.24001,129.2991,126.67999,127.02,300957952,181630888.8,34.952194732434265,39.977277366737155,NaN,NaN,-111.98701685400647,-123.21239373790377,-0.3999924817224234,-1.5204326912813997,-1.1204402095589763,4216601901,4325712006.6,19.10018685632876,29.992058629815926,NaN,NaN,-24.285462111090645,-14.995182131589589
2011-06-16T09:30:00-04:00,127.06,127.97,126.32001,127.3,308038400,190271402.4,36.29883429771113,39.19096059317248,NaN,NaN,-112.76546244978194,-119.3273423979875,-0.3652924053533315,-1.5770557162506407,-1.2117633108973092,4524640301,4353036256.2,21.368518727647697,29.328751600627847,NaN,NaN,-24.885422825727503,-16.408073659323577
2011-06-17T09:30:00-04:00,127.92999,127.94,126.62,127.05,234996064,196041961.6,35.590370133322324,38.161774063714894,NaN,NaN,-102.39658863529534,-108.33827371973314,-0.32930083938588406,-1.6233893601296643,-1.2940885207437802,4289644237,4381087155.4,23.732699485425584,28.673252338760513,NaN,NaN,-25.580436030805622,-17.71841114096387
2011-06-20T09:30:00-04:00,126.62,127.97,126.58,127.7,159478944,194883992.8,38.927906802813,36.90529867044552,NaN,NaN,-87.66064957552908,-97.66447728823111,-0.23620008946019544,-1.5893386325690244,-1.353138543108829,4449123181,4399513894.6,25.32113043873497,27.57414248727309,NaN,NaN,-25.13679069083285,-18.77817964808801
2011-06-21T09:30:00-04:00,128.36,129.7,127.75349,129.45,193157248,196101855.2,46.90489743460341,37.164717417592236,NaN,NaN,-34.339878902901205,-89.82991928350285,-0.041447126589353456,-1.404947451345521,-1.3635003247561674,4642280429,4424458009.8,27.521735217327475,26.24185775224669,NaN,NaN,-22.151652138803072,-19.260104289618734
2011-06-22T09:30:00-04:00,129.05,129.81,128.59,128.67,176886432,197586160.8,44.13765763250128,37.262105194461014,NaN,NaN,-28.847651027849583,-73.20204611827145,0.04544597882389256,-1.3066928512263019,-1.3521388300501944,4465393997,4474216429,31.83670769158404,25.200187633903422,NaN,NaN,-20.553022402056843,-19.444806877109894
2011-06-23T09:30:00-04:00,127.16,128.63609,126.19,128.30099,334286848,206745393.6,42.84969127698452,37.58545473675611,NaN,NaN,-70.6326368975372,-64.77548100782249,0.08630437607951125,-1.2442583599508055,-1.3305627360303167,4131107149,4395509798.6,28.905294306797956,24.27889084808728,NaN,NaN,-19.644880005766254,-19.473388752632232
2011-06-24T09:30:00-04:00,128.27,128.37,126.62,126.81,226129376,209802631.2,38.021881801166145,37.852073871007065,NaN,NaN,-84.5947732309403,-61.215117926951486,0.024368397822150056,-1.300102238752629,-1.3244706365747791,3904977773,4318576505.8,26.35119962829475,23.65470910919055,NaN,NaN,-20.358136936031556,-19.599781350260706
2011-06-27T09:30:00-04:00,126.89,128.42999,126.64,127.94,168908192,212201947.2,43.241312833572316,38.50854995638327,NaN,NaN,-64.27679800978608,-56.53834761380288,0.06845960095745829,-1.2388961353779564,-1.3073557363354147,4073885965,4243529062.6,24.112913760121955,23.380854892959004,NaN,NaN,-19.30403416623836,-19.557531752543227
2011-06-28T09:30:00-04:00,128.45,129.63,128.27,129.61,165556256,212243200.8,49.94964625213425,39.75471991486525,NaN,NaN,21.496165360144897,-45.371138761193656,0.21100075875925017,-1.043604787886352,-1.254605546645602,4239442221,4162961421,21.956700677851245,23.3018204004207,NaN,NaN,-16.158945526217813,-19.072019434496738
2011-06-29T09:30:00-04:00,130.2,130.92999,129.6321,130.72,244295376,212803256.8,53.853655130212346,40.88648944822991,NaN,NaN,112.20333806397213,-17.160940942829313,0.3715573926751481,-0.7901588058016671,-1.1617161984768152,4483737597,4166630141,22.29743504412393,23.421619495347247,NaN,NaN,-12.249171163500899,-18.097326824354475
2011-06-30T09:30:00-04:00,131.14,132.17999,130.705,131.97,223496496,213954744,57.841686719009154,42.68029940099318,NaN,NaN,188.7140581795676,34.70839807259164,0.5430767524227273,-0.4828702579484059,-1.0259470103711332,4707234093,4281855529.8,32.29550394827436,24.407244049585135,NaN,NaN,-7.639304448345962,-16.60332362778183
2011-07-01T09:30:00-04:00,132.09,134.10001,131.78,133.92,202385632,212339519.2,63.186555189793914,44.816278322236585,NaN,NaN,253.8590028990555,102.3991532985908,0.755910590978527,-0.08105877164797448,-0.8369693626265015,4909619725,4482783920.2,45.47146754554301,26.386493258603405,NaN,NaN,-1.7795775647990775,-14.485645618784293
2011-07-05T09:30:00-04:00,133.78,134.08,133.39,133.81,165935936,211638760,62.7036196525614,46.31856499205853,NaN,NaN,226.6533421261364,160.5851813257753,0.8502951823422423,0.22589961530130154,-0.6243955670409408,4743683789,4616743485,52.15651898374968,28.74485802227178,NaN,NaN,2.6062631400109257,-12.043944367527834
2011-07-06T09:30:00-04:00,133.49001,134.14,133.11,133.97,143332688,210715097.6,63.14485931094068,48.33232674766613,NaN,NaN,179.75548398932796,192.23704505161191,0.8807830585799981,0.47658325618405684,-0.4041998023959413,4887016477,4746258336.2,57.57229849446286,31.492865996424218,NaN,NaN,6.2374053124754445,-9.432322984670222
2011-07-07T09:30:00-04:00,135.16,135.7,134.88,135.36,170464192,209303491.2,66.8176371823719,50.51224123942762,NaN,NaN,185.10783781717032,206.81794500225155,0.9461117305518238,0.7784398607938385,-0.16767186975798531,5057480669,4861006950.6,61.70808277453138,34.37426342834448,NaN,NaN,10.560823829117446,-6.576159154129126
2011-07-08T09:30:00-04:00,133.83,135.3558,133.39,134.39999,194171504,210963848,62.206796992233784,52.41341458649271,NaN,NaN,128.10157735806706,194.69544883795146,0.8777247732152575,0.9294840967610867,0.0517593235458291,4863309165,4892221965,62.77121672897423,37.16272894574081,NaN,NaN,12.797932598613437,-3.8084317608801883
2011-07-11T09:30:00-04:00,132.75,133.17999,131.66,131.97,195918560,208828310.4,52.357957397720384,53.37270391470038,NaN,NaN,60.69862658369228,156.0633735748788,0.6333012054757843,0.8433858303905595,0.21008462491477517,4667390605,4843776141,59.987536190029886,39.63890078511901,NaN,NaN,11.551967890565374,-1.6140889535308225
2011-07-12T09:30:00-04:00,131.69,132.78,131.36,131.39999,214675632,209182104.8,50.344413145879805,53.61838360836298,NaN,NaN,43.54811796663158,119.44232874297784,0.4086105448400041,0.7208478059647803,0.3122372611247762,4452714973,4785582377.8,56.73292721797879,41.725414499451254,NaN,NaN,9.903111187228332,0.0312253522919137
2011-07-13T09:30:00-04:00,132.09,133.22,131.519,131.84,204062560,211356714.4,51.88272457419331,54.17160267562671,NaN,NaN,48.125316042792925,93.11629515367083,0.2715925545251156,0.6517279542811707,0.3801353997560551,4656777533,4739534589,54.225886021450165,43.32464152301312,NaN,NaN,9.037521834574903,1.317839135475198
2011-07-14T09:30:00-04:00,132.17,132.78,130.67999,130.92999,226111744,207614404,48.53391989407701,54.577619005419024,NaN,NaN,24.214139854128394,60.93755556106244,0.10993466805287111,0.517553734822144,0.40761906676927284,4430665789,4614171613,48.006195647209154,44.68899161875678,NaN,NaN,7.279087195492839,2.1694460011920036
2011-07-15T09:30:00-04:00,131.66,131.87,130.77,131.69,220124624,203218715.2,51.35774975420207,55.53018100206445,NaN,NaN,18.910902431996877,39.0994205758484,0.04763355714197698,0.4671610131967441,0.4195274560547671,4650790413,4571667862.6,46.0765195480853,46.09794304159896,NaN,NaN,6.646109242773214,2.808969321417891
2011-07-18T09:30:00-04:00,131.08,131.28,129.63,130.61,196872064,201312515.2,47.37945778426216,55.82576278425658,NaN,NaN,-15.084536553636623,23.942787948382623,-0.06666043063917282,0.3362019177558011,0.4028623483949739,4453918349,4528973411.4,44.15647887838241,47.52962626433185,NaN,NaN,4.889806569284832,3.106231785398882
2011-07-19T09:30:00-04:00,131.34,132.89,131.31,132.73,166554880,201666312,54.78372723953064,56.17105428335633,NaN,NaN,38.34160521170122,22.901485397396556,-0.0031826098498967115,0.39888408608260306,0.4020666959324998,4620473229,4562525062.6,46.05877749618207,49.25120317992691,NaN,NaN,5.681893510306427,3.474183460385674
2011-07-20T09:30:00-04:00,133.07001,133.14999,132.42,132.64999,137145312,198865715.2,54.4722008001872,56.21523611692596,NaN,NaN,49.21967022074321,23.120356232986616,0.027999279517340547,0.43706579532917544,0.4090665158118349,4483327917,4527835139.4,44.37562112053994,50.82821647109948,NaN,NaN,6.212199316402092,3.8653285826737336
2011-07-21T09:30:00-04:00,133.39999,134.82001,132.6693,134.49001,245270320,202284909.6,60.09251562755487,56.37600961039351,NaN,NaN,88.50666158251538,35.97886057866401,0.15977211161726523,0.6087816553334164,0.4490095437161512,4728598237,4587421629,47.89769257620493,51.94265851595166,NaN,NaN,8.477350199106946,4.5241888135927635
2011-07-22T09:30:00-04:00,134.52,134.72,133.75999,134.58,126019312,191871532.8,60.35031397597885,56.17342095226387,NaN,NaN,95.80885529268562,51.35845115080176,0.23563866907691722,0.7435578800622977,0.5079192109853805,4854617549,4628187056.2,50.21998493068455,52.28183832917606,NaN,NaN,10.352881561655884,5.356859206173209
2011-07-25T09:30:00-04:00,133.3,134.49001,133.16,133.83,136653680,187397748,57.04296829149441,55.769088712187646,NaN,NaN,69.31163477968542,68.23768541746617,0.21834393874915814,0.7808491344218282,0.5625051956726701,4717963869,4680996160.2,53.134173814855004,52.35167081711216,NaN,NaN,10.957058957543882,6.156887742083305
2011-07-26T09:30:00-04:00,133.74001,133.96001,133.03,133.33,131278128,185516244.8,54.883555265662814,55.178995566096376,NaN,NaN,43.64159826188366,69.29768402750265,0.15902090236383004,0.7612813236274576,0.6022604212636276,4586685741,4674238662.6,52.70895850488981,52.00428938928551,NaN,NaN,10.836454950873605,6.825397343339063
2011-07-27T09:30:00-04:00,132.59,132.63,130.42999,130.60001,249020000,189689432,44.89114948940598,53.61281787374166,NaN,NaN,-84.23560131031186,42.60662972129164,-0.06621004338065128,0.5194978670378134,0.5857079104184647,4337665741,4645106227.4,50.82074306738896,51.22662226734676,NaN,NaN,7.465129037884111,6.916787585416927
2011-07-28T09:30:00-04:00,130.60001,131.77,130.00999,130.22,207939872,187871656.8,43.69849951697192,52.290796625508676,NaN,NaN,-117.48263705161976,1.4087699944646146,-0.23350073448867859,0.2938319923076165,0.5273327267962951,4129725869,4525331753.8,43.863425614943196,49.87606575920169,NaN,NaN,4.386792643215579,6.55535973653102
2011-07-29T09:30:00-04:00,128.91,130.55,127.96671,129.33,307042560,192048960,40.954206640299994,51.476242999978645,NaN,NaN,-172.75550514742133,-52.30410209355678,-0.38772011698134146,0.04268258056961827,0.4304026975509597,3822683309,4318944905.8,34.97767405185951,48.08964703504666,NaN,NaN,0.948341375253989,5.754357113491444
2011-08-01T09:30:00-04:00,130.84,130.96001,127.53,128.78,325790720,198219214.4,39.3112062378281,50.68815679226066,NaN,NaN,-157.01142871822375,-97.56871479313861,-0.5030805233291628,-0.19844795661049375,0.304632566718669,3496892589,4074730649.8,27.800967247069607,46.023078465696,NaN,NaN,-2.3916471086514854,4.590642224613883
2011-08-02T09:30:00-04:00,127.81,128.5,125.49001,125.49001,346653696,207255102.4,31.23810491024446,49.2135411019786,NaN,NaN,-227.1483835874443,-151.7267111630042,-0.7617506315364742,-0.6475557227019237,0.11419490883455044,3150238893,3787441280.2,22.065369247839314,43.72589869615238,NaN,NaN,-8.417026608525195,2.732403819879729
2011-08-03T09:30:00-04:00,125.66,126.31,123.53,126.17,371029504,218639943.2,34.243855930275046,48.19282224742131,NaN,NaN,-220.36190884778114,-178.95197267049804,-0.8415935372162737,-0.9377970126857917,-0.09620347546951799,3521268397,3624161811.4,19.59146737372862,41.696275248046625,NaN,NaN,-12.256033605404628,0.5911984734105356
2011-08-04T09:30:00-04:00,124.42,124.62,120.06,120.25999,520721920,236152829.6,24.30118622530277,46.260210566785645,NaN,NaN,-263.73637316504363,-208.2027198931828,-1.2238057624107945,-1.6259606784830112,-0.40215491607221665,3000546477,3398325933,16.787885118763967,39.60422993166653,NaN,NaN,-20.231829965298836,-2.383519874976517
2011-08-05T09:30:00-04:00,121.75999,122.07001,116.86,120.08,655561472,259222328,24.07195354501043,44.59538883541052,NaN,NaN,-236.77879745781243,-221.00737835526107,-1.4070352318780266,-2.16094895591975,-0.7539137240417233,2344985005,3102786272.2,13.970394266140048,37.448081030792075,NaN,NaN,-26.111095875255298,-5.773173589302058
2011-08-08T09:30:00-04:00,116.91,120.1218,112.02,112.25999,702263808,284539590.4,16.700864870800544,41.87518438050122,NaN,NaN,-248.80931311904604,-239.36695523542548,-1.940302283443009,-3.1792915783454845,-1.2389892949024754,1642721197,2731951993.8,11.387805044291198,34.97158299851416,NaN,NaN,-35.29525616276312,-9.990613956939352
2011-08-09T09:30:00-04:00,114.07001,117.64,110.27,117.48,717828608,309697239.2,31.72900515784731,40.25067040604837,NaN,NaN,-186.1791954256641,-231.17311760306947,-1.8284054161645305,-3.5244960651081385,-1.696090648943608,2360549805,2574014176.2,10.497717927903054,32.55173277046867,NaN,NaN,-35.71247848942784,-13.665166033009136
2011-08-10T09:30:00-04:00,115.25999,116.28,111.95,112.28999,662607360,332624479.2,26.59212598147235,37.85778543132819,NaN,NaN,-166.42777045075744,-220.38628992366472,-1.9781739730439782,-4.168808115248581,-2.1906341422046025,1697942445,2209348985.8,8.789479429481432,29.75828897427413,NaN,NaN,-38.39501640491255,-17.19800180042391
2011-08-11T09:30:00-04:00,113.25999,118.92,112.317,117.33,487979776,345717880.8,37.2213750036351,36.205718361875064,NaN,NaN,-114.85988071852324,-190.61099143436064,-1.6267335974155333,-4.224051138974019,-2.597317541558486,2185922221,2046424134.6,8.151279027807732,26.75338140978293,NaN,NaN,-35.56095697056414,-19.82128111044394
2011-08-12T09:30:00-04:00,118.39999,119.215,117.28,118.12,313731584,350398228.8,38.71921233525428,34.89687865071506,NaN,NaN,-81.84005166795399,-159.6232422763889,-1.2470863126186909,-4.15617543233185,-2.9090891197131588,2499653805,2077357894.6,9.494961764176992,23.636294834734496,NaN,NaN,-32.98654407209377,-21.702032962108202
2011-08-15T09:30:00-04:00,119.19,120.74001,119,120.62,258810560,353495153.6,43.327335553434644,34.071434385555904,NaN,NaN,-55.52815799191307,-120.96701125096233,-0.7576906545259017,-3.856202437870536,-3.0985117833446343,2758464365,2300506528.2,18.731172283291656,21.20931010462035,NaN,NaN,-29.22498325624914,-22.776740146985478
2011-08-16T09:30:00-04:00,119.47,120.69,118.31,119.59,294095104,359872164.8,41.92842423238242,33.85981115291136,NaN,NaN,-54.98525656848625,-94.72822347952679,-0.44871119432534634,-3.659400776251317,-3.210689581925971,2464369261,2321270419.4,19.553842112202048,18.975960036392713,NaN,NaN,-26.907184023078973,-23.366803557855977
2011-08-17T09:30:00-04:00,120.25,121.2,118.72,119.67,238201056,364924952,42.08483187461913,33.74454917845758,NaN,NaN,-46.030220202349184,-70.64871342984513,-0.19715001517470654,-3.457127100894354,-3.2599770857196475,2702570317,2522195993.8,27.23033909168433,17.78788242758851,NaN,NaN,-25.10713707733887,-23.61542263206782
2011-08-18T09:30:00-04:00,116.5,119.714,113.39,114.50999,512956160,378309244,35.452239943807285,33.351551557279535,NaN,NaN,-79.79594883982428,-63.635927054105345,-0.3287206067227033,-3.6708778441230265,-3.342157237400323,2189614157,2522934381,27.25781030054881,17.23646358820917,NaN,NaN,-25.83498922775717,-23.932503574309155
2011-08-19T09:30:00-04:00,112.96001,115.88,112.5,112.64,428281344,393422345.6,33.39799823273424,32.929179556915685,NaN,NaN,-96.18874927226899,-66.50566657496833,-0.48282301076024403,-3.9456860008506283,-3.4628629900903842,1761332813,2375270182.6,25.208314799636653,17.051274127678244,NaN,NaN,-27.11452526772165,-24.38707810193951
2011-08-22T09:30:00-04:00,115.17,115.23,112.41,112.73,275090688,400344196,33.59742373809881,33.09770233033385,NaN,NaN,-93.58262510748021,-74.11655999808175,-0.516787181478152,-4.108846966938074,-3.5920597854599223,2036423501,2230862009.8,23.35860281399549,17.14364795383226,NaN,NaN,-28.037905795689994,-24.90862491533244
2011-08-23T09:30:00-04:00,113.14999,116.5665,112.58,116.44,331136512,410337115.2,41.388418976138645,33.60802826218125,NaN,NaN,-69.1887003377511,-76.95724875193473,-0.2414727715216496,-3.8939007498619844,-3.652427978340335,2367560013,2211500160.2,23.113713532949163,17.395236965205157,NaN,NaN,-26.294531406893544,-25.106611556984024
2011-08-24T09:30:00-04:00,116.19,118.24001,115.92,118.08,246869680,410229599.2,44.48899051781353,35.05001428307488,NaN,NaN,-35.15652635804305,-74.78250998307351,0.0817068259630167,-3.550294445886564,-3.632001271849581,2614429693,2193872035.4,22.878536390235013,17.830283484595945,NaN,NaN,-23.88187618372134,-24.93164936080364
2011-08-25T09:30:00-04:00,118.73,119.39999,115.87,116.28,312365312,415450871.2,41.870903978440936,36.32136788546277,NaN,NaN,-32.23356018564999,-65.27003225223864,0.1982267972417211,-3.3842177752974294,-3.5824445725391505,2302064381,2216362080.2,23.94179846290622,18.54252664150781,NaN,NaN,-22.697806807236105,-24.612528996008276
2011-08-26T09:30:00-04:00,115.69,118.50999,113.85001,117.97,314495744,415823530.4,45.13544542600582,38.35240935369172,NaN,NaN,-32.87245223958998,-52.60677284570285,0.40138019679782655,-3.0807193265418675,-3.482099523339694,2616560125,2387407542.6,31.65887972498203,19.990460547271443,NaN,NaN,-20.708706314369092,-24.054840041488394
2011-08-29T09:30:00-04:00,119.56,121.42999,118.0569,121.36,190977184,409082853.6,51.0713819028646,39.73400769262152,NaN,NaN,52.08473808457994,-23.47330020729081,0.755759315760641,-2.5374003786388926,-3.2931596943995336,2807537309,2541630304.2,37.78805964365737,21.93977066982532,NaN,NaN,-17.076187435448222,-23.05788966919694
2011-08-30T09:30:00-04:00,120.83,122.42999,119.25999,121.67999,241315680,403815952.8,51.60365115297481,41.5205452048717,NaN,NaN,86.3991767326859,7.644275206796593,0.9887032524669275,-2.0572806288158745,-3.045983881282802,3048852989,2677888899.4,42.67943357458679,24.36048168018999,NaN,NaN,-14.022739674835297,-21.767153955716704
2011-08-31T09:30:00-04:00,122.46001,123.50999,121.3,122.22,301828352,400355895.2,52.54192290990942,42.61487005531986,NaN,NaN,129.66433567902058,40.60844761420932,1.145110371128164,-1.614595917372597,-2.759706288500761,3350681341,2825139229,47.484725832578945,27.170013594816506,NaN,NaN,-11.254687239238951,-20.26537299621988
2011-09-01T09:30:00-04:00,122.28999,123.39999,120.78,120.94,254585872,387049092.8,50.0642900191999,43.42523274703026,NaN,NaN,112.03037271345674,69.46123419403067,1.126587850900008,-1.3514714748757513,-2.4780593257757593,3096095469,2983945446.6,52.14422850403308,30.21638979052051,NaN,NaN,-9.602023071970942,-18.742037292755747
2011-09-02T09:30:00-04:00,118.42,120.8726,117.42999,117.85001,255517184,367046878.4,44.597041320050415,43.51592601607425,NaN,NaN,32.441961160840755,82.52411687411681,0.8813167481528006,-1.3764133905847586,-2.2577301387375592,2840578285,3028749078.6,53.40044952958002,32.692766736683964,NaN,NaN,-9.732494570890996,-17.45495976106078
2011-09-06T09:30:00-04:00,114.39,117.16,114.38,116.99001,285142784,346190827.2,43.18357513436499,43.60557965193015,NaN,NaN,-41.41929347604014,63.8233105619928,0.6470855962256241,-1.448873143455529,-2.095958739681153,2555435501,2978328717,51.75398290376041,34.99277679322385,NaN,NaN,-10.248501186631682,-16.42546567899948
2011-09-07T09:30:00-04:00,118.75999,120.34,118.36,120.28999,209803120,320789552.8,49.763169864193046,44.15403236547114,NaN,NaN,52.43615678963437,57.030706573382496,0.6960582217881566,-1.2258859624459575,-1.921944184234114,2765238621,2921605843.4,49.890345236089026,36.61134866068132,NaN,NaN,-8.731432687264029,-15.326318108751558
2011-09-08T09:30:00-04:00,119.57001,120.94,118.77,119.03999,250568192,300187594.4,47.51840683210882,45.015901428921254,NaN,NaN,44.438251186436,39.985489674865576,0.62801471105426,-1.136925795416289,-1.764940506470549,2514670429,2754403661,44.772391081508225,37.862390145035576,NaN,NaN,-8.130214449480237,-14.298303300284227
2011-09-09T09:30:00-04:00,117.67999,119.05701,115.28,115.92,380195072,294798359.2,42.3797593709602,45.65745579593739,NaN,NaN,-45.08640463055688,8.562134206062852,0.36942494061509934,-1.303159330701675,-1.6725842713167742,2134475357,2562079638.6,39.72445234211049,38.89925711235513,NaN,NaN,-9.181241502426543,-13.567294472018844
2011-09-12T09:30:00-04:00,114.47,116.75999,114.05,116.67,305793536,294401456.8,43.94890692222983,46.396847451946755,NaN,NaN,-66.84361823208012,-11.294981672521327,0.2510918957839936,-1.3587194015867823,-1.6098112973707759,2440268893,2482017760.2,37.81317439050769,39.93172651067743,NaN,NaN,-9.577792389215666,-12.997365603046962
2011-09-13T09:30:00-04:00,117.05,118.17999,116.22,117.74001,272514560,295086656.8,46.19994425615602,46.74052782909085,NaN,NaN,-16.944717028640483,-6.400066383041398,0.2467222644629432,-1.3014084667920969,-1.54813073125504,2712783453,2513487350.6,39.05442117310092,41.070348484973984,NaN,NaN,-9.260733076555608,-12.46356095640534
2011-09-14T09:30:00-04:00,118.34,120.8,116.72,119.37,319389440,296351373.6,49.52541517147195,47.100272447209306,NaN,NaN,33.56390953952999,-10.174515833062271,0.34918604162325906,-1.1116481792259663,-1.4608342208492253,3032172893,2566874205,41.19866829100563,42.378929335029035,NaN,NaN,-8.028263985338361,-11.82994710339577
2011-09-15T09:30:00-04:00,120.64999,121.47,119.4034,121.42999,326777088,300780175.2,53.442183529742344,47.92679241515941,NaN,NaN,86.92691107598753,-1.6767838551519645,0.539885338820173,-0.7859775473240092,-1.3258628861441821,3358949981,2735730115.4,47.49127668742576,44.061034922494706,NaN,NaN,-5.805134376428087,-10.969259570971817
2011-09-16T09:30:00-04:00,121.28999,121.97,120.32001,121.521,284528128,289358773.6,53.613443534392786,48.53236370861562,NaN,NaN,91.43363478548386,25.627224028056183,0.6490059666967818,-0.5146054277732048,-1.1636113944699866,3643478109,3037530665.8,56.45982510210041,45.83253102086031,NaN,NaN,-3.947454855519942,-9.966144611621548
2011-09-19T09:30:00-04:00,119.53,120.92999,118.72,120.31,241516944,280020553.6,50.928918176255046,48.522187728143514,NaN,NaN,47.2028193867267,48.436511551817546,0.6167039291125702,-0.39273148307927386,-1.009435412191844,3401961165,3229869120.2,61.028296076921826,47.49254790895062,NaN,NaN,-3.0910763376922072,-8.983992001060214
2011-09-20T09:30:00-04:00,120.82001,121.99001,120.00999,120.17,218932128,277212625.6,50.61339746313077,48.45145532172608,NaN,NaN,65.63243132240169,64.95194122202598,0.5643973557644664,-0.3039387174862611,-0.8683360732507275,3183029037,3323918237,63.06884438730115,48.948934395573076,NaN,NaN,-2.463529859839271,-8.052497409457223
2011-09-21T09:30:00-04:00,120.23,120.60001,116.44,116.63,316251136,276468356.8,43.30731467489757,47.791840447796666,NaN,NaN,-44.08856463177638,49.42144638776471,0.28402789123954053,-0.5133012092013018,-0.7973291004408424,2866777901,3290839238.6,61.84234939375323,49.97447893565696,NaN,NaN,-3.9955362551739064,-7.4729315302738915
2011-09-22T09:30:00-04:00,113.25,114.21001,111.3,112.86,513920000,289820872.8,37.15596500238682,46.86981723231002,NaN,NaN,-203.5890813013873,-8.681752087710283,-0.13991496423874872,-0.9722228057392783,-0.8323078415005296,2352857901,3089620822.6,54.854218992007475,50.16804968479799,NaN,NaN,-7.35385307403567,-7.45592032223986
2011-09-23T09:30:00-04:00,112.11,114.16,112.02,113.53999,307242496,289564732,38.84329148227914,46.458835101040634,NaN,NaN,-162.71605853803678,-59.51169075241442,-0.34731619435393113,-1.2664530844429436,-0.9191368900890124,2660100397,2892945280.2,49.023205579294824,49.85538940263476,NaN,NaN,-9.580819573031286,-7.7594773580672065
2011-09-26T09:30:00-04:00,114.61,116.39999,112.98,116.24001,260673632,286873626.4,45.141644298911494,46.59869718422253,NaN,NaN,-96.46935383603994,-88.24612539696774,-0.27841581429964446,-1.267156657963568,-0.9887408436639236,2920774029,2796707853,46.42278538475556,49.474589579848704,NaN,NaN,-9.595238637703243,-8.021728969443783
2011-09-27T09:30:00-04:00,118.53,119.56,116.84,117.53999,311753728,292912453.6,47.92255427181152,46.46722464190957,NaN,NaN,-12.636680756068674,-103.89994781266182,-0.12865952571051698,-1.1495652508020697,-1.0209057250915528,3232527757,2806607597,46.73578370654083,49.24926375630954,NaN,NaN,-8.760983327313362,-8.127336734853722
2011-09-28T09:30:00-04:00,117.78,118.49001,114.97,115.145,286696704,295181504.8,43.54314389460129,46.18327728923045,NaN,NaN,-58.920211206657314,-106.866277127638,-0.17158590439150823,-1.2353881055809381,-1.06380220118943,2945831053,2822418227.4,47.26564889682282,49.42735360026058,NaN,NaN,-9.39558880537114,-8.308515602070496
2011-09-29T09:30:00-04:00,117.05,117.63,113.92999,116.05,298108928,294995533.6,45.56739489790471,46.410965541155065,NaN,NaN,-62.169936598164995,-78.58244818699355,-0.12204304292486268,-1.2163560048455082,-1.0943129619206455,3243939981,3000634643.4,52.947568934462964,50.37186192828576,NaN,NaN,-9.309802675201919,-8.451556612517843
2011-09-30T09:30:00-04:00,114.45,115.45,113.07001,113.14999,288685568,296700518.4,40.55004269165348,46.168189524685324,NaN,NaN,-112.25914234110621,-68.49106494760743,-0.2596880600455884,-1.4189230369776311,-1.1592349769320427,2955254413,3059665446.6,54.68905614871825,51.57728205387223,NaN,NaN,-10.802910803140973,-8.787464354035432
2011-10-03T09:30:00-04:00,112.49001,113.95,109.81,109.92999,365136640,302181491.2,35.83228192872866,45.42764221558337,NaN,NaN,-165.577696043529,-82.31273338910523,-0.5272723664146368,-1.8183254349503386,-1.2910530685357018,2590117773,2993534195.4,52.35140709107215,52.52706676229874,NaN,NaN,-13.656289613355236,-9.483010819652547
2011-10-04T09:30:00-04:00,108.35001,112.58,107.42999,112.34,459177472,310883225.6,41.3337730057615,44.84252491803262,NaN,NaN,-153.04337610809543,-110.39407245951058,-0.5017770445908478,-1.9182743742742616,-1.4164973296834138,3049295245,2956887693,51.049205133748345,53.230676536780365,NaN,NaN,-14.274632161029244,-10.167528154134931
2011-10-05T09:30:00-04:00,112.62,114.72,111.58,114.42,284108032,314598471.2,45.66372289680107,44.28692058710825,NaN,NaN,-73.9509600432572,-113.40022222683055,-0.31383841246351585,-1.8087953452628085,-1.4949569327992926,3333403277,3034402137.8,53.674081293058386,53.67230543718269,NaN,NaN,-13.38635190623,-10.627360118719942
2011-10-06T09:30:00-04:00,114.36,116.66,113.50999,116.49001,257800752,314960099.2,49.64677336625446,44.0035870036698,NaN,NaN,-19.695654192262232,-104.90536574565002,-0.03385775137434566,-1.5372791220172246,-1.503421370642879,3591204029,3103854947.4,55.95314186291978,53.63611377724122,NaN,NaN,-11.35785827031502,-10.73171699751924
2011-10-07T09:30:00-04:00,117.17,117.245,115.06,115.71001,312657920,311583241.6,48.212626705107915,43.80956618430216,NaN,NaN,-6.7330604792892865,-83.80014937328663,0.1073322100244094,-1.369256108112367,-1.4765883181367765,3278546109,3168513286.6,58.02355444021464,53.42148937461928,NaN,NaN,-10.161339580911653,-10.65023450943244
2011-10-10T09:30:00-04:00,117.67999,119.63,117.67,119.58,230666192,307826874.4,55.13714227055438,44.13269081340384,NaN,NaN,64.79735793571122,-37.725138577438585,0.45063630535579446,-0.9132929364420335,-1.363929241797828,3509212301,3352332192.2,63.304429789563805,53.438316903352316,NaN,NaN,-6.821911491634146,-10.10333122117554
2011-10-11T09:30:00-04:00,118.87,120.03999,118.75,119.7,209087936,304655543.2,55.3365645719526,44.99192294890777,NaN,NaN,72.53621854435973,7.390780353052437,0.6622823638404336,-0.5360762869972859,-1.1983586508377195,3718300237,3486133190.6,66.59841187688484,53.77803565214743,NaN,NaN,-4.132964836787947,-9.2504217376916
2011-10-12T09:30:00-04:00,120.60001,122.14,120.33,120.75,281544704,302763306.4,57.132170460621154,46.41879476735308,NaN,NaN,103.9661840019949,42.974209162102866,0.8381538312325695,-0.15066636179700765,-0.9888201930295771,3999844941,3619421523.4,69.53243051222496,54.82647933216297,NaN,NaN,-1.3676955094569825,-8.12431799080094
2011-10-13T09:30:00-04:00,120.03999,120.87,119.12,120.50999,212538816,297051392.8,56.572300129442496,47.68515252786475,NaN,NaN,84.45886178312405,63.80511235718011,0.8981472584385033,0.1338638800185521,-0.7642833784199512,3787306125,3658641942.6,70.35754589994879,56.350360783638244,NaN,NaN,0.730039055037124,-6.859409841395502
2011-10-14T09:30:00-04:00,121.91,122.60001,121.23,122.57001,211397568,293394864.8,60.17927164859096,48.75926876712757,NaN,NaN,127.7870491800102,90.70913428904001,1.027101102429905,0.51959299961743,-0.5075081028124749,3998703693,3802673459.4,73.22523777158817,58.264821668412004,NaN,NaN,3.6247798858925857,-5.3616684517829185
2011-10-17T09:30:00-04:00,121.99001,122.54919,119.92999,120.23,202311568,291434596,54.62881604076971,49.23828746491029,NaN,NaN,96.41979443824529,97.03362158954683,0.9093774195877318,0.6292136716721899,-0.28016374791554194,3796392125,3860109424.2,74.29325082122003,60.23321217660338,NaN,NaN,4.532242788100125,-3.9482525603710554
2011-10-18T09:30:00-04:00,120.14,123.5,119.2,122.58,318857984,296430888.8,58.744124099796714,50.3240717652814,NaN,NaN,112.61611102126173,105.04960008492723,0.9404451382419702,0.8953926748869208,-0.045052463355049394,4115250109,3939499398.6,75.73408509688703,62.26667190517939,NaN,NaN,6.574244116144181,-2.4450387494403074
2011-10-19T09:30:00-04:00,122.38,123.08,120.71001,121.13,226601248,291948394.4,55.40482986764383,51.02674569169134,NaN,NaN,98.8688510860367,104.0301335017356,0.8184932164272033,0.9780640571789547,0.15957084075175143,3888648861,3917260182.6,74.47482666751259,63.804333171825796,NaN,NaN,7.288004642960464,-1.05460397909734
2011-10-20T09:30:00-04:00,121.42999,122.10001,119.82001,121.66,262075632,279356176,56.38085269880861,52.15751783505956,NaN,NaN,80.52639065800956,103.2436392767127,0.7315179324616365,1.073968256328797,0.34245032386716057,4150724493,3989943856.2,75.88604438534323,65.31840376015616,NaN,NaN,8.154526099807866,0.26098603217483207
2011-10-21T09:30:00-04:00,123.09,124.12,122.72,123.97,278999296,277944016,60.44436268656809,53.915523603476665,NaN,NaN,118.01690622718236,101.28961068614713,0.7829528798516844,1.321141423681766,0.5381885438300816,4429723789,4076147875.4,77.47655121979254,67.11305691220761,NaN,NaN,10.125482620841362,1.6701998305557648
2011-10-24T09:30:00-04:00,124.17,125.8,124.06,125.49001,203215568,275071112.8,62.893924127075955,55.45553439785626,NaN,NaN,132.070706626682,108.41979312383447,0.8662445496416635,1.620994230882161,0.7547496812404975,4632939357,4243457321.8,80.2054661193774,69.19564698260969,NaN,NaN,12.530515728957695,3.221673530327469
2011-10-25T09:30:00-04:00,124.89,124.95,122.78,123.049,268596736,272913263.2,56.80963622822549,56.251671064386585,NaN,NaN,91.79315594176441,104.25520210793499,0.7103797196143657,1.6427243307584547,0.932344611144089,4364342621,4293275824.2,80.94575583744043,71.14362373577983,NaN,NaN,12.786786456184984,4.5881182340214
2011-10-26T09:30:00-04:00,124.35001,124.77,122.21001,124.3,289053696,273031112.8,58.998760824604915,56.919670168554475,NaN,NaN,87.24409130393882,101.93025015151542,0.6467832745928033,1.7408237043850932,1.0940404297922899,4653396317,4446225315.4,83.04256390547872,73.07858245310547,NaN,NaN,13.654233625897222,5.883277575717946
2011-10-27T09:30:00-04:00,127.63,129.42,124.3187,128.63,390025728,277626952.8,65.51414320631446,58.155492775783515,NaN,NaN,140.64647909297557,113.95426783850863,0.839373133474314,2.1432568466351825,1.3038837131608685,5043422045,4624764825.8,85.10332348071356,75.01285167028398,NaN,NaN,16.583098977792222,7.4118234902999856
2011-10-28T09:30:00-04:00,128,128.85001,127.8,128.60001,225906496,274487999.2,65.43658338587252,58.891167141163386,NaN,NaN,146.66875418558303,119.68463743018874,0.9022822486192947,2.431736523934987,1.5294542753156921,4817515549,4702323177.8,85.90467165304838,76.62715466053287,NaN,NaN,18.85667594865474,9.046802412922093
2011-10-31T09:30:00-04:00,127.16,128.6239,125.32001,125.5,228146624,267638498.4,57.81704078798575,59.06834401373718,NaN,NaN,108.2730876198882,114.92511362882999,0.682634198124408,2.382747022971202,1.700112824846794,4589368925,4693609091.4,85.34913977579282,77.96649236759772,NaN,NaN,18.442787313727276,10.389085970179975
2011-11-01T09:30:00-04:00,122.03,123.50999,121.52,122.002,416565760,265507912.8,50.65015536657597,58.6053429355911,NaN,NaN,16.22185438582662,99.81085331764243,0.2704444505635055,2.038168388051176,1.7677239374876703,4172803165,4655301200.2,82.81374441717205,78.91515764652252,NaN,NaN,15.679670585162972,11.144883772320403
2011-11-02T09:30:00-04:00,123.83,124.39999,122.7905,123.99001,245529376,263578980,54.13020057376051,58.430907253042385,NaN,NaN,41.57876710966673,90.67778847878803,0.10866890938480323,1.9035600742186745,1.7948911648338712,4418332541,4608288445,79.68524140568582,79.58142161121802,NaN,NaN,14.528029172611104,11.628190258076218
2011-11-03T09:30:00-04:00,125.27,126.5,123.595,126.25,291174912,265247688,57.77552349265407,58.25921095618975,NaN,NaN,78.5654631354374,78.2615852872804,0.12943813240626656,1.9566888303417045,1.827250697935438,4709507453,4541505526.6,75.33166571546946,79.73188075006668,NaN,NaN,14.75019803256225,12.07419136871708
2011-11-04T09:30:00-04:00,125.23,125.7,124.00999,125.481,249401504,262084867.2,56.14062455931278,58.36719727894282,NaN,NaN,60.373274999778374,61.002489450119455,0.0699360389448791,1.9146707466165367,1.8447347076716576,4460105949,4470023606.6,70.86855864745758,79.48725988051221,NaN,NaN,14.416959513337668,12.408872532234307
2011-11-07T09:30:00-05:00,125.39,126.39,124.2,126.25999,196617184,260382416.8,57.454020805862946,58.27504704366184,NaN,NaN,71.0383755517452,53.55554703649085,0.06187034452140483,1.9220726383234137,1.8602022938020089,4656723133,4483494448.2,71.21466866661302,79.16444442120692,NaN,NaN,14.537199204612724,12.712919199716938
2011-11-08T09:30:00-05:00,126.92,128.02,125.71001,127.88,224426192,261149329.6,60.128079748585414,58.61242203515767,NaN,NaN,111.59216278450657,72.62960871622684,0.1399977221495381,2.0351994464889316,1.8952017243393935,4881149325,4625163680.2,74.62865087445277,79.1754318645598,NaN,NaN,15.435573661600694,13.101869837128902
2011-11-09T09:30:00-05:00,124.89,125.8,122.86,123.161,337981952,263971192,50.22539832673524,58.17274672286673,NaN,NaN,-1.335213118540249,64.04681267058545,-0.13680621097652734,1.7241939606187344,1.8610001715952618,4543167373,4650130646.6,75.18717401463391,79.12551255236629,NaN,NaN,13.02285828397856,13.09058247239314
2011-11-10T09:30:00-05:00,124.78999,124.94,123.02,124.32001,231866496,264937576,52.303119833622965,57.59122937622778,NaN,NaN,-3.1153445636840087,47.71065113076117,-0.24613101882515354,1.55333639806382,1.7994674168889735,4775033869,4663235929.8,75.49215173183242,78.9837697317977,NaN,NaN,11.720943549392548,12.894919769107341
2011-11-11T09:30:00-05:00,125.83,126.99001,125.78999,126.66,189924320,263863913.6,56.27185482239757,57.118224425893615,NaN,NaN,78.40100797643903,51.31619772609331,-0.16882380148714482,1.5884376650300425,1.7572614665171873,4964958189,4764206377.8,77.76021431332009,78.8091088885079,NaN,NaN,11.871676403103598,12.748742145392521
2011-11-14T09:30:00-05:00,126.19,127.45,124.92,125.46001,159258256,261711248,53.79962040993804,56.903223296015945,NaN,NaN,51.6031498439674,47.429152584537746,-0.20412028847042185,1.5021111059291599,1.7062313943995817,4805699933,4794001737.8,78.39559100414019,78.62695425755787,NaN,NaN,11.231112422955322,12.531937899330064
2011-11-15T09:30:00-05:00,125.17,126.75,124.72,126.08299,184709376,255003817.6,54.90722946398677,56.61097105597179,NaN,NaN,42.449793005875286,33.600678628811494,-0.19134137761727854,1.4670546723779836,1.6583960499952621,4990409309,4815853734.6,78.8723286930321,78.32908031381169,NaN,NaN,11.036061861362874,12.318241322477608
2011-11-16T09:30:00-05:00,124.81,126.34,123.89999,124.08,235782432,255462876.8,50.69872894734642,55.55272718033122,NaN,NaN,-11.027683691681219,31.6621845141833,-0.3162467953498558,1.2630875558079424,1.5793343511577982,4754626877,4858145635.4,79.80131835411973,77.95036566191213,NaN,NaN,9.607622108051016,11.931010006130952
2011-11-17T09:30:00-05:00,123.85001,124.16,121.23,122.105,331219712,258920080.8,46.88292903818054,54.227466155496074,NaN,NaN,-128.84573135058508,6.516107156803085,-0.5183952876303017,0.931340241619921,1.4497355292502228,4423407165,4787820294.6,73.97637608509825,77.0983445499157,NaN,NaN,7.22469401973446,11.258679150931453
2011-11-18T09:30:00-05:00,122.5,122.75,121.47,121.979,215580368,255749134.4,46.64174340973196,53.429230628477946,NaN,NaN,-137.94475852854242,-36.753046144193206,-0.6391808964704779,0.6507594086621253,1.2899403051326033,4207826797,4636394016.2,63.267659713082004,75.52109597400776,NaN,NaN,5.228531254956336,10.397229451506437
2011-11-21T09:30:00-05:00,120.2,120.35001,118.64999,119.661,229611632,257068937.6,42.32766016650655,52.83476668561584,NaN,NaN,-204.06238624779462,-87.88615336254561,-0.841069541559375,0.2386033781833845,1.0796729197427595,3978215165,4470897062.6,54.057380450250704,73.46706997637054,NaN,NaN,2.1843721559633593,9.223964123571712
2011-11-22T09:30:00-05:00,119.39999,120.10001,118.52,119.19,216494816,254463841.6,41.48795290140176,51.93174899473308,NaN,NaN,-181.1854332757746,-132.6131986188756,-0.963420469474031,-0.1246026670997793,0.8388178023742517,3761720349,4225159270.6,43.849753001201066,70.90739223319306,NaN,NaN,-0.5663726363194341,7.825344586444405
2011-11-23T09:30:00-05:00,118.07001,119.19,116.56,116.56,224531632,251237738.4,37.06613842675253,50.45250720431153,NaN,NaN,-197.96932507812477,-170.0015268961643,-1.1650913654013726,-0.6175464043774639,0.5475449610239087,3537188717,3981671638.6,36.49606086002662,68.13342045780429,NaN,NaN,-4.358776701576146,6.084755831012898
2011-11-25T09:30:00-05:00,116.38,117.7,116.2,116.34,99557008,236714302.4,36.71363968777916,49.06486542777342,NaN,NaN,-179.5867239015743,-180.14972540636214,-1.2494505102899942,-1.0142681768385842,0.2351823334514101,3437631709,3784516547.4,31.839920707832263,65.34566060497392,NaN,NaN,-7.555975267687461,4.13607995976999
2011-11-28T09:30:00-05:00,119.53999,120.17999,118.82001,119.71001,210686000,235953277.6,45.295756698434865,48.196417991528556,NaN,NaN,-92.65404633123563,-171.09158296690077,-1.023904874829047,-1.0446987600848985,-0.02079388525585163,3648317709,3672614729.8,29.536600151026974,62.36865571100348,NaN,NaN,-7.919118494025663,2.4139087520848967
2011-11-29T09:30:00-05:00,120.05,121,119.61,120.05,199241504,234508021.6,46.09003554194934,47.193700548197405,NaN,NaN,-67.67448520910251,-143.81400275916235,-0.8069755132020222,-1.0295132767583794,-0.2225377635563572,3847559213,3646483539.4,29.008860396046074,59.110099248260134,NaN,NaN,-7.9839412601550475,0.9285016074791905
2011-11-30T09:30:00-05:00,123.49001,125.22,119.9971,124.99001,324439552,229901711.2,56.07057220039277,47.61121296774437,NaN,NaN,11.632557348875963,-105.25040463423224,-0.3114166703409321,-0.6118086014825224,-0.30039193114159024,4171998765,3728539222.6,33.05386456772359,56.1005771449094,NaN,NaN,-4.776215043681455,0.11354208588481263
2011-12-01T09:30:00-05:00,124.85001,125.64,124.42999,124.97,176954752,226472980,56.025326929571754,47.87708490316928,NaN,NaN,50.00497189485978,-55.655545239635345,0.016976612688597736,-0.27917116528084307,-0.2961477779694408,3995044013,3820110281.8,37.344376714881825,53.37573607227007,NaN,NaN,-2.2701091375721147,-0.22697951746617695
2011-12-02T09:30:00-05:00,126.12,126.5,124.78,124.86,221109680,222969718.4,55.75895826390419,47.84044943470546,NaN,NaN,59.301209525278196,-7.877958554264845,0.21759719810890168,-0.024151280333313707,-0.2417484784422154,3773934333,3887370806.6,40.367483303636554,50.70482671443553,NaN,NaN,-0.3239898503461009,-0.24083813644902322
2011-12-05T09:30:00-05:00,126.84,127.17999,125.44,126.22,225263872,221762836.8,58.39284823851715,48.16853713674682,NaN,NaN,78.82741351524881,26.418333415032038,0.42093148722080714,0.2844158805837935,-0.13651560663701362,3999198205,3957546905.8,43.434115180731546,48.20757844133491,NaN,NaN,2.1115177100317872,0.09521269876252111
2011-12-06T09:30:00-05:00,126.21001,127.11,125.75999,126.25999,178842064,220874080.8,58.471140613380015,48.42310221884634,NaN,NaN,79.37860639531839,55.82895173591622,0.530108211383181,0.5261196575919627,-0.003988553791218347,4178040269,4023643117,46.2384036604292,45.876583796148985,NaN,NaN,4.129160135810421,0.6714909040550783
2011-12-07T09:30:00-05:00,125.84,127.25999,124.97,126.73,237802496,221542896,59.437234674062104,49.04728119932603,NaN,NaN,80.10549358964205,69.52353898406945,0.6007802216350466,0.74698672325259,0.1462065016175433,4415842765,4072411917,48.27596498036647,43.6247728408809,NaN,NaN,6.09686357059485,1.4465441421321885
2011-12-08T09:30:00-05:00,125.89999,126.17999,123.64999,123.95,240862752,216686936,51.76644412973161,49.39610370586539,NaN,NaN,36.51323507366433,66.82519161983035,0.43483613437621077,0.6897516695878068,0.254915535211596,4174980013,4108399117,49.788253079245784,41.8970497690343,NaN,NaN,5.749414384970314,2.0612398911090635
2011-12-09T09:30:00-05:00,124.50999,126.37,124.39999,126.05,209111312,215549176.8,56.349259169300225,50.0894976886917,NaN,NaN,58.056266882113434,66.5762030911974,0.4397238443985873,0.8045703407098301,0.36484649631124283,4384091325,4230430515.4,54.63218685323179,41.280230279044986,NaN,NaN,6.796719110228731,2.737736922411873
2011-12-12T09:30:00-05:00,124.95,124.97,123.16,124.21001,215826064,216844264,51.71303988720603,50.759881954455935,NaN,NaN,26.19367787049208,56.04945596224604,0.29898621670569264,0.7385792671933586,0.439593050487666,4168265261,4264243926.6,55.901642014361684,41.411963247910066,NaN,NaN,6.310994944540135,3.2482023541444818
2011-12-13T09:30:00-05:00,124.86,125.57001,122.45,123.05,245159680,221139335.2,48.97714040851847,51.29482391924999,NaN,NaN,19.17451877919274,44.00863843902091,0.11706443254221877,0.5859235911654395,0.4688591586232207,3923105581,4213256989,53.47195566575973,42.099263438235674,NaN,NaN,5.085851252525238,3.5107236253417327
2011-12-14T09:30:00-05:00,122.56,123.03,121.47,121.74001,238618816,223834807.2,46.016378812556376,51.934126803950264,NaN,NaN,-17.63957280857994,24.45962515937651,-0.0909723292308195,0.3551437470846963,0.4461160763155158,3684486765,4066985789,47.14177430377415,42.8596715413605,NaN,NaN,3.1619134015714674,3.4608935933745517
2011-12-15T09:30:00-05:00,123.03,123.2,121.99001,122.185,199109120,222001141.6,47.18436965035716,52.682036086991545,NaN,NaN,-4.786244135148021,16.199729317614043,-0.19226575423489023,0.20578388352190302,0.39804963775679325,3883595885,4008708963.4,44.86300584682629,43.7898919084315,NaN,NaN,1.9053820547220384,3.2386776592813353
2011-12-16T09:30:00-05:00,122.23,122.95,121.3,121.59,220481312,216464221.6,45.75875222974846,52.71510719637109,NaN,NaN,-17.791364800985715,1.0302029809942135,-0.28727607464457616,0.03895454445107305,0.3262306190956492,3663114573,3864513613,39.743788270142346,44.5189767740826,NaN,NaN,0.45086950901602135,2.840419352100576
2011-12-19T09:30:00-05:00,122.06,122.32001,120.03,120.28999,183902944,214880350.4,42.721598721579504,52.474504566344685,NaN,NaN,-43.911321014879164,-12.990796796080037,-0.4177049997094592,-0.1959006305411748,0.2218043691682844,3479211629,3726702886.6,35.56668633592875,44.98739291264565,NaN,NaN,-1.6772959049179108,2.195031458240792
2011-12-20T09:30:00-05:00,122.17999,124.14,120.37019,123.92999,225418064,214670672,52.273531251865755,52.203287355735604,NaN,NaN,2.90215915032928,-16.245268721852728,-0.24728438860107813,-0.08730111658306328,0.15998327201801485,3704629693,3683007709,34.3345128120027,45.078867787237016,NaN,NaN,-0.7357663092442599,1.7763460628857848
2011-12-21T09:30:00-05:00,123.92999,124.36,122.75,124.17,194230880,213557475.2,52.83207826834205,51.97519816564777,NaN,NaN,24.729498042518376,-7.771454551633063,-0.11364665434566995,0.017924954085927425,0.13157160843159738,3898860573,3725882470.6,36.65352903023622,45.02952152404805,NaN,NaN,0.1878871914713397,1.5494233669694355
2011-12-22T09:30:00-05:00,124.63,125.39999,124.23241,125.27,119465312,208304159.2,55.40784722551028,51.950118805762486,NaN,NaN,55.85465649045674,4.35672557348789,0.04507235086563405,0.18791204701363995,0.1428396961480059,4018325885,3752828470.6,38.13232308092444,44.869867222425746,NaN,NaN,1.7306811757926273,1.575317339658463
2011-12-23T09:30:00-05:00,125.67,126.42999,125.41,126.39,92187184,207935668,57.927104855084025,51.916851421231556,NaN,NaN,90.4149715311593,25.99799283991689,0.21236512255476003,0.40829609934145594,0.1959309767866959,4110513069,3842308169.8,42.89928526917979,44.83166508588634,NaN,NaN,3.7850035076073665,1.890986792222592
2011-12-27T09:30:00-05:00,126.17,126.82001,126.06,126.49001,86075680,201705152,58.154443662477114,51.89423021045277,NaN,NaN,98.18877207737367,54.41801145836746,0.3106845994518627,0.5842867261015243,0.2736021266496616,4196588749,3985783593.8,49.60442711166987,45.072095332403535,NaN,NaN,5.529946567159082,2.4108381886420904
2011-12-28T09:30:00-05:00,126.50999,126.53,124.73,124.83,119107008,197698427.2,53.03217257498138,51.436725774804145,NaN,NaN,46.00290630147593,63.03816088859679,0.247590404244376,0.5830901319551316,0.3354997277107556,4077481741,4060354003.4,52.71246830100393,45.38898842673478,NaN,NaN,5.624792278753142,2.8699744872293835
2011-12-29T09:30:00-05:00,125.24001,126.25,124.8566,126.12,123507120,187651805.6,56.25662263026884,51.7574528105568,NaN,NaN,58.40681650109351,69.77362458031182,0.27433118626026853,0.6784137105360912,0.4040825242758227,4200988861,4120779661,55.12745435602615,45.770359946504804,NaN,NaN,6.63766743718206,3.408216337222623
2011-12-30T09:30:00-05:00,126.02,126.33,125.5,125.5,95599008,183584018.4,54.32620526551401,51.61294896028636,NaN,NaN,57.009757623742594,70.00464480696898,0.23346000147002915,0.6959075261133592,0.46244752464333,4105389853,4138192454.6,55.827540231865875,45.85574233069296,NaN,NaN,6.945307147196483,3.913515024361746
2012-01-03T09:30:00-05:00,127.75999,128.38,127.42999,127.495,193697808,182213424.8,59.18005042151019,52.1463068555938,NaN,NaN,133.57274712332728,78.63619992540258,0.31870456910604095,0.8608282360258812,0.5421236669198403,4299087661,4175907373,57.37859720659824,45.96123913013842,NaN,NaN,8.656395186706584,4.591069333268151
2012-01-04T09:30:00-05:00,127.2,127.81,126.71001,127.7,127186432,177309552.8,59.654521059272405,52.908976902076226,NaN,NaN,111.99562358135864,81.39757022619958,0.36356737558532626,0.9965828864014981,0.6330155108161718,4426274093,4221844441.8,59.25524457090196,46.374331194791445,NaN,NaN,10.192984342979674,5.391342906084082
2012-01-05T09:30:00-05:00,127.00999,128.23,126.42999,128.03999,173894944,177062196.8,60.47507085843649,53.941740619639084,NaN,NaN,112.41878096270203,94.68074515844481,0.388553996896036,1.1187080069362167,0.7301540100401808,4600169037,4326381901,63.2236571453475,47.52303711204668,NaN,NaN,11.704276544473426,6.293190568711132
2012-01-06T09:30:00-05:00,128.2,128.22,127.28999,127.71001,148049936,172574568.8,59.21626930803633,54.80116202375903,NaN,NaN,112.20928166836634,105.44123819189936,0.3561312570480142,1.1753180813501984,0.8191868243021843,4452119101,4376607949,64.9880804065618,48.96054243774207,NaN,NaN,12.648262903963142,7.201058045175705
2012-01-09T09:30:00-05:00,128,128.17999,127.41,128.02,99530128,165507937.6,60.057397123416855,55.822493801878196,NaN,NaN,104.24183877731761,114.88765442261437,0.3294547905693277,1.2310053125138438,0.9015505219445161,4551649229,4465859824.2,67.93233026441379,50.97400972304718,NaN,NaN,13.67105913499459,8.12534391514983
2012-01-10T09:30:00-05:00,129.39,129.64999,128.95,129.13,115281936,160816468.8,63.00003195687054,57.2709533186847,NaN,NaN,135.48410358293444,115.26992571453579,0.3580822764895275,1.3491533675564256,0.9910710910668981,4666931165,4539428525,70.15984332865257,53.44494950824174,NaN,NaN,15.374115497818591,9.160882712673938
2012-01-11T09:30:00-05:00,128.73,129.37,128.52,129.2,111540688,155602200,63.18423364202179,58.05028920369584,NaN,NaN,114.62545908479291,115.79589281522264,0.3526859959300521,1.4319285859794633,1.0792425900494111,4778471853,4609868077,72.15427674546174,56.146361217774526,NaN,NaN,16.853791286900986,10.25986965184923
2012-01-12T09:30:00-05:00,129.57001,129.7,128.53999,129.50999,118983632,149293397.6,64.03806025361038,58.85071648835786,NaN,NaN,110.23761784698493,115.35966019207925,0.34075891804869207,1.5051912376102763,1.1644323195615842,4897455485,4669325366.6,73.74918061935568,58.79605061699734,NaN,NaN,18.34635913532732,11.415082435203242
2012-01-13T09:30:00-05:00,128.64,129.05,127.72,128.84,179836128,146354263.2,60.75826649073556,59.23288929301681,NaN,NaN,81.09193070874349,109.13619000015467,0.2620470073689487,1.4919910787727702,1.2299440714038214,4717619357,4722425417.8,75.11976268383026,61.438010588633475,NaN,NaN,18.834251638436047,12.474963749950785
2012-01-17T09:30:00-05:00,130.08,130.32001,128.89571,129.34,132209184,143009266.4,62.30966967317885,59.545929637166445,NaN,NaN,103.68075847227468,109.02397393914607,0.21967063610506998,1.5045323665351589,1.2848617304300889,4849828541,4782061280.2,76.59757822776086,63.84503151424641,NaN,NaN,19.65523090494651,13.50071620066446
2012-01-18T09:30:00-05:00,129.31,130.84,129.08,130.77,163395120,140154956.8,66.40090776566345,60.134962787394066,NaN,NaN,118.10607879022733,105.54836898060466,0.26113986995189165,1.6112865678699535,1.3501466979180619,5013223661,4851319779.4,78.21586778508365,65.88870584806168,NaN,NaN,21.52710789351585,14.647343585357515
2012-01-19T09:30:00-05:00,131.22,131.57001,130.8,131.46001,126328816,137276250.4,68.19491973879936,61.218016156238214,NaN,NaN,149.87886933229052,112.59905103010419,0.30516839532466644,1.731607192073895,1.4264387967492285,5139552477,4923535904.2,79.78552118470493,67.82249533975461,NaN,NaN,23.648607104046402,15.933238373741641
2012-01-20T09:30:00-05:00,131.24001,131.95,130.92,131.53999,138230128,132916853.6,68.40550111666829,62.08579319098103,NaN,NaN,148.68271385901886,120.28807023251098,0.30886675702963307,1.8125222430362697,1.5036554860066367,5277782605,4999601328.2,81.31288843096075,69.69288348796422,NaN,NaN,25.48164322699761,17.297296209921065
2012-01-23T09:30:00-05:00,131.50999,132.25,130.98,131.61,129295744,129670096.8,68.60147404781281,63.10545524685953,NaN,NaN,137.1189030778704,131.49346470633637,0.28575284731601824,1.8608465451516594,1.5750936978356411,5407078349,5137493126.6,83.71505466655785,71.68484880472793,NaN,NaN,27.083907675808366,18.695383562190678
2012-01-24T09:30:00-05:00,130.8,131.5,130.60001,131.46001,103083248,128850993.6,67.63356663015733,63.70927783319146,NaN,NaN,108.39378638736352,132.43607028935412,0.23235402007759332,1.8655362229326329,1.6331822028550396,5303995101,5228326438.6,85.07599091625883,73.66323406970368,NaN,NaN,28.222651982417595,20.05642190793738
2012-01-25T09:30:00-05:00,131.25999,132.87,130.75,132.56,198613184,134172293.6,70.87863071243729,64.51099995127467,NaN,NaN,127.16037352243482,134.24692923579562,0.24201366961885884,1.9356992898786132,1.6936856202597543,5502608285,5326203363.4,86.39533805888236,75.601812175988,NaN,NaN,30.1316402430721,21.495738812956628
2012-01-26T09:30:00-05:00,133.14999,133.39999,131.36,131.88,184880496,139112534.4,66.44369749894656,64.93733042559681,NaN,NaN,119.87463022969632,128.2460814152768,0.17654437444297377,1.9143660883134714,1.7378217138704977,5317727789,5361838425.8,86.85110693128686,77.28948716069796,NaN,NaN,30.63758525039378,22.80171687544765
2012-01-27T09:30:00-05:00,131.24001,132.05,131.14999,131.82001,135259056,139920136.8,66.0510470446814,65.42552883535717,NaN,NaN,90.69661393487715,116.64886143044843,0.10658293024686527,1.8710503766790794,1.764467446432214,5182468733,5342775651.4,85.20664568550387,78.7336703949081,NaN,NaN,30.962107575716924,23.967486975486118
2012-01-30T09:30:00-05:00,130.50999,131.44,130.06,131.37,147311744,141110368,63.04146230261657,65.63867634815715,NaN,NaN,55.35535062771953,100.29615094041826,0.012340299283158274,1.779892820536162,1.7675525212530037,5035156989,5268391379.4,78.92675311413497,79.51898631274534,NaN,NaN,30.463068089544205,24.895427134637274
2012-01-31T09:30:00-05:00,132.02,132.17999,130.67999,131.32001,157211936,144191014.4,62.699689174534875,65.61722329227602,NaN,NaN,66.04723650746529,91.82684096443863,-0.06668073885598025,1.6842015976830282,1.7508823365390085,4877945053,5183181369.8,72.34861277495622,79.67532698748131,NaN,NaN,29.952147738771686,25.61781579237076
2012-02-01T09:30:00-05:00,132.28999,133.14,132.13,132.47,166234432,142817845.6,67.11628915361345,65.89808440024687,NaN,NaN,107.65727918488561,87.92622209692878,-0.055286864988717044,1.6817737553031122,1.7370606202918293,5044179485,5091495609.8,65.97675856212483,79.23407568867152,NaN,NaN,30.644536251895772,26.335918715160048
2012-02-02T09:30:00-05:00,132.73,133.02,132.21001,132.67999,113090368,142113042.4,67.864543624167,66.17140464100092,NaN,NaN,101.78273891487494,84.30784383396451,-0.04768255563926771,1.6774574257427446,1.7251399813820123,5157269853,5059404022.6,63.85685011321457,78.5274806525186,NaN,NaN,31.430803056850486,27.06375933540154
2012-02-03T09:30:00-05:00,134,134.62,133.77,134.53999,160598496,141448220,73.59569906358645,67.08836411049028,NaN,NaN,164.1995890360213,99.00843885419334,0.06255635929013748,1.803335430494684,1.7407790712045466,5317868349,5086483945.8,64.88225106238883,77.79622982241564,NaN,NaN,33.91536904294366,28.04256072219327
2012-02-06T09:30:00-05:00,133.98,134.5134,133.83,134.45,107694432,139430444.8,72.91812125035632,67.84611065171724,NaN,NaN,153.53103038531484,118.64357480571239,0.10675936568806854,1.8742282783146322,1.7674689126265637,5210173917,5121487331.4,66.2164491628435,77.05472060349295,NaN,NaN,35.74919287982092,29.14350817328293
2012-02-07T09:30:00-05:00,134.17,135.02,133.64,134.78999,135528064,141230341.6,73.89596824682278,68.38147211465719,NaN,NaN,154.25873892097067,136.28587528841348,0.1344521422079581,1.9355340903865113,1.8010819481785532,5345701981,5215038717,69.54653354474692,76.43548244346891,NaN,NaN,37.57609669463628,30.34816367633341
2012-02-08T09:30:00-05:00,134.86,135.22,134.31,135.19,139361376,142434313.6,75.03795651067188,68.87026045550522,NaN,NaN,153.4716684927338,145.44875314998313,0.15386881794464324,1.9934179706093573,1.839549152664714,5485063357,5303215491.4,72.31641359961066,75.90197475881932,NaN,NaN,39.458323313511336,31.649615053073113
2012-02-09T09:30:00-05:00,135.41,135.59,134.56,135.36,148602816,144287420,75.5279465154181,69.37900655541593,NaN,NaN,143.925812786939,153.87736792439594,0.1520509408032258,2.0296128286687463,1.8775618878655205,5633666173,5398494755.4,74.96602901718651,75.44862765783544,NaN,NaN,41.176082907461314,33.010539032271424
2012-02-10T09:30:00-05:00,134.16,134.47,133.84,134.36099,167907504,146733613.6,67.18217069029544,69.27762774416468,NaN,NaN,90.22142075614859,139.08173426842137,0.06206891139278614,1.9551480271065032,1.893079115713717,5465758669,5428072819.4,75.74221824026164,74.87913934167143,NaN,NaN,40.355775677833115,34.05985855306595
2012-02-13T09:30:00-05:00,135.32001,135.52,134.74001,135.36,115841808,143533897.6,70.67215786662791,69.49466997534114,NaN,NaN,119.935516283515,132.36263144806142,0.04891180709022436,1.9542188745764975,1.905307067486273,5581600477,5502358131.4,77.61908559750479,74.34650324747471,NaN,NaN,40.6430024249787,35.00030767762492
2012-02-14T09:30:00-05:00,135,135.27,134.25,135.19,165996128,145223244.8,69.32119384844026,69.38342448505564,NaN,NaN,93.25857843756852,120.16259935138098,0.009881827566064816,1.917659351943854,1.9077775243777892,5415604349,5516338605,77.96463203436412,73.74430996000912,NaN,NaN,40.48810811031312,35.78427916800894
2012-02-15T09:30:00-05:00,135.63,135.83,134.28999,134.56,195195120,146813244.8,64.40749905630966,69.23798173915301,NaN,NaN,82.51966658333494,105.9721989695012,-0.07269740092551502,1.8169057732208955,1.8896031741464105,5220409229,5463407779.4,73.34736915345098,72.77975726159228,NaN,NaN,38.911720000140065,36.23105642974196
2012-02-16T09:30:00-05:00,134.57001,136.17,134.33,136.049,186567744,149825191.2,69.84755652364717,69.50916098765057,NaN,NaN,98.94522483909199,96.9760813799318,-0.04284819365596659,1.8360429320764524,1.878891125732419,5406976973,5418069939.4,69.54802520197818,71.66128436991187,NaN,NaN,39.13908574533396,36.646489189112245
2012-02-17T09:30:00-05:00,136.52,136.6275,135.96001,136.41,129869376,149407153.6,71.00465532956508,70.07796048957546,NaN,NaN,121.31014797275259,103.19382682325258,-0.0159844308063124,1.8589105872245284,1.8748950180308408,5536846349,5432287475.4,70.07157278581847,71.02877148931783,NaN,NaN,39.67823283142631,37.07959542372854
2012-02-21T09:30:00-05:00,136.73,137.05,136.05,136.47,134042256,149644479.2,71.20245797064604,70.68530111786912,NaN,NaN,118.55368955409868,102.9174614773693,-0.01157281457820969,1.8604289998080787,1.8720018143862884,5670888605,5450145101,70.75175392636655,70.91471014299,NaN,NaN,40.170739548371984,37.52118744153475
2012-02-22T09:30:00-05:00,136.25999,136.55,135.78999,136.032,124455248,150713079.2,67.57820894189707,70.7182953884608,NaN,NaN,96.0306651796871,103.47187882579303,-0.05321985289048792,1.8054769982731784,1.8586968511636663,5546433357,5476310902.6,71.76434382438194,71.32810909029408,NaN,NaN,39.54018033470613,37.80961499770209
2012-02-23T09:30:00-05:00,135.96001,136.73,135.5,136.631,137704256,147667632.8,69.83922156311785,70.85934381267158,NaN,NaN,98.43331000025029,106.65460750917609,-0.055252140808575545,1.7896316751529469,1.8448838159615224,5684137613,5569056579.4,75.06021871019978,72.12834970436445,NaN,NaN,39.6434598150148,38.071592828746766
2012-02-24T09:30:00-05:00,136.92999,137.2,136.63,136.92999,105539056,143700560.8,70.92900548759252,70.66886570010058,NaN,NaN,119.5954138862942,110.78464531861653,-0.051368141270596857,1.7806736393732763,1.8320417806438731,5789676669,5645596518.6,77.40432486855872,73.02278354766231,NaN,NaN,40.038373880502434,38.352561550426145
2012-02-27T09:30:00-05:00,136.02,137.53,135.8,137.16,145728816,144224048.8,71.7739396217401,70.5871384409137,NaN,NaN,108.57925023581149,108.2384657712283,-0.048264597111991936,1.771711034253883,1.819975631365875,5935405485,5725308345.8,79.55910910718916,73.97583068654413,NaN,NaN,40.60412371119116,38.67421328767829
2012-02-28T09:30:00-05:00,137.2,137.72,136.92999,137.55901,129355808,143326252,73.22762877520414,70.53939990722667,NaN,NaN,132.5358628648721,111.034900433383,-0.03491773021346245,1.776328468599047,1.8112461988125095,6064761293,5804082883.4,81.44252068120359,74.8255440534339,NaN,NaN,41.49415787355024,39.07706251423143
2012-02-29T09:30:00-05:00,137.75999,138.19,136.53999,137.02,185934688,144762389.6,68.1235618900003,70.0455145771787,NaN,NaN,114.3865618193349,114.70607976131255,-0.07563287232912708,1.7167051084011007,1.7923379807302278,5878826605,5870561533,82.87642710829235,75.57983073262547,NaN,NaN,40.83460278397055,39.32813969562273
2012-03-01T09:30:00-05:00,137.31,137.99001,136.9312,137.73,145026128,143701974.4,70.99175897724508,69.7215011815949,NaN,NaN,119.66709510929387,118.95283678312126,-0.06821739641152669,1.7070662352158195,1.7752836316273461,6023852733,5938504557,84.2185608595946,76.24072586422604,NaN,NaN,41.07219551381363,39.57729052679286
2012-03-02T09:30:00-05:00,137.64,137.82001,137,137.312,120638256,144079368.8,67.16038123077806,69.71994479162937,NaN,NaN,99.97333197338594,115.0284204005396,-0.10285415659776631,1.6467159358801382,1.7495700924779045,5903214477,5961212118.6,84.65154926557503,76.8771066517484,NaN,NaN,40.16330900266789,39.66100745191786
2012-03-05T09:30:00-05:00,137.10001,137.2,136.28,136.75,140765008,143087694.4,62.292629535965084,69.12140705372488,NaN,NaN,53.50830849932792,104.01423205324288,-0.17098804564477188,1.5358350354219397,1.7068230810667115,5762449469,5926620915.4,81.00548804567717,77.11899254090359,NaN,NaN,37.939802634220385,39.41512104938965
2012-03-06T09:30:00-05:00,135.35001,135.42999,134.36,134.75,202129808,147809463.2,48.750848032844054,67.65209663832515,NaN,NaN,-78.1548459241773,61.876090295433,-0.34792567929120755,1.2719159819527022,1.6198416612439097,5560319661,5825732589,71.35257040068394,76.64670242421214,NaN,NaN,31.077922594865935,38.224092698743405
2012-03-07T09:30:00-05:00,135.06,135.91,134.92999,135.69,143692128,148217666.4,53.83095198517649,66.89662899038707,NaN,NaN,-37.97609517887894,31.403558895790248,-0.39536710441722045,1.125632780722384,1.5209998851396045,5704011789,5790769625.8,68.314424870305,76.28720640398741,NaN,NaN,27.030910895222643,36.625066726811866
2012-03-08T09:30:00-05:00,136.52,137.32001,136.24001,137.03999,116968816,147098038.4,59.96825809456851,66.19096481688145,NaN,NaN,56.78164615189428,18.826469104310327,-0.3320901313086684,1.1058872210037691,1.4379773523124375,5820980605,5750195200.2,64.86280087606275,75.9525475235649,NaN,NaN,25.721937618357764,35.06747685417557
2012-03-09T09:30:00-05:00,137.3,137.92999,137.13,137.57001,122836752,145809735.2,62.09850338713572,65.55481110670793,NaN,NaN,99.4900833853655,18.729819386706232,-0.25430576386546067,1.1200951474806118,1.3744009113460725,5943817357,5758315776.2,65.24132487153133,75.60752981540152,NaN,NaN,25.41712890758479,33.68885571894831
2012-03-12T09:30:00-04:00,137.55,137.75999,137.09,137.58,104003504,142614535.2,62.13939841895478,64.90744971015855,NaN,NaN,88.98954640553337,25.82606696794732,-0.20411351322068216,1.1192590198202197,1.3233725330409019,6047820861,5815390054.6,67.86183381023194,75.40110694996334,NaN,NaN,25.19503442462251,32.47545267690177
2012-03-13T09:30:00-04:00,138.32001,140.13,138.09,140.062,184090432,146026966.4,70.6209136933157,65.12478576383131,NaN,NaN,217.67317081206545,84.99167031519593,-0.015623508436128919,1.3038431474957406,1.3194666559318695,6231911293,5949708381,73.0174935419127,75.49061764407267,NaN,NaN,28.10674439715718,31.85135149408111
2012-03-14T09:30:00-04:00,140.10001,140.44501,139.48,139.91,145163504,144985335.2,69.59271694910079,65.10717829140152,NaN,NaN,225.93833461710346,137.7745562743924,0.08160777449505163,1.421476374050684,1.3398685995556323,6086747789,6026255581,75.43596812514899,75.51745688799761,NaN,NaN,29.971902975587422,31.582858848582013
2012-03-15T09:30:00-04:00,140.12,140.78,139.75999,140.72,165118432,143481500.8,71.93746361963922,65.17921101511914,NaN,NaN,216.3819969178577,169.6946264275851,0.1777494259924286,1.562055382046168,1.3843059560537394,6251866221,6112432704.2,77.84367859149472,75.54883929677875,NaN,NaN,32.30401497145314,31.68588115184932
2012-03-16T09:30:00-04:00,140.36,140.48,140,140.3,152893376,141797782.4,68.96775817499268,64.97876948320861,NaN,NaN,174.89401254105454,184.7754122587229,0.1892673599861363,1.6208901560364097,1.4316227960502734,6098972845,6143463801.8,78.65499578868916,75.48425977402876,NaN,NaN,33.22059912375035,31.90512657640661
2012-03-19T09:30:00-04:00,140.21001,141.28,140.11,140.85001,125291008,141568864,70.67502678949268,64.79644076994352,NaN,NaN,163.9321429379842,199.76393156521306,0.20861339163145964,1.692389535589598,1.4837761439581383,6224263853,6178752400.2,79.57113045207525,75.35058904337674,NaN,NaN,34.516041346390395,32.27811440069001
2012-03-20T09:30:00-04:00,140.05,140.61,139.64,140.44,121729632,140953232.8,67.6855629945602,64.76515513455493,NaN,NaN,113.83801748822361,178.9969009004447,0.17011006654680627,1.6964137271416462,1.52630366059484,6102534221,6152876985.8,76.96269016958954,74.92817926204081,NaN,NaN,34.66526348571275,32.6191356985504
2012-03-21T09:30:00-04:00,140.52,140.64999,139.92,140.21001,122388368,140849888.8,65.99914656907433,64.40853996254273,NaN,NaN,98.53772158408108,153.51677829384022,0.10846703390581758,1.661887452977112,1.5534204190712944,5980145853,6131556598.6,74.78725852717915,74.25451480972542,NaN,NaN,34.29093298144411,32.85796388182093
2012-03-22T09:30:00-04:00,139.17999,139.55,138.74001,139.2,135216688,140725510.4,59.041998720913035,63.82865549755237,NaN,NaN,44.52642367466494,119.14566364520167,-0.014474361951505532,1.5353274666319123,1.5498018285834179,5844929165,6050169187.4,67.0015702309176,72.99380202153561,NaN,NaN,31.82837469286339,32.71087971196985
2012-03-23T09:30:00-04:00,139.32001,139.81,138.55,139.64999,120520944,141474604.8,61.01381101059871,63.73731131716905,NaN,NaN,46.471896302489725,93.4612403974887,-0.07618481403176713,1.454570811043709,1.5307556250754761,5965450109,6023464640.2,64.624303346045,71.82371740013332,NaN,NaN,30.359829528527094,32.375015400049456
2012-03-26T09:30:00-04:00,140.64999,141.61,140.60001,141.61,120163936,140196360.8,68.19588988316943,65.12624287790659,NaN,NaN,114.55525268221758,83.58586234633539,0.0002576563964302725,1.531077695571014,1.5308200391745836,6085614045,5995734678.6,62.158042424567775,71.1669654018393,NaN,NaN,31.363488069627405,32.230511495703446
2012-03-27T09:30:00-04:00,141.74001,141.83,141.08,141.17,119868432,139721992,65.28816750892946,65.9446154153175,NaN,NaN,105.43641767804951,81.90554238430056,0.006120842980887442,1.5384710929006928,1.5323502499198054,5965745613,5968376957,59.73593096502818,70.55421583717667,NaN,NaN,31.23443423981439,32.08821474486215
2012-03-28T09:30:00-04:00,141.10001,141.32001,139.64,140.47,148562000,137853357.6,60.84350291187298,66.00713290226784,NaN,NaN,64.87827428179111,75.17365292384257,-0.04916759936102477,1.4708907507185245,1.5200583500795493,5817183613,5935784509,56.89168387158803,69.98485033685705,NaN,NaN,29.70809830440932,31.748198110511744
2012-03-29T09:30:00-04:00,139.64,140.49339,139.09,140.23,164963632,138850232.8,59.35161920327093,65.81092688913462,NaN,NaN,39.85242899551151,74.23885398801187,-0.11041819824201671,1.3820356022770284,1.492453800519045,5652219981,5897242672.2,53.63920750568618,69.15612766786812,NaN,NaN,28.022479599571987,31.21595260894892
2012-03-30T09:30:00-04:00,140.92,141.05,140.05,140.81,135486688,139592654.4,61.78998788989721,65.78596899420195,NaN,NaN,64.0646512665328,77.75740498082051,-0.11961275399081694,1.342937858030524,1.462550612021341,5787706669,5861693984.2,50.75692518197755,67.93434848013565,NaN,NaN,27.33313734407402,30.661264713966794
2012-04-02T09:30:00-04:00,140.64,142.21001,140.36,141.84,151741056,140141456.8,65.72241152017986,65.4360759818351,NaN,NaN,95.25477839103318,73.89731012258363,-0.06670702621240321,1.379166829255837,1.4458738554682402,5939447725,5832460720.2,48.45125282862218,66.17961700061491,NaN,NaN,27.95221460825011,30.274257556007267
2012-04-03T09:30:00-04:00,141.64,141.8826,140.42999,141.25999,155806624,137825297.6,61.86152795533544,64.88384819656615,NaN,NaN,81.33676517823079,69.07737962261989,-0.08024648759114061,1.3455657459793144,1.425812233570455,5783641101,5796039817.8,45.66788101572798,64.0533250642277,NaN,NaN,27.28560000996552,29.847306478001304
2012-04-04T09:30:00-04:00,140.22,140.339,139.34,139.86,146895936,137985488,53.66649700617317,63.578779152747146,NaN,NaN,-3.26851873231112,55.448021019799455,-0.18686905533778675,1.1922259143982217,1.3790949697360084,5636745165,5759952128.2,43.030140686606984,61.56664378530714,NaN,NaN,24.019051890822567,29.014698679832915
2012-04-05T09:30:00-04:00,139.38,140.2,139.25999,139.78999,137439376,139009016,53.286337674573986,62.45867768843152,NaN,NaN,-24.230168724189852,42.63150147585916,-0.2609428507486251,1.052916406300227,1.313859257048852,5499305789,5729369289.8,40.87543969928709,58.868104064635574,NaN,NaN,21.324166734455936,27.916051259064776
2012-04-09T09:30:00-04:00,138.03,139.84441,137.84,138.22,127555872,139244972,45.502111451249284,60.660612307128424,NaN,NaN,-132.88622818121848,3.2413255863089034,-0.40586311331035585,0.8065303654109073,1.2123934787212631,5371749917,5646177939.4,35.646472982792176,55.73062853111535,NaN,NaN,16.310811442410124,26.25815985668554
2012-04-10T09:30:00-04:00,137.95,138.34,135.75999,135.89999,235360256,145812809.6,36.91928209890888,58.4630208145819,NaN,NaN,-290.9329071292105,-73.99621151773984,-0.6345310894088549,0.41922961696019456,1.0537607063690495,5136389661,5485566326.6,28.15738120222227,52.24453503344626,NaN,NaN,8.54083571325764,23.727113550481555
2012-04-11T09:30:00-04:00,137.28999,137.53999,136.75,137,154132944,144314935.2,42.46109640985342,56.78173151749469,NaN,NaN,-209.0665327301898,-132.07687109942395,-0.6839994454115204,0.1987613996046491,0.8827608450161695,5290522605,5386942627.4,24.72262304868343,48.668489642125145,NaN,NaN,4.211948892356895,20.939232885035175
2012-04-12T09:30:00-04:00,137.13,138.89999,137.03,138.78999,154321504,144772835.2,50.13765695696719,56.145707105784275,NaN,NaN,-106.63804224083816,-152.75077580112935,-0.5729638534715074,0.16655602817678528,0.7395198816482926,5444844109,5348562416.2,23.52020427735573,45.5626777882993,NaN,NaN,3.374184415533628,18.429940246534954
2012-04-13T09:30:00-04:00,138.47,138.8168,137.00999,137.14,169246624,144979244.8,44.27399172218564,54.95000572804049,NaN,NaN,-122.51803220414135,-172.40834849711968,-0.5853737523051116,0.007802691266903139,0.5931764435720147,5275597485,5303820755.4,22.16672339299589,42.52999350593865,NaN,NaN,0.5049094347648742,15.869221559139229
2012-04-16T09:30:00-04:00,137.84,138.03999,136.58,137.05,147825184,144725835.2,43.97190869033166,53.219721357123504,NaN,NaN,-124.99902808683137,-170.83090847824224,-0.5736172432464588,-0.12384511048605873,0.4497721327604,5127772301,5255025232.2,20.763386972191,39.57323240219745,NaN,NaN,-1.7472803897619564,13.352578423581917
2012-04-17T09:30:00-04:00,137.84,139.36,137.698,139.082,147877568,145855163.2,51.94429732540109,52.266587772585765,NaN,NaN,-40.06543651062264,-120.65741435452466,-0.41060152118433185,-0.06347976872001482,0.34712175246431703,5275649869,5282877273.8,23.73141319403021,37.00148113284045,NaN,NaN,-0.8432625461242645,11.32460114219532
2012-04-18T09:30:00-04:00,138.46001,139.08,138.38,138.61,123884192,145962891.2,50.15890501820164,51.5034022087521,NaN,NaN,-37.18408949551323,-86.28092570758936,-0.32018859458726107,-0.05311399076975931,0.26707460381750175,5151765677,5255125888.2,22.814425134818492,34.5673912230712,NaN,NaN,-0.7394835347531086,9.60116047405983
2012-04-19T09:30:00-04:00,138.63,139.14999,137.07001,137.72,198666752,149776810.4,46.8864349224252,50.613031902977404,NaN,NaN,-68.06118464139224,-78.56555418770017,-0.30596729755150986,-0.11538451812188555,0.1905827794296243,4953098925,5156776851.4,19.882333399120228,32.15618592974506,NaN,NaN,-1.7316426758655252,7.982188595499065
2012-04-20T09:30:00-04:00,138.33,138.83,137.87,137.95,143199568,150175954.4,47.83363286426591,49.61614940114659,NaN,NaN,-51.12400010720178,-64.28674776831225,-0.2680737969001188,-0.14450946669552422,0.12356433020459458,5096298493,5120917053,18.927173244501006,29.882632219925302,NaN,NaN,-2.2195199242135017,6.524801664111555
2012-04-23T09:30:00-04:00,136.53999,136.91,135.94,136.78999,171844880,152742151.2,43.60952296109699,48.03665736121211,NaN,NaN,-118.78762123393929,-63.044466397733835,-0.305425654023742,-0.2582177373250829,0.04720791669865908,4924453613,5080253315.4,17.87830868627414,27.69885049547187,NaN,NaN,-3.965028764236902,5.026254460061776
2012-04-24T09:30:00-04:00,136.91,137.66,136.8,137.31,137484192,153608164,45.91526743006369,46.89763875226413,NaN,NaN,-79.35582688831975,-70.90254447327325,-0.2800707191707308,-0.3028804822647544,-0.02280976309402362,5061937805,5037510902.6,16.82301369878536,25.63850282997596,NaN,NaN,-4.688579535654084,3.638421032102367
2012-04-25T09:30:00-04:00,138.64999,139.25,138.53,139.19,150255008,155127492.8,53.34295272762828,46.87452844665378,NaN,NaN,12.506097722428867,-60.96450702968484,-0.1293118070843949,-0.18444952194951725,-0.055137714865122346,5212192813,5049596329.8,18.291607749440743,23.871464763035522,NaN,NaN,-2.9159091882952284,2.702088143474139
2012-04-26T09:30:00-04:00,138.89,140.32001,138.81,140.16,136292688,154514027.2,56.65089209851979,47.1148537626499,NaN,NaN,58.73332403544077,-35.60560529431824,0.03436551085554556,-0.012180826295690395,-0.046546337151235954,5348485501,5128673645,27.332538922917436,22.904114707580543,NaN,NaN,-0.36721306042990143,2.2636165429164192
2012-04-27T09:30:00-04:00,140.58,140.78999,139.8,140.39,130725008,152802096,57.421740506777844,47.9662558380448,NaN,NaN,87.76798510376459,-7.827208252124964,0.15025620266731743,0.14127391618291085,-0.00898228648440659,5479210509,5205256048.2,34.85079907483396,22.8472808570121,NaN,NaN,1.9039685839989928,2.2122382630710726
2012-04-30T09:30:00-04:00,140.11,140.21001,139.49001,139.87,115092192,151782371.2,55.03877494861001,49.26050532730917,NaN,NaN,66.40027588673848,29.210371172010593,0.18191426929481277,0.21841055013410937,0.0364962808392966,5364118317,5293188989,42.24021664458713,23.853197674323884,NaN,NaN,3.084686724777326,2.3368737576005376
2012-05-01T09:30:00-04:00,139.78999,141.66,139.63,140.74001,138837312,151137184,58.166785670475576,50.382340274496464,NaN,NaN,120.28781534955601,69.13909961958575,0.24740996161489598,0.3457587328579166,0.0983487712430206,5502955629,5381392553.8,48.54471229856453,25.554775477886817,NaN,NaN,5.032809983618056,2.722007504174469
2012-05-02T09:30:00-04:00,139.92,140.46001,139.46001,140.325,121080944,149400900,56.15966445348091,50.81248366710459,NaN,NaN,92.40758946865391,85.11939796883075,0.2481101580500113,0.40848646880553474,0.16037631075552344,5381874685,5415328928.2,50.77113982421161,27.50127087409081,NaN,NaN,6.073525007842885,3.2007957189842426
2012-05-03T09:30:00-04:00,140.34,140.45,138.99001,139.25,143762688,149244237.6,51.22854892743793,51.30923775319404,NaN,NaN,61.474314991931074,85.66759616012881,0.16547657432689705,0.3672220286641448,0.20174545433724772,5238111997,5393254227.4,49.2775153527886,29.437756014076008,NaN,NaN,5.530460137847653,3.5336049216790153
2012-05-04T09:30:00-04:00,138.515,139.30119,136.92,137,193931312,152068834.4,42.76474983112462,51.223012120393534,NaN,NaN,-48.7288398851432,58.36823116234725,-0.04042012892262367,0.15122029318396812,0.1916404221065918,5044180685,5306248262.6,43.80723892399199,31.08374543920465,NaN,NaN,2.2617272664481782,3.3519081137888955
2012-05-07T09:30:00-04:00,136.50999,137.56,136.46001,137.10001,127765872,152079334.4,43.213848041454995,50.59940860011168,NaN,NaN,-84.0504973840355,28.278076508192452,-0.16271804827720532,-0.011757138239914866,0.15096091003729045,5171946557,5267813910.6,41.60982640469759,32.36077495425232,NaN,NaN,-0.18067268144679866,2.8472537144695105
2012-05-08T09:30:00-04:00,136.28,136.77,134.92,136.55,213383872,150980515.2,41.29480379679881,49.96625851286861,NaN,NaN,-137.56339576976575,-23.292165715671896,-0.2673187009319854,-0.18318746612769132,0.08413123480429409,4958562685,5158935321.8,36.087411326561835,33.30884539651971,NaN,NaN,-2.785721648697593,2.0425429483027813
2012-05-09T09:30:00-04:00,135.10001,136.61,134.49001,135.74001,220778192,154312777.6,38.57778238389731,49.37278333154519,NaN,NaN,-151.89920239775643,-72.15352408895396,-0.37132575346268315,-0.38002595702405984,-0.008700203561376699,4737784493,5030117283.4,30.867599154156366,34.09350723616514,NaN,NaN,-5.821483950350469,0.9191105342094599
2012-05-10T09:30:00-04:00,136.67999,136.85001,135.71001,136.02,150600944,154126749.6,40.046240692629596,48.81654103357117,NaN,NaN,-105.26406064300441,-105.50119921594106,-0.3991022236668173,-0.5075779831448983,-0.10847575947808104,4888385437,4960171971.4,28.460426896049853,34.77445392556149,NaN,NaN,-7.902218569805139,-0.34107933779262556
2012-05-11T09:30:00-04:00,135.17,136.87,135.11,135.61,153032368,153316036.8,38.59127977049336,48.45809509138519,NaN,NaN,-110.08694261980605,-117.77281976287364,-0.4207666683936066,-0.6344340949700893,-0.2136674265764827,4735353069,4898406448.2,26.49549058104445,35.38996691804508,NaN,NaN,-10.064022660374143,-1.7300712410185566
2012-05-14T09:30:00-04:00,134.31,135.6144,133.91,134.11,163909936,154120274.4,33.7588134576084,47.589776950495526,NaN,NaN,-152.87884376781548,-131.5384890396296,-0.5060667691810941,-0.8462508880528503,-0.34018411887175626,4571443133,4778305763.4,23.148772847612378,35.841806857247015,NaN,NaN,-13.495607231886112,-3.4108620968567784
2012-05-15T09:30:00-04:00,134.02,134.81,133.13,133.34,207629248,157107858.4,31.573157411588042,46.03479157077836,NaN,NaN,-158.33314515784448,-135.69243891724537,-0.5790405710042631,-1.063984832627085,-0.484944261622822,4363813885,4659356003.4,20.400327926442543,35.99242972703285,NaN,NaN,-17.07445369891265,-5.362803754293331
2012-05-16T09:30:00-04:00,133.94,134.55,132.8,132.82899,207265568,161276927.2,30.176816618870987,44.14378617937488,NaN,NaN,-147.45652287210538,-134.80390301211517,-0.6226151928202566,-1.2632132526481428,-0.6405980598278862,4156548317,4543108768.2,18.134307658220763,35.33541320812595,NaN,NaN,-20.482480424579368,-7.522757564334194
2012-05-17T09:30:00-04:00,132.86,133.02,130.78999,130.86,247992944,163743236.8,25.49761494213911,41.8634914961864,NaN,NaN,-178.1716774583707,-149.38542637518842,-0.737104536011652,-1.5619787298424512,-0.8248741938307992,3908555373,4347142755.4,15.091107245428205,33.92400664888268,NaN,NaN,-25.153567140553346,-10.041444646651215
2012-05-18T09:30:00-04:00,131.37,131.60001,129.55,129.74001,319631104,172564813.6,23.285818448322345,39.59542317473728,NaN,NaN,-181.54726527399092,-163.67749090602538,-0.8341789252402538,-1.8675978503811166,-1.0334189251408628,3588924269,4117856995.4,12.45704707907096,31.796637394202953,NaN,NaN,-29.837759463341,-12.86948962046404
2012-05-21T09:30:00-04:00,130.16,132.02,129.95,131.97,177861056,172865622.4,35.317021835742395,37.96329718654205,NaN,NaN,-131.158416571845,-159.3334054668313,-0.6995599988739301,-1.9078689237332753,-1.2083089248593453,3766785325,3956925433.8,11.005109992801763,29.115237229505613,NaN,NaN,-29.89857812513284,-15.30221654970244
2012-05-22T09:30:00-04:00,132.31,133.23,131.34,132.2,197531120,175867968.8,36.424494056694456,36.55364215820016,NaN,NaN,-95.55464866432996,-146.7777061681284,-0.552817388220302,-1.8993306601347228,-1.3465132719144208,3964316445,3877025945.8,10.359515815719377,26.228692657470454,NaN,NaN,-29.58462286012049,-17.34256030833359
2012-05-23T09:30:00-04:00,131.25,132.46001,129.99001,132.27,204958320,178603134.4,36.779272489013856,35.521550984027016,NaN,NaN,-100.34997182412938,-137.35639595853317,-0.4151192208209158,-1.8654122979405656,-1.4502930771196498,4169274765,3879571235.4,10.539557947656334,23.461695699961005,NaN,NaN,-29.22844059077229,-19.040543205824832
2012-05-24T09:30:00-04:00,132.63,132.84,131.42,132.53,167357632,180156381.6,38.159654478133675,35.19261560167052,NaN,NaN,-75.59974083477609,-116.84200863381427,-0.2772368039042503,-1.7968390819999627,-1.5196022780957124,4336632397,3965186640.2,16.60691285313311,21.51881526632823,NaN,NaN,-28.532956609900662,-20.39660226354995
2012-05-25T09:30:00-04:00,132.48,132.85001,131.78,132.10001,135465568,180393409.6,36.73126902409206,34.72957424328745,NaN,NaN,-68.51084979098287,-94.23472553721265,-0.18986859819653312,-1.7569380258413787,-1.5670694276448456,4201166829,4087635152.2,24.49432006580112,20.296279099264193,NaN,NaN,-28.350122178896907,-21.5328193943138
2012-05-29T09:30:00-04:00,133.16,133.92999,131.17,133.7,152883440,182282972,44.98360185641555,34.993059818974366,NaN,NaN,-46.37120222298684,-77.27728266744103,-0.00876037702566368,-1.5780198989269252,-1.5692595219012615,4354050269,4205088141,31.214717836776714,19.948229564279547,NaN,NaN,-25.656411285764502,-22.12190395023533
2012-05-30T09:30:00-04:00,132.56,133.6924,131.49001,131.75999,162370368,183459624.8,38.43709595776471,34.983010788536326,NaN,NaN,-56.6447238533957,-69.49529770525416,-0.004286285672546963,-1.5746173789919453,-1.5703310933193984,4191679901,4250560832.2,33.67597776493348,20.14882803647791,NaN,NaN,-25.313546001721164,-22.577852814733305
2012-05-31T09:30:00-04:00,131.71001,132.45,130.34,131.47,196186192,187214887.2,37.55723769584712,34.80522486019472,NaN,NaN,-77.00703666151513,-64.82671067273131,-0.005447393214738527,-1.5771403348378215,-1.571692941623083,3995493709,4215804621,32.71249902966311,20.45254747459314,NaN,NaN,-25.3109019643664,-22.968288407538033
2012-06-01T09:30:00-04:00,129.41,131.5042,128.16,128.16,253245008,192689003.2,29.310013182928287,34.14227724679722,NaN,NaN,-138.52339600229234,-77.41144170623457,-0.20279723427155516,-1.825189484462527,-1.6223922501909718,3742248701,4096927881.8,29.593810857576912,20.673856065774032,NaN,NaN,-28.2448056511166,-23.722076585192113
2012-06-04T09:30:00-04:00,128.39,128.74001,127.13499,128.10001,202548256,193119850.4,29.184927287485777,33.815571091788456,NaN,NaN,-168.93521579841388,-97.49631490772076,-0.3048987064119826,-2.00351563320595,-1.6986169267939675,3539700445,3964634605,26.5592264278948,20.917459892937064,NaN,NaN,-30.51762397233085,-24.692869069069076
2012-06-05T09:30:00-04:00,127.85001,129.25999,127.78,129.07001,164149376,194939025.6,34.08344187925981,33.99487712519358,NaN,NaN,-135.7391064679974,-115.36989575672287,-0.27552153691673853,-2.0430188479398907,-1.7674973110231522,3703849821,3834594515.4,23.958567770832232,21.171619881822043,NaN,NaN,-30.805415357374542,-25.56608996739843
2012-06-06T09:30:00-04:00,129.97,132.03,129.92999,131.97,184202752,193479969.6,46.08997635844351,35.13153139230591,NaN,NaN,-37.09917053184837,-111.4607850924134,-0.0414806794709055,-1.819348160361784,-1.7778674808908785,3888052573,3773869049.8,22.83414171453198,21.5073223144157,NaN,NaN,-26.758431446072812,-25.736424464351913
2012-06-07T09:30:00-04:00,133.47,133.53,131.78,132.05,184772688,191679694.4,46.38012936958422,36.62313956569484,NaN,NaN,16.133254521574028,-92.83272685579557,0.1286999731763918,-1.6169925144203887,-1.7456924875967805,4072825261,3789335360.2,23.81485241416712,22.130446969325625,NaN,NaN,-23.582645386235153,-25.428741738906663
2012-06-08T09:30:00-04:00,131.71001,133.125,131.28999,133.10001,143915632,191345428.8,50.17090995397586,38.5435032446701,NaN,NaN,29.628495366917164,-59.20234858195367,0.31154357441932623,-1.3562630195726229,-1.667806593991949,4216740893,3884233798.6,29.717162683005185,23.36331236960664,NaN,NaN,-19.70889413017733,-24.61162065194533
2012-06-11T09:30:00-04:00,134.17,134.25,131.28,131.41499,169756064,192181613.6,44.70844393190609,39.214319108681785,NaN,NaN,32.85823090211008,-18.843659241848883,0.31748580691192485,-1.270949335352043,-1.5884351422639678,4046984829,3985690675.4,35.47290013269476,25.11101166531328,NaN,NaN,-18.187199683340474,-23.693846227858923
2012-06-12T09:30:00-04:00,131.78999,133.00999,131.16,132.92,181931744,193082704,49.94999591045703,40.18042638395054,NaN,NaN,45.253355003536036,17.3548330524578,0.4150948347080483,-1.0695665988789074,-1.4846614335869557,4228916573,4090704025.8,40.870533240103725,27.29037005276931,NaN,NaN,-15.138386764572404,-22.471637733103705
2012-06-13T09:30:00-04:00,132.53,133.36,131.62,132.07001,172223872,191312435.2,47.22697884694758,40.92669112380295,NaN,NaN,51.42676804581071,35.06002076798961,0.4138053240071755,-0.9674047785779862,-1.3812101025851617,4056692701,4124432051.4,42.53321526296256,29.575631289576897,NaN,NaN,-13.552429694698711,-21.197465156188706
2012-06-14T09:30:00-04:00,132.34,134,131.98,133.47,230616256,192479969.6,51.88001268246592,41.90671670982668,NaN,NaN,103.92928376522498,52.619226616719814,0.49324104484008213,-0.7646587965350591,-1.2578998413751412,4287308957,4167328790.6,44.66443217849676,31.57973981281716,NaN,NaN,-10.685118459678765,-19.69570134240157
2012-06-15T09:30:00-04:00,133.38,134.25999,133.10001,134.14,169444432,188552544,53.97164000744408,43.13817178006611,NaN,NaN,129.64231022185027,72.62198958770642,0.5713991726195153,-0.543650875600747,-1.1150500482202623,4456753389,4215331289.8,47.03171903018286,33.18955402455871,NaN,NaN,-7.697498537565636,-17.98167237028215
2012-06-18T09:30:00-04:00,133.58,134.73,133.28,134.39999,131365440,179139260.8,54.79280957158883,43.83882947400706,NaN,NaN,136.26290680318488,93.30292476792138,0.6171911369773119,-0.3435611269986225,-0.9607522639759344,4588118829,4323558089.8,52.015959447478984,34.67535699675173,NaN,NaN,-5.051212186332992,-16.134463772575128
2012-06-19T09:30:00-04:00,135.08,136.25,134.3714,135.7,137382560,177115336,58.75515015330604,45.29011905940287,NaN,NaN,189.20351185708572,122.09295613863132,0.7052610699774509,-0.07917592650412075,-0.7844369964815716,4725501389,4422875053,56.098545181904065,36.276968955106774,NaN,NaN,-1.5408363602767972,-14.049659856532509
2012-06-20T09:30:00-04:00,135.71001,136.10001,134.27,135.48,206466624,177562111.2,57.83137039829346,46.738271395291896,NaN,NaN,159.9088353135405,143.78936959217725,0.7166023234281378,0.11131590780360057,-0.6052864156245372,4519034765,4515343465.8,59.5493372753814,38.19388597265807,NaN,NaN,1.037359941904467,-11.894371313898656
2012-06-21T09:30:00-04:00,135.64,135.78,132.33,132.44,205272320,177577811.2,46.866150023628784,47.992281169627645,NaN,NaN,63.76700389176672,135.75691361748562,0.4976579061576816,0.016785967072564745,-0.48087193908511683,4313762445,4520634163.4,59.74430889017749,40.347492974986686,NaN,NaN,-0.08584788671047443,-10.207439395728915
2012-06-22T09:30:00-04:00,133.13,133.71001,132.62,133.46001,130029184,175711388.8,50.273063577600574,49.49857661892156,NaN,NaN,46.814505077055024,119.19135258852657,0.4038184102382253,0.02390107371266481,-0.3799173365255605,4443791629,4518041811.4,59.59274182882919,42.70702978933915,NaN,NaN,0.08395411356465039,-8.737240322972692
2012-06-25T09:30:00-04:00,132.05,132.10001,130.85001,131.32001,146375680,176256894.4,43.91152230263849,50.20058236344861,NaN,NaN,-42.70317552671179,83.39813612254724,0.19072663709353777,-0.1415090401586383,-0.33223567725217606,4297415949,4459901235.4,56.15206365574667,45.00656520969018,NaN,NaN,-1.923392709225803,-7.763833521008851
2012-06-26T09:30:00-04:00,131.7,132.38,130.92999,131.98,141633936,175694419.2,46.1737153683565,50.20656372129953,NaN,NaN,-23.058396516620533,40.945754447805996,0.09231458567718753,-0.21684244515569162,-0.30915703083287915,4439049885,4402610934.6,52.91032802325796,47.15486423174203,NaN,NaN,-2.8023123709069355,-7.055044785280006
2012-06-27T09:30:00-04:00,132.42,133.42999,131.96671,133.173,108087936,172980297.6,50.09215033978029,50.47170807631354,NaN,NaN,28.06805998551873,14.57759938220165,0.10474553385553298,-0.17822511351346293,-0.2829706473689959,4547137821,4408231545.8,53.19581329082949,49.25350429436077,NaN,NaN,-2.2832632781507987,-6.373361712832977
2012-06-28T09:30:00-04:00,132.28999,132.99001,131.28,132.78999,169242688,171633122.4,48.86231592909575,50.37823707453639,NaN,NaN,1.9371875704736363,2.211636117943032,0.0851830633366813,-0.1764918181981443,-0.2616748815348256,4377895133,4421058083.4,53.88292970546237,50.97963051025057,NaN,NaN,-2.2427937171960663,-5.783280570599132
2012-06-29T09:30:00-04:00,135.2,136.27,134.85001,136.105,212251056,169583424.8,58.38548002020598,51.355168223700666,NaN,NaN,153.47789682566213,23.544314467664435,0.28239808254284837,0.0913227216437349,-0.19107536089911348,4590146189,4450328995.4,55.48885695162828,52.40934171160297,NaN,NaN,1.0419572337294407,-4.808246598552193
2012-07-02T09:30:00-04:00,136.48,136.64999,135.52,136.50999,129524432,165932233.6,59.38069485718459,52.02878957703835,NaN,NaN,161.11009491262962,64.30696855553272,0.41879237502560657,0.33241510788289474,-0.08637726714271182,4719670621,4534779929.8,59.83464602627614,53.76392119632957,NaN,NaN,3.9447350338627625,-3.5578206510643424
2012-07-03T09:30:00-04:00,136.48,137.50999,136.34,137.412,80450192,161747274.4,61.584293581185236,53.054312058055324,NaN,NaN,178.47562361995327,104.61377258284747,0.5406795428335639,0.5894721613992431,0.04879261856567918,4800120813,4606994115.4,63.147971062976175,55.2364037534734,NaN,NaN,7.02925759429659,-2.0453809017270665
2012-07-05T09:30:00-04:00,136.89999,137.8,136.28999,136.78999,126177440,158846008.8,59.199299592405296,53.57711826590814,NaN,NaN,145.52275356972925,128.1047112996896,0.5485926851418456,0.7345334749929862,0.18594078985114057,4673943373,4632355225.8,64.2629373280856,56.63629697844403,NaN,NaN,8.830124876280957,-0.491737219154492
2012-07-06T09:30:00-04:00,135.47,135.77,134.85001,135.49001,151192000,157166974.4,54.452919825081366,53.611495395739375,NaN,NaN,65.16262571534187,140.7497989286632,0.44013748107827616,0.7361126411989858,0.2959751601207096,4522751373,4661326473.8,65.54536135427657,57.958700001593584,NaN,NaN,8.916091022071065,0.8522382438777305
2012-07-09T09:30:00-04:00,135.38,135.57001,134.7,135.32001,103780432,155160214.4,53.84494196736118,53.54379056686597,NaN,NaN,51.24059170953104,120.30233790543703,0.3355397743597069,0.7153998780703432,0.37986010371063633,4418970941,4627091424.2,62.6828326692938,58.7206195174375,NaN,NaN,8.807695666489886,1.9887321613937528
2012-07-10T09:30:00-04:00,136.00999,136.23,133.67999,134.14,167884816,155066652,49.697127451029786,52.89678894527481,NaN,NaN,24.28826857889667,92.93797263869043,0.17362181521961378,0.5968873727351536,0.4232655575155398,4251086125,4533374525,55.53307619955604,58.680228875841216,NaN,NaN,7.484409578999469,2.773828935337426
2012-07-11T09:30:00-04:00,134.21001,134.60001,133.38,134.16,141734000,153056764.8,49.76775692583053,52.32081655438459,NaN,NaN,-9.002667055971667,55.44231450350543,0.06045075483524048,0.4988290010595904,0.4383782462243499,4392820125,4451914387.4,50.17574633007636,58.01068666546228,NaN,NaN,6.430614448312593,3.29622686576245
2012-07-12T09:30:00-04:00,133.38,134.2269,132.60001,133.50999,143583120,151624727.2,47.43654904033533,52.361559341292214,NaN,NaN,-41.9882357018188,17.94011664919581,-0.0591303322344206,0.36446533093132416,0.42359566316574476,4249237005,4366973113.8,45.271422790514,56.97690908691488,NaN,NaN,4.878227805435563,3.522227000001466
2012-07-13T09:30:00-04:00,133.86,135.89,133.84,135.75,129644128,146576120.8,55.22090750297263,52.71497676453306,NaN,NaN,38.75597203767225,12.658785913661882,0.008108633109347674,0.43373145455242934,0.42562282144308167,4378881133,4338199065.8,43.71273154435222,55.84262263802368,NaN,NaN,5.753629166135367,3.8409987380205948
2012-07-16T09:30:00-04:00,135.44,135.83,134.89999,135.42999,97525184,142980158.4,53.99076142967302,53.43492241646411,NaN,NaN,45.75619106295769,11.5619057843472,0.025525033387955587,0.45752911317802614,0.43200407979007055,4281355949,4310676067.4,42.21550537330907,54.84715418927813,NaN,NaN,6.113746665008856,4.165677013304632
2012-07-17T09:30:00-04:00,135.97,136.64,134.55,136.36,138860192,143354896,56.98948568727753,54.20747743924419,NaN,NaN,62.88267375535487,19.28078681963884,0.09051579803648768,0.5451488273356802,0.45463302929919247,4420216141,4344502070.6,44.721473518021355,54.262236010332664,NaN,NaN,7.294770905920746,4.612690426535505
2012-07-18T09:30:00-04:00,136.03999,137.64,135.96001,137.37,113349632,142153249.6,60.035841311304026,54.91774108006731,NaN,NaN,109.45460781080222,42.97224179299362,0.18681680044402016,0.6881540298542177,0.5013372294101975,4533565773,4372651200.2,46.78952034725745,53.80464365722037,NaN,NaN,9.209343364394693,5.269355131943961
2012-07-19T09:30:00-04:00,137.64999,138.17999,137.21001,137.73,129847184,138322277.6,61.09361475091949,55.79140528162615,NaN,NaN,127.84812134021584,76.93951320140056,0.2557869208638859,0.8210708804900548,0.565283959626169,4663412957,4455486390.6,52.42948464634511,53.700826152997706,NaN,NaN,11.099762640645837,6.102270490329943
2012-07-20T09:30:00-04:00,136.95,137.16,136.32001,136.47,142904432,135203883.2,55.55155816525376,55.5889822919867,NaN,NaN,75.26733602357548,84.24178599858121,0.20004344074328828,0.8153382605552792,0.615294819811991,4520508525,4483811869,54.216527520951956,53.60994547937797,NaN,NaN,11.157203869483835,6.82440383020907
2012-07-23T09:30:00-04:00,134.47,136.38519,133.84,135.09,145210816,135962964.8,50.1822482401083,54.93195039076697,NaN,NaN,4.847543158614908,76.06005641771264,0.060939998123332506,0.6914698174661567,0.6305298193428241,4375297709,4502600221,55.41299670633605,53.29411338509653,NaN,NaN,9.582487551859026,7.218415790444777
2012-07-24T09:30:00-04:00,135.19,135.25,133.03,133.925,173301120,137309236.8,46.128789057201,53.827985781910954,NaN,NaN,-55.69445777693752,52.34463011125418,-0.10953791858253104,0.4936074211146604,0.6031453396971914,4201996589,4458956310.6,52.012663079670865,52.49873424343186,NaN,NaN,6.978724602458692,7.184174192161051
2012-07-25T09:30:00-04:00,134.21001,134.56,133.25,133.96001,129122256,136683652.8,46.26924802647918,52.904410670059086,NaN,NaN,-75.92200392677978,15.269307763737785,-0.21391251989421012,0.3357546898294288,0.5496672097236389,4331118845,4418466925,49.00810881981535,51.40910363569828,NaN,NaN,4.9251765495374995,6.86146024321483
2012-07-26T09:30:00-04:00,135.89,136.46001,135.25999,136.17,156526432,139105577.6,54.35892982643812,52.89769709872743,NaN,NaN,35.65077111402205,-3.1701622815009785,-0.13209366232621433,0.38455013181587105,0.5166437941420854,4487645277,4383313389,46.49676479637103,50.04848959584789,NaN,NaN,5.529412436950337,6.671167699462759
2012-07-27T09:30:00-04:00,136.89,139.07001,136.1364,138.675,236768880,142481887.2,61.444805445359705,53.440544490013046,NaN,NaN,146.78435743828024,11.133242001439967,0.08126648556696969,0.6182269011007975,0.5369604155338278,4724414157,4424094515.4,49.71593214566299,49.12228241558854,NaN,NaN,8.47904633433118,6.929436075872534
2012-07-30T09:30:00-04:00,138.52,139.339,138.27,138.67999,106781936,137208431.2,61.45764214808494,54.28058125408841,NaN,NaN,164.66820210263958,43.0973737902449,0.20615945386427836,0.7946597328641758,0.5885002789998974,4831196093,4515274192.2,56.0789064585634,49.16127029123192,NaN,NaN,10.768441395996787,7.4778654073188555
2012-07-31T09:30:00-04:00,138.49001,138.87,137.71001,137.71001,120575808,136761000,57.45328877185955,54.82954781451906,NaN,NaN,112.52932365479185,76.74213007659077,0.20636562532156777,0.8464573106518571,0.6400916853302894,4710620285,4616998931.4,61.87520218993648,49.99694570979336,NaN,NaN,11.449786066130816,8.045282644291992
2012-08-01T09:30:00-04:00,138.7,138.73,137.39999,137.59,138293744,139653177.6,56.958799731764074,55.50970857819254,NaN,NaN,97.1874527409718,111.36402141014109,0.18218247096723483,0.867819774039333,0.6856373030720981,4572326541,4665240470.6,64.28254090951208,51.35488271829322,NaN,NaN,11.851767168127326,8.58906614769704
2012-08-02T09:30:00-04:00,136.55,137.57001,135.58,136.64,199556560,143322133.6,53.06527407390173,55.355734761830334,NaN,NaN,33.1351630658481,110.8608998005063,0.09059702711088047,0.7988835869606987,0.7082865598498183,4372769981,4642265411.4,62.266028115293445,52.680118187646165,NaN,NaN,11.048134176178687,8.940361580337274
2012-08-03T09:30:00-04:00,138.56,139.64,136.6794,139.349,157825008,143653784,61.208381979401054,55.8712790868109,NaN,NaN,114.36500639514632,104.37702959187955,0.19486853725687114,0.9518722314209072,0.757003694164036,4530594989,4603501577.8,58.90834626757669,53.872463965808144,NaN,NaN,12.940856195617926,9.511860811091653
2012-08-06T09:30:00-04:00,139.72,140.17,139.56,139.62,86327744,142781149.6,61.92014618757433,56.2234691225464,NaN,NaN,146.65548234375797,100.77448564010322,0.26040169772771093,1.0825058163236747,0.8221041185959638,4616922733,4560646905.8,55.35450912937691,54.63196650947639,NaN,NaN,14.666939131114235,10.248300571094878
2012-08-07T09:30:00-04:00,140.17999,140.92,140.03,140.32001,109545056,139864161.6,63.76938740389923,56.4901509863032,NaN,NaN,152.36492992579042,108.74160689430293,0.3250039623598773,1.2283590715458104,0.9033551091859331,4726467789,4563816406.6,55.568007151823345,55.2590012812311,NaN,NaN,16.66281783233223,11.164660179843072
2012-08-08T09:30:00-04:00,139.85001,140.64999,139.81,140.49001,89754624,137265192.8,64.22377055580972,56.71373354379536,NaN,NaN,131.34139445683172,115.57239523747492,0.351071452280841,1.3421944245369843,0.9911229722561433,4816222413,4612595581,58.830991044913276,55.71625173827168,NaN,NaN,18.41561621130564,12.200511041480581
2012-08-09T09:30:00-04:00,140.28999,140.89,140.14999,140.61,90291632,134600618.4,64.56160305516805,57.35730817878924,NaN,NaN,126.55315528158437,134.25599368062217,0.3476279068375956,1.4256578558031379,1.0780299489655423,4906514045,4719344393.8,64.90502680174211,56.47971597261384,NaN,NaN,19.951728304068222,13.307827793278815
2012-08-10T09:30:00-04:00,140.03999,140.89,139.81,140.84,99792624,133108043.2,65.23918874999733,58.4328039294956,NaN,NaN,112.8996599332415,133.96292438824122,0.33209619937317236,1.4931501981820077,1.1610539988088353,5006306669,4814486729.8,69.25842581321028,57.46867519453342,NaN,NaN,21.42501780811912,14.467426366827429
2012-08-13T09:30:00-04:00,140.60001,140.84,140.03999,140.77,79426880,132203128,64.83289470186782,59.768811475543224,NaN,NaN,104.42408616815531,125.51664515312066,0.2898998503508581,1.523428811747408,1.2335289613965499,4926879789,4876478141,71.71996053610246,58.87633929856425,NaN,NaN,22.55817404434846,15.623247463616147
2012-08-14T09:30:00-04:00,141.28999,141.38,140.37,140.78999,102379376,130379087.2,64.90012065516335,61.099588091877806,NaN,NaN,104.44846165816953,115.93335149959648,0.2382848340892294,1.5313850040080865,1.2931001699188571,5029259165,4937036416.2,73.91712227101512,60.655554545078516,NaN,NaN,23.533603049906176,16.75329826165758
2012-08-15T09:30:00-04:00,140.64,141.19,140.55,140.95,71085808,128265896,65.46913964621623,61.89317450757624,NaN,NaN,94.49093587919518,108.56325978406919,0.1918647740649031,1.532931137499986,1.341066363435083,5100344973,4993860928.2,75.81583804796077,62.74977406304921,NaN,NaN,24.515027322513937,17.862116698922772
2012-08-16T09:30:00-04:00,141.14999,142.16,140.8,141.99001,112014192,127374246.4,68.98817431311852,62.43198656955901,NaN,NaN,107.36215175912135,104.7250590795766,0.20685647374826277,1.5996369556204115,1.3927804818721488,5212359165,5055029952.2,77.69788727963056,64.7484851440469,NaN,NaN,26.341253343324027,19.07342193383724
2012-08-17T09:30:00-04:00,142.23,142.3,141.86,142.17999,90813680,124769708.8,69.59768022201507,63.01341786055402,NaN,NaN,110.67184110671393,104.27949531427107,0.20483558848153693,1.64882496747407,1.443989378992533,5303172845,5114403187.4,79.37562682656404,66.41253659890408,NaN,NaN,28.06250261159083,20.357576316373464
2012-08-20T09:30:00-04:00,141.98,142.22,141.59,142.19,78255680,121421952,69.63154779857626,63.8832935053195,NaN,NaN,98.37065286879321,103.06880865439864,0.18030535600428865,1.669371073997894,1.4890657179936053,5381428525,5205312934.6,81.65166534377772,67.82514110989274,NaN,NaN,29.534116601364836,21.668510642800804
2012-08-21T09:30:00-04:00,142.53999,143.09,141.45,141.75999,105581008,118035946.4,66.2189220253063,64.54473081200108,NaN,NaN,97.00189240884859,101.57949480453445,0.11446061528334228,1.6321414870977833,1.517680871814441,5275847517,5254630605,82.7629818747549,69.14517260741009,NaN,NaN,30.002382041039755,22.859063699692083
2012-08-22T09:30:00-04:00,141.39999,142.05,141.07001,141.82001,133243440,118242005.6,66.46596389420662,65.50192294202286,NaN,NaN,77.94755731265664,98.27081909122674,0.05718412220746272,1.5891610245737695,1.5319769023663068,5409090957,5316379801.8,84.0644169918875,70.70220038430965,NaN,NaN,30.464144426643884,23.94550380354234
2012-08-23T09:30:00-04:00,141.47,141.48,140.44,140.66499,111466368,115989002.4,57.718357723113336,65.25263549514517,NaN,NaN,38.47740363387502,84.49386946617749,-0.06939077925372628,1.4452384282991488,1.5146292075528751,5297624589,5333432886.6,84.41439469689375,72.52406098640374,NaN,NaN,28.580612721040836,24.60766222032784
2012-08-24T09:30:00-04:00,140.31,141.83,140.22,141.50999,99481184,109124617.6,61.69069467089263,65.23624610109648,NaN,NaN,51.45223232312348,72.64994770945938,-0.1049705554570235,1.3834160132315958,1.4883865686886193,5397105773,5352219472.2,84.8101755356285,74.62803715827886,NaN,NaN,27.947988619723535,25.084851705955796
2012-08-27T09:30:00-04:00,141.89,142.08,141.34,141.53999,68785872,107224814.4,61.82781142441054,65.09756210256157,NaN,NaN,73.74567248283181,67.7249516322671,-0.13342334623799368,1.3216073858911273,1.455030732129121,5465891645,5369112096.2,85.17473428031074,76.74280338174223,NaN,NaN,27.4576081226012,25.42381690833371
2012-08-28T09:30:00-04:00,141.17999,141.84,140.97,141.39999,75689568,104980502.4,60.7353175367138,64.84838688691187,NaN,NaN,55.02194384943776,59.32896192038495,-0.16646244237432795,1.246952679161211,1.413415121535539,5390202077,5391983008.2,85.67598006398637,78.66030259739031,NaN,NaN,26.75550431138006,25.61405796591176
2012-08-29T09:30:00-04:00,141.52,141.89,141.12,141.50999,65421296,101336880,61.31373484379725,64.61639630038538,NaN,NaN,56.91701492144091,55.12285344214181,-0.1843103643094106,1.1830271661487757,1.3673375304581863,5455623373,5401289491.4,85.88510826231553,80.15887984457413,NaN,NaN,26.298529365789094,25.711839594465662
2012-08-30T09:30:00-04:00,140.89999,140.94,140.19,140.49001,96589808,96188542.4,53.45092032007014,63.77437712681915,NaN,NaN,-41.49281041339372,39.12881063268806,-0.26339373815525247,1.0380953577641208,1.3014890959193732,5359033565,5413571286.6,86.17203232507988,81.36699459542196,NaN,NaN,23.692891041029345,25.423418372546188
2012-08-31T09:30:00-04:00,141.28999,141.82001,140.36,141.16,151970368,95895810.4,57.32243769571801,63.23791591209416,NaN,NaN,3.676914600553903,29.57374708817415,-0.2682623608645778,0.9661611448386509,1.2344235057032287,5511003933,5436350918.6,86.71158295737699,82.43782476837013,NaN,NaN,22.447112491634133,24.99823181813018
2012-09-04T09:30:00-04:00,141.03999,141.46001,140.13,141.03,120226192,97590732.8,56.343237200249085,62.626709951028865,NaN,NaN,-35.01509159100324,7.821594273407141,-0.27680146278591633,0.8884216772208333,1.1652231400067496,5390777741,5421328137.8,84.37345647410211,83.18470578287635,NaN,NaN,21.135898576812505,24.44646992651337
2012-09-05T09:30:00-04:00,141.09,141.47,140.63,140.91,100660256,97146492.8,55.40243483130791,61.90765960710684,NaN,NaN,-22.79942437457066,-7.742679371394547,-0.28592445297241875,0.8078175737912261,1.0937420267636448,5290117485,5401311219.4,81.23047757866779,83.57146574935541,NaN,NaN,19.77733750855767,23.779451009662555
2012-09-06T09:30:00-04:00,141.75999,143.78,141.75,143.77,158272432,100572383.2,68.78176610663674,61.892916163786715,NaN,NaN,220.5495623995168,24.983830124220617,-0.10410685294956079,0.9636084605766939,1.0677153135262547,5448389917,5399864528.2,80.99564378722793,83.80701978561238,NaN,NaN,22.84451415572179,23.64588860195673
2012-09-07T09:30:00-04:00,144.00999,144.39,143.88,144.33,107272000,101421401.6,70.63913746927255,61.96730596716225,NaN,NaN,274.8326913548568,88.24893047787073,0.04131408464594033,1.1193579193336802,1.07804383468774,5555661917,5439190198.6,82.47849623446366,84.02865331474807,NaN,NaN,25.959922944610557,23.976464936621564
2012-09-10T09:30:00-04:00,144.19,144.44,143.46001,143.50999,86458432,100754692,64.58008348169363,61.60648708738491,NaN,NaN,193.69578488247097,126.25270453425415,0.06813591610610414,1.1632137298203702,1.095077813714266,5469203485,5430830109,81.03100650791215,83.98432054075765,NaN,NaN,26.539241354568254,24.342575853471093
2012-09-11T09:30:00-04:00,143.60001,144.37,143.56,143.91,88760000,101221348,66.10730461852363,61.59851441547187,NaN,NaN,166.47250645571572,166.55022414359792,0.09691961143659245,1.2162273280100067,1.1193077165734142,5557963485,5464267257.8,82.36414213569657,83.95583198796778,NaN,NaN,27.499515737579884,24.793567265486633
2012-09-12T09:30:00-04:00,144.39,144.55,143.89999,144.39,87640880,100484423.2,67.89612572674842,61.700668832082,NaN,NaN,158.8881068322584,202.88773038496373,0.1303079516908403,1.2821926561869645,1.1518847044961242,5645604365,5535364633.8,84.8088633241433,84.00900672598605,NaN,NaN,28.85531656775846,25.37381716581118
2012-09-13T09:30:00-04:00,144.37,147.03999,143.99001,146.59,225470128,108203639.2,74.53107423772529,62.90157715455428,NaN,NaN,206.0461161878495,199.9870411426303,0.2743015057946212,1.4947615867394006,1.2204600809447794,5871074493,5619901549,87.0988756276434,84.20075536389673,NaN,NaN,32.53283054290005,26.39653336253816
2012-09-14T09:30:00-04:00,146.88,148.11,146.75999,147.24001,169777008,111091780,76.1025704602666,63.930996853795286,NaN,NaN,217.01736231734628,188.42397533512818,0.3805299557581261,1.696122525642437,1.315592569884311,6040851501,5716939465.8,89.12535577632691,84.50898252394663,NaN,NaN,36.0174010205592,27.77094302796974
2012-09-17T09:30:00-04:00,146.94,147.19,146.37,146.74001,119427744,112522483.2,72.40184395461372,64.68628489166693,NaN,NaN,154.8043593858959,180.64569023581316,0.3832610428874361,1.794668873493606,1.41140783060617,5921423757,5807383520.2,90.60640609614538,84.89695908222052,NaN,NaN,37.56803326044857,29.170527346895287
2012-09-18T09:30:00-04:00,146.49001,146.81,146.25,146.62,98326496,113526024,71.50308228380828,65.45541094503082,NaN,NaN,125.3149504232673,172.41417902932346,0.34435536460078664,1.841852036357153,1.4974966717563665,5823097261,5860410275.4,91.35021249287786,85.30226139856993,NaN,NaN,38.50609712135385,30.50418017181794
2012-09-19T09:30:00-04:00,146.78999,147.17,146.41,146.7,128318256,114662886.4,71.75479024658974,66.20120061665885,NaN,NaN,114.71739515225737,163.58003669332325,0.2933713837422711,1.8642109014342054,1.5708395176919343,5951415517,5921572505.8,92.12478729631097,85.74795275814101,NaN,NaN,39.3322741666024,31.76533645678715
2012-09-20T09:30:00-04:00,146.03,146.78999,145.63,146.71001,154009744,115701201.6,71.78836834093738,67.51101833243509,NaN,NaN,91.11917485224551,140.59464842620247,0.2323543703338733,1.861282480609276,1.6289281102754027,6105425261,5968442659.4,92.66672997013352,86.2118597327877,NaN,NaN,40.012333190462925,32.943478847312264
2012-09-21T09:30:00-04:00,146.64,146.67,145.81,145.87,108737440,115564755.2,64.82399426263649,68.04684380150069,NaN,NaN,75.61764807698052,112.31470557812932,0.11347158595531859,1.770767592719551,1.6572960067642324,5996687821,5959609923.4,91.39036456759003,86.5460584192315,NaN,NaN,38.59196254926013,33.75040509044767
2012-09-24T09:30:00-04:00,145.14999,145.98,145.03999,145.645,95682000,115374796,63.05933784731015,68.52656527629077,NaN,NaN,52.60968993225773,91.87577168740167,0.0035415661077380367,1.6617229643989049,1.6581813982911668,5901005821,5955526336.2,90.7678998499867,87.00280437465183,NaN,NaN,36.906352325090005,34.20125469539658
2012-09-25T09:30:00-04:00,145.96001,146.24001,144.06,144.10001,133165120,118593758.4,52.49241040100622,68.31870638841208,NaN,NaN,23.913774315922623,71.59553646593272,-0.179261071092768,1.4341050594252067,1.6133661305179747,5767840701,5944475024.2,89.00118360682433,87.55785480523444,NaN,NaN,31.958907778571778,33.880919421564464
2012-09-26T09:30:00-04:00,144.065,144.11,142.95,143.295,146502128,122134386.4,47.98084272114268,66.83292614659106,NaN,NaN,-27.019158529766496,43.24822572952796,-0.35052366965022697,1.175211543455191,1.525735213105418,5621338573,5878459635.4,79.09716471923518,87.42224915752067,NaN,NaN,26.2765650914244,32.79458308868731
2012-09-27T09:30:00-04:00,143.89,144.97,143.50999,144.64,111830256,124454834.4,54.947932121612936,65.71212576461538,NaN,NaN,1.1745652753022928,25.259303814139308,-0.3675677974080922,1.066275466345303,1.433843263753395,5733168829,5804008349,69.67970664831589,86.50804990136724,NaN,NaN,23.522963843156504,31.470066053611482
2012-09-28T09:30:00-04:00,144.09,144.56,143.46001,143.97,150696064,127160147.2,51.264584447769934,64.76101869076368,NaN,NaN,-22.2874247394304,5.678289250857124,-0.4148121252668655,0.9153281071698132,1.3301402324366787,5582472765,5721165337.8,60.97958023170842,85.0758051673527,NaN,NaN,20.041801400283706,29.8374568174218
2012-10-01T09:30:00-04:00,144.52,145.69,144.00819,144.345,135911120,126357184.8,53.15725425171965,63.83601509313483,NaN,NaN,-0.6376928398909307,-4.971187303572603,-0.4108738283090949,0.8165479470503101,1.227421775359405,5718383885,5684640950.6,57.56683886539747,83.30456921947419,NaN,NaN,17.82509936195767,28.121405752355496
2012-10-02T09:30:00-04:00,144.92,145.14999,143.83,144.5,113422128,126016981.6,53.95325635744531,62.84009585247033,NaN,NaN,-20.581766971060315,-13.870295560969168,-0.3881651271967046,0.7422153663635243,1.1303804935602288,5831806013,5697434013,58.444098047402065,81.42137169970697,NaN,NaN,16.281029421476457,26.429923419372777
2012-10-03T09:30:00-04:00,144.89,145.42999,144.13,145.09,121283008,127048119.2,56.95193873020958,61.58444331621921,NaN,NaN,-11.460295160666917,-10.758522887149251,-0.3262365374367313,0.7225848217643147,1.048821359201046,5953089021,5763784102.6,62.745881161178524,79.68187209495947,NaN,NaN,15.864343565845946,24.920554868868944
2012-10-04T09:30:00-04:00,145.64,146.34,145.44,146.125,124311632,125350079.2,61.6678704893992,60.5533933183001,NaN,NaN,48.28546250412783,-1.336343441384146,-0.21382966083674826,0.7815342831551106,0.9953639439918589,6077400653,5832630467.4,66.60845261048323,78.07352186882778,NaN,NaN,16.970739986856444,23.784867028581445
2012-10-05T09:30:00-04:00,146.91,147.16,145.7,146.14,124842064,126228582.4,61.733299525843336,59.79135443053078,NaN,NaN,64.46252336471649,16.01364617944523,-0.14028318223101677,0.820009966203088,0.9602931484341047,6202242717,5956584457.8,72.19763361830967,76.75860954898238,NaN,NaN,17.872947393132094,22.94030708066011
2012-10-08T09:30:00-04:00,145.60001,146.12309,145.31,145.642,78415568,125826439.2,58.18252643179277,58.83988615538682,NaN,NaN,18.862124432890322,19.91360963400148,-0.1273678039651377,0.8010833934776826,0.9284511974428203,6123827149,6037673110.6,75.13032278124942,75.60004599815178,NaN,NaN,17.613191255552785,22.179290534216204
2012-10-09T09:30:00-04:00,145.53,145.64999,144.14999,144.2,148872816,128832080,49.33401021837548,57.23840186765723,NaN,NaN,-55.41285309131728,12.947392409950089,-0.2130854478978066,0.662094387570562,0.8751798354683686,5974954333,6066302774.6,76.08931936548716,74.45465543166436,NaN,NaN,14.569347030451194,21.09215574796406
2012-10-10T09:30:00-04:00,144.17999,144.32001,143.09,143.28,124247440,130662408,44.66667736909489,55.30113822681135,NaN,NaN,-125.67991005306334,-9.896530568529196,-0.3223324134173675,0.4722643186966593,0.7945967321140268,5850706893,6045826349,73.8945843025503,73.11378788397984,NaN,NaN,10.445933937711372,19.57126691792796
2012-10-11T09:30:00-04:00,144.28,144.49001,143.327,143.36,123601440,125568973.6,45.15259791074308,53.896038487390385,NaN,NaN,-101.03875119361572,-39.76137330807791,-0.37604787082532043,0.32453689358237625,0.7005847644076967,5974308333,6025207885,71.65337759223955,71.70400310002624,NaN,NaN,7.321047474597904,17.82123556888081
2012-10-12T09:30:00-04:00,143.46001,143.95,142.58,142.89,124181872,123289216.8,42.775919519117735,52.4472228925195,NaN,NaN,-126.89546607724905,-78.03297119647102,-0.42638402767052197,0.16760472981954422,0.5939887574900662,5850126461,5954784633.8,64.46191906921017,69.82500447282791,NaN,NaN,3.9840052504520065,15.844488380533837
2012-10-15T09:30:00-04:00,143.23,144.23,142.77,144.08,107689056,122702282.4,49.95808463922678,52.26619962382097,NaN,NaN,-84.65342004235565,-98.73608009152022,-0.365054262487558,0.13767092938061865,0.5027251918681767,5957815517,5921582307.4,61.33630707709584,67.84894186356159,NaN,NaN,3.2437681757441896,14.044385494135316
2012-10-16T09:30:00-04:00,144.75999,145.64,144.66,145.53999,108815440,123226729.6,57.07616212907264,52.915865295815955,NaN,NaN,29.592366636579676,-81.73503614594082,-0.21888730477802226,0.22911606089564884,0.4480033656736711,6066630957,5939917632.2,62.419968831840734,66.65771358589056,NaN,NaN,4.983532159013323,12.749977874832174
2012-10-17T09:30:00-04:00,145.64,146.32001,145.42,146.2,128834064,123252520,59.85609148526063,53.26644810750508,NaN,NaN,88.09408282734171,-38.98023756985981,-0.07776231807187084,0.3508004680838326,0.4285627861557034,6195465021,6008869257.8,66.25081163740298,66.4127925136825,NaN,NaN,7.333528044405958,11.976199327628429
2012-10-18T09:30:00-04:00,145.82001,146.52,145.33,145.82001,148108432,122957454.4,57.545347832677464,53.7150740635699,NaN,NaN,85.68115246722276,-1.6362568376921132,-0.013388680430348576,0.41182693561776773,0.4252156160481163,6047356589,6023478909,67.0179865306566,66.84410724932165,NaN,NaN,8.503575030138096,11.480110142272666
2012-10-19T09:30:00-04:00,145.55,145.56,143.05,143.3896,185645120,126802838.4,45.45767509273244,53.165104123642244,NaN,NaN,-58.989186053233496,11.944999167110996,-0.1313183726534327,0.2610676502313254,0.3923860228847581,5861711469,6025795910.6,67.14554125108646,67.52830027687087,NaN,NaN,5.2878634888454155,10.595503477497346
2012-10-22T09:30:00-04:00,143.14999,143.67,142.28,143.41,125578624,128297669.6,45.56104106468872,52.565660174159625,NaN,NaN,-117.67561648385815,5.340559878810493,-0.20062592110207966,0.14160362150715855,0.3422295426092382,5987290093,6031690825.8,67.4900274951197,68.17443809456499,NaN,NaN,2.8868947315741944,9.494273656651181
2012-10-23T09:30:00-04:00,141.86,142.06,140.83,141.42,192056320,131242229.6,37.996317724201354,51.21168724515905,NaN,NaN,-205.27808485464826,-41.633530419435104,-0.3636665998678432,-0.11235370722556581,0.2513128926422774,5795233773,5977411389,61.13377373911963,68.05928756441793,NaN,NaN,-1.9828634720890612,7.854682638259718
2012-10-24T09:30:00-04:00,141.92999,142.10001,140.8,141.02,120179312,129926088.8,36.67806867133663,49.42670140101172,NaN,NaN,-185.14944545757555,-96.28223607641856,-0.47461157179760854,-0.34195157210473326,0.13265999969287529,5675054461,5873329277,51.180007950343736,66.95725580297939,NaN,NaN,-6.227877667459014,5.842888308871328
2012-10-25T09:30:00-04:00,142.02,142.28,140.57001,141.42999,134457312,131057441.6,39.013606288461844,47.80386616977018,NaN,NaN,-149.21184466457697,-143.2608355027785,-0.49431463989588936,-0.4852333001769864,0.009081339718902959,5809511773,5825760313.8,47.38284189176648,65.18477067965487,NaN,NaN,-8.863784589791935,3.741935037633719
2012-10-26T09:30:00-04:00,141.3,141.84,140.39,141.35001,146023440,130823810.4,38.71362828583271,46.41323058791589,NaN,NaN,-138.42501439620108,-159.14800117137202,-0.48593828062134825,-0.5983415110577823,-0.11240323043643409,5663488333,5786115686.6,44.42463563308947,62.99150731192916,NaN,NaN,-11.041256902821795,1.6300504747115032
2012-10-31T09:30:00-04:00,141.85001,142.03,140.67999,141.35001,103438496,129200179.2,38.71362828583271,45.65463187844855,NaN,NaN,-114.22765423752118,-158.45840872210462,-0.4541896944639979,-0.6801403485164315,-0.22595065405243359,5663488333,5721355334.6,40.02836204476419,60.41572464616324,NaN,NaN,-12.791171485199548,-0.4301240909900752
2012-11-01T09:30:00-04:00,141.64999,143.00999,141.52,142.83,100995568,128578851.2,47.39429196466801,45.84946149241806,NaN,NaN,-58.269466173591255,-129.05668498589324,-0.3139714681799028,-0.6184149892773121,-0.3044435210974093,5764483901,5715205360.2,39.62730681379848,57.968061968395254,NaN,NaN,-11.735633816272813,-2.045196908887609
2012-11-02T09:30:00-04:00,143.67999,143.72,141.41,141.56,137702128,129399807.2,41.908707463186474,45.617755031878296,NaN,NaN,-61.88239726412091,-104.4032753472023,-0.2878993768279901,-0.6643177421323969,-0.3764183653044068,5626781773,5705550822.6,38.96725349892247,55.63333881887261,NaN,NaN,-12.54473394742247,-3.545130771535446
2012-11-05T09:30:00-05:00,141.35001,142.17,140.92999,141.8486,98378432,128103147.2,43.50883532617673,45.67010616095394,NaN,NaN,-79.38017379859761,-90.43694117400642,-0.23461622184213093,-0.6696886426070705,-0.43507242076493957,5725160205,5688680509,37.782966734122525,53.727699366366345,NaN,NaN,-12.705471765008314,-4.853750913460141
2012-11-06T09:30:00-05:00,142.28,143.52,142.13,142.96001,107068064,127214447.2,49.30057865627797,45.62314144788617,NaN,NaN,-18.09949888333583,-66.37183807143337,-0.11402634057366157,-0.5776053464820166,-0.463579005908355,5832228269,5722428496.2,41.60622002876898,52.318407434343,NaN,NaN,-11.010526248883034,-5.733290247091983
2012-11-07T09:30:00-05:00,141.66,141.67999,139.06,139.72,264304432,136508890.4,37.2959822860376,44.21027145909795,NaN,NaN,-138.50423612602523,-71.22715444913416,-0.23500899765480399,-0.75734025297686,-0.522331255322056,5567923837,5703315597,40.10319529581504,50.72435218176974,NaN,NaN,-13.758992551404962,-6.8798191477081225
2012-11-08T09:30:00-05:00,139.7,140.41,137.92999,138.03999,181517248,138141112,32.831813402426334,42.27996588175265,NaN,NaN,-176.29515090707488,-94.8322913958309,-0.40097134233847265,-1.0235454332451468,-0.6225740909066741,5386406589,5627700134.6,34.75407541439557,48.474585308697776,NaN,NaN,-17.706605793238577,-8.426502954212474
2012-11-09T09:30:00-05:00,137.62,139.44,137.55,138.16,201055184,141981499.2,33.44465992377458,40.55848817397388,NaN,NaN,-166.34953156545757,-115.72571825609823,-0.4706390974395449,-1.2108729627061052,-0.7402338652665603,5587461773,5619836134.6,34.24252700709671,46.133481057014926,NaN,NaN,-20.448543575411744,-10.143937328669512
2012-11-12T09:30:00-05:00,138.59,138.81,137.96001,138.265,97677440,140685299.2,34.01195616081573,39.740936821694106,NaN,NaN,-145.98087951115835,-129.0458593986104,-0.4761843919138984,-1.3354643551589334,-0.859279963245035,5685139213,5611831936.2,33.69883258535157,43.744430438033866,NaN,NaN,-22.38702102199899,-11.892949284859437
2012-11-13T09:30:00-05:00,137.53999,139.25,137.36,137.78999,123018192,140627115.2,32.65587267600512,38.819139079645275,NaN,NaN,-134.77446606467035,-152.3808528348773,-0.47717783946590786,-1.4557522625774197,-0.9785744231115119,5562121021,5557810486.6,30.212212172883568,41.081729343588414,NaN,NaN,-24.383857327662515,-13.67736471954559
2012-11-14T09:30:00-05:00,138.21001,138.42999,135.62,135.9299,191504944,144817909.6,27.95544740760772,38.10193405703144,NaN,NaN,-165.09894673212654,-157.69979495609755,-0.5625711843699366,-1.6817884035739326,-1.119217219203996,5370616077,5518348934.6,27.938257809835235,38.710621062925256,NaN,NaN,-27.737347779882043,-15.685933728165082
2012-11-15T09:30:00-05:00,135.98,136.4901,135.17999,135.7,178128368,148283556,27.429926262718084,37.441352456415835,NaN,NaN,-166.0601976147641,-155.65280429763538,-0.5910711586862534,-1.8580561675618128,-1.2669850088755594,5192487709,5479565158.6,25.87681781362842,36.90325033887416,NaN,NaN,-30.55606372775776,-17.810238013821177
2012-11-16T09:30:00-05:00,135.89999,136.64,134.7,136.37,239483808,153816043.2,31.47295006880502,36.90273415501178,NaN,NaN,-139.20739153671553,-150.22437629188698,-0.5236407683767585,-1.9215359693465075,-1.397895200969749,5431971517,5448467107.4,24.326842140025505,35.2563932137498,NaN,NaN,-31.663853176434802,-19.78932589419455
2012-11-19T09:30:00-05:00,137.89999,139.14999,136.4057,139.13,151495744,153985408.8,45.05325864875685,37.355564895220645,NaN,NaN,-61.2334582571508,-133.27489204108548,-0.2650454958715447,-1.7292020708091798,-1.464156574937635,5583467261,5428132717,23.34228691063886,33.75051116214619,NaN,NaN,-27.997497752118743,-20.961921873898007
2012-11-20T09:30:00-05:00,138.91,139.42,138.08,139.19,119807376,150693521.6,45.30700869543637,37.82652063876377,NaN,NaN,-33.79694913608674,-113.07938865536873,-0.07189137018782299,-1.554020787672414,-1.482129417484591,5703274637,5456363440.2,27.716206671339762,32.87107149261587,NaN,NaN,-25.09456059108885,-21.5522988334967
2012-11-21T09:30:00-05:00,139.31,139.57001,139.03,139.45,81710752,148500128,46.46084053520166,37.75984553665903,NaN,NaN,-13.40159859856219,-82.73991902865586,0.08304744177177481,-1.3783201152698723,-1.4613675570416471,5784985389,5539237302.6,38.76241581634918,32.80929356422663,NaN,NaN,-22.41285466494311,-21.675235380846186
2012-11-23T09:30:00-05:00,140.13,141.39999,140.03999,141.35001,65409152,142167769.6,54.08410698726375,38.62951693123597,NaN,NaN,44.13598227550424,-40.7006830506022,0.310383811814648,-1.073387792273337,-1.383771604087985,5850394541,5670818669,51.448705764379476,33.70082586890213,NaN,NaN,-17.473090558017816,-21.07492897758499
2012-11-26T09:30:00-05:00,140.64999,141.35629,140.19,141.05,100124320,141165020,52.80556851368768,39.29356930177247,NaN,NaN,43.1207829467237,-4.235048153914356,0.43007265627369606,-0.846180783745865,-1.276253440019561,5750270221,5734478409.8,56.17866448033929,35.01480427934619,NaN,NaN,-13.918107131407515,-20.05252585670249
2012-11-27T09:30:00-05:00,140.91,141.39,140.24001,140.33,128646192,140874464,49.765034300343416,39.32674470492001,NaN,NaN,37.60364293023752,15.53237208356332,0.44823282696775246,-0.7159624063098704,-1.1641952332776229,5621624029,5742109763.4,56.722960894424574,36.09457148403587,NaN,NaN,-11.864070307914805,-18.882746492589966
2012-11-28T09:30:00-05:00,139.75999,141.53999,139,141.46001,177086432,142427613.6,54.2203371970603,40.535627198564484,NaN,NaN,39.66041969722464,30.223845850225587,0.5188465086856116,-0.5156370974206084,-1.03448360610622,5798710461,5761196928.2,58.12396668429932,37.38176944035617,NaN,NaN,-8.702233667257916,-17.428387517542532
2012-11-29T09:30:00-05:00,141.99001,142.50999,141.37,142.12,151085872,144809982.4,56.63918379004716,42.23615365482311,NaN,NaN,87.14881414394765,50.33392839872756,0.5874572145479069,-0.30016208792133625,-0.8876193024692431,5949796333,5794159117,60.5019941312853,39.22090649156259,NaN,NaN,-5.328298448075941,-15.69980336476159
2012-11-30T09:30:00-05:00,142.14,142.42,141.66,142.155,136568320,146588620,56.769632574103085,43.902223129846575,NaN,NaN,91.70133324647443,59.846998592921594,0.6099914718411439,-0.1251299626678133,-0.7351214345089572,6086364653,5841353139.4,63.682006491553096,41.32372645473804,NaN,NaN,-2.5787002622214947,-13.82536006439872
2012-12-03T09:30:00-05:00,142.8,142.92,141.34,141.45,124656320,145936329.6,53.29179954011222,45.27935479979633,NaN,NaN,86.55488108529688,68.53381822063622,0.5538492556390132,-0.04280986496019068,-0.5966591205992039,5961708333,5883640761.8,66.30014504852547,43.65239163067903,NaN,NaN,-1.208853952669322,-12.023002048437377
2012-12-04T09:30:00-05:00,141.44,141.87,140.87,141.25,127622496,147398532.8,52.31270332821572,46.683414132097084,NaN,NaN,66.09306980263831,74.23170359511639,0.4823028035526858,0.006219383841653325,-0.47608341971103246,5834085837,5926133123.4,68.73884351072759,46.40429386909646,NaN,NaN,-0.34349185553981554,-10.354500592309154
2012-12-05T09:30:00-05:00,141.37,142.16,140.37,141.5,147300432,149410151.2,53.463641715951454,48.50542801126449,NaN,NaN,72.68567578818998,80.83675481330945,0.4324705411558521,0.06450475673378264,-0.36796578442206945,5981386269,5962668285,70.70199142103515,49.45884626989646,NaN,NaN,0.6951231611304753,-8.77598291324635
2012-12-06T09:30:00-05:00,141.37,142.03999,141.16,141.98,103220560,141355957.6,55.67560590506551,50.52297655714646,NaN,NaN,81.02127992846468,79.61124797021287,0.4125529765563677,0.1477254362733902,-0.2648275402829775,6084606829,5989630384.2,72.09470543556832,52.760123957177875,NaN,NaN,2.188346322875431,-7.209650165228953
2012-12-07T09:30:00-05:00,142.53,142.69,141.67,142.41499,108726320,137716411.2,57.640586883433635,52.39209347247707,NaN,NaN,90.76323007680602,79.42362733627918,0.40861675190786684,0.24594339960185607,-0.16267335230601077,6193333149,6011024083.4,73.18397438085363,56.24991911723703,NaN,NaN,4.005322055649414,-5.607511276532044
2012-12-10T09:30:00-05:00,142.21001,142.81,142.14999,142.47301,98840688,132605686.4,57.90862207671174,53.31033371733099,NaN,NaN,90.06985201176292,80.12662152157239,0.389914999969445,0.3247203976557955,-0.0651946023136495,6292173837,6077117184.2,76.26623950402274,60.03020144533588,NaN,NaN,5.600054529339127,-4.006430447121877
2012-12-11T09:30:00-05:00,143.06,144.11,142.99001,143.44,152570368,135350332.8,62.2014720872717,54.517081102462086,NaN,NaN,116.94735987915709,90.29747953687615,0.42005852504496194,0.45987855399255295,0.039820028947591,6444744205,6199248857.8,80.68439304077663,63.81364332886709,NaN,NaN,8.235713265508194,-2.25755277388901
2012-12-12T09:30:00-05:00,144,144.55,143.31,143.50999,145880000,136493423.2,62.49958946173678,55.662706025786015,NaN,NaN,119.31365821413254,99.62307602206465,0.4210353072761767,0.5661141630428119,0.1450788557666352,6590624205,6321096445,83.90376935132917,67.0380257242228,NaN,NaN,10.520572243100732,-0.43210634289047567
2012-12-13T09:30:00-05:00,143.42,143.83,142.27499,142.63,135714944,133703923.2,56.46913598894664,55.83306524019194,NaN,NaN,84.96351652101619,100.41152334057497,0.34209460670219227,0.5726971141443755,0.23060250744218327,6454909261,6395156931.4,85.48710091455288,69.4693396635209,NaN,NaN,10.955598252272617,1.1947085992756805
2012-12-14T09:30:00-05:00,142.32001,142.58,141.88,142.1051,137701680,131682588.8,53.173411848283486,55.859339764091644,NaN,NaN,50.44802978475769,92.3484832821653,0.23908268956996775,0.529455869404643,0.2903731798346752,6317207581,6419931817.8,85.98379381845469,71.59827747338628,NaN,NaN,10.421308518699785,2.5127943020505525
2012-12-17T09:30:00-05:00,142.47,143.85001,142.42999,143.77,143735744,126895185.6,60.95698963942558,56.65876514545465,NaN,NaN,106.42863885631648,95.620240651076,0.26558645756812116,0.6223562517948267,0.3567697942267055,6460943325,6453685715.4,86.65396093140717,73.73620604745646,NaN,NaN,12.277757165911611,3.9077889968878465
2012-12-18T09:30:00-05:00,144,145.5,143.78999,145.37,177762752,128208536,66.68769355103021,57.54929059930964,NaN,NaN,184.6541124216722,109.16159115957903,0.36713168491516096,0.8156844003706567,0.44855271545549574,6638706077,6492478089.8,87.3996250099947,75.82732449929185,NaN,NaN,15.856099814752442,5.614690542297074
2012-12-19T09:30:00-05:00,145.53,145.58,144.24001,144.28999,150895312,129762932.8,60.25824626806428,57.80779506202515,NaN,NaN,158.39081518865777,116.97702255448408,0.33851953199338947,0.8717021304472325,0.5331825984538431,6487810765,6471915401.8,84.69825846260471,77.55562909438609,NaN,NaN,16.742746384041975,7.204412805403488
2012-12-20T09:30:00-05:00,144.38,145.14,143.98,145.12,168486944,134101742.4,63.19504676023845,58.266753218177676,NaN,NaN,140.60294699489995,128.10490864926084,0.35094861077822503,0.9718683619266244,0.6209197511483994,6656297709,6512193091.4,85.63485654364953,79.12368981239298,NaN,NaN,18.442229620043182,8.809815207494873
2012-12-21T09:30:00-05:00,142.17,144.0881,141.94,142.78999,245883808,143125475.2,51.65518771605653,58.149852373602265,NaN,NaN,26.31914433654135,123.27913155961755,0.18598500875734192,0.8534010120950768,0.6674160033377349,6410413901,6530834355.4,86.06012842084618,80.53511719613017,NaN,NaN,15.794672873000165,9.807652016852773
2012-12-24T09:30:00-05:00,142.48,142.56,142.19,142.35001,53874544,140812986.4,49.805679898315326,57.970779271466526,NaN,NaN,-14.841468441070697,99.02511010014013,0.03867617737155338,0.7157612250521765,0.6770850476806232,6356539357,6509953561.8,83.09272874433303,81.56039471281629,NaN,NaN,13.099274910142256,10.27788385875127
2012-12-26T09:30:00-05:00,142.64,142.71001,141.35001,141.75,106947680,139728060.8,47.31754094500244,57.531772073541596,NaN,NaN,-49.973209510382105,52.09964571372925,-0.10014570502470632,0.5519029163997402,0.6520486214244465,6249591677,6432130681.8,72.9911502182094,81.72390605547159,NaN,NaN,10.105014911893134,10.253188294914393
2012-12-27T09:30:00-05:00,141.78999,142.08,139.92,141.5616,167920560,139269767.2,46.531491573513975,56.87862104985934,NaN,NaN,-106.16389779913752,-0.8112968838298003,-0.19987461882323443,0.4022053478954035,0.602079966718638,6081671117,6350902752.2,64.21604121377356,81.16114432534339,NaN,NaN,7.4885429967280075,9.858238966602052
2012-12-28T09:30:00-05:00,140.64,141.42,139.87,140.03,148806624,139155804.8,40.62333050037319,55.663102736783586,NaN,NaN,-144.11473147359604,-57.75483257752899,-0.35513719415892286,0.1581584740199844,0.5132956681789073,5932864493,6206216109,52.18201623430901,79.66100445773307,NaN,NaN,3.21338442381867,8.908974031918712
2012-12-31T09:30:00-05:00,139.66,142.56,139.53999,142.41,243952192,144524998.4,51.028813855165524,55.171687863816,NaN,NaN,-69.77869959604597,-76.97440136404644,-0.28662946863042443,0.1550088323908767,0.44163830102130114,6176816685,6159496665.8,48.9895609158332,77.7126702728624,NaN,NaN,3.002746616771418,8.06522725832624
2013-01-02T09:30:00-05:00,145.11,146.14999,144.73,146.06,192058944,147895129.6,62.021126940310836,55.15880606760451,NaN,NaN,165.382971263001,-40.92951342323211,0.00024357773936450888,0.4419427731955068,0.4416991954561423,6368875629,6161963920.2,49.16643146640216,75.46138730326422,NaN,NaN,7.245757514304037,7.948160152037354
2013-01-03T09:30:00-05:00,145.99001,146.37,145.34,145.7341,144761744,148752092,60.710767715687844,55.031033085743864,NaN,NaN,150.12574137407535,-0.9097232463406157,0.15521221291172327,0.6357144615957964,0.4805022486840731,6224113885,6156868361.8,48.790168634660056,72.95327296635928,NaN,NaN,9.87668698567736,8.223663985414497
2013-01-04T09:30:00-05:00,145.97,146.61,145.67,146.37,116817680,147227954.4,62.38089040849772,55.45330125856895,NaN,NaN,146.43594189700937,49.61024469288876,0.2804080756597406,0.8310123432587488,0.5506042675990083,6340931565,6208720451.4,52.75258279557374,70.61509310071791,NaN,NaN,12.499429583426483,8.834487642273352
2013-01-07T09:30:00-05:00,145.85001,146.4442,145.42999,145.9695,110002432,147567048,60.632733694678244,55.98610996188286,NaN,NaN,116.90378202462685,101.81394739253334,0.31360023393923864,0.9426045600230566,0.629004326083818,6230929133,6268333379.4,56.883173676662274,68.53647737630418,NaN,NaN,13.977204956582387,9.5691615443175
2013-01-08T09:30:00-05:00,145.71001,145.91,144.98,145.54961,121265056,148193984.8,58.773109632127735,55.83011853279015,NaN,NaN,84.50832494097922,132.67135229993838,0.2854340820120099,0.9857969285988304,0.7003628465868205,6109664077,6254902857.8,55.70165839190138,66.32559862348234,NaN,NaN,14.577694661477395,10.284666275340342
2013-01-09T09:30:00-05:00,145.87,146.32001,145.64,145.92,90745568,147789228.8,59.94028017900123,55.348160434788085,NaN,NaN,94.35486603641792,118.46573125462176,0.2700695075331111,1.0379497310032093,0.7678802234700982,6200409645,6221209661,52.74197060696899,63.85005188040907,NaN,NaN,15.415787566443923,11.017683602640854
2013-01-10T09:30:00-05:00,146.73,147.09,145.97,147.08,130735376,146697479.2,63.43199252280251,55.574856595840814,NaN,NaN,110.51424303568517,110.54343158694371,0.31330967266398146,1.159517314300075,0.8462076416360935,6331145021,6242615888.2,54.39975315550281,61.68587292990179,NaN,NaN,17.208831458740686,11.902133296369401
2013-01-11T09:30:00-05:00,147.03999,147.14999,146.61,147.07001,113917312,145099344.8,63.38075594108483,55.58812153732985,NaN,NaN,105.3870115950605,102.33364552655394,0.31563530770253423,1.2407517762642613,0.925116468561727,6217227709,6217875117,52.1238879121756,59.29223231336795,NaN,NaN,18.63016199348818,12.863280253100655
2013-01-14T09:30:00-05:00,146.89,147.07001,146.42999,146.97,89567120,142791953.6,62.83358096453435,56.3865781979354,NaN,NaN,91.76814763717843,97.30651864906426,0.2857303314841817,1.282279382916954,0.9965490514327724,6127660589,6197221408.2,50.234499724582314,56.73325883506339,NaN,NaN,19.64849039685915,13.832595987923296
2013-01-15T09:30:00-05:00,146.28999,147.21001,146.2,147.07001,93172560,140565497.6,63.17594263370236,57.34159696474876,NaN,NaN,85.71480666662661,97.54781499419371,0.24930507270375424,1.3081803923124653,1.058875319608711,6220833149,6219455222.6,52.241447887649855,54.52959591672887,NaN,NaN,20.58808348799568,14.79766563079078
2013-01-16T09:30:00-05:00,146.77,147.28,146.61,147.05,104849504,138621185.6,63.05079767880622,58.46540101716332,NaN,NaN,85.05914583589575,95.68867095408929,0.2024748866861319,1.311968927966376,1.109494041280244,6115983645,6202570022.6,50.57340619143307,52.92832848624486,NaN,NaN,21.344554889317195,15.732935524865981
2013-01-17T09:30:00-05:00,147.7,148.42,147.14461,148,133833440,136424720,66.44885116904824,59.88806955970149,NaN,NaN,105.44145691681902,94.67411373031607,0.21302030044393994,1.375769416835169,1.1627491163912291,6249817085,6186304435.4,48.951933031988325,51.838035044688766,NaN,NaN,22.937371230092634,16.762140625612645
2013-01-18T09:30:00-05:00,147.97,148.49001,147.42999,148.33,169905936,137375251.2,67.5647315912355,61.812455351905946,NaN,NaN,101.97213263947263,93.99113793919848,0.21892235265505322,1.4364020572100458,1.2174797045549925,6419723021,6226803497.8,52.99311955402792,51.89597099609727,NaN,NaN,24.599730795842454,17.881796364216903
2013-01-22T09:30:00-05:00,148.33,149.13,147.98,149.13,111797312,134540769.6,70.15608577586588,63.178689060527404,NaN,NaN,112.20837595080341,98.07918360192349,0.25109997414512897,1.5313546722364038,1.2802546980912748,6531520333,6307575446.6,59.82426726942444,52.669878592782354,NaN,NaN,26.794858271543937,19.15509092240648
2013-01-23T09:30:00-05:00,149.13,149.5,148.86,149.37,104596064,127476382.4,70.90702257647992,63.813395891682326,NaN,NaN,121.75672562189463,105.2875673929771,0.2617496099561165,1.6074417105364205,1.345692100580304,6636116397,6390632096.2,65.39342364514417,53.82894946269249,NaN,NaN,28.860375522640453,20.541560151011332
2013-01-24T09:30:00-05:00,149.14999,150.14,149.00999,149.41,146426320,132103971.2,71.03782392678272,64.5510427639034,NaN,NaN,125.62717592039822,113.40117340987759,0.24498753683180086,1.6519265216200552,1.4069389847882543,6782542717,6523943910.6,72.0826850387768,55.49270063441512,NaN,NaN,30.63200581027083,21.983052388048403
2013-01-25T09:30:00-05:00,149.88,150.25,149.3726,150.25,147211568,134117165.6,73.71085773758736,65.36032614455266,NaN,NaN,132.33537818259185,118.77995766303215,0.26241878607289704,1.7349624673793755,1.4725436813064785,6929754285,6659931350.6,76.97239541644967,57.22268725019196,NaN,NaN,32.968464932191296,23.552397037211673
2013-01-28T09:30:00-05:00,150.28999,150.33,149.50999,150.07001,113357632,131389019.2,72.17374307205446,66.18468395722239,NaN,NaN,127.82287861158845,123.95010685745532,0.23467648803619823,1.7658892913517263,1.5312128033155281,6816396653,6739266077,79.2551963054139,58.82068886653137,NaN,NaN,34.55760326295888,25.12456935517556
2013-01-29T09:30:00-05:00,149.77,150.85001,149.67,150.66,105694368,129233406.4,74.08167423885277,67.27815285770275,NaN,NaN,132.4232691077023,127.99308548883509,0.2286780324277955,1.8170603438502724,1.5883823114224769,6922091021,6817380214.6,81.22839851351067,60.64402744664632,NaN,NaN,36.48141803012873,26.746976308740297
2013-01-30T09:30:00-05:00,150.64,150.94,149.92999,150.07001,137447632,123908178.4,68.987617894775,67.9243912659723,NaN,NaN,117.11736166379603,127.06521269721539,0.16079787451591399,1.7893796545673695,1.6285817800514555,6784643389,6847085613,81.93221213596533,62.72904469871749,NaN,NaN,36.80511308084154,28.183852990469045
2013-01-31T09:30:00-05:00,149.89,150.38,149.60001,149.7,108975808,119754021.6,65.92591788914731,68.1025287921398,NaN,NaN,88.33361075990808,119.60649966511735,0.07136197329689908,1.7177842466725792,1.6464222733756801,6675667581,6825710585.8,79.61892972329639,64.53041445355989,NaN,NaN,36.254107667648015,29.336746515780327
2013-02-01T09:30:00-05:00,150.64999,151.42,150.39,151.24001,131173008,119074584.8,71.57943765954519,68.68814891488697,NaN,NaN,121.53594336248051,117.44661270109509,0.09483409337768522,1.7649648900977866,1.6701307967201013,6806840589,6801127846.6,76.92881202233528,66.30219474714272,NaN,NaN,37.40187834258004,30.488908205323142
2013-02-04T09:30:00-05:00,150.32001,151.2679,149.42999,149.535,159073568,121187379.2,59.75780501815501,68.46845063300272,NaN,NaN,73.62312010908678,106.60666100059476,-0.019461415026523543,1.645804027936947,1.6652654429634706,6647767021,6767401920.2,73.27112850759212,67.94766823164342,NaN,NaN,34.54226312356804,31.067958907929555
2013-02-05T09:30:00-05:00,150.35001,151.48,150.28999,151.05,113912320,121382873.6,65.24965519971954,68.61657295914681,NaN,NaN,100.45509471557114,100.21302612216851,-0.00857757237673451,1.6545434774925525,1.663121049869287,6761679341,6735319584.2,69.86797130774984,69.20670561879342,NaN,NaN,33.91513444826737,31.474698270834956
2013-02-06T09:30:00-05:00,150.52,151.25999,150.41,151.16,138762752,122257758.4,65.61655806652274,68.79984155826942,NaN,NaN,93.78990243314453,95.5475342760382,-0.009448554271032528,1.6513103570304963,1.6607589113015289,6900442093,6758479325,70.91805747353993,70.65989499608676,NaN,NaN,33.54757653299913,31.77082373685841
2013-02-07T09:30:00-05:00,151.205,151.35001,149.86,150.96001,162490000,125844980,64.28757541285829,68.64546471854156,NaN,NaN,78.43219487669184,93.56725109939497,-0.037402876591034584,1.6140053155627356,1.6514081921537702,6737952093,6770936227.4,71.49349942794301,72.2700068815121,NaN,NaN,32.84344536246639,31.92405539765955
2013-02-08T09:30:00-05:00,151.22,151.89,151.22,151.8,103133680,124464895.2,67.28471578166202,68.62546358928633,NaN,NaN,115.3100650899751,92.32207544489388,-0.014412757491359729,1.6333922452895706,1.6478050027809303,6841085773,6777785264.2,71.82361612206876,73.61504235065787,NaN,NaN,33.1631772395071,32.10107280363777
2013-02-11T09:30:00-05:00,151.74001,151.89999,151.3938,151.77,73774944,122457776.8,67.06822650389789,68.40490221271718,NaN,NaN,111.67548605422155,99.93254863392085,-0.016184709255278484,1.6275741162118322,1.6437588254671107,6767310829,6801694025.8,72.99909327940104,74.55610135137049,NaN,NaN,33.35555261597789,32.28028420540065
2013-02-12T09:30:00-05:00,151.78,152.3,151.61,152.02,65392608,121249051.2,67.99244758839593,68.19671828499689,NaN,NaN,122.63225185632629,104.36798006207187,-0.015478324580801228,1.6244109197411092,1.6398892443219104,6832703437,6815898845,73.70108199616291,75.1495055193004,NaN,NaN,33.77676114972839,32.4940666260189
2013-02-13T09:30:00-05:00,152.33,152.61,151.72,152.151,82322560,120706551.2,68.49145282302908,68.01483463472877,NaN,NaN,127.6140954228502,111.132818660013,-0.020814620253614136,1.6138709690048927,1.6346855892585068,6915025997,6818815625.8,73.85141445136033,75.27584333448495,NaN,NaN,34.2631333690019,32.74679044644504
2013-02-14T09:30:00-05:00,151.69,152.47,151.52,152.28999,80834192,119505785.6,69.04290739925139,67.68140961056191,NaN,NaN,115.96263701555831,118.63890708778631,-0.0291012696011399,1.598309002257082,1.627410271858222,6995860189,6870397245,76.41861629560135,75.23628768299578,NaN,NaN,34.81872010397766,33.04278039752113
2013-02-15T09:30:00-05:00,152.42999,152.59,151.55,152.11,215226432,123575435.2,67.39786531396615,67.34027548498419,NaN,NaN,105.6371568872432,116.70432544723992,-0.05909297434684335,1.5535440539246679,1.6126370282715112,6780633757,6858306841.8,74.57058275885336,74.90167242967001,NaN,NaN,34.86635515611,33.303291077319535
2013-02-19T09:30:00-05:00,152.37,153.28,152.1629,153.25,95105376,119835407.2,71.95556580308019,67.18841059671472,NaN,NaN,149.4054988022522,124.25032799684604,-0.016743409693120714,1.5917077661551104,1.6084511758482312,6875739133,6879992502.6,75.70542762460376,74.5071745090338,NaN,NaN,36.19985032564326,33.7170852556515
2013-02-20T09:30:00-05:00,153.14,153.19,151.25999,151.34,160574816,122274282.4,57.46150868469882,66.36511708170927,NaN,NaN,73.11837354386392,114.34755233435358,-0.12587748604793236,1.4511043182883157,1.576981804336248,6715164317,6856484678.6,71.95660241280724,73.79463095737967,NaN,NaN,32.77268849554652,33.582171432779354
2013-02-21T09:30:00-05:00,150.96001,151.4218,149.94,150.42,183256944,126207326.4,52.02549047706842,65.37222940941793,NaN,NaN,-36.555500690650824,81.51363311165338,-0.2607711978104865,1.25101780707314,1.5117890048836264,6531907373,6779860953.8,61.30114130837449,72.48621749917096,NaN,NaN,28.04423166800775,32.79103718066912
2013-02-22T09:30:00-05:00,151.14999,151.89,150.4913,151.89,106356496,124203835.2,58.74176865642852,64.45525305205246,NaN,NaN,25.049230568246863,63.33095182219107,-0.25162063189503825,1.1972632150148286,1.4488838469098668,6638263869,6708341689.8,53.35874321896582,70.80264115607314,NaN,NaN,26.196992292970638,31.849030768140768
2013-02-25T09:30:00-05:00,152.63,152.86,149,149,245824752,129134494.4,45.3113315212885,63.42336208799056,NaN,NaN,-76.70814720981713,26.86189100277901,-0.43033711104558403,0.9109624581028868,1.3412995691484708,6392439117,6630702761.8,46.33970604784303,68.87896812323392,NaN,NaN,19.103589966193592,30.028253510719743
2013-02-26T09:30:00-05:00,149.72,150.2,148.73,150.02,186596192,132796422.4,49.68390457673809,62.3115227577776,NaN,NaN,-129.24909751704075,-28.86902826107958,-0.46692851045058537,0.7576389310852392,1.2245674415358245,6579035309,6571361997,41.812442464882125,66.8750017773148,NaN,NaN,15.26670826682644,27.9194613330207
2013-02-27T09:30:00-05:00,149.89,152.33,149.75999,151.91,150781872,135050797.6,56.6070742256327,61.667988197714024,NaN,NaN,13.551696474032676,-40.78236367504583,-0.3559348896235741,0.7796488295063568,1.135583719129931,6729817181,6574292569.8,42.11322038624431,64.81751341393654,NaN,NaN,14.799928793798234,26.04524239884606
2013-02-28T09:30:00-05:00,151.89999,152.87,151.41,151.61,126865936,134521712.8,55.30625652041605,61.02646541968244,NaN,NaN,64.02918396185237,-20.665426744545197,-0.2972057424731742,0.7640765410384631,1.0612822835116373,6602951245,6588501344.2,43.63453046593084,62.8275870595071,NaN,NaN,13.984160183811031,24.322230653841057
2013-03-01T09:30:00-05:00,151.09,152.34,150.41,152.11,170634752,137604660,57.0766616351553,60.29731869493196,NaN,NaN,27.0725518114301,-20.26076249590855,-0.22258211077129864,0.783054645047514,1.0056367558188126,6773585997,6615565769.8,46.51773230138633,61.02002392945836,NaN,NaN,13.954648399116845,22.84114747459474
2013-03-04T09:30:00-05:00,151.75999,152.92,151.52,152.92,99010192,135996519.2,59.85124455704097,59.78181998444217,NaN,NaN,100.32807497408966,15.146481940872809,-0.12161723272574798,0.8536152149116276,0.9752324476373756,6872596189,6711597184.2,55.26223969840081,59.753105816529775,NaN,NaN,14.860592628949679,21.70106821093116
2013-03-05T09:30:00-05:00,153.66,154.7,153.64,154.28999,121663056,134125993.6,64.08039235292085,59.50238746762253,NaN,NaN,240.23292088930316,89.0428856221416,0.026579526304845058,1.008456855518432,0.9818773292135868,6994259245,6794641971.4,61.174178432892724,58.85832699058191,NaN,NaN,17.075207307304208,21.040230938984454
2013-03-06T09:30:00-05:00,154.84,154.92,154.16,154.5,94469872,133153871.2,64.69434143377262,59.231165225532784,NaN,NaN,220.95175051066875,130.5228964294688,0.12252380051919687,1.135032079862583,1.0125082793433862,7088729117,6866424358.6,65.42705053159223,58.25658671059847,NaN,NaN,19.00634490708718,20.749675791570557
2013-03-07T09:30:00-05:00,154.7,154.98,154.52,154.776,86101312,130520799.2,65.52824898046634,58.98011819561957,NaN,NaN,200.31252210487568,157.77956405807348,0.1846197432647898,1.2432829584243734,1.0586632151595836,7174830429,6980800195.4,70.89718218460517,57.862198559813024,NaN,NaN,20.816066080644134,20.759160118581068
2013-03-08T09:30:00-05:00,155.46001,155.64999,154.66,155.44,123487632,128570680.8,67.51610690069883,58.98856402324333,NaN,NaN,187.73751023254795,189.91255574229703,0.24658550349113284,1.3668950945234997,1.1203095910323668,7298318061,7085746608.2,74.83202680484057,57.8808731345264,NaN,NaN,22.94100874271929,21.07085277917224
2013-03-11T09:30:00-04:00,155.325,156.03999,155.13,156.03,83746688,127601331.2,69.2148654963303,58.79279971561834,NaN,NaN,171.85252244125158,204.21744523572943,0.2999367949277485,1.4952305846920524,1.195293789764304,7382064749,7187640320.2,77.94932849669937,58.04115176824751,NaN,NaN,25.23544848568268,21.665795022959447
2013-03-12T09:30:00-04:00,155.92,156.10001,155.21001,155.67999,105755680,129200368,66.97715741341926,59.472488910526934,NaN,NaN,138.23589741135538,183.81804054013986,0.2844190825691748,1.5508176429757725,1.2663985604065977,7276309069,7244050285,79.46569352650744,58.57751541922609,NaN,NaN,26.501655518426816,22.356632236597644
2013-03-13T09:30:00-04:00,155.75999,156.12,155.23,155.905,92550880,130558281.6,67.70011216422316,60.5921047453237,NaN,NaN,120.39627326727565,163.70694509146125,0.2625972613969243,1.594645137152753,1.3320478757558287,7368859949,7300076451.4,80.87257711014463,59.97547511935253,NaN,NaN,27.755857906468158,23.127950189436287
2013-03-14T09:30:00-04:00,156.31,156.8,155.90781,156.73,126329872,132758647.2,70.27007742083222,61.41555537135253,NaN,NaN,126.91187429826729,149.02681553013957,0.2756595307131344,1.6766222891472466,1.4009627584341122,7495189821,7364148329.8,82.36095883614584,62.0470619491511,NaN,NaN,29.594999121224085,24.05181432254883
2013-03-15T09:30:00-04:00,155.85001,156.03999,155.31,155.83,138601056,135646990.4,64.26303480049405,62.76924846272436,NaN,NaN,87.38256652489696,128.9558267886094,0.1991879724722534,1.649947724024429,1.4507597515521755,7356588765,7375802470.6,82.62578479514839,64.63892471681577,NaN,NaN,29.47297197022537,24.826265415074047
2013-03-18T09:30:00-04:00,154.34,155.64,154.2,154.97,126704256,131220881.6,59.06695855189745,63.43946660380718,NaN,NaN,54.08370823503639,105.40206394736632,0.07270582799519132,1.5416420365461647,1.4689362085509734,7229884509,7345366422.6,79.27819661801186,67.3150500134679,NaN,NaN,27.825861774750404,25.254779180742098
2013-03-19T09:30:00-04:00,155.3,155.50999,153.59,154.61,167567248,134843975.2,56.98965923941846,63.46679410479187,NaN,NaN,38.073972363973205,85.36967893788989,-0.046748459433378464,1.4105006342592503,1.4572490936926288,7062317261,7302568061,74.69536750872923,69.64234623650253,NaN,NaN,25.851154194886732,25.33997561133419
2013-03-20T09:30:00-04:00,155.52,155.95,155.25999,155.69,113759248,132503196.8,61.377953019689635,63.90048671188284,NaN,NaN,67.85139327266592,74.86070293896796,-0.06353184598757844,1.3778342862081558,1.4413661321957343,7176076509,7264011373,70.72863912910597,71.57763971244361,NaN,NaN,25.395373312210463,25.347889568602227
2013-03-21T09:30:00-04:00,154.75999,155.6389,154.10001,154.35899,128604944,129770596.8,54.057751534334855,63.684850276109955,NaN,NaN,31.8840130076227,55.85513068083905,-0.1688035117960982,1.2303617424506115,1.3991652542467097,7047471565,7174467721.8,62.43598547779662,72.71465779647292,NaN,NaN,22.683591957941797,24.967275624222165
2013-03-22T09:30:00-04:00,154.85001,155.60001,154.73,155.60001,111163504,130010947.2,58.971151399208196,63.6219864791219,NaN,NaN,50.70101045780163,48.51881946741999,-0.15949371884570285,1.199798105689581,1.3592918245352839,7158635069,7134876982.6,59.13469253800933,72.99126157073067,NaN,NaN,21.905360968778016,24.529859244873002
2013-03-25T09:30:00-04:00,156.00999,156.27,154.35001,154.95,151322256,125285822.4,55.61612070926585,63.01739564743226,NaN,NaN,42.4338041071195,46.18883864183661,-0.19917212044874222,1.110326673974356,1.3094987944230982,7007312813,7090362643.4,55.57648579885225,72.59142638258493,NaN,NaN,20.199542569334017,23.91124257693886
2013-03-26T09:30:00-04:00,155.59,156.23,155.42,156.19,86856560,120298840.8,60.260863279844166,62.70071863643737,NaN,NaN,79.2046217478082,54.41496851860359,-0.1464053896184443,1.1264920574000428,1.272897447018487,7094169373,7096733065.8,55.98466030418595,71.91696993777019,NaN,NaN,20.229884455671428,23.385334273900657
2013-03-27T09:30:00-04:00,155.25999,156.245,155,156.19,99950560,117757275.2,60.26086327984417,62.324476800678646,NaN,NaN,68.78143199363173,54.60097626279675,-0.11726217559798369,1.1263197275210075,1.2435819031189912,7094169373,7080351638.6,54.595482417567645,70.75256281155323,NaN,NaN,20.25370267689184,22.937958331470828
2013-03-28T09:30:00-04:00,156.09,156.85001,155.75,156.67,102932816,116560619.2,62.04408276255791,61.93361793366858,NaN,NaN,108.87549917413996,69.9992734961002,-0.07355371683580447,1.1516397570742356,1.22519347391004,7197102189,7110277763.4,56.70883295077832,69.45804896483449,NaN,NaN,20.803049468403152,22.632971351032587
2013-04-01T09:30:00-04:00,156.59,156.91,155.67,156.05,99194064,112988584.8,58.39884575326283,61.16104509487804,NaN,NaN,92.95661760785484,78.45039492611085,-0.09303910087868483,1.108894597811684,1.2019336986903688,7097908125,7098132374.6,55.57819761748786,67.86011104489081,NaN,NaN,20.19828327940372,22.28515876937132
2013-04-02T09:30:00-04:00,156.61,157.21001,156.37,156.82001,101504320,113113291.2,61.42971764295262,60.76479939698756,NaN,NaN,149.4248379390667,99.84860169250028,-0.062192459480025386,1.1241931243403371,1.1863855838203625,7199412445,7136552301,58.403460329105364,66.35566581650495,NaN,NaN,20.576345000221625,22.04104251663565
2013-04-03T09:30:00-04:00,156.91,157.03,154.82001,155.23,154167312,114738504,52.86490564473119,59.70514178845242,NaN,NaN,17.63183073155935,87.53404348925052,-0.15188492530935083,0.996529427183674,1.1484143524930248,7045245133,7126767453,57.40214011236553,64.6792060309493,NaN,NaN,18.19908497957035,21.492191439912034
2013-04-04T09:30:00-04:00,155.42999,156.17,155.09,155.86,131884944,116609257.6,55.511644222881685,58.650967988598815,NaN,NaN,13.36331437396897,76.45041996531796,-0.17040511273025127,0.9354079615802107,1.105813074310462,7177130077,7143359593.8,58.695342376417344,62.98880485525441,NaN,NaN,17.0526661713101,20.85797354439747
2013-04-05T09:30:00-04:00,153.95,155.35001,153.77,155.158,159665936,120287488.8,52.007258714789835,57.77555541104851,NaN,NaN,-124.29965940446463,29.815388249597042,-0.2279617765369386,0.8208608536392887,1.0488226301762273,7017464141,7107431984.2,54.814844552746806,61.0023091236543,NaN,NaN,15.006254009697656,20.022013610868925
2013-04-08T09:30:00-04:00,155.27,156.22,154.75,156.21001,86571120,118441663.2,56.44473350945717,57.58825362230277,NaN,NaN,13.437218527822404,13.911508433590551,-0.1945121405419472,0.8056824544987933,1.0001945950407405,7104035261,7108657411.4,54.92430824189333,59.262745668217256,NaN,NaN,14.633875679232263,19.252279620635115
2013-04-09T09:30:00-04:00,156.5,157.32001,155.98,156.75,101922128,119350435.2,58.56262223967946,57.70060812232141,NaN,NaN,140.6632746541388,12.15919577660498,-0.13800759182190758,0.827685105263356,0.9656926970852636,7205957389,7109966400.2,55.049576542411735,57.85947488490887,NaN,NaN,14.978814242298903,18.641784566587084
2013-04-10T09:30:00-04:00,157.17,158.87,157.13,158.67,135711008,120848201.6,65.06690892390901,57.9641049726228,NaN,NaN,264.7182265773737,61.57647494576785,0.0183688291959323,0.988653733580179,0.9702849043842467,7341668397,7169251053,60.41517912830706,57.12279917056609,NaN,NaN,17.47319678280658,18.47484345461844
2013-04-11T09:30:00-04:00,158.7,159.71001,158.53999,159.19,110142496,121727782.4,66.5961997617249,58.85970841743637,NaN,NaN,260.98545808608395,111.10090368819083,0.13975889891869153,1.1449835280326113,1.0052246291139197,7451810893,7224187216.2,64.62862470430333,57.279416258173704,NaN,NaN,19.98095232293195,18.690001864377514
2013-04-12T09:30:00-04:00,158.67999,159.03999,157.92,158.8,116359808,121229279.2,64.32184853047227,59.24190106966952,NaN,NaN,176.20655269559782,171.20214610820332,0.17446412053049487,1.2233047797770382,1.0488406592465433,7335451085,7287784605,68.77254117265787,57.96783401779146,NaN,NaN,21.315144692266102,19.0650222683616
2013-04-15T09:30:00-04:00,158,158.13,155.10001,155.118,217258944,125162173.6,47.74392685253084,58.679601508474164,NaN,NaN,0.5260049242907884,168.619903387497,-0.057467734662537406,0.9770059909183715,1.0344737255809089,7118192141,7290615981,68.94696509281283,58.922868253074355,NaN,NaN,16.522714908319404,18.701835502641284
2013-04-16T09:30:00-04:00,156.28999,157.49001,155.91,157.41,147507808,126202351.2,55.442464543168,58.33543017014016,NaN,NaN,51.959790992297506,150.87920665512874,-0.06298658864127415,0.9557404897793162,1.0187270784205904,7265699949,7302564493,69.71571950180127,59.90365819576117,NaN,NaN,15.415938392347822,18.23242162974222
2013-04-17T09:30:00-04:00,156.28999,156.32001,154.28,155.11,226834752,129165726.4,47.82781506030864,57.44735529731618,NaN,NaN,-73.59977134813583,83.21560707002683,-0.21921200543690222,0.7447120716244626,0.9639240770613648,7038865197,7242003853,61.41662296778102,60.39088252077641,NaN,NaN,11.502784446327793,17.271044889254444
2013-04-18T09:30:00-04:00,155.37,155.41,153.55,154.14,167583120,131856920,45.0195559409155,56.23131766719887,NaN,NaN,-126.08422743535871,5.8016699657383075,-0.37633066025628137,0.4935107517410131,0.8698414119972945,6871282077,7125898089.8,49.29969917514609,59.86165867965982,NaN,NaN,7.4608928909571475,15.869594603783401
2013-04-19T09:30:00-04:00,154.5,155.55,154.12,155.48,149687568,132911051.2,49.436402850589545,55.59114317415078,NaN,NaN,-80.94074184342034,-45.62778894206532,-0.3774962227347447,0.3979711335788636,0.7754673563136083,7020969645,7063001801.8,44.21114789376136,59.049726556536505,NaN,NaN,5.846915742745791,14.437783337920886
2013-04-22T09:30:00-04:00,155.78,156.53999,154.75,156.17,106553440,132680548,51.592867942210916,54.88851105266923,NaN,NaN,-28.956072151089963,-51.52420435714148,-0.3214733987664854,0.3736256078555016,0.695099006621987,7127523085,7064867990.6,44.39454081348281,58.049089448277755,NaN,NaN,5.334268628296647,13.137281236545995
2013-04-23T09:30:00-04:00,156.95,157.92999,156.17,157.78,166141248,133421497.6,56.27842992975838,55.13233421588546,NaN,NaN,67.9766746864248,-48.32082761831602,-0.1730978574869252,0.47872668476333047,0.6518245422502557,7293664333,7070460867.4,44.978299698410964,57.161672275852425,NaN,NaN,6.532670451716011,12.193765410141712
2013-04-24T09:30:00-04:00,157.83,158.3,157.53999,157.88,96781184,133917728.8,56.55968741133699,55.20719444363227,NaN,NaN,97.06114003991219,-14.188645340706415,-0.07058566055228743,0.5635924665598964,0.6341781271121838,7390445517,7140776931.4,51.82583460579875,56.67099314937967,NaN,NaN,7.546438451083214,11.52986155884764
2013-04-25T09:30:00-04:00,158.34,159.27,158.10001,158.52,131060560,135473228.8,58.4039594610715,55.66410163979525,NaN,NaN,123.81343809450264,35.79088776526586,0.03242883937087593,0.6747141763257787,0.6422853369549028,7521506077,7270821731.4,61.39487402350761,57.14099525443401,NaN,NaN,8.9478060516055,11.160996486384478
2013-04-26T09:30:00-04:00,158.33,158.60001,157.73,158.24001,95918752,135122525.6,57.25865638924763,55.722238988351705,NaN,NaN,86.36687566189698,69.25241126632932,0.0715724583464149,0.7317509098879214,0.6601784515415065,7425587325,7351745267.4,65.93003194170322,57.92711837584901,NaN,NaN,9.74488693655495,10.958695122123117
2013-04-29T09:30:00-04:00,158.67,159.64999,158.42,159.3,88572688,134591456.8,60.42287383731613,55.85511410246862,NaN,NaN,120.65130054528795,99.1738858056049,0.1539823383923179,0.8526563745319038,0.6986740361395859,7514160013,7429072653,69.60454087280738,58.96675868516298,NaN,NaN,11.377006520082983,11.018453893260242
2013-04-30T09:30:00-04:00,159.27,159.72,158.61,159.67999,116010624,135316772,61.522586200090494,55.60194819362444,NaN,NaN,113.89179977523136,108.35691082336623,0.21544364228986423,0.9679785890019161,0.7525349467120519,7630170637,7496373913.8,72.39508299902911,59.82246610450027,NaN,NaN,13.042867898891375,11.30765589406469
2013-05-01T09:30:00-04:00,159.33,159.41,158.10001,158.28,138874128,134552112.8,55.413352649235755,54.80317339987521,NaN,NaN,71.01328297044768,103.1473394094733,0.14646767650594494,0.9356195423444831,0.7891518658385381,7491296509,7516544112.2,73.18951405650068,60.433958201085794,NaN,NaN,12.710483603867221,11.508059852607909
2013-05-02T09:30:00-04:00,158.67999,159.89,158.53,159.75,96407568,132778244,59.91443760720973,54.488358333927884,NaN,NaN,97.39219692659043,97.86309117589087,0.18217421869723793,1.0168696392100856,0.8346954205128476,7587704077,7529783712.2,73.72405079515184,60.78763745983537,NaN,NaN,13.800905289213222,11.835609200694382
2013-05-03T09:30:00-04:00,161.14,161.88,159.782,161.368,144202256,132005060,64.19853255117889,55.663687312402736,NaN,NaN,154.11947465188652,111.41361097388877,0.29065173525682153,1.1980100895838746,0.907358354327053,7731906333,7591047513.8,76.09874325192882,61.29847875691509,NaN,NaN,16.12031848007371,12.44771052632
2013-05-06T09:30:00-04:00,161.49001,162.00999,161.42,161.78,66882064,131020607.2,65.21789891973589,56.36193262501473,NaN,NaN,166.90103545449466,120.66355795573013,0.3614275614122039,1.3591428060923079,0.997715244680104,7798788397,7647973190.6,78.08099470202674,61.89599841407405,NaN,NaN,18.309315877817983,13.28508271939114
2013-05-07T09:30:00-04:00,162.13,162.64999,161.67,162.5999,90359184,130442460,67.21826621642336,57.7469648504515,NaN,NaN,168.19364212021898,131.52392642472765,0.43006997121627055,1.535302708700442,1.1052327374841715,7889147581,7699768579.4,79.72837598650982,63.20398077255469,NaN,NaN,20.75622601615156,14.352388904642629
2013-05-08T09:30:00-04:00,162.42,163.39,162.33,163.34,97419184,128527868.8,68.95396468874995,59.45656547529681,NaN,NaN,166.00751636048355,150.52277310273482,0.4877039824030711,1.7148627154880103,1.2271587330849392,7986566765,7798822630.6,82.44559816086687,65.57154498582045,NaN,NaN,23.33301480575322,15.635335461944141
2013-05-09T09:30:00-04:00,163.27,163.7,162.47,162.881,106738560,128357672,66.59882907192454,60.68245306253503,NaN,NaN,145.34701233102788,160.1137361836223,0.45778153579055525,1.7993856528231333,1.341604117032578,7879828205,7857247456.2,83.82295265292117,68.40095961147472,NaN,NaN,24.79980085169023,16.944544803336438
2013-05-10T09:30:00-04:00,162.99001,163.5498,162.50999,163.41,103202880,127699825.6,67.95718928494404,61.85133315844454,NaN,NaN,127.09650211926517,154.70914167709805,0.43655745690789116,1.8873009381674422,1.450743481259551,7983031085,7907472406.6,84.91845262784013,71.29552474107167,NaN,NaN,26.42252764470995,18.298542352104082
2013-05-13T09:30:00-04:00,163.2,163.81,162.82001,163.53999,81843184,120929037.6,68.29836170965045,62.70989971415111,NaN,NaN,118.13534108076422,144.95600280235197,0.39543905889844355,1.9450423048826053,1.5496032459841618,8064874269,7960689581,86.00026029442814,74.22566478364433,NaN,NaN,27.858716793030457,19.66428155795071
2013-05-14T09:30:00-04:00,163.67,165.35001,163.67,165.23,119000816,119503688,72.41118770728393,63.842149735290185,NaN,NaN,133.65386245046253,138.04804686840066,0.4426623277504267,2.102931155672195,1.6602688279217683,8183875085,8019635081.8,87.10370984379475,76.74551301492976,NaN,NaN,30.396469703452823,21.19745129302244
2013-05-15T09:30:00-04:00,164.96001,166.45,164.91,166.11501,120718432,114197872,74.29210110448821,64.97701699553423,NaN,NaN,139.6522277465148,132.77698914560693,0.49039878378310986,2.2732673076506558,1.782868523867546,8304593517,8083240432.2,88.18580242879239,78.65915075816439,NaN,NaN,33.135980435041354,22.902955456167998
2013-05-16T09:30:00-04:00,165.78,166.36,165.09,165.34,109913568,111314394.4,69.80402636069326,65.8731148506375,NaN,NaN,120.90405838198775,127.8883983557989,0.4288981553762734,2.3189912180878878,1.8900930627116144,8194679949,8146210781,89.15590995345701,80.31814204471823,NaN,NaN,34.16451765317141,24.511750055739913
2013-05-17T09:30:00-04:00,165.95,167.03999,165.73,166.94,129801008,110320066.4,73.37948132901936,66.79858681433059,NaN,NaN,131.59603735002457,128.78830540195077,0.4527438473731418,2.4560228719280417,2.0032790245549,8324480957,8214500755.4,90.10485954124647,81.78245052103532,NaN,NaN,36.18646795033567,26.179566897825023
2013-05-20T09:30:00-04:00,166.78,167.58,166.61,166.92999,85071184,109245953.6,73.32098759320724,67.64132977098178,NaN,NaN,130.83617598153424,131.32847238210474,0.4250539572565226,2.5345964711255533,2.1095425138690307,8239409773,8249407856.2,90.55961832174712,83.07991732980088,NaN,NaN,37.78759014611224,27.837855933294623
2013-05-21T09:30:00-04:00,167.08,167.8,166.5,167.17,95804192,105729100.8,73.85905410426582,68.9588798749125,NaN,NaN,121.73012064232809,128.94372402047787,0.38150102083613957,2.5864187899142053,2.2049177690780657,8335213965,8279675632.2,90.94808263251166,84.34838651380166,NaN,NaN,39.265071634038115,29.470315319115123
2013-05-22T09:30:00-04:00,167.34,169.07001,165.17,165.92999,244031744,113091628.8,66.40723744048807,69.42265129157524,NaN,NaN,101.52252610829647,121.3177836928342,0.23496761440617275,2.4986272870857817,2.263659672679609,8091182221,8236993373,85.59897070606864,85.19659507886715,NaN,NaN,38.421263358340084,30.749022181861545
2013-05-23T09:30:00-04:00,164.16,165.91,163.94,165.45,211064320,117091816.8,63.72699816440312,69.3889702639484,NaN,NaN,55.080945616369085,108.15316113971046,0.07953672986986904,2.363080585016945,2.283543855147076,7880117901,8174080963.4,78.28981816178344,85.35310042957103,NaN,NaN,36.94054576619587,31.633525551052163
2013-05-24T09:30:00-04:00,164.47,165.38049,163.98,165.308,151573872,119874572.8,62.91795151088944,69.22468830617363,NaN,NaN,43.23159513750761,90.48027269720708,-0.051934525868196246,2.218625697811831,2.270560223680027,7728544029,8054893577.8,66.67436793359482,84.53834137468304,NaN,NaN,35.490986292206735,32.1845913712171
2013-05-28T09:30:00-04:00,167.03999,167.78,165.81,166.3,143679744,122629925.6,66.15094387085301,69.14845099577576,NaN,NaN,84.37396831476983,81.18783116385418,-0.08900880991997573,2.1592992112800573,2.248308021200033,7872223773,7981456377.8,60.69877268429122,83.17908399595315,NaN,NaN,35.098426017870985,32.60085346359623
2013-05-29T09:30:00-04:00,165.42,165.8,164.34,165.22,160363312,124847560,60.01607458084221,68.51003027378235,NaN,NaN,34.19349646302073,63.68050632799272,-0.1970007360074657,2.002057101190701,2.1990578371981666,7711860461,7856785677,52.15328404629535,81.01534727348374,NaN,NaN,32.94900967268069,32.65059006489401
2013-05-30T09:30:00-04:00,165.35001,166.59,165.22,165.83,107793744,123293540.8,62.15114767083321,68.19233874513297,NaN,NaN,53.3657925424294,54.04915961481929,-0.2354804946278235,1.9047072189133871,2.1401877135412106,7819654205,7802480073.8,48.922342090189645,78.52244651900291,NaN,NaN,31.73189847371291,32.519348409010995
2013-05-31T09:30:00-04:00,165.37,166.31,163.13,163.44501,176850000,127315662.4,50.74236228358896,66.96270824503618,NaN,NaN,-15.877099229815089,39.857550645582464,-0.41897075809978457,1.6164742659164801,2.0354450240162647,7642804205,7755017334.6,46.22687008981601,75.7587620520012,NaN,NaN,26.823194449511096,31.70561212908244
2013-06-03T09:30:00-04:00,163.83,164.46001,162.6599,164.35001,168390688,128525084,54.17949888565178,65.954218043322,NaN,NaN,-47.533995793752744,21.704432459330402,-0.47281753898764345,1.4444231002817105,1.917240639269354,7811194893,7771547507.4,47.31559692236738,72.99557181113971,NaN,NaN,23.83698316426191,30.58152227696522
2013-06-04T09:30:00-04:00,164.44,165.10001,162.73,163.56,157631440,133062552.8,50.844210340299135,64.41371965996593,NaN,NaN,-58.612819246555944,-6.892925052934757,-0.5496774909067899,1.2301437756358666,1.7798212665426565,7653563453,7727815443.4,44.73506661465001,69.96924015191509,NaN,NaN,20.296174384870614,29.112186863808848
2013-06-05T09:30:00-04:00,163.09,163.42,161.13,161.272,211737680,139131477.6,42.6544548050504,62.15388778143466,NaN,NaN,-153.58458266167682,-44.448540877874265,-0.7312779229366029,0.8657238628719028,1.5970017858085057,7441825773,7673808505.8,41.70971326957715,66.64951949768543,NaN,NaN,14.234319020703467,26.98677717193665
2013-06-06T09:30:00-04:00,161.2,162.74001,160.25,162.73,200225440,144271790.4,48.36242216924367,60.622344624902546,NaN,NaN,-145.48657082946414,-84.21901355225297,-0.7282801650423527,0.6866515795055648,1.4149317445479175,7642051213,7638287907.4,39.8031096007305,63.12431947249069,NaN,NaN,11.128414570040915,24.721296800237262
2013-06-07T09:30:00-04:00,163.85001,164.95,163.14,164.8,188337744,148351749.6,55.18301244542831,59.322596847503185,NaN,NaN,-31.378000321566535,-87.31919377060326,-0.5690206773188065,0.7036558978994094,1.2726765752182159,7830388957,7675804857.8,42.77830749676312,59.74385146931331,NaN,NaN,10.91226107218517,22.748577410515534
2013-06-10T09:30:00-04:00,165.31,165.39999,164.37,164.8,105667056,148474958.4,55.18301244542831,58.02702719409041,NaN,NaN,-6.902683540220795,-79.19293131989687,-0.45097366101924985,0.7089594989441537,1.1599331599634035,7830388957,7679643670.6,43.08826184905823,56.35304029269268,NaN,NaN,10.748670320546518,21.034304969091387
2013-06-11T09:30:00-04:00,163.3,164.53999,162.739,163.09801,159505376,152358068,49.01000411172081,56.252095051765764,NaN,NaN,-85.98959828617971,-84.6682871278216,-0.4725352084928336,0.5692641493473616,1.0417993578401952,7670883581,7683107696.2,43.38626966439873,52.95576793782747,NaN,NaN,8.527813494409958,19.247663329851182
2013-06-12T09:30:00-04:00,164.22,164.39,161.60001,161.75,177363504,155276202.4,44.74107748399921,54.704512197730836,NaN,NaN,-118.43959906950107,-77.63929040938645,-0.5568032271623602,0.3457953238872449,0.9025985510496051,7493520077,7693446557,44.32334650853487,50.00750906657505,NaN,NaN,5.237404625953129,17.24619780072289
2013-06-13T09:30:00-04:00,161.66,164.5,161.3,164.21001,163587744,157419668,52.81788603508844,53.92528990277979,NaN,NaN,-70.76169312380482,-62.69431486825458,-0.43166897101100243,0.363012337285852,0.7946813082968545,7657107821,7696457878.6,44.61091859708721,47.60187338338246,NaN,NaN,5.22610695662579,15.529041965851874
2013-06-14T09:30:00-04:00,164.03,164.67,162.91,163.175,141197440,158983861.6,49.53722466769234,52.969523699694285,NaN,NaN,-52.661910657773646,-66.951096935496,-0.4039053207735229,0.28979965732995083,0.6937049781034738,7515910381,7633562163.4,39.96758276970948,45.69424587167638,NaN,NaN,4.089934516220255,13.894883758761644
2013-06-17T09:30:00-04:00,164.28999,165.22,163.21919,164.44,136295568,159308589.6,53.35098608022626,52.05524100036381,NaN,NaN,-12.847651788115774,-68.140090585075,-0.29092524947849774,0.33004841625535164,0.6209736657338494,7652205949,7597925561.8,37.58078986554815,44.04296138462329,NaN,NaN,4.460197838593716,12.54707148445194
2013-06-18T09:30:00-04:00,164.53,165.99001,164.52,165.735,114695504,160789805.6,56.938819311281264,51.83543705253803,NaN,NaN,54.82467230319415,-39.97723646720023,-0.12787817100283383,0.46112595198030704,0.5890041229831409,7766901453,7617129136.2,39.671528064053575,43.15140738589173,NaN,NaN,5.976449431068947,11.608411191111513
2013-06-19T09:30:00-04:00,165.60001,165.89,163.38,163.45,206149440,166307068,49.67844673014474,50.944529842488855,NaN,NaN,-4.4910958234397835,-17.18753581798798,-0.17017303591007915,0.37628782809554195,0.5464608640056211,7560752013,7630575523.4,41.15773402237806,42.59679252390519,NaN,NaN,4.770756203551438,10.631603335745787
2013-06-20T09:30:00-04:00,161.86,163.4668,158.98,159.39999,321255936,170168277.6,39.953992997971305,50.1739320363733,NaN,NaN,-205.60994240851642,-44.15718567493029,-0.4512060421313753,-0.017546688658597986,0.4336593534727773,7239496077,7547053174.6,35.33480908801796,41.818788166633894,NaN,NaN,-0.05399595230921035,9.10508915173793
2013-06-21T09:30:00-04:00,159.64,159.75999,157.47,159.07001,271956736,173212898.4,39.27934436918815,49.109635285197335,NaN,NaN,-246.5950933950234,-82.94382222238025,-0.6287112618595192,-0.35222972385162166,0.2764815380078975,6967539341,7437378966.6,29.444021617632927,40.54224707343857,NaN,NaN,-3.8930916216143405,7.248206184116177
2013-06-24T09:30:00-04:00,157.41,158.42999,155.73,157.06,222334752,176750942.4,35.362342634277084,48.00378759191005,NaN,NaN,-245.59489444896872,-129.49327075455085,-0.8378047833512576,-0.7707744411811746,0.06703034217008305,6745204589,7255978694.6,22.70244651727576,38.96848849505469,NaN,NaN,-8.457351599839265,5.0045550721225425
2013-06-25T09:30:00-04:00,158.48,160.10001,157.42,158.575,162262128,177680061.6,40.2026255553353,47.82865693121611,NaN,NaN,-149.66410311670063,-170.3910258385298,-0.8288687828084205,-0.9690556363404426,-0.1401868535320221,6907466717,7084091747.4,18.40275947043125,37.30370608082999,NaN,NaN,-10.476439548657833,2.7929844120110605
2013-06-26T09:30:00-04:00,159.87,160.5,159.25,160.14,134847936,176404292.8,44.80098444887384,47.57426852261826,NaN,NaN,-91.15405155815145,-187.72361698547212,-0.678664498892766,-0.9885174771479797,-0.30985297825521363,7042314653,6980404275.4,16.386615588766475,35.6310993656897,NaN,NaN,-10.554307195189613,0.8862284681252501
2013-06-27T09:30:00-04:00,161.10001,161.82001,160.95,161.08,129483680,177488789.6,47.416563836052454,47.01952219337714,NaN,NaN,-39.488472190231874,-154.49932294181522,-0.4861291747574522,-0.9175144467020289,-0.43138527194457665,7171798333,6966864726.6,16.137987305588936,33.7282193520344,NaN,NaN,-9.754660673774008,-0.6338985521460723
2013-06-28T09:30:00-04:00,160.63,161.39999,159.86,160.42,160402816,176666430.4,45.77643010619596,46.34762345486054,NaN,NaN,-57.75744393196885,-116.73179304920431,-0.3781548699268804,-0.9040788593531772,-0.5259239894262968,7011395517,6975635961.8,17.016392357855906,31.865942959805665,NaN,NaN,-9.623455689023045,-1.9181210002713538
2013-07-01T09:30:00-04:00,161.25999,162.48,161.08,161.36,131954816,174844636.8,48.50827014037879,46.3117853140504,NaN,NaN,-16.94104668389552,-71.00102349618967,-0.22587181170595672,-0.8082637540587427,-0.582391942352786,7143350333,7055265110.6,24.725005903523368,30.532995548314567,NaN,NaN,-8.673075312816655,-2.8831144734921113
2013-07-02T09:30:00-04:00,161.12,162.3,160.5,161.21001,154863632,174706246.4,48.09192029083792,46.55113122882459,NaN,NaN,-24.108294956447537,-45.889861864139064,-0.12284562264749144,-0.7359489706621503,-0.6131033480146588,6988486701,7071469107.4,26.226823554626392,29.240386765892527,NaN,NaN,-8.028283301435295,-3.618138591769709
2013-07-03T09:30:00-04:00,160.48,161.77,160.22,161.28,75216320,167880178.4,48.31484940093728,46.229485754956656,NaN,NaN,-30.960588742601733,-33.851169301029124,-0.04177488827935094,-0.6653219583638474,-0.6235470700844965,7063703021,7075746781,26.64290540725743,27.95695725233326,NaN,NaN,-7.440168142125171,-4.164142813249061
2013-07-05T09:30:00-04:00,162.47,163.08,161.3,163.02,122416880,163989750.4,53.64485539982898,46.52288795010927,NaN,NaN,17.381238655444715,-22.477227131893805,0.12795608075086717,-0.46360196914591256,-0.5915580498967797,7186119901,7078611094.6,26.940042800957542,27.02641868313669,NaN,NaN,-5.36509276662086,-4.335707092302175
2013-07-08T09:30:00-04:00,163.86,164.39,163.0838,163.94501,108092432,159977484.8,56.22907546694764,46.728465763446515,NaN,NaN,66.75442418644334,2.425146491788655,0.2920575937437466,-0.2264860577170964,-0.518543651460843,7294212333,7135174457.8,32.7344280840161,26.68024998445583,NaN,NaN,-2.844277004648876,-4.122645651208846
2013-07-09T09:30:00-04:00,164.98,165.33,164.27,165.13,119297872,160659025.6,59.35508778679932,46.901056368840656,NaN,NaN,106.2673629800418,27.066828424576112,0.45995385818314194,0.0563986712680844,-0.40355518691505754,7413510205,7189206432.2,37.80852879595684,26.5471786081632,NaN,NaN,0.25743601985598796,-3.4969196981995845
2013-07-10T09:30:00-04:00,164.97,165.75,164.63,165.192,121410368,158754275.2,59.51799064853917,47.60388093444026,NaN,NaN,108.194313691913,53.527350154248225,0.5487122735227906,0.28233515498843076,-0.26637711853435986,7534920573,7298493206.6,46.585190894002764,26.934854098993537,NaN,NaN,2.8379682000594477,-2.5919357127340086
2013-07-11T09:30:00-04:00,167.11,167.61,165.1774,167.44,135592192,156665709.6,64.99607340758041,49.39260096369805,NaN,NaN,139.41544568321007,87.60255703941058,0.7214705422442154,0.6354610592709093,-0.08600948297330602,7670512765,7419855155.4,54.29831588179019,28.289390298548692,NaN,NaN,6.883670912211688,-1.238277623456052
2013-07-12T09:30:00-04:00,167.39,167.9332,167.13,167.50999,104212624,153696953.6,65.15417695880944,51.24080329152815,NaN,NaN,143.22397154576157,112.77110361747395,0.7971821305260814,0.9104681801842958,0.11328604965821434,7774725389,7537576253,60.28851501891819,30.492568398640493,NaN,NaN,10.2119577310536,0.3974702843310409
2013-07-15T09:30:00-04:00,167.97,168.39,167.67999,168.155,69450560,150109609.6,66.64919462353032,53.47557843361767,NaN,NaN,138.02570370888907,127.02535952196311,0.8429773067694325,1.167007683120005,0.3240303763505724,7844175949,7647568976.2,64.91569383846075,33.507800350153715,NaN,NaN,13.467420296662036,2.264606000378326
2013-07-16T09:30:00-04:00,168.25999,168.36,167.07001,167.52499,88702064,147729934.4,63.77122607959229,55.15904989963603,NaN,NaN,114.74508797858734,128.72090452167222,0.7843306831929838,1.3044437303418022,0.5201130471488183,7755473885,7715961712.2,67.45500038996833,37.01153184440636,NaN,NaN,15.465919805778821,4.150507972578397
2013-07-17T09:30:00-04:00,168.16,168.48,167.73,167.9501,92873872,146638852.8,64.87343859144352,56.59279662410529,NaN,NaN,115.20011710508582,130.12206520430678,0.7288439609466821,1.431167998332171,0.7023240373854889,7848347757,7778647149,69.62500109060778,40.81427366596645,NaN,NaN,17.460812145849694,6.051979997331439
2013-07-18T09:30:00-04:00,168.31,169.27,168.2,168.87,103620256,141512393.6,67.19897476572767,58.00582597622495,NaN,NaN,116.627458884388,125.56446784454238,0.7081616683676704,1.5875261228450768,0.8793644544774064,7951968013,7834938198.6,71.46497328649198,44.76620123603095,NaN,NaN,19.85500540239611,8.023840769483535
2013-07-19T09:30:00-04:00,168.52,169.23,168.31,169.17,103831632,130641178.4,67.94432049588721,59.589246718345755,NaN,NaN,105.40545416682534,118.00076436875513,0.6692037044939563,1.7158690850948517,1.0466653806008954,8055799645,7891153049.8,73.21023399670906,48.78004706737761,NaN,NaN,22.078911730614365,10.031708049645081
2013-07-22T09:30:00-04:00,169.41,169.74001,169.00999,169.5,79428560,121014769.6,68.78458653270347,61.037555032083226,NaN,NaN,104.13231039903155,111.22208570678363,0.6212224240585131,1.8231934106740368,1.2019709866155237,8135228205,7949363501,74.92076480346617,52.365458417373524,NaN,NaN,24.19965814119408,12.055700919866366
2013-07-23T09:30:00-04:00,169.8,169.83,169.05,169.14,80829632,113939513.6,66.72962474998145,62.36881963630777,NaN,NaN,94.8787227303053,107.24881265712722,0.5246506820196579,1.857784339140096,1.3331336571204382,8054398573,8009148438.6,76.57507051903735,55.9617617719743,NaN,NaN,25.500099508504437,13.976329289671805
2013-07-24T09:30:00-04:00,169.78999,169.86,168.17999,168.52,112914000,111472107.2,63.22627049014648,63.43392114267986,NaN,NaN,78.00032209396304,99.80885365490266,0.38489745267350206,1.8142554729623157,1.4293580202888136,7941484573,8027775801.8,77.08231406639635,59.56457667619851,NaN,NaN,25.736360720034245,15.656333779723582
2013-07-25T09:30:00-04:00,168.22,169.08,167.94,168.92999,111156560,110287538.4,64.55161294442057,64.21297525300783,NaN,NaN,67.177856210394,89.91893312010386,0.29025929526533445,1.7921821393704818,1.5019228441051473,8052641133,8047910425.8,77.64578875753077,63.1864156730966,NaN,NaN,26.27947760951157,17.17392575540758
2013-07-26T09:30:00-04:00,168.22,169.16,167.52,169.11,107814496,109204079.2,65.14557191340486,64.8498678563262,NaN,NaN,60.728446738176416,80.98353163437407,0.2135211335450704,1.7688242610364853,1.5553031274914149,8160455629,8068841622.6,78.24462146840851,66.43714377198178,NaN,NaN,26.892959596445493,18.56235916127014
2013-07-29T09:30:00-04:00,168.67999,169.06,168.11,168.59,79845120,105176194.4,61.91805401409347,65.0329368725615,NaN,NaN,56.32930802307833,71.42293115918343,0.10686542287937639,1.6888849060906352,1.5820194832112588,8080610509,8057918083.4,77.08406897240103,69.24253949887064,NaN,NaN,26.613125416337667,19.712468626279787
2013-07-30T09:30:00-04:00,169.10001,169.28,168.19,168.588,85216944,102839300.8,61.90535051734539,65.20346257747623,NaN,NaN,55.425702751301706,63.53232716338272,0.019863022669377672,1.6068482615479809,1.5869852388786032,7995393565,8046117081.8,75.77643958298998,71.32762869094117,NaN,NaN,26.37238956242765,20.663885902872337
2013-07-31T09:30:00-04:00,168.94,169.85001,168.49001,168.71001,142388624,102215550.4,62.41199736577894,65.01888571734756,NaN,NaN,62.82978317835939,60.49821938026199,-0.04239149706774503,1.533995867543922,1.576387364611667,8137782189,8085376605,77.16429824070829,72.96091314514959,NaN,NaN,26.28393416268187,21.466749939987984
2013-08-01T09:30:00-04:00,169.99001,170.81,169.89999,170.66,110438368,103976652.8,69.41352008736158,65.32312451224409,NaN,NaN,119.15783671873254,70.8942154819297,0.030882991926906245,1.6149911045202998,1.5841081125933936,8248220557,8124492489.8,78.48682535874875,74.26079245513749,NaN,NaN,28.126715668458687,22.4181736154838
2013-08-02T09:30:00-04:00,170.28,170.9725,170.05,170.95,91116624,102411640,70.299566237747,65.583865341831,NaN,NaN,133.41731548357137,85.43198923100866,0.07925619582169174,1.6831783573705081,1.6039221615488164,8339337181,8160268800.2,79.64781498790384,75.31308682295484,NaN,NaN,29.92963943898036,23.491240161697593
2013-08-05T09:30:00-04:00,170.57001,170.96001,170.35001,170.7,54072640,99710650.4,68.458452508931,65.91866722964092,NaN,NaN,136.27569621932562,101.42126687025811,0.07484377398915809,1.6974768790352641,1.622633105046106,8285264541,8201199606.6,80.91668488355374,76.27463571535381,NaN,NaN,30.971635996126196,24.559868138044536
2013-08-06T09:30:00-04:00,170.37,170.7402,169.35001,169.73,87494944,98120504,61.7058565391581,65.69241136876339,NaN,NaN,91.22494676320788,108.58111567263936,-0.00854165102709925,1.611956041262232,1.6204976922893313,8197769597,8241674813,82.10481934659663,77.1660513050673,NaN,NaN,30.02307471699943,25.340326220752377
2013-08-07T09:30:00-04:00,169.19,169.42999,168.55,169.17999,84854624,96292716.8,58.200334491605666,65.04965134918324,NaN,NaN,15.147451564929504,99.04464934995337,-0.11023237393309082,1.4827072248729678,1.5929395988060586,8112914973,8236701369.8,81.43390082101712,77.87811755753339,NaN,NaN,28.207944732113173,25.749986008089635
2013-08-08T09:30:00-04:00,169.98,170.17999,168.92999,169.8,102181248,94622169.6,60.89712841744766,64.54628048643755,NaN,NaN,58.42798487773967,86.8986789817548,-0.1431465222952768,1.4140064459369626,1.5571529682322394,8215096221,8230076502.6,80.49038360460447,78.39812824381161,NaN,NaN,27.378080338176648,25.98257091238778
2013-08-09T09:30:00-04:00,169.58,170.10001,168.72,169.31,91856432,94004360,57.727282599915235,63.75647306266698,NaN,NaN,26.186274322747426,65.45247074959,-0.2017394172462743,1.3049786966743966,1.506718113920671,8123239789,8186857024.2,74.43155444272368,78.36318464661574,NaN,NaN,25.763430927679504,25.951265200286596
2013-08-12T09:30:00-04:00,168.46001,169.31,168.38,169.11099,68593184,93961491.2,56.44226446489793,63.021661613732434,NaN,NaN,-24.69128157878221,33.25907518996845,-0.2543256097717186,1.1888111017060226,1.4431367114777411,8054646605,8140733437,68.50508865912494,77.7867573709077,NaN,NaN,24.051966360027162,25.679936794535248
2013-08-13T09:30:00-04:00,169.41,169.89999,168.41,169.61,80806000,93566688,58.91206290505323,62.71350392908291,NaN,NaN,7.271437439025524,16.468373325131978,-0.2552645972718035,1.1240559648879866,1.3793205621597902,8135452605,8128270038.6,66.9537323063953,77.06328724519334,NaN,NaN,23.23176869463591,25.330198494549627
2013-08-14T09:30:00-04:00,169.53,169.8,168.7,168.74001,79829184,92914453.6,53.24374135664607,61.90579881567045,NaN,NaN,-28.216302005659422,7.795622611014191,-0.31056747607274215,0.9911112170688625,1.3016786931416047,8055623421,8116811728.2,65.48547389024995,76.19469332610184,NaN,NaN,20.857857822957683,24.691292684322207
2013-08-15T09:30:00-04:00,167.41,167.42999,166.09,166.38,152931744,95380028,41.56150939248142,60.22122292131878,NaN,NaN,-279.67534572248496,-59.82504350903073,-0.49142726978931917,0.6873946059049558,1.178821875694275,7902691677,8054330819.4,58.014523154988915,74.74968630371472,NaN,NaN,14.521206660488811,23.238423252346006
2013-08-16T09:30:00-04:00,166.06,166.63,165.5,165.83,130868128,96731852.8,39.39229691106901,58.61224027110274,NaN,NaN,-273.5100236934532,-119.76430311227087,-0.6248720642501264,0.39773179538161685,1.0226038596317433,7771823549,7984047571.4,50.97024084629928,72.88441286613603,NaN,NaN,8.652555634461644,21.154727878362525
2013-08-19T09:30:00-04:00,165.64,166.21001,164.75999,164.77,96437568,97582303.2,35.54210971445757,56.72915164232505,NaN,NaN,-252.86202061813242,-165.39845092014087,-0.7527254578398466,0.08169703733193501,0.8344224951717816,7675385981,7908195446.6,44.666700852943215,70.6622886711327,NaN,NaN,2.3490420238029714,18.46820132771116
2013-08-20T09:30:00-04:00,165.03999,166.2,164.86,165.58,89294368,98005540,40.3406883485872,55.152629569668484,NaN,NaN,-183.19820986404844,-203.4923803807557,-0.7493173386091845,-0.10222417808969908,0.6470931605194854,7764680349,7834040995.4,39.520943654298996,67.97347762924632,NaN,NaN,-1.3236984780983596,15.640787069738371
2013-08-21T09:30:00-04:00,165.12,166.03,164.19,164.56,159530496,100336364.8,36.64147551366002,52.81176924297552,NaN,NaN,-168.87144366652853,-231.6234087129295,-0.7788941843428316,-0.3265245699090542,0.45236961443377743,7605149853,7743946281.8,34.34410753628238,64.820426356213,NaN,NaN,-5.661025977161866,12.597670920181194
2013-08-22T09:30:00-04:00,164.89999,166.3,164.89,166.06,101471376,99852105.6,44.67592212807371,50.98150894942743,NaN,NaN,-108.21612991327667,-197.33156555108786,-0.6649991297436484,-0.3788792977457831,0.2861198319978653,7706621229,7704732192.2,32.35738146461421,61.44253824740661,NaN,NaN,-6.660522377902704,9.846500449026351
2013-08-23T09:30:00-04:00,166.55,166.83,165.77,166.62,90893568,99006059.2,47.35972442456102,49.474456943400995,NaN,NaN,-70.67670406201792,-156.7649016248008,-0.5256221709495774,-0.3709078816891065,0.15471428926047093,7797514797,7709870441.8,32.90506944141609,58.01313714439677,NaN,NaN,-6.563482198554771,7.5022172136576195
2013-08-26T09:30:00-04:00,166.78999,167.3,165.89,166,89705056,99499056,44.77023548249172,48.26476972506769,NaN,NaN,-63.28410909093328,-118.84931931936096,-0.4516868628170094,-0.40989428926079086,0.04179257355621857,7707809741,7716355193.8,33.63538779461929,54.5510348906841,NaN,NaN,-7.31535656502069,5.385420959560719
2013-08-27T09:30:00-04:00,164.36,166.0024,163.21001,163.33,158621744,103169296,35.71400104758341,46.65860305049467,NaN,NaN,-124.7212442360235,-107.15392619375598,-0.5524416496272095,-0.6487594884777934,-0.09631783885058384,7549187997,7673256723.4,31.204354646101734,50.96321016390443,NaN,NaN,-11.301375440569341,3.0015929023992816
2013-08-28T09:30:00-04:00,163.25999,164.49001,163.05,163.91,108112944,101455512,38.61866581742242,45.067284293350006,NaN,NaN,-119.4818747672464,-97.27601241389956,-0.5487405375496769,-0.78224351078768,-0.23350297323800306,7657300941,7683686941,32.476295444681355,47.53363243819564,NaN,NaN,-13.4112174342954,0.6569057114428984
2013-08-29T09:30:00-04:00,163.55,165.03999,163.39999,164.17,119200432,101893615.2,39.92897770486697,43.79597680084656,NaN,NaN,-97.59379284709118,-95.15154500066247,-0.49893347184500997,-0.8571698130442655,-0.35823634119925557,7776501373,7697662969.8,34.23099325185247,44.66216378170484,NaN,NaN,-14.632292746427353,-1.5272654968242803
2013-08-30T09:30:00-04:00,164.50999,164.53,163.17,163.64999,134928944,104084231.2,38.17377802261587,42.49108491211213,NaN,NaN,-103.04223627181499,-101.62465144262187,-0.4714803019623699,-0.947586718652218,-0.4761064166898481,7641572429,7666474496.2,32.21888389334775,42.070292012720756,NaN,NaN,-16.174881361377192,-3.6197820489032675
2013-09-03T09:30:00-04:00,165.23,165.58,163.7,164.39,142375056,108499352,42.07596204553351,41.28850627928929,NaN,NaN,-73.57092951632227,-103.68201552769968,-0.37799112970112425,-0.9485953288162534,-0.5706041991151292,7783947485,7681702045,34.250969484891755,39.73438038261337,NaN,NaN,-16.2470397800819,-5.423676010500214
2013-09-04T09:30:00-04:00,164.42999,166.03,164.13499,165.75,97389376,108994073.6,48.508160662279415,40.95025051540596,NaN,NaN,-42.744692317859666,-87.2867051440669,-0.2075848957377573,-0.8300853187873258,-0.6225004230495685,7881336861,7748131817.8,42.3682825034322,38.08315242641209,NaN,NaN,-14.223668476071444,-6.680817791296104
2013-09-05T09:30:00-04:00,165.85001,166.39999,165.73,165.96001,63090432,107905864,49.4417975272029,41.51312823931464,NaN,NaN,-9.542296007100216,-65.29878939203766,-0.07081806124410028,-0.711022999604694,-0.6402049383605937,7944427293,7805557088.2,48.30929370873216,37.389921751679466,NaN,NaN,-12.318325203938791,-7.4861759931022025
2013-09-06T09:30:00-04:00,166.50999,166.98,164.48,166.03999,159756432,110784623.2,49.81499582904824,42.25760673345601,NaN,NaN,-11.289574179103644,-48.03794565844016,0.029557903765155102,-0.6032575586541498,-0.6328154624193049,8104183725,7871093558.6,54.12187633306218,37.61503857216253,NaN,NaN,-10.672160757753192,-7.94131667376663
2013-09-09T09:30:00-04:00,166.45,167.73,166.45,167.634,87559248,110569764,56.6784992216674,43.76734884111385,NaN,NaN,70.4741816013983,-13.334662083797493,0.19841739194892183,-0.3847937224831526,-0.5832111144320744,8191742973,7981127667.4,61.87379514934318,38.844116736191104,NaN,NaN,-7.0102870616910105,-7.808312443470113
2013-09-10T09:30:00-04:00,168.64,168.89999,168.25999,168.87,105847744,112432492,61.1189034295548,45.25150706118297,NaN,NaN,148.36349898127153,31.052223615721267,0.3780495371191474,-0.11064919303314014,-0.48869873015228754,8297590717,8083856313.8,67.41026910409401,40.83621141117646,NaN,NaN,-2.3879610584322806,-7.033976531321851
2013-09-11T09:30:00-04:00,168.64,169.39999,168.35001,169.39999,94545808,113119482.4,62.876046484250836,47.12540498765374,NaN,NaN,171.32332071498888,73.86582622229096,0.5090996009110265,0.14767577098649554,-0.3614238299245309,8392136525,8186016246.6,71.79645557798118,43.51137912844065,NaN,NaN,1.9574387921586258,-5.749488627967498
2013-09-12T09:30:00-04:00,169.34,169.56,168.72,168.95,83209008,113288473.6,60.38094402192251,48.24719226578579,NaN,NaN,172.8250280340778,110.33929103052655,0.5391291212335643,0.31248757161742446,-0.22664154961613983,8308927517,8258916291.4,74.44006859083716,46.517285351742295,NaN,NaN,4.797595994326822,-4.242762253354024
2013-09-13T09:30:00-04:00,169.13,169.46001,168.74001,169.33,72727744,109278273.6,61.76093375247179,49.27585007492228,NaN,NaN,152.41971991578248,143.0811498495038,0.5560059633960406,0.4683659046289108,-0.08764005876712971,8381655261,8314410598.6,76.26399431910939,49.61435141443467,NaN,NaN,7.559039001478684,-2.5567906455207803
2013-09-16T09:30:00-04:00,171.16,171.24001,170.03999,170.31,126187504,109044242.4,65.1338310971125,50.730392618823764,NaN,NaN,173.7114044279263,163.72859441480938,0.6007775979752703,0.6633319387019583,0.06255434072668792,8507842765,8377630557,78.1747175886751,52.795732114010086,NaN,NaN,10.994235836413242,-0.6209297195302055
2013-09-17T09:30:00-04:00,170.46001,171.11,170.46001,171.07001,82523184,108348523.2,67.52609083236561,53.002684746308205,NaN,NaN,153.88715053846627,164.83332472624835,0.6452776034292955,0.8691513450133073,0.2238737415840118,8590365949,8436185603.4,79.79691136781723,56.266629022704045,NaN,NaN,14.65434746722168,1.5612527357200636
2013-09-18T09:30:00-04:00,171.00999,173.52,170.58,173.05099,203460624,114056836,72.77042575378634,55.442096170334196,NaN,NaN,167.71241015551203,164.11114261435296,0.7637233279982889,1.178527901581873,0.4148045735835841,8793826573,8516523613,81.79607904853562,59.789470708693635,NaN,NaN,19.788792204226308,4.16518694550667
2013-09-19T09:30:00-04:00,173.52,173.60001,172.58501,172.75999,146616816,113411152,70.95761512116644,57.658427414355586,NaN,NaN,155.86598128557955,160.71933326465333,0.7755745403474039,1.384272749017839,0.6086982086704351,8647209757,8584180061,83.29522809234936,63.29405891158627,NaN,NaN,23.330314113163173,6.903062255171884
2013-09-20T09:30:00-04:00,172.33,172.33,170.58,170.72,132867936,114980980,59.725162467128314,59.19781201753505,NaN,NaN,94.04967330150622,149.04532394179805,0.6066089702809428,1.3669594215216136,0.7603504512406708,8514341821,8610717373,83.85679568222102,66.98248118222008,NaN,NaN,22.782864447238556,9.171605425467122
2013-09-23T09:30:00-04:00,170.49001,170.64999,169.39,169.92999,104616432,115667123.2,56.02639124953436,60.19427124639225,NaN,NaN,56.38256627914821,125.57955631204246,0.41155661725597215,1.274796222810636,0.8632396055546638,8409725389,8591093897.8,81.67039470257446,70.36958298348313,NaN,NaN,21.109481048550546,10.877016228764754
2013-09-24T09:30:00-04:00,169.89999,170.53,169.21001,169.53,106333008,116498520.8,54.196307126010495,60.60056742237304,NaN,NaN,45.957068259520135,103.99353985625321,0.23433068517397582,1.1561529620221336,0.9218222768481578,8303392381,8533699184.2,75.47227911913227,72.73415417031885,NaN,NaN,19.185608423180987,12.063957970824216
2013-09-25T09:30:00-04:00,169.64,169.98,168.89,169.03999,117306496,114432758.4,51.95725059882566,60.780242641774656,NaN,NaN,29.99718339048514,76.45049450324784,0.0712895314669848,1.0109341911818888,0.939644659714904,8186085885,8412151046.6,64.33665435160529,73.87896564480978,NaN,NaN,16.916552819698182,12.75718580637764
2013-09-26T09:30:00-04:00,169.32001,170.17,169.05,169.69,77146880,112884455.2,54.63468635448701,61.12450625073457,NaN,NaN,34.38903843066191,52.15510593226431,-0.0017230614264942545,0.9374908329317861,0.9392138943582804,8263232765,8335355648.2,58.46703711324548,74.18933427196573,NaN,NaN,15.810875650956135,13.193427212745997
2013-09-27T09:30:00-04:00,168.84,169.14,168.47,168.909,99141680,111881517.6,50.9598735070671,60.71603298540598,NaN,NaN,4.302606945201154,34.2056926610033,-0.10579984367226847,0.8069640897679449,0.9127639334402133,8164091085,8265305501,53.65814025061283,73.60250177919929,NaN,NaN,13.756597572719379,13.273880121313622
2013-09-30T09:30:00-04:00,167.48,168.53999,167.14999,168.00999,143937376,112331939.2,47.03783154145209,59.71024213625578,NaN,NaN,-40.11238293428423,14.906702818316825,-0.2311811643489443,0.6237874780040329,0.8549686423529772,8020153709,8187391165,48.845817322565324,72.27646950909009,NaN,NaN,10.792133201206473,12.919344847012601
2013-10-01T09:30:00-04:00,168.14,169.5,167.9671,169.34,127160432,111571208,52.822682869631294,58.99214473521153,NaN,NaN,-9.339708802377357,3.847347405937326,-0.22056530332437618,0.579262013197507,0.7998273165218832,8147314141,8156175517,47.02612483107956,70.50716017002568,NaN,NaN,9.9873631221691,12.500490314892101
2013-10-02T09:30:00-04:00,168.35001,169.34219,167.83,169.17999,113349744,112369226.4,52.08559213564028,58.39961960047709,NaN,NaN,-27.362549089787137,-7.624599090117132,-0.21985242698904006,0.5250117827855831,0.7448642097746232,8033964397,8125751219.4,45.25648717094374,68.42261864003329,NaN,NaN,9.121097554123436,12.017719920496578
2013-10-03T09:30:00-04:00,168.78999,168.94,166.84,167.62,176698432,118049626.4,45.42978738636613,57.23310914575526,NaN,NaN,-87.74720890672715,-32.051848557594944,-0.3142262845984568,0.35208135402655216,0.666307638625009,7857265965,8044557859.4,40.839646154498325,65.8923080568468,NaN,NaN,6.231794741848599,11.191159180689723
2013-10-04T09:30:00-04:00,167.75,169.06,167.53,168.89,96878368,114905723.2,50.92756496884591,56.21837585087906,NaN,NaN,-62.50065200540683,-45.41250034771654,-0.28193189565561905,0.31389276905548513,0.5958246647111042,7954144333,8002568509,38.73427033426096,63.07513325296007,NaN,NaN,5.5056931390981845,10.378949746176646
2013-10-07T09:30:00-04:00,167.42,168.45,167.25,167.42999,96295120,115342516.8,45.27984396370587,54.62935821740337,NaN,NaN,-112.65396655391739,-59.92081707164317,-0.3455175095575682,0.1639277777641439,0.5094452873217121,7857849213,7970107609.8,37.14023346143226,60.02822768821829,NaN,NaN,2.998977214386305,9.324667955920884
2013-10-08T09:30:00-04:00,167.39999,167.62,165.36,165.48,178014944,118950876.8,39.050922465156056,52.2208222682155,NaN,NaN,-183.04889526322913,-94.66265436381352,-0.49634746340941654,-0.11098904194005854,0.385358421469358,7679834269,7876611635.4,32.9359651208984,56.53821955052991,NaN,NaN,-1.3808263132475322,7.795311631753967
2013-10-09T09:30:00-04:00,165.8,166.2,164.53,165.60001,168972816,122672227.2,39.6016072191973,49.98110741807484,NaN,NaN,-188.9413947956251,-126.97842350498112,-0.5607198835500831,-0.31554143296824577,0.24517845058183727,7848807085,7839580173,31.41891604563547,52.83276869005035,NaN,NaN,-4.577987205974233,6.02769751207851
2013-10-10T09:30:00-04:00,167.28999,169.25999,167.23,169.17,195954752,128309514.4,53.15948766507503,49.51213064649961,NaN,NaN,-32.67580533038332,-115.96414278971235,-0.3460802300329458,-0.187421836959345,0.1586583930736008,8044761837,7877079347.4,34.698997374031165,49.3214973823225,NaN,NaN,-2.608405443961119,4.793968518358563
2013-10-11T09:30:00-04:00,168.91,170.32001,168.77,170.25999,105039744,129925114.4,56.379083806882775,49.53732297202449,NaN,NaN,25.377399481716132,-98.38853249228775,-0.12529199884051506,0.002043394522956987,0.12733539336347205,8149801581,7916210797,38.02982314424285,46.20431369958453,NaN,NaN,0.11179108704238898,4.1250860281705375
2013-10-14T09:30:00-04:00,169.21001,171.08,169.08,170.94,112106368,129221057.6,58.30459237175722,49.83077191814926,NaN,NaN,54.02021120671955,-65.05369694016038,0.06189755780400924,0.2047073406184836,0.14280978281447437,8261907949,7997022544.2,44.34348501006877,43.98082840607999,NaN,NaN,2.9066740973113507,3.9510271809049393
2013-10-15T09:30:00-04:00,170.50999,171.14999,169.47,169.7,155484496,132869123.2,53.6536494635793,49.95194326563166,NaN,NaN,44.60448363285624,-19.5230211609433,0.09554370051967562,0.2622394084640689,0.16669570794439328,8106423453,8082340381,50.12130119748089,42.96544603792825,NaN,NaN,3.6388370524226414,3.906428591121754
2013-10-16T09:30:00-04:00,170.72,172.16,170.63499,172.07001,161676064,130779895.2,60.19010684313864,50.34875901482106,NaN,NaN,125.11242684827526,43.287743167836766,0.26135266075462366,0.49338653388767284,0.23203387313304918,8268099517,8166198867.4,55.05959128013668,42.722057049849056,NaN,NaN,6.6067712300909,4.292191825260203
2013-10-17T09:30:00-04:00,171.37,173.32001,171.34,173.22,129389184,129918513.6,62.92263310714754,51.20324184339824,NaN,NaN,179.71286713988653,85.76547766189074,0.4228522331186459,0.7605991645313566,0.33774693141271067,8397488701,8236744240.2,58.758722899943145,43.08638438194408,NaN,NaN,9.942023891854976,5.0993106919166
2013-10-18T09:30:00-04:00,173.86,174.50999,173.50999,174.388,138315680,130190900.8,65.51189581830545,52.52281786317348,NaN,NaN,224.69042018283665,125.62808180211485,0.5733702805550812,1.0544597821065622,0.481089501551481,8535804381,8313944800.2,62.405610699441375,44.05494105172094,NaN,NaN,13.533858545920024,6.304246099631374
2013-10-21T09:30:00-04:00,174.45,174.75,174.00999,174.39999,104103568,130165257.6,65.5385007668618,53.43109057011851,NaN,NaN,193.599961941051,153.54403194898114,0.6340342317483413,1.2736322912369076,0.6395980594885663,8639907949,8389544800.2,65.61245244709181,45.38253588143609,NaN,NaN,16.31851357390939,7.734855738813947
2013-10-22T09:30:00-04:00,174.91,175.92999,174.42619,175.41,126663248,131181769.6,67.7924395007769,54.553008239056844,NaN,NaN,182.51082108785647,181.1252994399812,0.697445484192744,1.5114049147294963,0.8139594305367523,8766571197,8521574349,70.36657498277744,47.17611358228136,NaN,NaN,19.35584106222483,9.394996499301216
2013-10-23T09:30:00-04:00,174.81,174.89,173.96001,174.57001,105484368,130590663.2,64.04099002051422,55.88237985578171,NaN,NaN,130.64263160848014,182.23134039202216,0.6396022718021663,1.6134622702894603,0.973859998487294,8661086829,8600171811.4,72.77921170650124,49.457511121710134,NaN,NaN,20.744731000768365,11.016387142367952
2013-10-24T09:30:00-04:00,174.92,175.37,174.50999,175.14999,70350432,130250840.8,65.46213037257874,56.920563098905475,NaN,NaN,123.49026705092251,170.98682037422935,0.5979527318527216,1.721300913303196,1.1233481814504744,8731437261,8666961523.4,74.66671340058578,52.024114197876195,NaN,NaN,22.31504360383898,12.630480922578098
2013-10-25T09:30:00-04:00,175.50999,176,175.17,175.95,93625056,129975009.6,67.37733741661322,58.498955488398856,NaN,NaN,120.45687368907465,150.14011107547694,0.581315355113105,1.8499923753418557,1.2686770202287507,8825062317,8724813110.6,76.2057503858798,54.81450826390816,NaN,NaN,24.20664382552379,14.284218480141767
2013-10-28T09:30:00-04:00,175.89,176.47,175.7,176.23,84979018,127027091.7,68.04522481615916,60.56997708489909,NaN,NaN,113.6272621561908,134.1455711185049,0.5467165178438107,1.952072667533514,1.4053561496897033,8910041335,8778839787.8,77.57584711263512,58.00307126331792,NaN,NaN,25.95473927584708,15.951435736671097
2013-10-29T09:30:00-04:00,176.63,177.24,176.38,177.17,87401344,125039137.3,70.24745387356933,62.758966131639944,NaN,NaN,115.3206864380515,120.70754418854392,0.5435470938934304,2.0847900170564913,1.5412429231630609,8997442679,8825014084.2,78.70445896202293,61.38061004305989,NaN,NaN,28.10323863375942,17.687407579112286
2013-10-30T09:30:00-04:00,177.38,177.51,175.66,176.29,140001834,126371741.8,65.68368409779995,63.65355159112029,NaN,NaN,94.76538337565785,113.53209454197948,0.44285616183973975,2.0948131254627356,1.6519569636229958,8857440845,8864284887.4,79.64288277203387,64.59088757148865,NaN,NaN,28.651509198650167,19.25370781047484
2013-10-31T09:30:00-04:00,176.15,176.89,175.53,175.79,133795417,124226591.05,63.17241843236211,64.13878977865454,NaN,NaN,78.58006089331133,104.55005331045724,0.30956037633189704,2.038907434037867,1.72934705770597,8723645428,8862726520.8,79.49318175488621,67.55255604367747,NaN,NaN,28.405727890946597,20.561139250542233
2013-11-01T09:30:00-04:00,176.02,176.61,175.22,176.21,142805050,126522925.15,64.40355368735025,64.57442987262549,NaN,NaN,71.28541675019919,94.71576192268215,0.2208227856740752,2.005375539798564,1.7845527541244888,8866450478,8871004153,79.71133040337148,70.07883071462766,NaN,NaN,28.533895385646595,21.7001044127
2013-11-04T09:30:00-05:00,176.69,176.9,175.9825,176.83,85676773,125992007.8,66.19985117673366,65.4705871378508,NaN,NaN,77.12652241939152,87.41561397532227,0.17692541241390392,2.0057095196418686,1.8287841072279647,8952127251,8879421336.2,79.94495747705938,72.2090918774547,NaN,NaN,29.13406453215417,22.762098715479166
2013-11-05T09:30:00-05:00,176.14,176.75,175.57,176.27,85824778,121382499.5,63.10244046342245,65.67861096787108,NaN,NaN,65.11179289878424,77.37383526746883,0.0877260994543998,1.9384417315459643,1.8507156320915645,8866302473,8853193295,76.97069845308422,73.77417096123666,NaN,NaN,28.803968502873545,23.62522297082122
2013-11-06T09:30:00-05:00,177.03,177.5,176.54,177.17,87347728,117301245.1,65.866584654875,65.88889322128016,NaN,NaN,87.61322148725279,75.94340288978782,0.06778222736396589,1.935443416296522,1.867661188932556,8953650201,8872435166.2,77.62828529401254,75.12199684652732,NaN,NaN,29.27578872265983,24.432446649655308
2013-11-07T09:30:00-05:00,177.5,177.64,174.76,174.93,157000422,115353528.6,54.85247338309632,65.12750590447952,NaN,NaN,44.024217212178876,69.03223415356133,-0.10825013915447057,1.732348514989468,1.8405986541439385,8796649779,8887036036.4,78.13840294702831,76.24576772135497,NaN,NaN,26.30144902439035,24.699446988903173
2013-11-08T09:30:00-05:00,174.87,177.31,174.85,177.29,136712623,116937172.55,62.0522498836937,64.87848798425321,NaN,NaN,65.62279742883635,67.89971028928875,-0.07907986498605024,1.7417488229113758,1.820828687897426,8933362402,8900418421.2,78.61960368904988,77.1748499529234,NaN,NaN,25.97109655540496,24.88111121268914
2013-11-11T09:30:00-05:00,177.12,177.53,176.91,177.32,62614326,114462570.45,62.13491417237028,64.47437903222418,NaN,NaN,96.04105572998898,71.68261695140824,-0.07133662273099128,1.7316579094836868,1.802994532214678,8995976728,8909188316.6,78.94665144019841,77.78771255702489,NaN,NaN,25.740108681212543,25.003825136763915
2013-11-12T09:30:00-05:00,176.94,177.36,176.37,176.96,83989617,110887826.5,60.433631333545456,64.21671055458356,NaN,NaN,78.64541126099367,74.38934062385013,-0.10215564081851936,1.6752999811915288,1.7774556220100481,8911987111,8918325244.2,79.3018871529048,78.25361794605372,NaN,NaN,25.040750918363102,25.009100248420943
2013-11-13T09:30:00-05:00,176.09,178.4261,176.09,178.38,103844266,107996236.6,64.5560616043815,64.15199135685518,NaN,NaN,125.05066288461377,81.87682890332232,-0.04170087779468434,1.7253295247666927,1.767030402561377,9015831377,8930761479.4,79.80144879632834,78.62038476003534,NaN,NaN,25.697799026592925,25.107485788159796
2013-11-14T09:30:00-05:00,178.54,179.42,178.25,179.27,103435238,106698539.3,66.88490094666105,64.11681732328717,NaN,NaN,213.39793914701096,115.75157329028873,0.03906506730067827,1.815861736687225,1.7767966693865467,9119266615,8995284846.6,82.20166562507613,79.04866441997794,NaN,NaN,26.969535944482153,25.373492953348705
2013-11-15T09:30:00-05:00,179.56,180.12,179.33,180.05,102818190,104923664.8,68.81857300667812,64.1720564797528,NaN,NaN,235.45706577303315,149.7184269591281,0.12121880331381663,1.9283201735288173,1.8071013702150007,9222084805,9053029327.2,84.03059574088941,79.50971789342466,NaN,NaN,28.626964892060087,25.838274658878902
2013-11-18T09:30:00-05:00,180.35,180.5,179.02,179.42,104796009,104958286.85,65.49215608001371,63.832392351641694,NaN,NaN,186.2102955001689,167.7522749131641,0.10967655703810264,1.9441970665126291,1.8345205094745265,9117288796,9077291740.8,84.74013533874115,79.94083763461883,NaN,NaN,29.018607932253136,26.29260798364665
2013-11-19T09:30:00-05:00,179.33,179.87,178.72,179.03,93891416,103319695.25,63.44761855572444,63.67267338435058,NaN,NaN,136.15048615609808,179.25328989218497,0.05507881213647137,1.9033690246451158,1.8482902125086444,9023397380,9099573794.6,85.382479150358,80.35080880449912,NaN,NaN,28.750327119779897,26.64371071737997
2013-11-20T09:30:00-05:00,179.39,179.93,177.98,178.47,124908601,104290906.9,60.525792320642225,63.483628662084875,NaN,NaN,96.97487996715373,173.63813330869294,-0.03461771977719108,1.8050180627871555,1.8396357825643466,8898488779,9076105275,81.49162458070197,80.49355472062882,NaN,NaN,27.68623682271429,26.792643018142016
2013-11-21T09:30:00-05:00,178.97,180.05,178.86,179.91,92841271,105415448.85,64.99041872444059,63.52554759330561,NaN,NaN,123.05229064292645,155.56900360787606,-0.013897222572964107,1.8222642543481413,1.8361614769211054,8991330050,9050517962,77.35280970942249,80.32508895677532,NaN,NaN,28.05770584285155,26.973366278814808
2013-11-22T09:30:00-05:00,179.98,180.83,179.77,180.81,81295887,104798990.4,67.46704202518069,63.616061225337546,NaN,NaN,143.20911323606575,137.11941310048257,0.040514462766430226,1.8868045553791433,1.846290092612713,9072625937,9020626188.4,72.70710538335616,79.80809952151081,NaN,NaN,29.121027201681216,27.280174982081437
2013-11-25T09:30:00-05:00,181.13,181.17,180.37,180.63,79485709,104524324.95,66.45450217167449,63.855494204498406,NaN,NaN,131.98757007882742,126.27486801621426,0.044175364086668445,1.9015092977210486,1.8573339336343802,8993140228,8995796474.8,69.00004584574367,79.23876719241505,NaN,NaN,29.697358537407027,27.625486918556522
2013-11-26T09:30:00-05:00,180.72,181.22,180.405,180.68,86993560,104503935.75,66.60443317872857,63.908197670487944,NaN,NaN,115.70181037556654,122.18513286010798,0.030412124780763605,1.8953490896103347,1.864936964829571,9080133788,9007143756.4,69.7588945121345,78.67666785085234,NaN,NaN,30.211338494648604,27.994894286569675
2013-11-27T09:30:00-05:00,180.87,181.24,180.65,181.12,58800056,100443846.85,67.96148655320835,64.84455575406737,NaN,NaN,111.02536395500707,124.99522965767865,0.031268836943954215,1.9040230110095138,1.8727541740655596,9138933844,9055232769.4,72.79792383295029,78.29520505698962,NaN,NaN,31.019553484617234,28.426988457719325
2013-11-29T09:30:00-05:00,181.32,181.75,180.8,181,55870903,96547621.15,67.15993468949834,65.20939038305342,NaN,NaN,107.188301403599,121.82243180981315,0.005434981442865583,1.8795479008691416,1.874112919426276,9083062941,9073579347.6,73.87652782557632,77.95641392388437,NaN,NaN,31.489366521720186,28.864471038290876
2013-12-02T09:30:00-05:00,181.09,181.43,180.25,180.53,99725781,94393657.7,63.977235987734204,65.34098479843655,NaN,NaN,82.85526257138048,109.75166167687613,-0.058122321152412004,1.801460017985761,1.859582339138173,8983337160,9055721592.2,70.92846320745316,77.38368619297398,NaN,NaN,31.065641977326575,29.17892402958169
2013-12-03T09:30:00-05:00,179.94,180.39,179.17,179.75,116563302,95937984.15,58.98168002263851,65.23727399051464,NaN,NaN,38.31789775529973,91.01772721217057,-0.16164317399286698,1.6575283716470892,1.8191715456399562,8866773858,9030448318.2,66.86189091969057,76.49511503345867,NaN,NaN,29.33134807980859,29.20069889389982
2013-12-04T09:30:00-05:00,179.1,180.48,178.35,179.73,123032637,97798377.1,58.854780445272766,64.83003962200686,NaN,NaN,22.081197334323846,72.29360460392203,-0.2359158297463828,1.5242767584569776,1.7601925882033604,8743741221,8963169804.8,57.42351475845705,74.89669117361073,NaN,NaN,27.849401196737496,29.007656365733773
2013-12-05T09:30:00-05:00,179.41,179.74,178.7701,178.94,106934067,98777694.05,53.91992854145105,63.90397016449187,NaN,NaN,-1.1633983697463004,49.85585213897134,-0.336564688095911,1.3394867280834717,1.6760514161793827,8636807154,8862744466.8,46.803032870405254,72.36821740541995,NaN,NaN,25.172532057685697,28.459781464584047
2013-12-06T09:30:00-05:00,180.67,181.11,180.15,180.94,127727518,97314048.85,62.49389745259429,63.45220762491444,NaN,NaN,79.91011166702627,44.40021419165681,-0.2696510787161792,1.3389875677841587,1.608638646500338,8764534672,8799038813,41.55284790164424,69.33409255975958,NaN,NaN,25.1369069273918,27.98508510212801
2013-12-09T09:30:00-05:00,181.47,181.67,181.16,181.4,70123608,93984598.1,64.14629783362909,63.35607489302983,NaN,NaN,116.58968205689216,51.14709808875914,-0.19888489568734213,1.3600325268911604,1.5589174225785025,8834658280,8769303037,39.33483570008679,66.09085687128427,NaN,NaN,25.603133700865282,27.64480633051905
2013-12-10T09:30:00-05:00,180.98,181.36,180.635,180.75,80976207,94902692.15,60.11594353205911,63.118098105625165,NaN,NaN,76.3964606986962,58.76281067743844,-0.1997979823119973,1.309169944688506,1.5089679270005032,8753682073,8746684680,37.68697361428101,62.68403504727877,NaN,NaN,24.796500530393963,27.237905501929752
2013-12-11T09:30:00-05:00,180.81,180.85,178.5,178.72,130590810,97232751.8,49.628489877844984,62.33971935971107,NaN,NaN,-50.046954352409124,44.33718034009185,-0.33320337703931235,1.0924637057013626,1.425667082740675,8623091263,8722554688.4,35.95636028604709,59.431516169089136,NaN,NaN,20.54982368766748,26.282465242749428
2013-12-12T09:30:00-05:00,178.64,178.86,177.76,178.13,115564840,97818780.5,47.05890559687674,61.058896993456514,NaN,NaN,-147.585688060969,15.0527224018473,-0.45000217865543957,0.8631643594213756,1.3131665380768152,8507526423,8696698542.2,34.146890840303485,56.3453791070092,NaN,NaN,16.253849308455095,24.849805823564523
2013-12-13T09:30:00-05:00,178.5,178.66,177.77,178.11,107807610,98037399.1,46.970125381697386,59.594831518921985,NaN,NaN,-143.58332338373052,-29.64596460830406,-0.5128677888837283,0.6720818019721548,1.1849495908558831,8399718813,8623735370.4,29.617421083083855,53.26754451413262,NaN,NaN,12.833139684115261,23.133139232214628
2013-12-16T09:30:00-05:00,178.95,179.81,178.9,179.216,96194790,97706229.1,52.32639221526534,58.5856808077499,NaN,NaN,-49.16929161681617,-62.79775934304572,-0.46560598154898414,0.6029421139196529,1.068548095468637,8495913603,8555986435,26.148979417039882,50.206754054939495,NaN,NaN,11.486247623253625,21.46929757379163
2013-12-17T09:30:00-05:00,179.36,179.41,178.25,178.65,89886224,96960739.85,49.56719986662808,57.36873557117131,NaN,NaN,-84.02302117106181,-94.88165571699733,-0.45743790813404084,0.496750710301086,0.9541886184351268,8406027379,8486455496.2,23.152291980638964,46.877711016975525,NaN,NaN,9.521892296671936,19.762525391345957
2013-12-18T09:30:00-05:00,178.92,181.73,177.32,181.7,234906482,104011493.15,61.383930668922034,56.89891015086513,NaN,NaN,23.25904097864183,-80.22045665078714,-0.24239394778658252,0.6511961837018987,0.8935901314884812,8640933861,8490024015.8,23.63598534864036,43.36614398238196,NaN,NaN,11.819740266767264,18.62784180212043
2013-12-19T09:30:00-05:00,181.19,181.7,180.71,181.49,136298872,104581006.7,60.335686020222255,56.411463817345414,NaN,NaN,94.01206764203197,-31.90090551018694,-0.11645026831377059,0.748027296096268,0.8644775644100385,8504634989,8489445729,23.610050960034286,39.77568134912896,NaN,NaN,13.237404702728103,17.857779359350097
2013-12-20T09:30:00-05:00,180.67,181.99,180.5683,181.56,197086908,109793288.55,60.577352919639786,56.16861502676725,NaN,NaN,90.30931096438037,14.87762135943523,-0.03482073493805793,0.8209516457374662,0.8557723806755241,8701721897,8549846345.8,32.0023161653571,36.995242274693524,NaN,NaN,14.42200730805959,17.36695478059431
2013-12-23T09:30:00-05:00,182.41,182.64,182.065,182.53,85597541,110008371.25,63.863047041745,56.51728409956057,NaN,NaN,147.48690256023662,54.208860194845784,0.07226965608005631,0.9461094507755945,0.8738397946955382,8787319438,8608127512.8,38.96956028107711,35.00293294336399,NaN,NaN,16.47539189032945,17.239588653413616
2013-12-24T09:30:00-05:00,182.54,183.01,182.53,182.93,45368841,108302527.85,65.15284480273712,56.96714583937945,NaN,NaN,153.5735269249814,101.72816981405444,0.15316377861308006,1.0652945179618882,0.9121307393488082,8832688279,8693459692.8,47.45825112235796,34.29112839792834,NaN,NaN,18.55068908742525,17.426888715415277
2013-12-26T09:30:00-05:00,183.34,183.96,183.32,183.855,63365227,107121111.2,67.99744457845583,57.9726826991655,NaN,NaN,177.76844379993548,132.63005037831317,0.24655316626226742,1.2203221971766425,0.9737690309143751,8896053506,8744483621.8,51.77733068720748,34.646435384842775,NaN,NaN,21.218916701405032,17.9686069991281
2013-12-27T09:30:00-05:00,184.1,184.18,183.66,183.845,61813841,107271800.45,67.93288259919919,58.36118163820871,NaN,NaN,162.33713352330147,146.29506355456707,0.2826472577855448,1.327078103146306,1.0444308453607611,8834239665,8810404557,56.72660775795438,35.730275374579215,NaN,NaN,23.33856396734889,18.735743708873926
2013-12-30T09:30:00-05:00,183.87,184.02,183.58,183.82,56857458,107321128.2,67.75966970568696,58.619279629069986,NaN,NaN,138.09811165150884,155.85282369199277,0.2793361805397041,1.3936010710353912,1.114264890495687,8777382207,8825536619,57.79736140153015,37.049027210396595,NaN,NaN,25.02564128661348,19.63430050569386
2013-12-31T09:30:00-05:00,184.07,184.69,183.93,184.69,86247638,106647221.05,70.57175484794789,59.366123294490606,NaN,NaN,140.54571172180076,154.4645855243056,0.3079804245123592,1.499240421136136,1.191259996623777,8863629845,8840798700.4,58.90192428202968,38.5643808295215,NaN,NaN,27.33318561455477,20.734141235531133
2014-01-02T09:30:00-05:00,183.98,184.07,182.48,182.92,119636836,106800897.75,59.24907440169019,60.053307903336695,NaN,NaN,79.42230029446732,139.63434019820278,0.18597148398176344,1.4237243516009812,1.2377528676192178,8743993009,8823059646.4,57.03347194605423,40.06988880523629,NaN,NaN,25.99090330905691,21.485107246034815
2014-01-03T09:30:00-05:00,183.21,183.6,182.63,182.885,81390502,104718791,59.04733158904082,60.90962404563413,NaN,NaN,67.92939637921313,117.66653071405828,0.08623173640802695,1.3455425381292514,1.2593108017212244,8662602507,8776369446.6,52.32836334449181,41.368565412678315,NaN,NaN,24.85912774959545,21.967110175114907
2014-01-06T09:30:00-05:00,183.47,183.56,182.08,182.36,108028139,104773494.6,55.968834771333675,61.55238900203672,NaN,NaN,47.44167333492921,94.68743867638383,-0.02578878490716985,1.2270748205872621,1.252863605494432,8554574368,8720436387.2,47.29474529231358,42.63123142762329,NaN,NaN,23.000347151249088,22.11471545741979
2014-01-07T09:30:00-05:00,183.09,183.79,182.95,183.48,86144169,102694327.15,60.67871184400478,62.148983261232395,NaN,NaN,69.44442551500632,80.95670144908334,-0.034595521615545355,1.2096192034750004,1.2442147250905458,8640718537,8693103653.2,45.01593303739325,43.978870971934256,NaN,NaN,22.758030326286466,22.2066175815436
2014-01-08T09:30:00-05:00,183.45,183.83,182.89,183.52,96582234,104017258.45,60.83982118153618,62.95417049801154,NaN,NaN,63.260594758410356,65.49967805640526,-0.047092420756293496,1.185349199145179,1.2324416199014725,8737300771,8667837838.4,42.95554144091246,45.393388790525215,NaN,NaN,22.608504266671808,22.264029965133343
2014-01-09T09:30:00-05:00,184.1,184.13,182.795,183.64,90683302,104502613.2,61.35142339759093,62.951848550059324,NaN,NaN,61.626621036060335,61.940542204723855,-0.05603438785809134,1.1623986350788584,1.2184330229369498,8827984073,8684636051.2,44.76566046447763,46.902651298799306,NaN,NaN,22.625183064626487,22.315623265060935
2014-01-10T09:30:00-05:00,183.95,184.22,183.01,184.14,102026318,103074388.6,63.4916203928041,63.177272433815176,NaN,NaN,66.85434758103284,61.72553244508781,-0.037901013781766135,1.171056755709742,1.2089577694915081,8930010391,8738117628,50.18537422676056,48.80088867499404,NaN,NaN,23.22902068567459,22.446108610862886
2014-01-13T09:30:00-05:00,183.71,184.18,181.34,181.685,149891938,104790743.5,49.11131819194022,62.35826995326521,NaN,NaN,5.446259660219259,53.32644971014582,-0.19224273432875205,0.9686543515805681,1.1608970859093202,8780118453,8783226445,54.26187440444582,50.39085712064324,NaN,NaN,19.146074916617543,21.974675225970696
2014-01-14T09:30:00-05:00,182.28,183.77,181.95,183.67,105016055,104651165.75,57.494202438496714,61.90335248160461,NaN,NaN,33.58357817866323,46.1542802428772,-0.16280906733046074,0.9573857517462443,1.120194819076705,8885134508,8832109639.2,58.24917080726822,51.76797215822832,NaN,NaN,18.392827268398236,21.462982660603203
2014-01-15T09:30:00-05:00,184.1,184.94,183.7102,184.66,98525721,104767712.3,60.94930104552435,61.60309935608941,NaN,NaN,106.40796069638122,54.78375343047137,-0.08285900990178185,1.0166210566994778,1.0994800666012596,8983660229,8881381530.8,61.85846792403352,52.79655907263371,NaN,NaN,18.984624946165436,21.108931558540664
2014-01-16T09:30:00-05:00,184.28,184.6618,183.83,184.42,72290520,103887927.1,59.68275246855642,61.009192776810885,NaN,NaN,100.28467291587744,62.51536380643479,-0.05374424578961934,1.0322997593642356,1.086044005153855,8911369709,8898058658,63.02363559612281,53.599866566127666,NaN,NaN,19.03177442403257,20.81219482503951
2014-01-17T09:30:00-05:00,184.1,184.45,183.32,183.635,107848616,97535033.8,55.612086995255126,60.12913594795774,NaN,NaN,54.3809568400382,60.020685658235855,-0.09267643550269011,0.9701984607754923,1.0628748962781824,8803521093,8872760798.4,60.02798420556265,53.835679169528255,NaN,NaN,17.756474733675326,20.375663383416054
2014-01-21T09:30:00-05:00,184.7,184.77,183.05,184.18,88621138,95151147.1,57.76582142377599,59.41528964210696,NaN,NaN,69.20188918509794,72.7718115632116,-0.08712952664716989,0.95396298796922,1.0410925146163899,8892142231,8895165554,61.761507563900345,54.11883246684041,NaN,NaN,17.38730156858734,19.94875455272624
2014-01-22T09:30:00-05:00,184.49,184.57,183.91,184.3,61270816,88360342.5,58.246210090620345,58.53489358801213,NaN,NaN,94.11911967656624,84.8789198627922,-0.08091867994700874,0.939944164682629,1.0208628446296377,8953413047,8908821261.8,62.819890904431986,54.39868722558344,NaN,NaN,17.23401018508669,19.560933928777732
2014-01-23T09:30:00-05:00,183.36,183.4,181.82,182.79,132496880,90705309.45,50.467293721405206,57.90762353942035,NaN,NaN,-112.72545308185029,41.0522371071459,-0.17845563469847237,0.7977933012565472,0.9762489359550196,8820916167,8876272449.4,58.65276753718117,54.51435119637822,NaN,NaN,14.63416469483052,18.85710975249956
2014-01-24T09:30:00-05:00,181.6,181.66,178.83,178.89,208677093,98870722.05,36.797956104983825,56.31838243341628,NaN,NaN,-350.9267725044006,-49.19005197690971,-0.4880241331654982,0.3662187694981469,0.8542429026636451,8612239074,8816446322.4,51.84525264696263,54.479843289411846,NaN,NaN,6.707149177273906,17.121401098895895
2014-01-27T09:30:00-05:00,179.06,179.52,177.12,178.01,180843004,104744610.9,34.52557523131651,54.78672103770077,NaN,NaN,-330.77001982795105,-126.22024731050756,-0.7204201528265364,-0.046282288369525304,0.6741378644570111,8431396070,8742021317.8,44.86848636422166,54.306539080262425,NaN,NaN,-0.2764876216580831,14.63598842453104
2014-01-28T09:30:00-05:00,178.14,179.3,178.12,179.07,110463152,107177076.45,39.38148489180821,53.265490541115305,NaN,NaN,-213.83049574540814,-182.82672429660877,-0.766815123423932,-0.28438103982290386,0.4824340836010281,8541859222,8671964716,39.48250595269158,53.91129428849802,NaN,NaN,-4.117618526640009,11.956901717220891
2014-01-29T09:30:00-05:00,177.56,178.55,176.88,177.35,216597269,115164067,34.8632017662739,51.41001772573942,NaN,NaN,-207.78597489096614,-243.2077432101152,-0.8698615175206499,-0.6048928132997844,0.26496870422086555,8325261953,8546334497.2,32.05214124812966,53.132479989013525,NaN,NaN,-8.962573978214266,8.968405189301583
2014-01-30T09:30:00-05:00,178.86,179.81,178.26,179.23,118938051,116798587.65,42.61329188617735,50.071579760638464,NaN,NaN,-118.64246408208238,-244.39114541016164,-0.7712878839947189,-0.6991411507725331,0.07214673322218582,8444200004,8470991264.6,28.57853776030821,51.976256938715714,NaN,NaN,-10.147831789653807,6.237514192307955
2014-01-31T09:30:00-05:00,177.02,179.29,176.92,178.18,194677861,120550638.9,39.767367718713516,48.3769902839177,NaN,NaN,-126.74818917213886,-199.5554287437093,-0.7367379498212376,-0.8487757040543613,-0.11203775423312362,8249522143,8398447878.4,25.69150926924108,50.22669515603575,NaN,NaN,-12.091921618359164,3.6190233622126526
2014-02-03T09:30:00-05:00,177.95,178.37,173.83,174.17,254837004,129222964,31.198062378124277,47.09747201150228,NaN,NaN,-169.09113633741222,-167.21965204560155,-0.9313491047830136,-1.2762241352118906,-0.344875030428877,7994685139,8311105692.2,22.716045215454827,47.97342164253639,NaN,NaN,-17.273745175964404,0.6343421424730735
2014-02-04T09:30:00-05:00,174.95,175.84,174.1055,175.385,165012351,132072174.6,35.717925132727146,45.54202363251874,NaN,NaN,-147.06233544481978,-153.8660199854839,-0.923822126054259,-1.4996526879967007,-0.5758305619424418,8159697490,8234673345.8,20.480685611765836,45.275672700000506,NaN,NaN,-19.525654206458213,-2.2456573359456815
2014-02-05T09:30:00-05:00,174.79,175.56,173.71,175.17,164230470,135976489.65,35.276299306790506,43.70823779403775,NaN,NaN,-131.6825547728793,-138.6453359618665,-0.8791471396213616,-1.6747644864691438,-0.7956173468477822,7995467020,8168714359.2,18.764612669189702,42.19754018179738,NaN,NaN,-21.361270030563592,-4.976459149462526
2014-02-06T09:30:00-05:00,175.58,177.48,175.2209,177.48,132877526,137791254.25,43.37694668554044,42.543537380965184,NaN,NaN,-80.52501764058019,-131.02184667356605,-0.650387082942787,-1.608601200526266,-0.958214117583479,8128344546,8105543267.6,17.271949860933304,38.92956262928384,NaN,NaN,-20.021992664671494,-7.125821080206665
2014-02-07T09:30:00-05:00,178.31,179.87,177.73,179.68,170787197,141796449,49.81856315358653,42.129714249417425,NaN,NaN,-26.21786696497436,-110.91578223213314,-0.3237756300319701,-1.3629336551234417,-1.0391580250914716,8299131743,8115465187.6,18.370278842225034,35.9540122461883,NaN,NaN,-16.55955254539109,-8.47349700380444
2014-02-10T09:30:00-05:00,179.7,180.07,179.21,180.01,92218729,141306069.55,50.72411220340443,41.626735019390885,NaN,NaN,-7.482797724697651,-78.59411450959024,-0.07155541090587225,-1.1286022887238119,-1.0570468778179396,8391350472,8194798254.2,26.744823081095618,33.45282049741653,NaN,NaN,-13.606348302963905,-9.206761475112934
2014-02-11T09:30:00-05:00,180.16,182.439,180.0389,181.98,117814009,139702173.1,55.846484545546964,41.45532605188565,NaN,NaN,34.774198328708714,-42.22680775488454,0.22564008133750857,-0.7749967761460539,-1.0006368574835625,8509164481,8264691652.4,33.242792009727154,31.340170576366187,NaN,NaN,-9.34849926941647,-9.22700973144201
2014-02-12T09:30:00-05:00,182.22,182.83,181.705,182.07,94717638,139187252.25,56.07115575856758,41.85560191168296,NaN,NaN,54.13351394870854,-5.063594010566973,0.4149542372944375,-0.48194406086551567,-0.8968982981599531,8603882119,8386374672.2,42.76202723480741,30.205117697625205,NaN,NaN,-5.983705758306048,-8.763680592422586
2014-02-13T09:30:00-05:00,180.84,183.2,180.83,183.01,100542155,139288073.95,58.449260236101836,43.40212363533424,NaN,NaN,63.145108977098026,23.670431312968663,0.5800255503953616,-0.17186636016575108,-0.7518919105611127,8704424274,8501590617.8,50.02806065201074,30.07531826941436,NaN,NaN,-2.4574140433838174,-7.862785371131334
2014-02-14T09:30:00-05:00,182.84,184.36,182.67,184.02,96498305,140498463.2,60.89861396435114,45.28591211626529,NaN,NaN,99.65396840348846,48.844798386661225,0.7243938491666536,0.15360040089720428,-0.5707934482694493,8800922579,8601948785,55.34550710525738,30.823676893774046,NaN,NaN,1.2478565256903718,-6.561265100156805
2014-02-18T09:30:00-05:00,184.19,184.49,183.65,184.24,80460878,139129076.3,61.43193242710968,46.86094408307253,NaN,NaN,109.93104702174585,72.32756733594992,0.7961508803332614,0.4243951521471274,-0.371755728186134,8881383457,8699955382,59.83978778635048,32.277768453321116,NaN,NaN,4.401734440167966,-4.995122308681838
2014-02-19T09:30:00-05:00,183.76,184.95,182.87,183.02,126524261,141024232.45,56.8049043725662,48.42820855495056,NaN,NaN,98.05423610967573,84.98357489214334,0.7249229287341593,0.5343979327315651,-0.19052499600259418,8754859196,8749094325,61.90975732107161,34.41045531567411,NaN,NaN,5.784676360213297,-3.455151070268247
2014-02-20T09:30:00-05:00,183.27,184.52,182.6,184.1,104998099,143210596.6,59.69874826377938,49.648598296207844,NaN,NaN,103.29254759559348,94.81538162152032,0.7129370277276053,0.7006462886569125,-0.012290739070692835,8859857295,8800289360.2,63.99210121039249,36.939995562108706,NaN,NaN,7.822697335809842,-1.8440298693999488
2014-02-21T09:30:00-05:00,184.49,184.89,183.8,183.89,118116359,142491570.55,58.87283239122132,51.01327434424412,NaN,NaN,109.28997714186038,104.04435525447279,0.6547615030364341,0.8061611397248498,0.1513996366884157,8741740936,8807752692.6,64.29851941414216,39.69763914388741,NaN,NaN,9.261071708983373,-0.25758678677376023
2014-02-24T09:30:00-05:00,184.28,186.15,184.2,184.91,114063868,137760909.3,61.64820824966721,53.188284763640034,NaN,NaN,113.17744960425878,106.74905149462685,0.6476882667819109,0.9610099701658044,0.3133217033838934,8855804804,8818729137.6,64.77331013586584,42.70172949534534,NaN,NaN,11.29987490889282,1.3934791697500368
2014-02-25T09:30:00-05:00,185.03,185.59,184.23,184.84,117084901,134573004.15,61.342268862793524,55.01859503007336,NaN,NaN,96.3028728363146,104.02341665754061,0.6019782795009733,1.06579455276011,0.46381627325913677,8738719903,8790196426.8,62.44841469190724,45.69942442964116,NaN,NaN,12.89515018956605,3.036575029723753
2014-02-26T09:30:00-05:00,185.11,185.6,184.33,184.85,98677144,133983703.75,61.37176101633376,56.882556580755015,NaN,NaN,87.39845961997467,101.8922613596004,0.5381811010991021,1.1365426496330144,0.5983615485339123,8837397047,8806703997,63.26981572317442,48.878367504925784,NaN,NaN,14.22995897392475,4.635629878895324
2014-02-27T09:30:00-05:00,184.59,185.87,184.37,185.82,93880780,127847879.3,64.22298080531986,58.37155901788212,NaN,NaN,88.51812665772401,98.9373771720265,0.5264299088941498,1.2563989346515996,0.7299690257574498,8931277827,8820988103.4,64.00355403853405,52.21633923189727,NaN,NaN,16.18351881276822,6.285328298020024
2014-02-28T09:30:00-05:00,185.79,187.15,185.05,186.29,150842000,129443076.75,65.54984882280456,59.49522227996913,NaN,NaN,96.87737455513583,96.4548566546816,0.5148074772953736,1.3734783723766668,0.8586708950812932,9082119827,8889063881.6,67.35099036337192,55.71496148340776,NaN,NaN,18.21772711739185,7.9899567007874275
2014-03-03T09:30:00-05:00,184.69,185.45,183.75,184.98,167748455,128096606.45,58.98365941241434,60.085189937755544,NaN,NaN,61.97884918166529,86.2151365701629,0.3891062254485941,1.3450536768920358,0.9559474514434417,8914371372,8900777195.2,67.90405351941982,58.654906514716636,NaN,NaN,18.265039973270362,9.457825739713561
2014-03-04T09:30:00-05:00,186.75,187.98,186.75,187.58,167545852,123732048.85,66.2168319012955,60.82592903459472,NaN,NaN,117.11612107001008,90.377786216902,0.44713226020879304,1.5148627767044331,1.06773051649564,9081917224,8969416659.4,71.00378983715869,61.35212064524745,NaN,NaN,20.54383039468572,11.041540690423869
2014-03-05T09:30:00-05:00,187.72,188.07,187.45,187.75,88376859,119900274.25,66.63118722500099,61.580216996482825,NaN,NaN,122.48139456248364,97.39437320540378,0.46117715025613104,1.644201954315804,1.183024804059673,9170294083,9035996066.6,73.66099257869038,63.559189598381955,NaN,NaN,22.50162759644071,12.678695962711988
2014-03-06T09:30:00-05:00,188.21,188.61,187.7796,188.18,82516500,115814575.75,67.70999694945979,62.24169819029411,NaN,NaN,138.0432010953835,107.29938809293567,0.4624607310900706,1.761100717922261,1.2986399868321905,9252810583,9100302617.8,75.95313643345503,65.41098072562798,NaN,NaN,24.44172231334364,14.35912829851651
2014-03-07T09:30:00-05:00,188.87,188.96,187.43,188.26,114513432,114896371.05,67.91781071367002,62.74306938667403,NaN,NaN,133.94183053112724,114.71227928813396,0.4322882592198385,1.8390003108569886,1.40671205163715,9367324015,9157343455.4,77.79872833437088,67.01478224199323,NaN,NaN,26.095107436729077,16.035696746832592
2014-03-10T09:30:00-04:00,187.94,188.23,187.08,188.16,74939176,110103970,67.33444859092921,63.16467768408971,NaN,NaN,112.6208594317946,124.84068133815981,0.37150898187983916,1.871098278986949,1.4995892971071099,9292384839,9232946148.8,79.99074664037371,68.45413644585203,NaN,NaN,27.32414668471549,17.648332452244436
2014-03-11T09:30:00-04:00,188.44,188.71,186.8,187.23,99009013,110443484.2,62.000855687311436,63.53581706371437,NaN,NaN,93.6624274572833,120.14994261561446,0.24091669688803918,1.8007351682171588,1.5598184713291197,9193375826,9255237869.2,80.59899582774746,69.78908205347173,NaN,NaN,26.97913964566637,18.98130490844757
2014-03-12T09:30:00-04:00,186.32,187.35,185.9,187.28,104824323,109793999.9,62.17433228603898,63.712644493875764,NaN,NaN,56.6738309773669,106.98842989859114,0.13540504723221436,1.7290747803693876,1.5936697331371732,9298200149,9280819082.4,81.30145439784143,71.0254644240038,NaN,NaN,26.735338882603916,20.08902404761276
2014-03-13T09:30:00-04:00,187.84,187.99,184.66,185.18,155014237,112808829.85,51.53319341368678,63.188384566909015,NaN,NaN,13.602828046746094,82.10035528886365,-0.08637204376320584,1.4857046784331658,1.5720767221963716,9143185912,9258894148.2,78.6722759397465,72.05216131868983,NaN,NaN,23.34764293513461,20.554541031544453
2014-03-14T09:30:00-04:00,184.8,185.8,184.44,184.66,153919598,115477702,49.28387687132144,62.305218039884316,NaN,NaN,-37.67620497037609,47.77674818856296,-0.26836737118422915,1.236617508216085,1.5049848794003142,8989266314,9183282608,70.23660325435338,72.44239654143894,NaN,NaN,19.833157556322803,20.451486249369932
2014-03-17T09:30:00-04:00,185.59,186.77,185.51,186.33,98359454,115570759.45,55.935800005815764,61.91904169295734,NaN,NaN,15.802449285836422,28.41306615937133,-0.275515416816452,1.1605906083797493,1.4361060251962012,9087625768,9142330793.8,66.1024613317924,72.70339987285931,NaN,NaN,18.641355636522157,20.19289616182025
2014-03-18T09:30:00-04:00,186.71,187.91,186.51,187.66,101804519,116637941.5,60.39143988750573,61.849018755183906,NaN,NaN,66.80338461955682,23.04125759182603,-0.19376791154665374,1.1938961357628841,1.3876640473095379,9189430287,9141541686,66.02182008244557,72.89997161280725,NaN,NaN,19.00820336216372,20.023654333297888
2014-03-19T09:30:00-04:00,187.7,187.94,185.47,186.66,176267253,119125091.1,55.82103067665426,61.24887946027923,NaN,NaN,26.85297250214259,17.077085896781163,-0.20884125690157251,1.1266124761825722,1.3354537330841447,9013163034,9084534263,60.298766629078045,72.63534394070324,NaN,NaN,17.866931420647735,19.71555106006215
2014-03-20T09:30:00-04:00,186.25,187.89,185.92,187.747,117240972,119737234.75,59.41640752564264,60.81077651048194,NaN,NaN,47.66404601505247,23.889329490442435,-0.1501464101692882,1.1477707203725345,1.2979171305418227,9130404006,9081977881.8,60.04739666560696,72.11365867657717,NaN,NaN,18.039149912058615,19.47606518177593
2014-03-21T09:30:00-04:00,187.72,189.0239,186.03,186.2,163127905,121987812.05,52.82721757048774,60.37103066463004,NaN,NaN,36.001743247891774,38.624919134096004,-0.21604548307385874,1.0278602766994993,1.243905759773358,8967276101,9077579839.2,59.587165336552424,71.5195952349438,NaN,NaN,16.019968224960206,18.98233704508797
2014-03-24T09:30:00-04:00,186.82,187.07,184.62,185.43,121411145,122355175.9,49.86313490147196,59.20290945035693,NaN,NaN,-55.84834456098156,24.29476036473241,-0.30650433658304577,0.860775339044551,1.1672796756275967,8845864956,9029227676.8,54.62978081525601,70.35002316195074,NaN,NaN,13.408099681022243,18.18601742165001
2014-03-25T09:30:00-04:00,186.37,186.94,185.27,186.31,103851737,121693517.7,53.10179538787787,58.236524319133856,NaN,NaN,-31.480276213825935,4.63802819805586,-0.30161705151439233,0.7902583612346064,1.0918754127489987,8949716693,8981284958,50.17262190222658,68.67228239934619,NaN,NaN,12.254890235028023,17.33871353784687
2014-03-26T09:30:00-04:00,187.03,187.34,184.92,184.97,119842897,122751805.35,48.01555364595745,56.82977836888369,NaN,NaN,-68.18864981427217,-14.370296265227092,-0.37821262090992125,0.6191096366115971,0.9973222575215184,8829873796,8944627110.4,47.014087186892084,66.60520745316312,NaN,NaN,9.619392226672696,16.235953350536274
2014-03-27T09:30:00-04:00,184.77,185.34,183.9,184.58,142382757,125176904.2,46.616069642487716,55.308225435227804,NaN,NaN,-143.60381677871518,-52.623868823980615,-0.4403759948881095,0.44685226391138144,0.887228258799491,8687491039,8856044517,40.3961198076392,63.93359255839657,NaN,NaN,7.059925277805826,14.925092197289068
2014-03-28T09:30:00-04:00,185.105,186.42,185,185.49,101641547,122716881.55,50.25908683225657,54.088556738179754,NaN,NaN,-66.20781659374224,-73.06578079230742,-0.40626817265853843,0.37939304297631793,0.7856612156348564,8789132586,8820415814,38.07462078187311,60.93958356850367,NaN,NaN,6.010978069301327,13.651647321862248
2014-03-31T09:30:00-04:00,186.65,187.3,185.5216,187.01,99744911,119316704.35,55.69742850433318,53.63831193939559,NaN,NaN,-5.994764900162238,-63.095064860143566,-0.27375267585684604,0.4434703708137988,0.7172230466706448,8888877497,8829018322.2,38.986349490134394,57.96725168724559,NaN,NaN,6.8238903789512,12.676253472874954
2014-04-01T09:30:00-04:00,187.62,188.36,187.0015,188.25,89193125,115399068,59.57993771186464,53.452998041240285,NaN,NaN,87.79967631174627,-39.23907435502912,-0.10374884456684152,0.5875369909620929,0.6912858355289344,8978070622,8834689108,39.61746827182517,54.98982410681585,NaN,NaN,8.771400673054126,12.118417358614836
2014-04-02T09:30:00-04:00,188.5,189.13,188.14,188.88,78773818,114918915.95,61.42939195994932,54.15986936597333,NaN,NaN,140.512290868733,2.5011137815719167,0.04214775643069635,0.7439705310673048,0.7018227746366085,9056844440,8880083236.8,44.56103430519475,52.55330684720502,NaN,NaN,10.94737179681246,11.951125135500211
2014-04-03T09:30:00-04:00,189.17,189.22,188.05,188.63,77435320,114664856.95,60.25125214475387,54.94325331407564,NaN,NaN,129.84756780989014,57.19139069929298,0.10903066418652729,0.8381111048697676,0.7290804406832403,8979409120,8938466853,50.20740948258906,51.122650149221855,NaN,NaN,12.358493178219462,12.00932057017439
2014-04-04T09:30:00-04:00,189.64,189.7,186.1,186.4,169380705,117408220.6,50.87781983578646,54.581969016216405,NaN,NaN,48.38721482574609,80.11039698319065,-0.003724270072524072,0.7244251030925852,0.7281493731651093,8810028415,8942646018.8,50.59529735016654,50.01499557910572,NaN,NaN,10.639738355278979,11.813665968046474
2014-04-07T09:30:00-04:00,185.9,186.26,183.96,184.34,140802699,120701396.75,44.058931591840796,53.41536128081176,NaN,NaN,-122.15315087247755,56.87871978872759,-0.21230443235683627,0.462768832719064,0.6750732650759003,8669225716,8898715662.6,46.49506784146265,48.620227561892655,NaN,NaN,6.793601852714658,11.0965139515705
2014-04-08T09:30:00-04:00,184.21,185.4,183.59,185.1,112659755,121383933.85,46.88716728946301,52.77722818172667,NaN,NaN,-117.43240370956276,15.832303784465784,-0.28956217764294234,0.31312054302222236,0.6026827206651647,8781885471,8859478632.4,43.13287579463899,47.394092502289865,NaN,NaN,4.622415982311226,10.17164281310489
2014-04-09T09:30:00-04:00,185.6,187.15,185.06,187.09,100253612,121155398.3,53.51433630048965,52.35565166564431,NaN,NaN,0.5208690288395306,-12.165980583512916,-0.20130390015132782,0.3510528454760049,0.5523567456273327,8882139083,8824537561,40.33563832417726,45.98610976361632,NaN,NaN,4.9949926389856545,9.432121359659286
2014-04-10T09:30:00-04:00,187.09,187.17,182.93,183.155,172959331,122052653,42.28015361284868,51.60228995438438,NaN,NaN,-122.73153370725754,-62.68180088694245,-0.39159087671845105,0.06286814972926891,0.45445902644771996,8709179752,8770491687.4,36.40312178425132,44.33010665273766,NaN,NaN,1.0428478523220093,8.233653715753961
2014-04-11T09:30:00-04:00,182.17,183.42,181.31,181.51,167250792,122719212.7,38.62930302416696,50.79987339171974,NaN,NaN,-230.45852595708,-118.45094904350768,-0.5994544995041661,-0.29485909793248766,0.3045954015716784,8541928960,8716871796.4,32.968858382188344,42.782897907518546,NaN,NaN,-3.4567090858289404,6.563601886956404
2014-04-14T09:30:00-04:00,182.93,183.37,181.44,182.9401,132381601,124420320.05,43.21960347065131,50.094002540489264,NaN,NaN,-165.11675085981315,-127.04366904097478,-0.6098262929714369,-0.45768746464261767,0.1521388283288192,8674310561,8717888765.4,33.09777295659299,41.56326583997329,NaN,NaN,-5.35530901365167,4.860900329726679
2014-04-15T09:30:00-04:00,183.32,184.33,181.51,184.2,157092533,127184720.75,46.981944871998955,50.02017334234937,NaN,NaN,-113.38290288999195,-126.23376887706063,-0.5053421762272162,-0.47953889195520105,0.025803284272015142,8831403094,8727792290,34.42047021985533,40.663721770899244,NaN,NaN,-5.5416503871807095,3.3748216558827666
2014-04-16T09:30:00-04:00,185.47,186.14,184.65,186.125,105196633,123631189.75,52.194135575595745,50.41860662328566,NaN,NaN,-6.237092883186498,-127.58536125946583,-0.2907489248977637,-0.33763287185018953,-0.0468839469524258,8936599727,8738684418.8,35.920995454813394,40.344070031411675,NaN,NaN,-3.8546686097780696,2.342037332216933
2014-04-17T09:30:00-04:00,185.88,186.91,185.56,186.39,105254649,123031873.6,52.88087743958215,50.605877380951775,NaN,NaN,27.29971554427014,-97.57911140916029,-0.12366538033695154,-0.20146567237361523,-0.07780029203666369,9041854376,8805219343.6,44.30435056864152,40.78905073046656,NaN,NaN,-2.3284825459811676,1.6748202067600615
2014-04-21T09:30:00-04:00,186.44,187.1,186.21,187.04,68329343,118291945.5,54.60348759374926,50.52773874448149,NaN,NaN,52.795424989424355,-40.92832121985942,0.02973286392545489,-0.04063421212984508,-0.07036707605529997,9110183719,8918870295.4,55.10817379653014,41.940609609494835,NaN,NaN,-0.5546032246816354,1.3563311451255333
2014-04-22T09:30:00-04:00,187.23,188.4,187.13,187.89,85790307,116510903.6,56.82628305187834,50.331049125911036,NaN,NaN,91.18111137827626,10.331251227758457,0.17920780319861512,0.15364267794296893,-0.025565125255646193,9195974026,9023202988.4,62.33190919413633,43.5630696753742,NaN,NaN,1.5963229102315961,1.390615682997828
2014-04-23T09:30:00-04:00,187.81,187.92,187.3,187.45,73869384,115011785.95,55.31637954682047,49.894405382116126,NaN,NaN,73.08957219737498,47.625746245231845,0.23565473044093896,0.2690032877955275,0.033348557354588554,9122104642,9081343298,65.64912667705156,45.069361987649664,NaN,NaN,2.9118280179481935,1.6079317308478802
2014-04-24T09:30:00-04:00,188.37,188.39,186.93,187.83,88169916,113428136.9,56.39399024473672,49.61888667497204,NaN,NaN,72.23569764893129,63.32030435165542,0.2826278403260267,0.38663335776212193,0.10400551743609524,9210274558,9136078264.2,68.46471582921404,46.373455298122884,NaN,NaN,4.30602008450384,1.993372924227303
2014-04-25T09:30:00-04:00,187.21,187.33,185.87,186.29,100380205,111328009.3,51.0235932925375,49.629299064739975,NaN,NaN,18.147105554433843,61.48978235368817,0.19802645644262887,0.3515385879893813,0.15351213154675244,9109894353,9149686259.6,69.14191200435504,47.69821348770778,NaN,NaN,3.9742063973680706,2.276349134675984
2014-04-28T09:30:00-04:00,187.05,187.69,184.96,186.875,135121094,113001986.65,52.860057384057335,50.25795090704115,NaN,NaN,16.913098145008206,54.31331698480493,0.17055286648865914,0.3667032146575764,0.19615034816891724,9245015447,9176652605.2,70.49410644087801,49.41243053052317,NaN,NaN,4.222472338437804,2.5543667352133865
2014-04-29T09:30:00-04:00,187.48,188.04,187.08,187.75,84097551,112219618.65,55.54510493942575,50.87637502489564,NaN,NaN,62.04201259705734,48.485497228561144,0.1984444800288172,0.44420594820493875,0.24576146817612154,9329112998,9203280399.6,71.8078081241276,51.460639982629495,NaN,NaN,5.203041571658271,2.9327488547055127
2014-04-30T09:30:00-04:00,187.44,188.5,187.18,188.31,101507717,112835348.25,57.2243876817669,51.14137869498687,NaN,NaN,77.51693710205643,49.370970209497436,0.23902094683261782,0.5445376517168938,0.305516704884276,9430620715,9264983614.2,74.62695587937296,53.91001980800062,NaN,NaN,6.502585563554289,3.442725527398195
2014-05-01T09:30:00-04:00,188.22,188.84,187.73,188.325,93019095,113547612.1,57.27094794307089,52.21214971857416,NaN,NaN,92.13491279225352,53.35081323816188,0.2500955446089337,0.6181361356454431,0.36804059103650943,9523639810,9327656664.6,77.12867239978175,56.81898770910993,NaN,NaN,7.585795721628867,4.034592698002577
2014-05-02T09:30:00-04:00,188.31,189.14,187.78,188.06,98121662,114581929.2,56.10898865196547,53.46069869198834,NaN,NaN,94.67055650616894,68.65550342850891,0.22365942950543294,0.6476148779183006,0.4239554484128677,9425518148,9390781423.6,79.3383738670617,60.131095958029455,NaN,NaN,8.204566891790302,4.630303297115109
2014-05-05T09:30:00-04:00,187.14,188.55,186.62,188.42,75882739,109907030.9,57.37422069891104,54.47174277972118,NaN,NaN,72.81594572124926,79.8360729437571,0.21447442591400073,0.6920484808053686,0.4775740548913679,9501400887,9442058511.6,80.94856772205517,63.549009869848184,NaN,NaN,9.062122993322383,5.263420396573291
2014-05-06T09:30:00-04:00,188,188.13,186.74,186.78,85454226,107139607.25,50.26551173177747,54.70628326970536,NaN,NaN,41.626681701972274,75.75300676474009,0.08845941963881693,0.588148329439889,0.4996889098010721,9415946661,9459425244.2,81.47512827664151,66.91005687390434,NaN,NaN,7.90658583653072,5.641015459424352
2014-05-07T09:30:00-04:00,187.43,187.97,186.01,187.88,106500480,106831643.5,54.35095471892143,54.860341779942914,NaN,NaN,41.214398733857024,68.49249909110021,0.07048232786317543,0.5877918196300413,0.5173094917668659,9522447141,9477790529.4,82.04043070530867,70.20430224893973,NaN,NaN,8.034960634610641,5.983007627308107
2014-05-08T09:30:00-04:00,187.67,189.05,187.08,187.675,93617513,106499838.55,53.469433156429645,54.90238147400345,NaN,NaN,66.15752865463315,63.29702226357615,0.03772100194585204,0.5644607441991809,0.5267397422533289,9428829628,9458828493,79.34806551185176,72.70742474488331,NaN,NaN,7.900622711360418,6.25695263931558
2014-05-09T09:30:00-04:00,187.69,188.04,186.83,187.96,83678568,102035800.4,54.57254575476607,54.90017134264751,NaN,NaN,47.17072993928847,53.79705695020006,0.028595288803908603,0.5624838532582146,0.533888564454306,9512508196,9476226502.6,79.99671001230605,74.48517733172444,NaN,NaN,8.080378964854877,6.517442114392622
2014-05-12T09:30:00-04:00,188.76,189.88,187.9992,189.785,86940045,98020263.05,60.9557820553685,55.19513555718252,NaN,NaN,129.69932521183546,65.1737328483173,0.13297633264583808,0.7001089802616036,0.5671326476157655,9599448241,9495835973.4,80.73130717358869,75.79942004454247,NaN,NaN,10.106888864893996,7.030220221607104
2014-05-13T09:30:00-04:00,190.03,190.42,189.77,189.96,66453965,94723881.25,61.514229833589596,55.6378391490946,NaN,NaN,188.19574372960895,94.48754525384463,0.197427160714698,0.8139165985091381,0.6164894377944401,9665902206,9545827082.4,82.49610180738674,77.00277541099499,NaN,NaN,11.935323814060613,7.730949306243319
2014-05-14T09:30:00-04:00,189.79,189.88,188.79,189.06,72366848,90487597,56.99897728375748,55.68105250902465,NaN,NaN,135.4868958296265,113.34204467299851,0.16441791916787607,0.8220118367542852,0.6575939175864092,9593535358,9560044725.8,82.97372038600034,78.03913287933686,NaN,NaN,12.263957900060877,8.37852196250297
2014-05-15T09:30:00-04:00,188.67,188.72,186.48,187.4,154956399,92975585.3,49.7460209035515,55.5897973383828,NaN,NaN,-22.905790678660537,95.52938080633979,0.02317682689074574,0.6865649511998413,0.6633881243090956,9438578959,9561994592,83.04206139223885,79.03200069275714,NaN,NaN,10.364584197688545,8.662245138958053
2014-05-16T09:30:00-04:00,187.51,188.13,186.72,188.05,97457678,92585736.75,52.305246455608795,55.55016798635076,NaN,NaN,-21.537755049114445,81.7876838086592,-0.031131822435589873,0.6244733462646082,0.655605168700198,9536036637,9566700280.2,83.21713900842735,79.94078873329637,NaN,NaN,9.527659023390925,8.785875693877035
2014-05-19T09:30:00-04:00,187.69,188.89,187.52,188.74,63839398,92361239.5,54.9291865877863,55.50617381837651,NaN,NaN,50.880637569825495,66.0239462802572,-0.025482289269831204,0.623752307112909,0.6492345963827402,9599876035,9566785839,83.22053105649994,80.75598322846584,NaN,NaN,9.591356808106402,8.90094442448123
2014-05-20T09:30:00-04:00,188.645,188.67,187.07,187.55,111644478,93653948.05,49.83685691565787,54.978493049368716,NaN,NaN,-16.241953284084552,25.13640687751851,-0.1024674154504508,0.5211503270696767,0.6236177425201275,9488231557,9531251709.2,76.32120160695736,80.87700078043613,NaN,NaN,8.100825667878352,8.786641744966532
2014-05-21T09:30:00-04:00,188.1,189.22,188.06,189.13,89093285,94415143.1,55.7081286697069,54.86686310127129,NaN,NaN,84.65763211964627,14.970554135522471,-0.050202184941931405,0.5608650113427132,0.6110671962846446,9577324842,9528009606,75.70451570531321,80.77527530225983,NaN,NaN,8.631187137722202,8.764433943931628
2014-05-22T09:30:00-04:00,189.18,189.98,188.86,189.59,61549345,93084114.55,57.275980351465726,54.9502196512356,NaN,NaN,129.1429218953556,45.380296650325704,0.008973472854921227,0.6222840373532961,0.6133105644983748,9638874187,9568068651.6,78.06310549398759,80.6841847041831,NaN,NaN,9.544459227969787,8.87586612736565
2014-05-23T09:30:00-04:00,189.75,190.48,189.5858,190.35,60156088,91072908.7,59.807418341133776,55.12401948282294,NaN,NaN,163.23154804887795,82.33415726992419,0.08850321361952829,0.7239395815227851,0.6354363679032569,9699030275,9600667379.2,79.7830966818788,80.60093677274192,NaN,NaN,11.083083716254363,9.191182925778325
2014-05-27T09:30:00-04:00,191.05,191.58,190.95,191.52,72010355,87917371.75,63.40246080562864,56.062372988098026,NaN,NaN,215.14024077062683,115.18607791008444,0.20258494427573326,0.8886675482479234,0.6860826039721901,9771040630,9634900298.2,81.42973125898455,80.59769412862359,NaN,NaN,13.533477890062848,9.81151077781897
2014-05-28T09:30:00-04:00,191.52,191.82,191.06,191.38,66722865,87048637.45,62.68000053306714,56.65730483196557,NaN,NaN,177.795786061562,153.99362577921377,0.24827996831271992,0.99643256436309,0.7481525960503701,9704317765,9678117539.8,83.28108144319883,80.68631203847288,NaN,NaN,15.30021210369494,10.595610967229824
2014-05-29T09:30:00-04:00,191.82,192.4,191.33,192.37,64376573,85192080.25,65.6598977377008,57.52805230205637,NaN,NaN,176.7144778126183,172.40499491780818,0.3202642006882833,1.1484828469107242,0.8282186462224409,9768694338,9716391439,84.7327319306168,81.07093106838465,NaN,NaN,17.726736692382545,11.614343213680213
2014-05-30T09:30:00-04:00,192.19,192.8,192.03,192.68,76315640,84356907.5,66.56029319955236,58.38431997668396,NaN,NaN,166.96726072202156,179.96986268314134,0.36082650884224965,1.279251782275253,0.9184252734330033,9845009978,9757618597.2,86.12975444788728,81.50900567092617,NaN,NaN,19.993537578094863,12.811370980025163
2014-06-02T09:30:00-04:00,192.95,192.99,191.97,192.895,64655648,82683606.8,67.2025855803931,58.830520228471435,NaN,NaN,145.7712055502106,176.47779418340787,0.3726827457544901,1.3842787056261159,1.0115959598716258,9909665626,9799745667.4,87.39863888874999,81.98524365058054,NaN,NaN,22.056576881563235,14.132114680244888
2014-06-03T09:30:00-04:00,192.4,192.9,192.25,192.8,65047193,82141829.5,66.59392559026922,59.19335563966284,NaN,NaN,126.16048149319866,158.68184232792225,0.34529215466394714,1.4432111532015597,1.0979189985376125,9844618433,9814461228,87.81787735955145,82.36537047573518,NaN,NaN,23.614123315072533,15.486687342363123
2014-06-04T09:30:00-04:00,192.47,193.3,192.265,193.19,55529372,80645586.8,67.88006804343144,59.97057640821098,NaN,NaN,119.58613656176301,147.03991242796246,0.3249028484500933,1.5040475591002291,1.1791447106501358,9900147805,9853627236,88.87841823173105,82.78713460757308,NaN,NaN,25.299516436403174,16.88852007008313
2014-06-05T09:30:00-04:00,193.41,194.65,192.7,194.45,92102592,79925692.4,71.67438494089112,61.536888125163806,NaN,NaN,138.64591372951114,139.42619961134102,0.3647515012916638,1.6350840872647154,1.2703325859730517,9992250397,9898338447.8,89.95365553689292,83.2808199036198,NaN,NaN,27.936633414614477,18.46682197644475
2014-06-06T09:30:00-04:00,194.87,195.43,194.78,195.375,78696219,79179627.7,74.09384172304496,63.093216358552105,NaN,NaN,156.4347621021036,137.31969988735744,0.4180569478052345,1.7929037707295947,1.3748468229243602,10070946616,9943525775.4,90.91014386481508,83.83032025050464,NaN,NaN,30.973432237481912,20.253480585164343
2014-06-09T09:30:00-04:00,195.35,196.05,195.17,195.58,65118828,78251640.7,74.61141731652724,64.4990899820336,NaN,NaN,148.55138640724547,137.8757360587644,0.4301009380047114,1.9124729954302495,1.4823720574255381,10136065444,9988805739,91.75703778229473,84.44007073091855,NaN,NaN,33.639448074571185,22.165761655079606
2014-06-10T09:30:00-04:00,195.33,195.64,194.92,195.6,57129440,76761110.45,74.66459866931572,66.27250010729487,NaN,NaN,125.56706834153744,137.7570534284322,0.40286512604126146,1.985953464977115,1.5830883389358534,10193194884,10058521029.2,92.86003571225838,85.62141602415434,NaN,NaN,35.858842710844094,24.12191609161739
2014-06-11T09:30:00-04:00,194.9,195.12,194.48,194.92,68772479,76877036.15,69.34590083439083,67.24662669048658,NaN,NaN,97.78924696223903,133.39767550852739,0.30684666554065965,1.966646670861678,1.6598000053210185,10124422405,10103375949.2,93.46585983845817,86.89008346223612,NaN,NaN,36.3795558487369,25.873007485491605
2014-06-12T09:30:00-04:00,194.65,194.8,193.11,193.54,106350200,78576203.75,60.00417887700906,67.44149801373968,NaN,NaN,61.90431767422881,118.04935629747092,0.12737828954891373,1.8190228672571607,1.691644577708247,10018072205,10108540310.8,93.533887419283,87.99513931404294,NaN,NaN,34.093221843230324,27.047323822311423
2014-06-13T09:30:00-04:00,193.9,194.32,193.3,194.13,82017278,74929247.7,62.340022716685695,67.62239832627911,NaN,NaN,59.72109538468331,98.70662295398685,0.030443628880674645,1.7296991138090902,1.6992554849284156,10100089483,10114368884.2,93.61468699531497,88.98311005071695,NaN,NaN,32.81657115343471,27.871502012471893
2014-06-16T09:30:00-04:00,193.89,194.7,193.66,194.29,87424332,74427580.4,62.97158611302319,67.59162156252157,NaN,NaN,64.15347594035033,81.82704086060782,-0.0371900055073191,1.6527679780442668,1.6899579835515859,10187513815,10124658558.4,93.76286208701241,89.86404796700465,NaN,NaN,31.93900261189867,28.452573526675717
2014-06-17T09:30:00-04:00,194.02,194.97,193.81,194.83,84833876,75477304.3,65.09891338143375,67.76440105169061,NaN,NaN,70.4366290544153,70.8009530031834,-0.05857738160814785,1.616736256541401,1.6753136381495488,10272347691,10140489119.8,93.99378819334271,90.62924130630063,NaN,NaN,31.773838109131347,28.92703989559795
2014-06-18T09:30:00-04:00,194.83,196.37,194.4,196.255,105266767,75158418.75,69.99741892086952,68.07422399334553,NaN,NaN,105.34923735771463,72.31295108227852,0.006754804822990623,1.683757144178287,1.6770023393552964,10377614458,10191127530.4,94.67318532100364,91.33927369132826,NaN,NaN,33.104714051157856,29.523850489249366
2014-06-19T09:30:00-04:00,196.43,196.6,195.8,196.48,85928920,75000200.5,70.69676565372852,68.36968631150096,NaN,NaN,121.56630731146232,84.24534900972522,0.04641971969525782,1.7350269889743686,1.6886072692791108,10463543378,10280221765,95.61336129376218,92.01667418031933,NaN,NaN,34.399330842667126,30.22034768259476
2014-06-20T09:30:00-04:00,196.03,196.1039,195.7,195.94,100587108,76952088.65,66.67957293393172,68.33232826532515,NaN,NaN,100.65971260853381,92.43307245449532,0.018991272879935295,1.7123463603790299,1.6933550874990946,10362956270,10332795122.4,96.05575252591247,92.63503944011666,NaN,NaN,34.32938192393732,30.807352574215127
2014-06-23T09:30:00-04:00,195.97,196.05,195.52,195.88,70611486,77474858.55,66.22925919977362,68.30628066600403,NaN,NaN,90.44068002719703,97.69051327186466,-0.018462955041350426,1.6702763936974065,1.688739348738757,10292344784,10353761316.2,96.21949560712643,93.23515502922916,NaN,NaN,34.1462611034424,31.28433950696188
2014-06-24T09:30:00-04:00,195.53,196.5,194.48,194.7,96236917,78686186.65,57.94165971629295,67.59639435692272,NaN,NaN,54.57535536022706,94.51825853302702,-0.13167143847691132,1.5241500506426178,1.655821489119529,10196107867,10338513351.4,93.18949491004689,93.54308907768029,NaN,NaN,31.501737573394912,31.31539637359517
2014-06-25T09:30:00-04:00,194.25,195.781,194.25,195.58,82781912,79489139,61.78250186310893,66.88983127993826,NaN,NaN,47.27146551668007,82.90270416482011,-0.15466215258810267,1.4624937983844006,1.6171559509725033,10278889779,10318768415.6,89.26927708636653,93.49420490264268,NaN,NaN,30.340865321929993,31.176177651928718
2014-06-26T09:30:00-04:00,195.61,195.63,194.13,195.44,84311822,80485901.45,60.83074177797446,65.94246699814752,NaN,NaN,33.39106525262839,65.26765575305332,-0.1846424162347038,1.3863529306791236,1.5709953469138274,10194577957,10264975331.4,79.4618052263655,92.67646642846772,NaN,NaN,29.117451277266643,30.88207388411985
2014-06-27T09:30:00-04:00,194.98,195.88,194.885,195.82,71453616,80242800.25,62.518533362568654,65.07868957286477,NaN,NaN,59.16432029043347,56.96857728943324,-0.18382595655850342,1.3412129012156981,1.5250388577742016,10266031573,10245590392,76.21240357072386,91.56613541335551,NaN,NaN,28.561654568117216,30.55058541040519
2014-06-30T09:30:00-04:00,195.7,196.165,195.53,195.72,70504228,80535229.25,61.7642891193925,64.15723889072741,NaN,NaN,75.56106158756387,53.99265360150656,-0.1939630095939231,1.2825850957817977,1.4765481053757208,10195527345,10226226904.2,73.00112242268929,90.14764160695772,NaN,NaN,27.893600706186827,30.171016166945424
2014-07-01T09:30:00-04:00,196.19,197.63,196.13,197.03,90470121,81806375.65,67.32548674392885,64.01292359855155,NaN,NaN,163.8384732893191,75.84527718732497,-0.12000912420495036,1.326536700119533,1.4465458243244833,10285997466,10244204824,74.09260535218034,88.76383771508075,NaN,NaN,28.923745114578658,29.992834588035887
2014-07-02T09:30:00-04:00,197.05,197.48,196.96,197.23,52474832,81653648.65,68.08859897534424,64.59038217700406,NaN,NaN,179.74258665020383,102.33950141402971,-0.06778953436705315,1.3618089063656669,1.42959844073272,10338472298,10256121327.8,74.81926938644293,87.4270792841636,NaN,NaN,29.993435586852712,29.99292044500972
2014-07-03T09:30:00-04:00,197.79,198.29,197.64,198.2,52938832,79695460.65,71.55808073920807,65.24881489289851,NaN,NaN,218.8395367482644,139.42919571315693,0.017364090095496554,1.4513035533520906,1.433939463256594,10391411130,10295487962.4,77.1039935759015,86.24774403991978,NaN,NaN,32.00416183898785,30.28024064414945
2014-07-07T09:30:00-04:00,197.82,197.98,197.22,197.51,61696447,78845472.05,66.05639656327826,65.46915849648816,NaN,NaN,150.40466860237103,157.67726537554444,0.012719337507381967,1.4498386351408215,1.4371192976334395,10329714683,10308224584.4,77.80564065307388,85.10794250892418,NaN,NaN,32.059912640007596,30.534479500700616
2014-07-08T09:30:00-04:00,197.15,197.22,195.76,196.24,108142552,80996658.25,57.32087051372548,64.91358400593758,NaN,NaN,54.69072557641244,153.50319817331416,-0.0850090474839098,1.3308579882785523,1.415867035762462,10221572131,10313433541.6,78.10121061881861,83.97275839645816,NaN,NaN,29.278830916730996,30.355101131562098
2014-07-09T09:30:00-04:00,196.73,197.295,196.31,197.12,72992322,81789802.35,61.154246105468694,64.28192880483752,NaN,NaN,82.00239234588543,137.13598198462745,-0.09855563648338994,1.2926724901582247,1.3912281266416147,10294564453,10315146939,78.20403256885038,82.79639034273293,NaN,NaN,28.156416643268688,30.04100334752018
2014-07-10T09:30:00-04:00,195.22,196.86,195.06,196.34,99040407,83303198.75,56.32516082580395,63.2553856028429,NaN,NaN,20.322608017745015,105.25198625813566,-0.1643412657536205,1.185801544449589,1.3501428102032096,10195524046,10286557288.6,72.11915578600701,81.1182328064647,NaN,NaN,25.636474175089987,29.41178489431587
2014-07-11T09:30:00-04:00,196.22,196.75,195.78,196.61,64243410,81197859.25,57.57404937957353,62.60499106324588,NaN,NaN,35.105183286218356,68.50511556572646,-0.19203760803916348,1.1100958001542551,1.3021334081934186,10259767456,10260228553.8,66.95265750869902,79.03944030523517,NaN,NaN,23.99630670452804,28.638145152917605
2014-07-14T09:30:00-04:00,197.61,197.86,197.44,197.6,58657919,80029891.3,61.878506549610606,62.29422301680567,NaN,NaN,121.59818530960617,62.74381890717348,-0.14802202462356506,1.1171058774139624,1.2651279020375275,10318425375,10257970692.2,66.51260789723246,76.91751975452846,NaN,NaN,23.940854409649546,27.967103618165027
2014-07-15T09:30:00-04:00,197.72,198.1,196.36,197.23,111346230,81225986.2,59.45080249916775,62.402018929868156,NaN,NaN,80.89543967117754,67.9847617261265,-0.1478208157404144,1.0803518823620095,1.228172698102424,10207079145,10255072095,65.91366623330184,74.9692462776181,NaN,NaN,23.14639338838775,27.278430728196845
2014-07-16T09:30:00-04:00,198.11,198.26,197.42,197.96,80073242,80987954.5,62.57091961446663,62.458334483536554,NaN,NaN,121.58653949065211,75.90159115507984,-0.10455581195125019,1.0974779331633613,1.2020337451146115,10287152387,10253589681.8,65.5883741437693,73.27775321028972,NaN,NaN,23.436201345537345,26.729540816388344
2014-07-17T09:30:00-04:00,197.35,198.1,195.43,195.71,145398459,82994539.1,49.84113869634244,61.673362834848554,NaN,NaN,-5.676591008076763,70.70175134991548,-0.2265056131217702,0.9189017287123988,1.145407341834169,10141753928,10242835658.2,63.1534711978052,72.1128722082497,NaN,NaN,19.234541249866588,25.65882659259952
2014-07-18T09:30:00-04:00,196.35,197.91,196.24,197.7099,124330419,84914614.05,58.01698094491181,61.35182337644449,NaN,NaN,63.597311713272866,76.40017703532638,-0.1738811016401176,0.9280559647840221,1.1019370664241397,10266084347,10244099036.4,63.32572286303896,71.19239501484364,NaN,NaN,18.59624116957333,24.649885817881493
2014-07-21T09:30:00-04:00,197.09,197.5,196.43,197.34,67591618,83264839.55,56.19256269597386,60.95384291762888,NaN,NaN,42.33098449963327,60.5467368733318,-0.1654342464162235,0.8951442584038602,1.0605785048200838,10198492729,10220112507.2,57.800879021257344,70.10666334331279,NaN,NaN,17.469621689851568,23.624133799591505
2014-07-22T09:30:00-04:00,198.01,198.56,197.87,198.2,67677602,83118145.35,59.38999343074644,60.38702196668727,NaN,NaN,121.70613101675406,68.70887514244711,-0.106253485539058,0.9277616478962614,1.0340151334353194,10266170331,10231930744.4,59.6679471011509,69.0763306110964,NaN,NaN,17.655015856964766,22.77140266493054
2014-07-23T09:30:00-04:00,198.495,198.85,198.1,198.64,65611830,81586891,60.96000189459681,59.8778364609196,NaN,NaN,136.86293697521725,71.76415463936014,-0.04493729437123295,0.9778435154712781,1.022780809842511,10331782161,10240856699.2,61.06895154811757,68.09416505121602,NaN,NaN,18.318831325771864,22.13532104505073
2014-07-24T09:30:00-04:00,198.83,199.06,198.45,198.65,56888093,80292200.05,60.996908149464694,59.123466990223655,NaN,NaN,141.19715231473361,101.1389033039222,-0.01283612718645677,1.00673565085944,1.0195717780458968,10388670254,10290239964.4,67.74470139414177,67.42564418109032,NaN,NaN,18.849952394829074,21.665982666447636
2014-07-25T09:30:00-04:00,198.09,198.26,197.33,197.72,76837257,79918471.8,55.72122753396358,58.38524063098689,NaN,NaN,55.250969748488,99.46963491096524,-0.06068851513193452,0.9437111341309787,1.0043996492629133,10311832997,10299389694.4,68.81180682494683,66.78322747908125,NaN,NaN,17.678085167530043,21.096283023745123
2014-07-28T09:30:00-04:00,197.76,198.09,196.62,197.8,69258785,79808730.25,56.07318655062283,58.29612034790813,NaN,NaN,23.39143448559044,95.68172490815667,-0.09155157936904046,0.8899601750516126,0.9815117544206531,10381091782,10335909505,72.69472109194592,66.3970496557332,NaN,NaN,16.839948060907698,20.488235171911207
2014-07-29T09:30:00-04:00,198.17,198.45,196.92,196.95,80466351,80306836.4,51.39842013550634,57.59927563576797,NaN,NaN,9.079058579679668,73.15631042074179,-0.16928993459959096,0.7698993361711644,0.9391892707707553,10300625431,10342800525,73.36847802951851,66.05165290292378,NaN,NaN,14.716514705382554,19.663703676692826
2014-07-30T09:30:00-04:00,197.65,197.91,196.16,196.98,104222452,80994452.95,51.55194123456424,57.25833137925084,NaN,NaN,-41.49980310943153,37.48376240381204,-0.215788250897459,0.6694539571489315,0.8852422080463905,10404847883,10357413669.4,74.7891350067959,66.24236570440871,NaN,NaN,13.039428241119449,18.717378614468057
2014-07-31T09:30:00-04:00,195.61,195.78,192.97,193.09,183479441,87544683.4,35.772792814344896,55.7010987674488,NaN,NaN,-294.2743913753296,-49.61054633420061,-0.48994181452927554,0.2728149398847961,0.7627567544140716,10221368442,10323953307,66.09487408817077,66.18109546008527,NaN,NaN,5.435153628180512,16.819917902141263
2014-08-01T09:30:00-04:00,192.56,193.76,191.57,192.5,189260864,94360785,34.069492242244365,53.71474060263693,NaN,NaN,-294.9058253235464,-119.6419053486075,-0.680698726853451,-0.08811665415274206,0.592582072700709,10032107578,10268008223.2,54.65459081819818,65.33409424015424,NaN,NaN,-1.114058072188306,14.257921334379896
2014-08-04T09:30:00-04:00,192.87,194.3,192.05,193.89,91340487,95842987,41.17576984883047,52.40938112761284,NaN,NaN,-186.87750882303496,-161.6956940103326,-0.6812740167960565,-0.2590104482943616,0.42226356850169483,10123448065,10216479479.8,46.64600617102807,63.95783280713469,NaN,NaN,-4.125836675867072,11.6316701900589
2014-08-05T09:30:00-04:00,193.1,193.6,191.31,192.01,152690379,98070378.35,35.58857207962063,50.48207058940955,NaN,NaN,-193.99913925684925,-202.31133357763835,-0.7697479920026951,-0.5399214215016741,0.229826570501021,9970757686,10150505930.8,38.80575104461061,62.04478830005193,NaN,NaN,-8.739075910673082,8.721563604240046
2014-08-06T09:30:00-04:00,191.11,192.89,191.08,192.07,94818317,99161678.1,35.88757306402162,49.485387329958066,NaN,NaN,-164.49818414244507,-226.91100978424106,-0.7831165290916284,-0.7490690908635145,0.0340474382281139,10065576003,10082651554.8,32.7151832219064,59.87062487320201,NaN,NaN,-12.121203148942525,5.744025496642536
2014-08-07T09:30:00-04:00,192.935,193.13,190.55,191.03,135733421,100996328.8,33.0258326344037,47.70030530777892,NaN,NaN,-146.1375884629505,-197.28364920176523,-0.8171241810193006,-0.9873577880460118,-0.17023360702671125,9929842582,10024346382.8,28.566313550100546,57.38780992227784,NaN,NaN,-15.877088215815057,2.6552949662914513
2014-08-08T09:30:00-04:00,191.46,193.37,190.95,193.24,117014384,103634877.5,43.36156010353142,46.783805122604456,NaN,NaN,-98.35566169185675,-157.9736164754273,-0.6530154942695658,-0.9865029748636687,-0.33348748059410277,10046856966,10027296260.4,29.056514956905133,55.334641060538395,NaN,NaN,-15.5489713759104,0.054685488834044005
2014-08-11T09:30:00-04:00,193.965,194.66,193.71,193.795,74543691,104429166.1,45.63075812561292,45.801002600809205,NaN,NaN,-47.0438672241153,-130.00688815564337,-0.4774640523396544,-0.9303175460186708,-0.4528534936790164,10121400657,10026886778.8,29.026737692493924,53.145983245634326,NaN,NaN,-14.521678555047401,-2.027652231720448
2014-08-12T09:30:00-04:00,193.61,194.15,192.94,193.53,73631640,102543436.6,44.70967214221429,44.64026476135331,NaN,NaN,-55.485064990747986,-102.30407330242312,-0.3551854569909201,-0.8968353149176664,-0.5416498579267464,10047769017,10042289045,31.855565936993415,51.059312844839745,NaN,NaN,-14.002374354576903,-3.7383268206999416
2014-08-13T09:30:00-04:00,194.29,195.06,193.96,194.84,69046544,101992101.7,50.07471445731971,43.86010806905723,NaN,NaN,-20.82182377082749,-73.56880122809959,-0.17138493582077374,-0.7558810277027135,-0.5844960918819397,10116815561,10052536956.6,33.74768430948056,48.63095448164966,NaN,NaN,-11.812239413676414,-4.891742905410866
2014-08-14T09:30:00-04:00,195.16,195.76,194.98,195.76,57370793,97590718.4,53.488128831654706,43.70060101889232,NaN,NaN,6.503571440161859,-43.04056924747711,0.01684294158820432,-0.5634424148966843,-0.5802853564848887,10174186354,10101405711,42.01582700882375,46.71695592335515,NaN,NaN,-8.889244937147685,-5.462814624230411
2014-08-15T09:30:00-04:00,196.47,196.65,194.31,195.72,139950669,98371730.9,53.317444118991986,43.50376227377583,NaN,NaN,11.330759932925666,-21.10328492252065,0.13667523801415982,-0.4094413089671889,-0.5461165469813487,10034235685,10098881454.8,41.726157926310385,44.50491569723833,NaN,NaN,-6.627900256205386,-5.629255428798265
2014-08-18T09:30:00-04:00,196.8,197.45,196.69,197.36,75424360,98763368,59.08263182763941,44.05263453749962,NaN,NaN,61.217711698376625,0.5490308619777451,0.314258867030091,-0.15329296319373498,-0.46755183022382596,10109660045,10096533332.4,41.43995080082646,42.2243066094746,NaN,NaN,-2.7664379941196677,-5.220281509558466
2014-08-19T09:30:00-04:00,197.84,198.54,197.4426,198.39,59134709,98336223.35,62.236939623237326,44.81584870811913,NaN,NaN,91.348926792681,29.91582921866354,0.47908565075334764,0.13130523321785859,-0.34778041753548905,10168794754,10120738479.8,45.58351625201071,40.138190984132805,NaN,NaN,1.506084603541863,-4.259372064829847
2014-08-20T09:30:00-04:00,198.12,199.16,198.08,198.92,72762541,98693758.9,63.78404415292766,46.81665237516076,NaN,NaN,109.15583662582168,55.91136129799338,0.5942754336062535,0.3950638744723278,-0.19921155913392566,10241557295,10145686826.6,49.54616583932833,38.95614039492978,NaN,NaN,5.48718956536254,-2.867006117659506
2014-08-21T09:30:00-04:00,199.09,199.76,198.93,199.5,67790690,99238888.75,65.45210127886197,49.05826730634772,NaN,NaN,127.11921937256491,80.03449088447398,0.6741516764510015,0.6434780364298263,-0.030673640021175258,10309347985,10172719152.8,53.49761796544084,38.873499476875686,NaN,NaN,9.303738929001987,-1.1283282538507213
2014-08-22T09:30:00-04:00,199.34,199.69,198.74,199.19,76107359,99202393.85,63.76170217473105,50.6715481867692,NaN,NaN,115.31308035863137,100.83095496961514,0.6693725830812564,0.8060420888303952,0.13666950574913883,10233240626,10212520141,58.63446163782344,39.729817724503924,NaN,NaN,11.964949873104574,0.742140050000035
2014-08-25T09:30:00-04:00,200.14,200.5949,199.1502,200.2,63855022,98932205.7,66.7726658898899,52.89898345893129,NaN,NaN,127.568868682707,114.10118636648122,0.6944973737125004,1.0047912228897644,0.310293849177264,10297095648,10250007261.6,62.802293794296126,41.44385649233861,NaN,NaN,15.184747239686827,2.805369648526719
2014-08-26T09:30:00-04:00,200.33,200.82,200.28,200.33,47298324,97273804.35,67.15099229084157,55.132084832275574,NaN,NaN,128.37491017348293,121.5063830426416,0.6793058123027829,1.1594261145557425,0.4801203022529597,10344393972,10285127105.2,66.23469029744531,43.83810699773424,NaN,NaN,17.92783710237401,4.965722141933474
2014-08-27T09:30:00-04:00,200.43,200.57,199.94,200.25,47873708,94456367.15,66.64808245757848,57.53367410535948,NaN,NaN,109.85986040917456,121.64718779931215,0.6246911244859207,1.2609842078603606,0.6362930833744399,10296520264,10296119699,67.25323929903522,46.601458836943856,NaN,NaN,20.064733027749522,7.122723697050052
2014-08-28T09:30:00-04:00,199.59,200.27,199.39,200.14,58330373,88198913.75,65.91707301151803,59.14478217021566,NaN,NaN,89.85517017545395,114.19437795988998,0.5448914496225485,1.3174073954026255,0.772515945780077,10238189891,10281888080.2,64.53885549628092,49.13591173261356,NaN,NaN,21.67329090582917,9.201376155447068
2014-08-29T09:30:00-04:00,200.45,200.73,199.82,200.71,65906598,82031200.45,67.88287105877376,60.73421880829858,NaN,NaN,90.61250718616087,109.25426332539587,0.49564363717383464,1.3920704922473703,0.8964268550735357,10304096489,10296059252.8,66.00996768521502,51.77757101780792,NaN,NaN,23.609890753989653,11.259735383810295
2014-09-02T09:30:00-04:00,200.97,200.995,199.86,200.61,72425793,81085465.75,67.15111709337233,62.337179161952726,NaN,NaN,83.66437561692227,100.47336471223892,0.4242392850400676,1.42672596137362,1.0024866763335525,10231670696,10282974262.4,63.394803212228226,54.03037368032469,NaN,NaN,25.064630620606604,13.231863274781196
2014-09-03T09:30:00-04:00,201.38,201.41,200.22,200.5,57461742,76324033.9,66.30442642488205,63.49644430249289,NaN,NaN,82.18037582099302,91.23445784174096,0.3410856734206118,1.4288437681093171,1.0877580946887053,10174208954,10248937258.8,57.06195957693618,55.69567905657152,NaN,NaN,26.10019300424005,15.070196093275317
2014-09-04T09:30:00-04:00,200.84,201.58,199.66,200.2101,85236442,75844940.15,64.01364169345607,64.24826664976442,NaN,NaN,71.46608042660112,83.55570184522625,0.24266870233733795,1.3910939726103777,1.1484252702730398,10088972512,10207427708.4,50.443839611068626,56.29767995673187,NaN,NaN,26.442786130501784,16.694851812879097
2014-09-05T09:30:00-04:00,200.17,201.19,199.41,201.11,102176784,74167108.3,67.73963256588891,65.2784229673999,NaN,NaN,70.03525538310515,79.5917188867565,0.2152212988439013,1.4174518938279164,1.202230594984015,10191149296,10198019589.4,49.05512875863647,56.82117787332658,NaN,NaN,27.731517922720673,18.271518399999323
2014-09-08T09:30:00-04:00,200.92,201.21,200,200.59,64145745,71523676.35,63.63926475495805,65.60389674792268,NaN,NaN,67.40413754528224,74.95004495858078,0.14258984992299095,1.3804679073877537,1.2378780574647628,10127003551,10162601001.8,44.12966177572333,57.01330008581922,NaN,NaN,27.77698544298372,19.629442263282808
2014-09-09T09:30:00-04:00,200.41,200.55,198.91,199.32,88590876,72226035.6,54.898915188303434,65.07975214542739,NaN,NaN,30.361521589555206,64.28947415310736,-0.0027428617153821833,1.234449480320535,1.2371923420359172,10038412675,10123949397.6,39.47195065098204,56.57675968574574,NaN,NaN,25.270833216051592,20.43535525653549
2014-09-10T09:30:00-04:00,199.43,200.2,198.77,200.07,67251103,71907008.75,58.52188631058316,64.70388372811708,NaN,NaN,27.371998374559652,53.32779866382068,-0.05710680302418547,1.1658088382556855,1.222915641279871,10105663778,10110240362.4,37.94230880328229,55.7479127545996,NaN,NaN,24.13363802169516,20.963681365844014
2014-09-11T09:30:00-04:00,199.27,200.33,199.12,200.3,66823558,71795859.45,59.593841674055234,64.28543661348802,NaN,NaN,32.75395914514452,45.585374407529365,-0.08465846104239927,1.117092564976872,1.2017510260192712,10172487336,10126943327.2,40.945121906558626,54.85130589325087,NaN,NaN,23.492986847442268,21.32501072035805
2014-09-12T09:30:00-04:00,200.1,200.12,198.56,199.13,117478516,74801245.6,52.20297054553681,63.459812925688425,NaN,NaN,-18.564678191286266,27.86538769265108,-0.18311217148138126,0.9728608116675446,1.1559729831489258,10055008820,10099715232,37.73933051852807,53.35879652758691,NaN,NaN,20.65208499901276,21.22887847445158
2014-09-15T09:30:00-04:00,199.16,199.32,198.38,198.981,76401421,71623783.2,51.32989917312688,62.35675816020535,NaN,NaN,-74.158472904069,-0.4471343972191768,-0.2552696241520136,0.8368859529589088,1.0921555771109224,9978607399,10070036001.6,34.562739486286375,51.34168550558621,NaN,NaN,18.077675134428766,20.778706568734034
2014-09-16T09:30:00-04:00,198.61,200.84,198.5,200.48,116200722,73662601.3,58.796001559386106,61.759973107958544,NaN,NaN,12.356232992890424,-4.04819211655213,-0.2014091579124111,0.8403941297204085,1.0418032876328196,10094808121,10081315090.8,36.74190056156558,49.23505766730909,NaN,NaN,18.016328984714033,20.38408119958832
2014-09-17T09:30:00-04:00,200.77,201.68,199.75,200.75,151265896,78269160.65,59.986649668469724,61.28415648016506,NaN,NaN,100.21872840053145,10.521153888642226,-0.14935941273328335,0.8551040217162154,1.0044634344494987,10246074017,10109397138.6,41.92722822304627,47.42605687616703,NaN,NaN,18.327768300748684,20.0903222140398
2014-09-18T09:30:00-04:00,201.36,201.85,201.1,201.82,94990300,79380548.6,64.3795213047242,61.174331358251216,NaN,NaN,188.2648561184911,41.623333283311545,-0.04977857471772662,0.9422402160523404,0.992018790770067,10341064317,10143112534.8,47.49225906581553,46.2084428454195,NaN,NaN,19.989573568813093,20.075929550435987
2014-09-19T09:30:00-04:00,201.52,201.899,200.29,200.7,121649147,82073471.45,57.28964503356946,60.41767235645091,NaN,NaN,98.84897298458485,65.10606351848577,-0.06527358894061808,0.9104268045942945,0.9757003935349126,10219415170,10175993804.8,52.29374182491535,45.22871242682667,NaN,NaN,19.131293896395146,19.940981599858723
2014-09-22T09:30:00-04:00,200.35,200.38,198.73,199.15,125552758,84545741.4,49.21239106552086,59.13633478303295,NaN,NaN,-100.76385735299434,59.7849866287007,-0.17937646743587665,0.7514798092400667,0.9308562766759434,10093862412,10199044807.4,55.374522861472606,44.655835258915545,NaN,NaN,15.575791313974921,19.31738298758961
2014-09-23T09:30:00-04:00,198.43,199.26,197.95,198.01,111393319,86922656.25,44.26879329816745,57.56236098826762,NaN,NaN,-190.10137958389052,19.293464113344516,-0.32272930604984007,0.5274446441136433,0.8501739501634834,9982469093,10176577001.8,51.859187918523695,44.28420871188609,NaN,NaN,10.867295886285843,18.11022768740336
2014-09-24T09:30:00-04:00,198.04,199.69,197.52,199.56,107275635,89921521.8,51.415097894666296,56.662465002639784,NaN,NaN,-115.97315878055413,-23.9449133228726,-0.3044955792813906,0.46955447606174516,0.7740500553431358,10089744728,10145311144,47.354048809089754,44.063509368887594,NaN,NaN,9.392058506402932,16.86477494726044
2014-09-25T09:30:00-04:00,199.04,199.05,196.27,196.34,150300028,95042837.8,39.95346727543228,54.677738910464306,NaN,NaN,-231.17508426850384,-107.8329014002716,-0.4896546152621998,0.16198178626538606,0.6516364015275858,9939444700,10064987220.6,38.17801361223236,43.286572572715876,NaN,NaN,3.389244653995855,14.939699191079784
2014-09-26T09:30:00-04:00,196.7,198.39,196.42,197.9,103546740,97303656.15,46.20970286368115,53.43277020394453,NaN,NaN,-163.88602146013412,-160.37990028921539,-0.48642549697115356,0.04360453031364386,0.5300300272847974,10042991440,10029702474.6,34.97213641420824,42.632463618321935,NaN,NaN,1.1496518769057782,12.969692431912069
2014-09-29T09:30:00-04:00,196.2,197.89,196.05,197.54,95111605,98763906.5,45.04338018860158,52.72880341825153,NaN,NaN,-163.09543195871984,-172.84621521036047,-0.4867088614127645,-0.07835604948115815,0.40835281193160633,9947879835,10000505959.2,32.53743568288961,42.13714112060105,NaN,NaN,-0.9362502327643604,10.983129194101151
2014-09-30T09:30:00-04:00,197.69,198.3,196.61,197.02,131302082,101707720.95,43.341703512475895,51.64450464695816,NaN,NaN,-131.29784966666253,-161.0855092269149,-0.49828044581546405,-0.2144977453377237,0.28378270047774035,9816577753,9967327691.2,29.982940879418777,41.56861484032509,NaN,NaN,-3.138336813712629,8.96577690727061
2014-10-01T09:30:00-04:00,196.7,196.77,193.91,194.35,177797862,107724526.95,35.8521792407293,49.94867161600631,NaN,NaN,-216.18277632929946,-181.12743273666393,-0.6523929615052653,-0.5317085014038412,0.12068446010142403,9638779891,9877134723.8,24.379548790190725,40.38535961772738,NaN,NaN,-7.887402155814653,6.55817989825843
2014-10-02T09:30:00-04:00,194.18,195.055,192.35,194.38,157285182,111326963.95,35.98602903280856,48.790318650811436,NaN,NaN,-214.66269244445095,-177.82495437185338,-0.7139739108852678,-0.7717829285051607,-0.05780901761989293,9796065073,9848458798.4,22.913343761911563,39.32636056368335,NaN,NaN,-11.390334416084086,3.9941064247809277
2014-10-03T09:30:00-04:00,195.68,196.94,195.08,196.52,121568769,112296563.2,44.82945018314232,48.32600086581254,NaN,NaN,-100.60872738792973,-165.16949555741252,-0.578047130392175,-0.7803679306101117,-0.2023208002179367,9917633842,9823387278.8,21.68538421124991,38.40654947260932,NaN,NaN,-11.298124236122506,1.809502044651866
2014-10-06T09:30:00-04:00,197.34,197.6,195.582,196.29,104778335,114328192.7,44.12391556127334,47.277994723090195,NaN,NaN,-77.9543656496388,-148.14128229559628,-0.4753822145278007,-0.7965485683776876,-0.3211663538498869,9812855507,9796382413.2,20.416222321263234,37.240429598302015,NaN,NaN,-11.458661087188469,-0.08594983132532485
2014-10-07T09:30:00-04:00,195.28,195.72,193.22,193.26,147913498,117294323.8,36.07009908578694,45.56966968146999,NaN,NaN,-148.4392846963738,-151.56956930153854,-0.576553022021269,-1.0418576313764731,-0.4653046093552041,9664942009,9766055264.4,19.06664309668939,35.607530660705095,NaN,NaN,-14.507876952685395,-2.1462251343767633
2014-10-08T09:30:00-04:00,193.37,196.92,192.36,196.64,186461453,123254841.3,47.56722489036616,44.3687913661587,NaN,NaN,-91.97252761786687,-126.72751955925203,-0.38979526502250517,-0.9525486906333356,-0.5627534256108304,9851403462,9808579978.6,26.412178384886687,34.10181061206732,NaN,NaN,-12.709578059807352,-3.655275552295419
2014-10-09T09:30:00-04:00,196.33,196.6,192.58,192.74,210704601,130448893.45,38.878969350063045,43.053743103051104,NaN,NaN,-124.09971135708984,-108.61492334177979,-0.496063782463823,-1.1828331536906092,-0.6867693712267862,9640698861,9777506736.2,24.651541372378844,32.127367722600425,NaN,NaN,-14.748180133799183,-5.239976206795957
2014-10-10T09:30:00-04:00,192.69,193.65,190.49,190.54,221908954,135670415.35,34.99582315613033,42.03827396666607,NaN,NaN,-176.4996927098442,-123.7931164061627,-0.6708040623835714,-1.5252744492062504,-0.8544703868226791,9418789907,9677737949.2,20.033867948946806,29.603035228848587,NaN,NaN,-17.885090623398757,-7.0464211234534995
2014-10-13T09:30:00-04:00,190.46,191.15,187.3,187.4099,230938833,143397285.95,30.35106461431282,41.04415048924788,NaN,NaN,-213.15166363531864,-150.83257600329867,-0.9371288532572555,-2.0258814533942484,-1.088752600136993,9187851074,9552737062.6,15.99197859844486,27.04109170598581,NaN,NaN,-22.29464461424865,-9.224738764995664
2014-10-14T09:30:00-04:00,188.42,189.82,187.04,187.7,215846527,148379576.2,31.261649080549233,39.60461843109666,NaN,NaN,-186.5222359161988,-158.44916624726366,-1.0264907756841404,-2.3718660697421683,-1.345375294058028,9403697601,9500488181,14.660548357550084,24.70584167373298,NaN,NaN,-25.15997596397352,-11.501201221992499
2014-10-15T09:30:00-04:00,185.16,187.694,181.92,186.43,380714600,159852011.4,29.44662671325993,38.85412981951293,NaN,NaN,-206.9664822028842,-181.44795716426714,-1.0974736580782651,-2.7172173666558592,-1.619743708577594,9022983001,9334804088.8,11.415043374449112,22.794200942462748,NaN,NaN,-28.046106325332893,-13.86475909389827
2014-10-16T09:30:00-04:00,183.06,187.58,182.89,186.27,270391490,168622070.9,29.216483072363488,37.64032840584737,NaN,NaN,-169.97056938243952,-190.62212876933705,-1.0798769029518158,-2.969589837267364,-1.889712934315548,8752591511,9157182618.8,9.091431159499379,20.945579138554972,NaN,NaN,-30.329342693262205,-16.216842465235974
2014-10-17T09:30:00-04:00,188.42,189.75,187.62,188.47,214624921,173270859.6,36.55863442021114,37.034275136676634,NaN,NaN,-99.34632495193982,-175.1914552177562,-0.8546116535730839,-2.9579775012819027,-2.103365847708819,8967216432,9066867923.8,8.179691866879239,19.205740294554232,NaN,NaN,-29.842897989632373,-18.16342182586403
2014-10-20T09:30:00-04:00,188.13,190.45,188.07,190.3,130010813,173493762.35,41.95236009879742,36.935036321413875,NaN,NaN,-69.95305618991941,-146.55173372867634,-0.5326572945937729,-2.7691874659510347,-2.236530171357262,9097227245,9048743158,8.006166996377615,17.635970731479862,NaN,NaN,-27.641540193653196,-19.517438735548197
2014-10-21T09:30:00-04:00,191.68,194.2,191.48,194.07,154948579,175671525.35,51.163900225853844,38.0287306774942,NaN,NaN,1.0486036612053014,-109.03756581319553,-0.04195715287207591,-2.2889766124473567,-2.247019459575281,9252175824,9018438802.6,7.711598351149078,16.445402842976886,NaN,NaN,-22.384293625961117,-19.926989434178616
2014-10-22T09:30:00-04:00,194.41,194.91,192.61,192.69,151822409,177898864.05,48.15171378115901,38.89770815951924,NaN,NaN,9.80471822045303,-65.68332572852808,0.20022092422836701,-1.9967433042898222,-2.196964228518189,9100353415,9033912885.4,9.541781086962828,15.490291223337689,NaN,NaN,-19.219654550446766,-19.825941593645496
2014-10-23T09:30:00-04:00,194.62,196.2,194.26,194.93,154944169,178131071.1,52.98970219691293,39.48058330335999,NaN,NaN,47.9538623691358,-22.09843937821301,0.5044984099478986,-1.5663412160833161,-2.0708396260312147,9255297584,9134454100,20.564435923880268,15.410223488525572,NaN,NaN,-14.920072851515911,-19.125103201912697
2014-10-24T09:30:00-04:00,195.25,196.49,194.49,196.43,117927286,178850098.4,55.9536353989415,40.325563291764865,NaN,NaN,64.97738371628186,10.76630235543133,0.7833729481774063,-1.0916234408094567,-1.874996388986863,9373224870,9215655787.6,28.17662545495412,15.964537998074922,NaN,NaN,-10.442285429676312,-17.884700663021786
2014-10-27T09:30:00-04:00,195.73,196.45,195.03,196.16,82953689,178242202.6,55.278042227717364,41.69755923047418,NaN,NaN,68.92598649438696,38.54211089229259,0.9169636165785089,-0.7287918682637269,-1.6457554848422358,9290271181,9254264574.8,31.53603125527745,16.855208580831214,NaN,NaN,-7.144713299303699,-16.350416753919202
2014-10-28T09:30:00-04:00,196.82,198.42,196.73,198.41,106735936,177013895.3,59.65025396197977,42.56063273558944,NaN,NaN,109.94342969530126,60.32107609911179,1.1112206936574087,-0.25672961777047476,-1.3679503114278835,9397007117,9283230833.4,34.02913177226624,17.399276679929752,NaN,NaN,-2.8986597303796464,-14.428737179127836
2014-10-29T09:30:00-04:00,198.55,199.12,196.8,198.11,142557417,175251873.05,58.824478668133814,43.985311972594495,NaN,NaN,106.51359674572375,79.66285180416594,1.1680512839441068,0.09211379350225002,-1.0759374904418568,9254449700,9314050090.4,36.671488463975315,18.257844329329497,NaN,NaN,0.23914605077243214,-12.333325289142083
2014-10-30T09:30:00-04:00,197.58,199.95,197.4,199.38,113329976,173054112.75,61.268902669743035,45.86196050928112,NaN,NaN,113.79185720462051,92.83045077126287,1.2332979682971295,0.4656849699295549,-0.7676129983675745,9367779676,9336546508.8,38.60457438103082,19.584323360192645,NaN,NaN,3.621457544960184,-10.054070598556045
2014-10-31T09:30:00-04:00,201.78,201.82,200.77,201.66,146902554,174320802,65.2566277662055,48.355215020130586,NaN,NaN,149.213819986333,109.6777380252731,1.3620442632708483,0.9349423307209861,-0.4271019325498623,9514682230,9364837980.8,41.04194661480633,21.373606789932747,NaN,NaN,7.833747501285853,-7.4986680128643455
2014-11-03T09:30:00-05:00,201.92,202.45,201.305,201.77,93734143,173768592.4,65.44149624281708,50.79663267457829,NaN,NaN,142.79511038242114,124.45156280287995,1.3822530855905049,1.3007144244382687,-0.08153866115223607,9608416373,9428467019.2,46.21374569860114,23.627406600007824,NaN,NaN,11.262180332220284,-4.818546820709399
2014-11-04T09:30:00-05:00,201.23,201.6,200.06,201.07,93342777,171040056.35,63.13910383325279,53.20323818314921,NaN,NaN,111.71589457614346,124.80605577904839,1.2785306008359263,1.5166245898926718,0.23809398905674556,9515073596,9452080315,48.03550562924636,26.243153903921915,NaN,NaN,13.481444322145302,-2.204262371730156
2014-11-05T09:30:00-05:00,202.54,202.59,201.45,202.34,91708574,166302412.4,65.50998543497113,55.79563120904975,NaN,NaN,116.26901952830517,126.75714033556467,1.2253744456610813,1.7698120461330973,0.544437600472016,9606782170,9522546809,53.136610811149865,29.38923816475409,NaN,NaN,16.07535823259165,0.4071120003158164
2014-11-06T09:30:00-05:00,202.39,203.26,201.64,203.15,107089076,161121636.15,66.96923183940143,57.96781673899192,NaN,NaN,109.31873207116602,125.86251530887378,1.174549818139297,2.0126248731461374,0.8380750550068403,9713871246,9591765123,57.545271516200295,32.91535099684845,NaN,NaN,18.68329707400587,3.0179955822715385
2014-11-07T09:30:00-05:00,203.17,203.5999,202.61,203.34,89539712,154503174.05,67.31852506904964,59.779685665438514,NaN,NaN,104.61715041401166,116.94318139440949,1.0856068697501993,2.1950836421945894,1.1094767724443901,9803410958,9649510868.6,60.85387990539323,36.69018763320671,NaN,NaN,20.94083273335194,5.578400889568739
2014-11-10T09:30:00-05:00,203.38,204.04,203.13,203.98,66318964,146272180.6,68.52588317698178,61.019827304804785,NaN,NaN,102.07304779699189,108.79876887732364,1.003678263707961,2.3640746020793415,1.3603963383713804,9869729922,9701773578.4,63.617441503921064,40.68346214411899,NaN,NaN,23.19921612420523,8.095660208802522
2014-11-11T09:30:00-05:00,204.055,204.31,203.65,204.175,54499375,138204823,68.90284248275525,62.50205078349023,NaN,NaN,97.3309462779988,105.92177921769473,0.89975449828259,2.485089461224618,1.585334962942028,9924229297,9783604718.6,67.48769608177915,44.822456072320115,NaN,NaN,25.202190743661703,10.539450285210977
2014-11-12T09:30:00-05:00,203.35,204.24,203.31,203.96,90120295,123675107.75,67.93671597540714,63.56969462481125,NaN,NaN,89.47425455487081,100.56282622300785,0.7592764839139363,2.5344305678344483,1.775154083920512,9834109002,9829070085,69.4332460695382,48.313085368438536,NaN,NaN,26.66961527246775,12.843759569104803
2014-11-13T09:30:00-05:00,204.16,204.83,203.21,204.19,85357918,114423429.15,68.44642172858494,64.46203650550007,NaN,NaN,87.43277797052887,96.18563540288041,0.6299193798294254,2.562553308707294,1.9326339288778684,9919466920,9870189219.8,71.11665670223326,51.38023045752991,NaN,NaN,28.057442215335676,15.017142804280642
2014-11-14T09:30:00-05:00,204.1,204.49,203.72,204.24,80417514,107713058.8,68.56341845206236,65.41099195009613,NaN,NaN,82.64224702976416,91.79065472603091,0.5013908668383644,2.559372512425824,2.0579816455874598,9999884434,9909483915,72.66590181571488,54.318078354704014,NaN,NaN,29.275627829682204,17.054069236480863
2014-11-17T09:30:00-05:00,203.85,204.58,203.65,204.37,80440954,105234565.85,68.8864409759932,66.07071959395424,NaN,NaN,79.10509613955382,87.19706439454328,0.38408201762542893,2.538084167619246,2.154002149993817,10080325388,9951603008.2,74.25964028645998,57.19168610571785,NaN,NaN,30.409298673834538,18.961959156102818
2014-11-18T09:30:00-05:00,204.44,205.92,204.44,205.55,76068107,101290542.25,71.72633978017058,66.99228110195688,NaN,NaN,97.02464309855715,87.13580375865494,0.3460881064256096,2.586612283025829,2.2405241766002195,10156393495,9998035847.8,75.9260815313211,59.995585610528266,NaN,NaN,32.16519217364336,20.848135301465753
2014-11-19T09:30:00-05:00,205.31,205.55,204.3,205.22,82373009,97818072.25,69.80735740262928,67.60217072573445,NaN,NaN,88.23597010618192,86.88814686891718,0.2626454882281437,2.568831036885399,2.3061855486572553,10074020486,10046018144.6,77.54397092721092,62.77697107811256,NaN,NaN,33.228456736112946,22.616752649272495
2014-11-20T09:30:00-05:00,204.26,205.71,204.18,205.58,72840326,93712880.1,70.72743887026797,67.99294294745322,NaN,NaN,87.99319842071873,87.00023095895514,0.19852626673941698,2.5543433820815267,2.3558171153421097,10146860812,10091496923,78.98553149678118,65.48722714111076,NaN,NaN,34.384116067073904,24.297804566101266
2014-11-21T09:30:00-05:00,207.64,207.8445,205.98,206.68,142327285,94932880.05,73.39527304176893,68.56106986166405,NaN,NaN,128.45966928833403,96.1637154106691,0.19665240119919325,2.6016326168411013,2.404980215641908,10289188097,10149357655.6,80.68442945570025,67.94941883804641,NaN,NaN,36.13207393703922,25.98841447623526
2014-11-24T09:30:00-05:00,207.17,207.39,206.91,207.26,65880759,94079233.55,74.70434646360695,69.38715862097507,NaN,NaN,135.83162215425264,107.5090206136089,0.20025755421635694,2.655302158412354,2.4550446041959972,10355068856,10204306349.2,82.15950389687569,70.38684728573422,NaN,NaN,38.009000976713445,27.705641119160713
2014-11-25T09:30:00-05:00,207.54,207.79,206.8,207.11,79108301,92697851.8,73.69442458585759,69.97176141746696,NaN,NaN,132.2668808716713,114.55746816823171,0.16006453977981305,2.6551252789207638,2.4950607391409507,10275960555,10228219761.2,82.77597113319058,72.50394445159428,NaN,NaN,39.35845490318937,29.370328802593377
2014-11-26T09:30:00-05:00,207.29,207.76,207.03,207.64,62167832,88678372.55,74.98141115164874,70.54405993977034,NaN,NaN,137.16392443773634,124.3430590345426,0.13755785865945658,2.6670080624652712,2.5294502038058146,10338128387,10281041341.4,84.08420652625662,74.3995826665983,NaN,NaN,40.87759206360479,31.014223554166435
2014-11-28T09:30:00-05:00,207.49,207.87,206.91,207.2,57890088,85906378.15,71.8391042016862,70.86695844924438,NaN,NaN,119.15768638928296,130.57595662825543,0.06509980994724796,2.610824966239875,2.545725156292627,10280238299,10307716838.8,84.71557944347197,76.10398977646106,NaN,NaN,41.41047297337629,32.499402042624986
2014-12-01T09:30:00-05:00,206.4,206.54,205.38,205.76,103968354,83759668.15,62.59380727551707,70.44323874199691,NaN,NaN,53.65446168722613,115.61491510803384,-0.0988344570608839,2.422182084966522,2.521016542027406,10176269945,10285133208.4,81.75854276935279,77.39978272399189,NaN,NaN,39.33636339526813,33.47611080728829
2014-12-02T09:30:00-05:00,205.81,207.34,205.782,207.085,74507192,82798320.6,66.82453471784788,70.29478818736067,NaN,NaN,80.26437176495604,104.50146503017454,-0.13482943616729326,2.3524797468182896,2.487309182985583,10250777137,10264274864.6,79.01523210031613,78.2231781538874,NaN,NaN,38.64843166046707,34.21501378631383
2014-12-03T09:30:00-05:00,207.3,208.15,207.1,207.89,68951968,81578780.15,69.11038960456638,70.3786220180149,NaN,NaN,112.3114800574201,100.51038486732429,-0.1216255135561477,2.3352772910403985,2.456902804596546,10319729105,10273028574.6,79.32870965768217,78.92999698161198,NaN,NaN,38.71642641274057,34.858072732946226
2014-12-04T09:30:00-05:00,207.54,208.265,206.7,207.66,91316591,81559181,67.67562534234514,70.32356513328348,NaN,NaN,93.82537707036919,91.84267539385087,-0.14405091683485782,2.276839158552974,2.420890075387832,10228412514,10251085400,76.25364072848642,79.29692441205862,NaN,NaN,38.3623313760087,35.35868111052658
2014-12-05T09:30:00-05:00,207.87,208.47,207.55,208,91025470,80756000.7,68.7097710058054,70.33401888712227,NaN,NaN,103.66192861166793,88.74352383832787,-0.15092812507643938,2.2322299190422825,2.383158044118722,10319437984,10258925337,76.6026119711324,79.57811799458844,NaN,NaN,38.34621455079437,35.78547160199341
2014-12-08T09:30:00-05:00,207.52,208.12,205.93,206.61,108588152,81708422.7,60.22656105485842,69.71545603561263,NaN,NaN,46.93572496261381,87.3997764934054,-0.2577600739451378,2.0609579516873,2.3187180256324376,10210849832,10265841314.4,76.92476660610328,79.76848416027725,NaN,NaN,35.79647271786905,35.78704318997564
2014-12-09T09:30:00-05:00,204.37,206.6,203.91,206.47,125180054,84651477.2,59.430676083606905,68.83719434300095,NaN,NaN,-18.45820609487882,67.65526092143844,-0.3412818433825935,1.8921157214041955,2.233397564786789,10085669778,10232819842.6,71.83868936774829,79.47652757716492,NaN,NaN,33.47456603843936,35.456689311184746
2014-12-10T09:30:00-05:00,205.91,205.98,202.93,203.1601,159856394,89919328.15,44.468719688948724,67.02729164916663,NaN,NaN,-103.56509022022271,24.479946865909866,-0.6073326569590258,1.4742317435880068,2.0815644005470326,9925813384,10154036698.4,61.40696787196557,78.32388450179026,NaN,NaN,25.844299740593023,34.08349080110021
2014-12-11T09:30:00-05:00,203.88,206.19,203.71,204.19,159012805,93363953.65,48.78894415902896,65.46025631264955,NaN,NaN,-73.21894976064696,-8.928918500293364,-0.6955021845388576,1.2121866698734607,1.9076888544123183,10084826189,10125319433.4,58.095399141316044,76.83173219068559,NaN,NaN,21.02170546385999,32.217521467208755
2014-12-12T09:30:00-05:00,202.64,203.819,200.85,200.89,202330191,99212567.3,38.46327040509707,62.965113267173,NaN,NaN,-202.20999480322922,-70.1033031832728,-0.9422960882601197,0.7298187440871686,1.6721148323472883,9882495998,10037931036.2,49.37018224774064,74.59500024725992,NaN,NaN,12.5174952175292,29.40323200296882
2014-12-15T09:30:00-05:00,201.98,202.53,198.78,199.51,189965750,104689979.1,35.11627405287621,60.137393809263656,NaN,NaN,-234.5257860515306,-126.39560538610166,-1.1508977357193984,0.23349266269804048,1.3843903984174388,9692530248,9934267119.4,41.42267156217475,71.685226509067,NaN,NaN,4.4977983999434645,25.84531291682234
2014-12-16T09:30:00-05:00,198.58,202.395,197.86,197.91,259543848,113645123.8,31.674771463504612,57.13599001480988,NaN,NaN,-222.21798766196662,-167.14756169951926,-1.3360427311003957,-0.2856630154580557,1.05037971564234,9432986400,9803730443.8,34.00035519417399,68.20125394199438,NaN,NaN,-3.2759348234034555,21.685134668218655
2014-12-17T09:30:00-05:00,198.44,202.34,198.29,201.79,253910092,122537223.05,45.598281090561564,55.0371950104465,NaN,NaN,-141.7547548526604,-174.78549462600677,-1.1440140354355353,-0.3796378286520792,0.7643762067834561,9686896492,9755947065.4,31.757136191946813,64.46360606097225,NaN,NaN,-4.548260623380634,17.937506769418757
2014-12-18T09:30:00-05:00,204.74,212.97,203.92,206.78,257633887,131300266.95,57.57295970514633,54.018184689265084,NaN,NaN,75.2331281063007,-145.09507905261722,-0.652201592596273,-0.05087578396188519,0.6013258086343878,9944530379,9727887903.4,30.485215540393042,60.590008639323756,NaN,NaN,-0.2818985910933831,15.33473457505988
2014-12-19T09:30:00-05:00,206.43,207.33,205.6109,206.52,245084590,139912480.15,56.870540965829896,53.609379952858866,NaN,NaN,30.13069476665295,-98.6269411386408,-0.33182836142596184,0.18654035685193548,0.5183687182778973,9699445789,9691277861.6,28.86101199476184,56.81161358399583,NaN,NaN,2.409579017244819,13.4882837810863
2014-12-22T09:30:00-05:00,206.75,207.47,206.46,207.47,148318934,140212062.6,58.84624523835339,53.039502132894974,NaN,NaN,49.123364665154334,-41.897110995303805,-0.057728723792876524,0.4462078135368017,0.5039365373296782,9847764723,9722324756.6,32.16187609637872,53.4649452980003,NaN,NaN,5.1780038804527,12.301100938138644
2014-12-23T09:30:00-05:00,208.17,208.23,207.3991,207.75,122167931,143026421.2,59.43604866390265,52.348477779990425,NaN,NaN,67.61765606463216,16.070017750015936,0.13037250662766886,0.6669021706142644,0.5365296639865955,9969932654,9829714007.4,42.159157071425255,50.80997725612481,NaN,NaN,7.471100592474743,11.611100888758086
2014-12-24T09:30:00-05:00,208.02,208.34,207.72,207.77,42963399,141219176.1,59.48071869005183,51.76312730482662,NaN,NaN,70.38921774452936,58.4988122694539,0.23782128624538057,0.8338062717933212,0.5959849855479407,10012896053,9894913919.6,47.24264679912541,48.737763404027596,NaN,NaN,9.251317482793532,11.273988973620293
2014-12-26T09:30:00-05:00,208.31,208.85,208.25,208.44,57326703,140977119.65,61.02899013467048,51.21450009974556,NaN,NaN,84.62495928339969,60.3771785048737,0.33002546828306767,1.0085168209017752,0.6784913526187075,10070222756,9920052395,49.10011235073097,46.773299145427494,NaN,NaN,11.181116173032892,11.260721430679236
2014-12-29T09:30:00-05:00,208.22,208.97,208.14,208.72,79643948,142064812.65,61.68784515817679,51.31887753569686,NaN,NaN,84.03483818108876,71.15800718776087,0.3822000526235223,1.1562414183981105,0.7740413657745882,10149866704,10010136578,55.18873754946409,45.22072564138184,NaN,NaN,12.940362195407786,11.500670111354744
2014-12-30T09:30:00-05:00,208.21,208.37,207.51,207.6,73540761,140543433,57.500268691556776,51.18099129340758,NaN,NaN,57.02111469993802,72.7375571947176,0.31633394212822574,1.1694587934348704,0.8531248513066446,10076325943,10055848822,57.9382663097331,44.227838280095035,NaN,NaN,13.235172074250459,11.748456106054132
2014-12-31T09:30:00-05:00,207.99,208.19,205.39,205.54,130333829,143334764.85,50.68508991444941,51.625017738086186,NaN,NaN,16.946891831502906,62.60340434809176,0.11922542825842686,1.0021566366296781,0.8829312083712513,9945992114,10051060714,57.54001506790434,43.951627365519236,NaN,NaN,11.404824545698581,11.699365883146196
2015-01-02T09:30:00-05:00,206.38,206.88,204.18,205.43,121465865,145960459.7,50.34196858088445,51.73594805393301,NaN,NaN,-4.721619811492003,47.581236836887484,-0.025637821878607747,0.8508839310229916,0.8765217529015994,9824526249,10013386753.2,54.373090709790866,43.68574819183886,NaN,NaN,9.834544185605052,11.432962783497462
2015-01-05T09:30:00-05:00,204.17,204.37,201.35,201.72,169632646,149876262.45,40.406568178640555,51.874755037757545,NaN,NaN,-80.21086534072877,14.61407191206178,-0.35984593788109875,0.4267143305502259,0.7865602684313246,9654893603,9930320922.6,48.088528610861175,43.59420150349033,NaN,NaN,5.009080982217287,10.51526538331458
2015-01-06T09:30:00-05:00,202.09,202.72,198.855,199.82,209151408,155782559.35,36.44014002807371,51.9693168931288,NaN,NaN,-115.9206120222247,-25.377018128600916,-0.6788818727030572,-0.06204207244749682,0.6168398002555604,9445742195,9789496020.8,39.70896666470303,43.471794010813774,NaN,NaN,-0.41785384196412,8.953391208274766
2015-01-07T09:30:00-05:00,201.42,202.72,200.88,202.31,125346709,156620487.2,44.17428563393316,52.8621393338737,NaN,NaN,-69.22627307067881,-50.62649568272428,-0.6899769341387229,-0.2456313674178432,0.44434556672087966,9571088904,9688448613,34.99662860583376,43.5429563973609,NaN,NaN,-2.4257538250888873,7.327799060651388
2015-01-08T09:30:00-05:00,204.01,206.16,203.99,205.9,147217784,157722373.7,53.04555744600313,53.394087644976665,NaN,NaN,14.374778091473798,-51.1409184307301,-0.435706973287446,-0.10028814988842782,0.3354188233990182,9718306688,9642911527.8,33.09081654217104,43.638219279519774,NaN,NaN,-0.9243162686254558,6.148925442183267
2015-01-09T09:30:00-05:00,206.4,206.42,203.51,204.25,158567288,157657918.4,49.17750571706394,52.79441236011364,NaN,NaN,-1.9354260101032947,-50.58367967045236,-0.36185210302849746,-0.11689630538660367,0.2449557976418938,9559739400,9589954158,30.978039566719275,43.67342099568593,NaN,NaN,-1.106124799646201,5.112489693350486
2015-01-12T09:30:00-05:00,204.41,204.6,201.92,202.65,144396067,156927081.5,45.69767526185791,51.99635052411564,NaN,NaN,-40.39439817769561,-42.62038623784573,-0.40093389334119883,-0.25621156903460474,0.1447223243065941,9415343333,9542044104,29.163876352973745,43.695054164129644,NaN,NaN,-2.460998485108922,4.030562810713429
2015-01-13T09:30:00-05:00,204.12,205.48,200.51,202.08,214553306,157538237.25,44.48988255498642,50.97089604673228,NaN,NaN,-51.17069098118508,-29.670402029637806,-0.44210745935003665,-0.4079119998809517,0.034195459469084935,9200790027,9493053670.4,27.39704363072758,43.354708988011694,NaN,NaN,-3.9151982289757843,2.895454090757827
2015-01-14T09:30:00-05:00,199.65,201.1,198.57,200.86,192991092,157689504.35,41.93514604871644,49.720831574218984,NaN,NaN,-112.84943489085805,-38.395034393673654,-0.5229075526269721,-0.6194389813146302,-0.09653142868765809,9007798935,9380395676.6,23.822841137053587,42.04497213555658,NaN,NaN,-5.924690823758107,1.6354333886841221
2015-01-15T09:30:00-05:00,201.63,202.01,198.88,199.0199,176613906,153543007.25,38.35746944843748,48.21202805696081,NaN,NaN,-120.07526674905125,-65.28504336177866,-0.6626906323443083,-0.9248947191180434,-0.2622040867737352,8831185029,9202971344.8,19.50670432954145,40.063833387729154,NaN,NaN,-8.778426579335493,0.14773910753846287
2015-01-16T09:30:00-05:00,198.77,201.82,198.55,201.63,211879605,151441482.9,45.46470909347665,47.10029369687554,NaN,NaN,-102.24299955333538,-85.34655807042509,-0.5466036717317936,-0.9454586764384771,-0.39885500470668356,9043064634,9099636391.6,17.516211654332807,37.80784048084356,NaN,NaN,-8.893186179093595,-1.1438216476946883
2015-01-20T09:30:00-05:00,202.4,202.72,200.17,202.055,130991069,145109342,46.5454501339901,46.01869405229077,NaN,NaN,-69.39472188511043,-91.14662281190805,-0.4144299540403883,-0.9168924472571689,-0.5024624932167806,9174055703,9051378865.6,16.6611748776634,35.055871718572085,NaN,NaN,-8.643641775240523,-2.215224523058379
2015-01-21T09:30:00-05:00,201.5,203.66,200.94,203.08,122942707,139002247.85,49.162132188576805,45.42311287350649,NaN,NaN,-42.218595428110966,-89.35620370129323,-0.23986696536589003,-0.8022961999241431,-0.5624292345582531,9296998410,9070620542.2,18.372157002028686,32.22972105373606,NaN,NaN,-7.6327614879456,-2.9891583751851245
2015-01-22T09:30:00-05:00,203.99,206.26,202.33,206.1,174356029,140304102.6,55.996812114558196,45.80252160208569,NaN,NaN,18.928133015119062,-63.000690120097794,0.07997686147658778,-0.4624581577125184,-0.5424350191891062,9471354439,9163331643,26.23078564471301,29.993347523508106,NaN,NaN,-4.491199373987318,-3.203735660728295
2015-01-23T09:30:00-05:00,205.79,206.1,204.81,204.97,117516753,140071543.7,53.11916033911016,46.00089244195895,NaN,NaN,33.981828797276684,-32.1892710108322,0.20908757291697927,-0.2810755530428821,-0.4901631259598614,9353837686,9267862174.4,33.95165955519721,28.53467386960856,NaN,NaN,-2.8235885067409368,-3.1494289244443867
2015-01-26T09:30:00-05:00,204.71,205.56,203.85,205.45,92009711,142523859.3,54.195938895142575,46.98584749313767,NaN,NaN,30.694400401895656,-5.601791019786002,0.31415215177250483,-0.09747293624423037,-0.4116250880167352,9445847397,9348418727,39.23028558247724,27.901942224723996,NaN,NaN,-1.1523974811912863,-2.864138718265372
2015-01-27T09:30:00-05:00,202.97,204.12,201.74,202.74,134044598,146359754.05,47.554859715549746,47.77975604224309,NaN,NaN,-23.299786674520924,3.6171960223318935,0.19434305786153422,-0.16869626568981744,-0.36303932355135166,9311802799,9375968146.2,40.967861386995814,27.991863276316337,NaN,NaN,-1.7538634312226635,-2.7055279629735565
2015-01-28T09:30:00-05:00,204.17,204.29,199.91,200.14,168514312,150803272.25,42.21065871716333,47.63949697675953,NaN,NaN,-63.28480204163762,-0.5960453003734386,-0.05355491105497945,-0.42998296237007594,-0.3764280513150965,9143288487,9345226161.6,39.606943171901236,28.321171459606866,NaN,NaN,-4.028271280871879,-2.894491294101888
2015-01-29T09:30:00-05:00,200.38,202.3,198.68,201.9902,173585424,155805505.4,46.79299254081911,47.19288519781782,NaN,NaN,-75.42247346823915,-19.46616659704508,-0.08461785417184042,-0.48220036902989705,-0.3975825148580566,9316873911,9314330056,38.23234368163804,28.688423398140223,NaN,NaN,-4.438694217567075,-3.115091711739772
2015-01-30T09:30:00-05:00,200.57,202.17,199.13,199.45,197729724,159175300.15,41.8826979470817,46.67182749996194,NaN,NaN,-98.12009867869803,-45.886552092240024,-0.25813664312171475,-0.7202533187602,-0.4621166756384853,9119144187,9267391356.2,36.17805234733722,29.059852882470075,NaN,NaN,-6.424903253985126,-3.587921932060537
2015-02-02T09:30:00-05:00,200.05,202.03,197.86,201.92,163106969,161257355.35,47.63666954797852,46.81032709182771,NaN,NaN,-76.02303862305664,-67.23003989723048,-0.19152024988376182,-0.7015169879931875,-0.5099967381094257,9282251156,9234672108,34.77536849520166,29.460673749772067,NaN,NaN,-6.167402427880504,-3.956419145749104
2015-02-03T09:30:00-05:00,203,204.85,202.55,204.84,124212881,158986367.1,53.49809918674946,47.45377113695363,NaN,NaN,68.01569414517073,-48.966943733292155,0.05127054405399212,-0.4459085580419355,-0.49717910209592764,9406464037,9253604355.6,36.31402597614831,30.09760106015926,NaN,NaN,-3.924868741057081,-3.9519119450788147
2015-02-04T09:30:00-05:00,203.92,205.38,203.51,204.06,134306728,155244133.1,51.82913621817482,48.160484720486366,NaN,NaN,70.57576007346529,-22.19483131027157,0.15551433260790215,-0.3027861863360499,-0.4583005189439521,9272157309,9279378120,38.44298940631961,31.141897365106836,NaN,NaN,-2.700293562253269,-3.7731093189608798
2015-02-05T09:30:00-05:00,204.86,206.3,204.77,206.12,97953181,153874456.7,55.75495535450509,49.40316228520549,NaN,NaN,113.47377410997555,15.58441820537137,0.3483426272588942,-0.022872234870334296,-0.3712148621292285,9370110490,9290025435.8,39.34505390613888,32.558922334863794,NaN,NaN,-0.3900592567817433,-3.289816452935289
2015-02-06T09:30:00-05:00,206.56,207.24,204.92,205.55,125672026,152797168.8,54.433048573501424,50.043757962350114,NaN,NaN,117.24824957153363,58.658087855417705,0.41795119717476714,0.15122413433923043,-0.2667270628355367,9244438464,9315084291.2,41.51722398943409,34.2732803587996,NaN,NaN,1.0474249928545636,-2.6702105321081673
2015-02-09T09:30:00-05:00,204.77,205.64,204.135,204.63,87219016,149229755.2,52.27858651701445,50.453267703994705,NaN,NaN,74.76041146279225,88.81477787258748,0.3833902568743223,0.2125107582573662,-0.17087949861695612,9157219448,9290077949.6,39.97861261601287,35.93881162582456,NaN,NaN,1.586189132190347,-2.0621534372083796
2015-02-10T09:30:00-05:00,205.88,207.12,204.6801,206.81,96164183,146818161,56.656374975567886,50.98857076020836,NaN,NaN,111.39439876905729,97.49051879736479,0.4823105611563514,0.43200870282848314,-0.05030185832786825,9253383631,9259461868.4,38.11612457090455,37.349095023601414,NaN,NaN,3.398886670839859,-1.2820048503443457
2015-02-11T09:30:00-05:00,206.61,207.45,205.83,206.93,91087785,140644884.95,56.89080907455984,51.05242768592276,NaN,NaN,112.83433165613947,105.94223311389962,0.5271450869780535,0.6086295003946987,0.08148441341664513,9344471416,9273924689.8,39.54883542947359,38.300384293941455,NaN,NaN,4.922711226112544,-0.39561683942193293
2015-02-12T09:30:00-05:00,207.89,208.99,206.9727,208.92,97545949,135872627.8,60.68811775898504,51.59306750162811,NaN,NaN,145.27625397788952,112.30272908748243,0.6538669558026992,0.8988181081700191,0.2449511523673199,9442017365,9288306064.8,41.01128880060035,38.804643525755964,NaN,NaN,7.389057971368327,0.7164795621195329
2015-02-13T09:30:00-05:00,209.07,209.84,208.76,209.78,93670430,131725454,62.236260777381204,52.1673762075023,NaN,NaN,165.48198423210562,121.94947601959682,0.7516669998684173,1.1845349022028415,0.43286790233442424,9535687795,9346555931,46.64191615570985,39.33404570955829,NaN,NaN,9.900073607027627,2.028421568534975
2015-02-17T09:30:00-05:00,209.4,210.32,209.1,210.11,76968199,124979883.7,62.840977109210385,53.259241735620925,NaN,NaN,159.62282933719447,138.92195959447727,0.7906760016046388,1.4212129043402228,0.630536902735584,9612655994,9437643240.2,54.03114605291362,40.26713747140956,NaN,NaN,12.141998813782894,3.473218317856106
2015-02-18T09:30:00-05:00,209.66,210.22,209.3401,210.13,80652941,122462977.3,62.87977320903082,54.735607056468595,NaN,NaN,144.74652636955312,145.59238511457642,0.7692054143216988,1.5920436706377075,0.8228382563160087,9693308935,9525628301,59.81944128271784,41.710887336467884,NaN,NaN,14.003638555005915,4.977564066020364
2015-02-19T09:30:00-05:00,209.41,210.42,209.24,209.98,91462491,120888966.5,62.3539572656793,55.847104536815756,NaN,NaN,126.35571483367103,148.29666175008273,0.6983507384072216,1.6957766793250357,0.9974259409178141,9601846444,9577103306.6,62.77282090258717,43.46377856653568,NaN,NaN,15.43803534926617,6.471917106484051
2015-02-20T09:30:00-05:00,209.48,211.33,208.73,211.239,140896392,119215984.65,64.99950795920526,57.49830525196744,NaN,NaN,122.11651920663427,143.66471479583169,0.688584797384971,1.858156937649028,1.1695721402640569,9742742836,9637248400.8,65.92444711321352,45.58852104981256,NaN,NaN,17.41807887635102,8.035654502179332
2015-02-23T09:30:00-05:00,210.94,211.21,210.48,211.209,74411054,117060699.7,64.88250292177705,58.730150492953044,NaN,NaN,117.7189197137503,134.11210189216064,0.6337896459729293,1.9618091977302186,1.3280195517572893,9668331782,9663777198.2,67.24178400447772,47.90755072904657,NaN,NaN,19.053843834679192,9.609681549679312
2015-02-24T09:30:00-05:00,211.12,212.05,210.76,211.81,72472263,116083827.3,66.19533455781885,59.63709587660086,NaN,NaN,114.05838321474934,124.9992126676716,0.5924679212943749,2.068604453375258,1.476136532080883,9740804045,9689406808.4,68.50843595169479,50.2071514415856,NaN,NaN,20.81638536392993,11.2106392374294
2015-02-25T09:30:00-05:00,211.66,212.24,211.22,211.63,73061687,113034681.75,65.4066737508287,60.606919986076136,NaN,NaN,104.37589740537597,116.92508687483617,0.5105652828791134,2.114343135679775,1.6037778528006614,9667742358,9684293493,67.94397581902001,52.31436475677849,NaN,NaN,22.136171136518417,12.771429508727831
2015-02-26T09:30:00-05:00,211.52,211.71,210.65,211.38,72697868,108243859.55,64.26151414971926,61.214531328591434,NaN,NaN,85.96159234884077,108.8462623778701,0.40188986753638556,2.1061401872211434,1.7042503196847578,9595044490,9682933102.2,67.78396035763417,54.34571521759958,NaN,NaN,23.00598461156548,14.233508809133209
2015-02-27T09:30:00-05:00,211.26,211.58,210.6,210.66,108075972,104968386.95,60.95167585087009,61.68014756268919,NaN,NaN,73.08945341654662,99.04084921985256,0.25122044884389183,2.0182758807396226,1.7670554318957308,9486968518,9631778238.6,61.88216161656169,55.80035361953726,NaN,NaN,22.973750949672038,15.482114829210184
2015-03-02T09:30:00-05:00,210.78,212.06,210.72,211.99,87491428,99456472.15,64.58077402429241,62.55887524178048,NaN,NaN,82.60091589125112,92.01724845535273,0.21238197091472277,2.032532895539134,1.8201509246244114,9574459946,9613003871.4,59.82346624025544,57.217843164126016,NaN,NaN,23.871039314397315,16.680532612808346
2015-03-03T09:30:00-05:00,211.47,212.054,210.08,211.12,110325809,96817414.15,60.6124214884218,62.84144999269862,NaN,NaN,65.90353481410602,82.38627877522407,0.1047900154502055,1.9511384439371682,1.8463484284869627,9464134137,9557669889.8,54.1098122418162,58.36024942633399,NaN,NaN,23.623276138749873,17.672353116514277
2015-03-04T09:30:00-05:00,210.4,210.49,209.06,210.2301,114497192,96331629.7,56.76977186270792,62.83280447756634,NaN,NaN,28.37678318494135,67.18645593113715,-0.041763948816549545,1.7941434924662758,1.8359074412828253,9349636945,9494048807.2,48.38752575730908,58.99158444975081,NaN,NaN,22.369765668161563,18.34341205246389
2015-03-05T09:30:00-05:00,210.62,210.8,209.85,210.46,76872957,93459941.15,57.51905467913143,62.60644282900536,NaN,NaN,37.98699879023556,57.591537219416104,-0.1334977359748657,1.6690352713142431,1.8025330072891088,9426509902,9460341889.6,45.63402611584213,59.32177997226808,NaN,NaN,21.49711192432064,18.793940605586283
2015-03-06T09:30:00-05:00,209.42,209.94,207.1,207.5,188127982,97968681.2,46.37424780699268,61.473441902549034,NaN,NaN,-51.06328228347315,32.76099007941215,-0.3893301589270397,1.3158703086303092,1.7052004675573489,9238381920,9410624570,41.851068226099144,58.97957654872446,NaN,NaN,17.237609481667693,18.571607587883626
2015-03-09T09:30:00-04:00,207.74,208.79,207.5459,208.36,89818893,96176024.55,49.43948255847778,60.516192291782424,NaN,NaN,-59.08455500516699,4.423895900128528,-0.48993443135268677,1.0927824283664904,1.5827168597191772,9328200813,9361372743.4,38.450553680516585,57.866677093553236,NaN,NaN,14.530884119917761,17.99436137817422
2015-03-10T09:30:00-04:00,206.71,206.81,204.93,204.98,157121263,99671136.9,39.80852690513685,58.86824612721857,NaN,NaN,-184.65739406030636,-45.68828987475395,-0.7574410990104128,0.6359154859561613,1.393356584966574,9171079550,9302761826,34.82427608126608,56.081308150592406,NaN,NaN,8.632247836501673,16.65691658650671
2015-03-11T09:30:00-04:00,205.29,205.5,204.4,204.5,110145718,100370213.65,38.65684873538498,57.17559551791184,NaN,NaN,-204.0742322688838,-92.17849296551898,-0.9287382264600001,0.23243380189157392,1.161172028351574,9060933832,9245021203.4,31.656801695269493,53.858735350069715,NaN,NaN,3.569210719478882,14.78724431978845
2015-03-12T09:30:00-04:00,205.26,207.175,205.2,207.1,93993523,100515500.55,47.51437056932287,55.92665713292023,NaN,NaN,-129.3033222677367,-125.63655717711342,-0.8320782126787108,0.12107426250318554,0.9531524751818964,9154927355,9190704694,28.985928302711073,51.22026972074811,NaN,NaN,2.0506631106598854,12.967732718484369
2015-03-13T09:30:00-04:00,206.77,207.9338,204.58,205.8272,162410893,103758747.75,44.153277070910725,54.44599814357264,NaN,NaN,-128.72056591410285,-141.16801390323934,-0.8177915054861399,-0.06908690667577844,0.7487045988103614,8992516462,9141531602.4,26.78288062429553,48.3303480507351,NaN,NaN,-0.32356333914981317,11.068976138822343
2015-03-16T09:30:00-04:00,206.71,208.69,205.8641,208.58,136099192,105880185.85,52.053068234178674,53.43583626331262,NaN,NaN,-59.21103894974559,-141.19331069215508,-0.5971154240983524,0.0023103186874209314,0.5994257427857733,9128615654,9101614570.6,25.11420642296777,45.2307602272546,NaN,NaN,0.39145783167077325,9.543616380657834
2015-03-17T09:30:00-04:00,207.69,208.42,206.98,207.96,94510422,106757297,50.326374646444016,52.35867204157086,NaN,NaN,-50.68102133681846,-114.39803614745752,-0.4725299559165513,0.008763297890084232,0.4812932538066355,9034105232,9074219707,24.008658079062045,42.092523245829035,NaN,NaN,0.37573406692326566,8.233918907267181
2015-03-18T09:30:00-04:00,207.39,211.27,206.62,210.46,228808524,114165076.15,56.58075403686944,51.81004631922445,NaN,NaN,8.869084971638035,-71.80937269935313,-0.21451509615395303,0.21314938361419422,0.42766447976814725,9262913756,9114615691.8,28.973788600101173,39.32036812029096,NaN,NaN,2.5438247159570744,7.4210483085085945
2015-03-19T09:30:00-04:00,209.96,210.4697,209.03,209.5,117917302,115487816.7,53.78048972925129,51.29781873910882,NaN,NaN,17.03973015208452,-42.54076221538889,-0.106715037516466,0.29427068287256475,0.40098572038903074,9144996454,9112629511.6,28.873895138698586,36.962634800443595,NaN,NaN,3.3451662900579944,6.838779448729937
2015-03-20T09:30:00-04:00,209.71,211.02,209.4903,210.41,177715081,117328751.15,56.00331386107858,50.685143013164975,NaN,NaN,40.27942303004528,-8.740764426559252,0.02086449321088807,0.42706633690264084,0.4062018436917528,9322711535,9178668526.2,36.68968491497151,35.3102218486376,NaN,NaN,4.714802766390302,6.535354208395704
2015-03-23T09:30:00-04:00,210.42,211.11,210,210,71784536,117197425.25,54.72627877451534,50.264704247885945,NaN,NaN,44.184714284699055,11.938386220329686,0.06986661339642058,0.4935351104372785,0.4236684970408579,9250926999,9203130795.2,39.34837151401159,34.255833225222986,NaN,NaN,5.422283400941675,6.3763440930451285
2015-03-24T09:30:00-04:00,209.85,210.4,208.74,208.82,77805321,117464078.15,51.11376268690958,49.86070359247177,NaN,NaN,10.572138828473285,24.189018253388035,0.017750321555382365,0.4458563989850859,0.4281060774297035,9173121678,9230934084.4,42.31354849046318,33.82197770616256,NaN,NaN,4.919007137634937,6.168153099415101
2015-03-25T09:30:00-04:00,209.07,209.35,205.71,205.76,159521708,121787079.2,43.15772986205058,48.834894676965995,NaN,NaN,-71.38939085840074,8.137323087380278,-0.2150306743689046,0.15931773446857278,0.3743484088374774,9013599970,9181071327.2,38.6629202996501,33.32404157643456,NaN,NaN,1.8188134210939282,5.546818859654934
2015-03-26T09:30:00-04:00,204.96,206.37,204.12,205.27,153067241,125805547.85,42.02956404618245,48.52456012262241,NaN,NaN,-120.62651080548827,-19.395925104134278,-0.3843445478823926,-0.10608227601551334,0.27826227186687924,8860532729,9124178582.2,34.95706544521522,32.83161280637142,NaN,NaN,-1.0082584783858726,4.610379239934819
2015-03-27T09:30:00-04:00,205.13,205.95,204.9,205.74,118938966,126348697.55,43.55374297757444,48.10415015255789,NaN,NaN,-100.33970121244217,-47.51974995263176,-0.44286178936931736,-0.2753149648447675,0.1675468245245499,8979471695,9055530614.2,31.085337606169062,32.30552594391802,NaN,NaN,-2.8437330762277755,3.545506051911591
2015-03-30T09:30:00-04:00,206.98,208.61,206.96,208.25,96180365,126783144.4,50.968028261900024,48.901257392326684,NaN,NaN,-4.571113500638058,-57.27091550969919,-0.29766887210778364,-0.20453926561017965,0.09312960649760398,9075652060,9020475626.4,29.30068208029573,31.91098351527728,NaN,NaN,-2.1310893960128268,2.734563845065246
2015-03-31T09:30:00-04:00,207.26,208.1,206.36,206.43,126768703,127605289.1,46.22660731281945,49.44195443357201,NaN,NaN,-38.4738316199445,-67.08010959938275,-0.3080576632658268,-0.29194247258467954,0.016115190681147265,8948883357,8975627962.2,27.15290224620793,31.589276411772886,NaN,NaN,-3.0524541611168496,1.9078469870392323
2015-04-01T09:30:00-04:00,206.39,206.42,204.51,205.7,137303584,128745608.7,44.4408232913973,49.222415342291605,NaN,NaN,-90.00043911082533,-70.80231924986768,-0.3451540782540397,-0.41532740713640237,-0.07017332888236266,8811579773,8935223922.8,25.35004862122939,31.329570720238483,NaN,NaN,-4.356902718278862,1.0128827434223617
2015-04-02T09:30:00-04:00,205.62,206.98,205.4,206.435,86900906,129247006.15,46.67450343081281,49.40250293942747,NaN,NaN,-52.03073711028894,-57.08316451082781,-0.302766105619002,-0.4486309609061152,-0.14586485528711318,8898480679,8942813512.8,26.339415988943855,31.297894674856217,NaN,NaN,-4.7534896044042005,0.1891152651614243
2015-04-06T09:30:00-04:00,205.37,208.45,205.21,207.83,114368155,125559014.8,50.72375137882736,49.30755173547381,NaN,NaN,-9.60293727854783,-38.935811724048946,-0.16997118294088015,-0.35832883396321336,-0.1883576510223332,9012848834,8949488940.6,27.252667910297816,31.450641923951217,NaN,NaN,-3.856252214794758,-0.38879437483231594
2015-04-07T09:30:00-04:00,207.855,208.76,207.24,207.28,81236337,125129887,49.13943190973664,49.22277011142329,NaN,NaN,19.379491025190315,-34.14569081888327,-0.11121022214724374,-0.3273704287063879,-0.21616020655914414,8931612497,8920681028,25.767921782160812,31.576303617029705,NaN,NaN,-3.5818407305946014,-0.8449438542269281
2015-04-08T09:30:00-04:00,207.55,208.51,207.08,207.975,89351939,121741420.8,51.21310994263146,48.83936696183486,NaN,NaN,19.346743250225686,-22.581575844849226,-0.02222619900451922,-0.24394295531479315,-0.22171675631027393,9020964436,8935097243.8,27.885265447385535,31.498551963264298,NaN,NaN,-2.7518153900175912,-1.1173540736255942
2015-04-09T09:30:00-04:00,207.78,209.18,207.19,208.9,85548854,120511577.6,53.90674707575329,48.848385343727855,NaN,NaN,41.56222271724887,3.7309565207656106,0.09576508524982202,-0.10201039974799642,-0.19777548499781844,9106513290,8994083947.2,35.93708386706041,32.003065443861566,NaN,NaN,-1.265769642496387,-1.1385562977499932
2015-04-10T09:30:00-04:00,209.2,210.09,208.96,210.04,72722915,119448047.2,57.05383006770849,48.92342221563,NaN,NaN,98.62254296892873,33.861612536609144,0.23925479043317535,0.10129300304365074,-0.1379617873895246,9179236205,9050235052.4,42.51669952660693,32.4192807732641,NaN,NaN,0.9369922121844849,-0.8420493677593535
2015-04-13T09:30:00-04:00,209.87,210.63,209.03,209.09,74436594,115049332.25,53.75976883972686,48.85438579171653,NaN,NaN,82.37200094199937,52.25660018071858,0.25728021697451287,0.18363848382861647,-0.0736417331458964,9104799611,9068625207.8,44.52622410875721,32.7891273871745,NaN,NaN,1.8801544536722528,-0.4531631075548383
2015-04-14T09:30:00-04:00,208.85,209.71,208.1,209.49,75099866,111999365.95,54.93944940993496,49.127649129075486,NaN,NaN,52.0366552684548,58.788033029371476,0.2812895941620511,0.27797025955666754,-0.0033193346053835976,9179899477,9118282603.8,49.64512130408347,33.31281115957595,NaN,NaN,2.997528194827647,0.03979279278551673
2015-04-15T09:30:00-04:00,210.05,211.04,209.95,210.43,99529320,112250310.85,57.6723340320633,50.16440656979068,NaN,NaN,104.80326057972876,75.8793364952721,0.3416114070378888,0.4236949241919774,0.08208351715408861,9279428797,9169975476,54.365859936378826,34.43444970505657,NaN,NaN,4.736722020169365,0.7107826824117808
2015-04-16T09:30:00-04:00,210.03,210.98,209.7928,210.37,68934864,104256627.85,57.4328957450494,51.264644548281176,NaN,NaN,95.40730372330958,86.64835269648424,0.3569347166911603,0.528251913018039,0.1713171963268787,9210493933,9190771604.6,56.14702424902296,35.94801819104284,NaN,NaN,6.110542092747684,1.4821768838883385
2015-04-17T09:30:00-04:00,208.94,209.23,207.01,207.95,191113230,107916424.25,48.65821984934589,51.62925003912199,NaN,NaN,-3.8863766455040727,66.14656877359769,0.19182735004827958,0.41110138388722817,0.21927403383894858,9019380703,9158800504.2,52.73897713641371,37.49470672891746,NaN,NaN,4.833945574843409,1.9610009825962056
2015-04-20T09:30:00-04:00,209.06,210.25,208.96,209.85,92189481,103640144.25,54.53177785287641,51.88380358133459,NaN,NaN,74.84562680486685,64.64129394617119,0.1975398263713326,0.46619881680311437,0.26865899043178176,9111570184,9160154618.8,52.86946308673855,39.17819108652053,NaN,NaN,5.504290428119117,2.4671851890994785
2015-04-21T09:30:00-04:00,210.67,210.86,209.24,209.6,72559831,103678909,53.66188186230251,52.41489462058338,NaN,NaN,87.75165333526836,71.7842935595339,0.172361203056408,0.4841104942522918,0.3117492911958838,9039010353,9131976794,49.78890141892547,40.79504817028606,NaN,NaN,5.790443091401946,2.941936317999831
2015-04-22T09:30:00-04:00,210.01,210.85,208.9,210.63,78264616,103701873.75,56.72482150989642,53.29232306476189,NaN,NaN,93.76792381638334,69.57722620686482,0.21043430562807286,0.5747921732309749,0.364357867602902,9117274969,9099546028.4,46.43532709152943,42.301139489593204,NaN,NaN,6.940385164130733,3.5131432960185314
2015-04-23T09:30:00-04:00,210.15,211.94,210.01,211.16,102585942,100855085.45,58.25393228476736,54.11942512575864,NaN,NaN,119.70445534453536,74.43665653110997,0.25376805538840264,0.6815679368384053,0.4277998814500027,9219860911,9101419424,46.65883601098701,43.75252663402485,NaN,NaN,8.341872095852668,4.202961695994837
2015-04-24T09:30:00-04:00,211.66,211.97,211.11,211.6499,61327387,96268092.75,59.67239765005025,54.75861414513171,NaN,NaN,129.70197993476344,101.15432784716347,0.2949899730735498,0.79653734779194,0.5015473747183902,9281188298,9153780943,52.61083541170024,45.56382431269646,NaN,NaN,9.920509380408147,5.0197542223395955
2015-04-27T09:30:00-04:00,212.33,212.48,210.54,210.77,79358126,94289050.75,55.99243763835077,55.24811455431843,NaN,NaN,106.9495167093299,107.57510582805608,0.2446375365695146,0.8073442954302834,0.5627067588607688,9201830172,9171832940.6,54.49599335389294,47.615829424963046,NaN,NaN,10.251643484936697,5.767166974139181
2015-04-28T09:30:00-04:00,210.74,211.5,209.3301,211.44,86863531,93823209.05,58.110788831125966,55.74080590349661,NaN,NaN,76.47285781487084,105.31934672397658,0.23788104559480527,0.8600580658542754,0.6221770202594701,9288693703,9221769610.6,59.31722752267363,49.860969573197906,NaN,NaN,11.127789740058551,6.532970226413377
2015-04-29T09:30:00-04:00,210.37,211.29,209.6,210.57,125684903,93769019.05,54.44586712839416,55.779314478685244,NaN,NaN,59.047631856687495,98.3752883320374,0.15998245380503795,0.8221550875157675,0.6621726337107295,9163008800,9230916376.8,60.15008120780717,51.59046938325125,NaN,NaN,10.854773510195814,7.150370695525154
2015-04-30T09:30:00-04:00,209.88,210.35,207.62,208.46,161304890,94969084.35,46.745740611714005,55.043022374685634,NaN,NaN,-34.15897775512765,67.60260171210481,-0.037921591128410204,0.6147706448002168,0.652692235928627,9001703910,9187284976.6,54.42629747053607,52.44115495067475,NaN,NaN,8.237254001972458,7.30563973930334
2015-05-01T09:30:00-04:00,209.4,210.77,209.28,210.72,103399711,95794024.6,54.21484158062321,55.07552757046394,NaN,NaN,41.608994693068624,49.98400466376584,-0.021698650283872967,0.6255689230737858,0.6472675733576587,9105103621,9152068041.2,50.26835244134148,52.85130697443078,NaN,NaN,8.287500691200131,7.44590558957431
2015-05-04T09:30:00-04:00,211.23,212.02,211.1,211.32,70927235,93621978.6,55.98003057973333,55.14985479687812,NaN,NaN,114.85271530094379,51.564644382088616,0.021996637226897597,0.6747633698912807,0.6527667326643831,9176030856,9146908178,49.66962094024838,52.85305694844256,NaN,NaN,8.882926256629887,7.651194256296535
2015-05-05T09:30:00-04:00,211.03,211.46,208.73,208.9,113326156,95226469.55,47.95021060057877,54.45541740891493,NaN,NaN,-18.482357441182234,32.573601330878006,-0.11215899928915363,0.5125679835529411,0.6247269828420947,9062704700,9101710377.4,44.65257826783149,52.159251114974886,NaN,NaN,6.723896018533888,7.5187230794733
2015-05-06T09:30:00-04:00,209.56,209.93,206.76,208.04,135060151,97511880.15,45.45491883841882,53.5998476298699,NaN,NaN,-136.96332336732436,-6.62858971392437,-0.25094430069001705,0.3110466069795734,0.5619909076695905,8927644549,9054637527.2,40.10863680908447,51.01365201212214,NaN,NaN,4.155948319429915,7.038326685181389
2015-05-07T09:30:00-04:00,207.92,209.38,207.52,208.87,88244940,97646684.45,48.25373361580244,53.570955756045365,NaN,NaN,-110.95565433541108,-21.987925029981056,-0.27693222684398056,0.2158256241146148,0.49275785095859537,9015889489,9057474643,40.50162773477555,50.139555626290836,NaN,NaN,2.934226844791339,6.45202670798281
2015-05-08T09:30:00-04:00,210.88,211.86,210.78,211.62,155877260,101804401.7,56.26166116816664,53.694518849994665,NaN,NaN,104.69687059934515,-9.370349848725752,-0.10769751431695207,0.3581359580624053,0.46583347237935735,9171766749,9070807268.6,42.41394078329678,49.39273260461643,NaN,NaN,4.555186357281627,6.1810495150254985
2015-05-11T09:30:00-04:00,211.57,211.89,210.52,210.605,75708065,101867975.25,53.00144174272553,53.64734455573917,NaN,NaN,66.83734340821054,-18.973424227272403,-0.06500063708683579,0.38458267602081264,0.44958331310764843,9096058684,9054812834.2,40.722988201904194,48.745167374829194,NaN,NaN,4.789920611165775,5.9823168144741095
2015-05-12T09:30:00-04:00,209.61,210.63,208.62,209.98,119727592,104099361.55,51.04013834277908,53.24129575808793,NaN,NaN,-31.923907692213575,-21.66173427747867,-0.07881642594416832,0.351062780677438,0.42987920662160634,8976331092,9037538112.6,38.91829468240595,48.20823648846323,NaN,NaN,4.355468442273894,5.749909904159793
2015-05-13T09:30:00-04:00,210.47,211.22,209.74,210.02,94667943,103856292.7,51.16469177176703,52.73492143573077,NaN,NaN,14.58082919508625,8.647096235003454,-0.08471062757502046,0.32399092215283076,0.4087015497278512,9070999035,9066209009.8,43.401452393873655,47.97556623009799,NaN,NaN,4.048011091324663,5.506781502326203
2015-05-14T09:30:00-04:00,211.24,212.32,210.91,212.21,95934006,105206249.8,57.534425997198014,52.58220917481275,NaN,NaN,117.59083096660812,54.356393295407294,0.0520703018536553,0.47378942704492033,0.42171912519126503,9166933041,9096417720.2,47.75268616363613,47.628555569521986,NaN,NaN,5.783993493913351,5.546383215410081
2015-05-15T09:30:00-04:00,212.44,212.61,211.86,212.44,76510099,99476093.25,58.15177790592754,52.73644776535395,NaN,NaN,140.92146007316845,61.601311190171955,0.145905657180124,0.60410119666642,0.45819553948629604,9243443140,9110752998.4,49.72780661867314,47.287970802720565,NaN,NaN,7.362275658152879,5.805796421516195
2015-05-18T09:30:00-04:00,212.24,213.4,212.16,213.1,74549685,98594103.45,59.95101379866026,52.86789240589212,NaN,NaN,158.42873949094803,79.91959040671945,0.23501360120676607,0.7519625409947537,0.5169489397879876,9317992825,9155139826.6,55.35549799353439,47.004990122067774,NaN,NaN,9.211630948006968,6.2923442110148775
2015-05-19T09:30:00-04:00,213.24,213.57,212.69,213.03,72114610,98571842.4,59.65804665852682,53.24019094375874,NaN,NaN,150.20886748294794,116.34614544175174,0.26936477162367356,0.8536549043175796,0.5842901326939061,9245878215,9209049251.2,61.05743321955006,47.06980098004941,NaN,NaN,10.639006428480462,6.9132959563671035
2015-05-20T09:30:00-04:00,213.15,213.78,212.504,212.88,76857530,98501488.1,58.99277486999205,54.114979105064315,NaN,NaN,129.6277701427614,139.3555336312868,0.26187536213430085,0.9116343353617822,0.6497589732274813,9169020685,9228653581.2,62.91247680766962,47.675956646987515,NaN,NaN,11.650476990284071,7.590036104069528
2015-05-21T09:30:00-04:00,212.71,213.75,212.51,213.5,64764585,96610420.25,60.93203462896347,54.59477860851719,NaN,NaN,123.78965358681714,140.59529815532858,0.2770964291848228,0.9961295097085099,0.7190330805236871,9233785270,9242024027,64.16619809718304,48.66865990811906,NaN,NaN,13.0478673295258,8.36972627913471
2015-05-22T09:30:00-04:00,213.04,213.54,212.91,212.99,57433495,96415725.65,58.482060822421055,54.77349505442346,NaN,NaN,106.706851537725,133.7523764482399,0.23300855054220604,1.0102937687014446,0.7772852181592386,9176351775,9228605754,61.90451921054787,49.54258121314046,NaN,NaN,13.606994705539305,9.117907482906794
2015-05-26T09:30:00-04:00,212.4,212.9089,210.2,210.7,124308584,98663248.55,48.96227203189721,54.84578515666049,NaN,NaN,9.695053542335074,104.00563925851732,0.03993161797962774,0.8271997406337732,0.7872681226541455,9052043191,9175415827.2,53.80815251861538,50.19655080248216,NaN,NaN,11.325411993486743,9.433265270132502
2015-05-27T09:30:00-04:00,211.25,212.98,210.7612,212.7,93213981,98980771.05,55.73879716927918,55.580347894579084,NaN,NaN,50.26274285932231,84.0164143337922,0.03727941021016512,0.8338673854168519,0.7965879752066868,9145257172,9155291618.6,51.08581337233789,50.980634842714544,NaN,NaN,11.373545179058727,9.71044811426482
2015-05-28T09:30:00-04:00,212.33,212.59,211.63,212.46,74974560,96445253.9,54.79853151894449,56.04783345908923,NaN,NaN,49.77161981202963,68.04518426764585,0.01108422964659106,0.8104432622649256,0.7993590326183345,9070282612,9135544004,48.493099414264556,51.551454248392325,NaN,NaN,11.13000189767181,9.91324151189439
2015-05-29T09:30:00-04:00,212.38,212.43,210.82,211.14,124919611,94625989.95,49.820595967644024,55.587757373337624,NaN,NaN,5.191324071547505,44.32551836459193,-0.09744237563507518,0.6775560630744906,0.7749984387095658,8945363001,9077859550.2,41.81682506928003,51.508803125962565,NaN,NaN,9.388459118734437,9.838272598585824
2015-06-01T09:30:00-04:00,211.94,212.34,210.62,211.57,93338750,94122941.9,51.370342826341755,55.47125030788163,NaN,NaN,4.544396172619542,23.893027291570846,-0.1399805763591353,0.6000227182606466,0.7400032946197819,9038701751,9050329545.4,39.0534144155135,51.38954785550609,NaN,NaN,8.412735937918539,9.634624504204783
2015-06-02T09:30:00-04:00,211.02,212.19,210.27,211.36,91531012,95153130.75,50.54926256377943,55.43618775223881,NaN,NaN,-8.903101014803166,20.173396380143163,-0.17945286153596895,0.5156872176998206,0.6951400792357896,8947170739,9029355055,37.04482252810782,51.25572841591337,NaN,NaN,7.377835289590635,9.31222604497419
2015-06-03T09:30:00-04:00,212,212.67,211.3301,211.92,87820909,93877868.4,52.71950656495803,55.54724595175245,NaN,NaN,27.610384868232856,15.642924781925274,-0.16538567732000453,0.4884079825857839,0.6537936599057884,9034991648,9007301950.2,35.006182915010854,50.656066310280316,NaN,NaN,7.101715907364503,8.99643888245852
2015-06-04T09:30:00-04:00,211.07,211.859,209.75,210.1292,151882820,94719001.85,45.79764816830881,54.70890467826036,NaN,NaN,-76.54288454601632,-9.619976089683918,-0.26814403265192466,0.3186136190908826,0.5867576517428073,8883108828,8969867193.4,31.806420755538625,49.51704735255907,NaN,NaN,4.764272273344377,8.39184365258507
2015-06-05T09:30:00-04:00,209.95,210.58,208.98,209.77,121704676,96391988.65,44.53459167992232,53.73624851926,NaN,NaN,-147.27545092316356,-40.11333108862614,-0.34676708808725,0.1532987916337447,0.5000658797209947,8761404152,8933075423.6,29.000715769865735,48.03654086335854,NaN,NaN,2.4662362814668883,7.545328313853902
2015-06-08T09:30:00-04:00,209.64,209.82,208.39,208.48,89063330,93051292.15,40.24219969446831,52.32847608324629,NaN,NaN,-178.8585837770758,-76.7939270785652,-0.4647521837854717,-0.08087435001084486,0.3838778337746268,8672340822,8859803237.8,24.386929446562945,45.824500252860574,NaN,NaN,-0.8625141243218297,6.344207965543083
2015-06-09T09:30:00-04:00,208.45,209.1,207.69,208.45,105034690,94517623.4,40.14529322695733,50.93470798099132,NaN,NaN,-178.305365743792,-110.67438002436297,-0.5197541494266095,-0.26581485300863505,0.2539392964179744,8567306132,8783830316.4,20.708217080550256,42.94241338578916,NaN,NaN,-3.5839925045266403,4.92589361267598
2015-06-10T09:30:00-04:00,209.37,211.41,209.2987,210.95,134551285,95258808.05,50.78182404487307,50.34821149348283,NaN,NaN,-57.647774315740534,-127.72601186115764,-0.369752901107909,-0.20825182996691183,0.16150107114099715,8701857417,8717203470.2,18.125880039752488,39.74337075950937,NaN,NaN,-2.8289948087604393,3.8180524096136343
2015-06-11T09:30:00-04:00,211.48,212.09,211.2,211.63,73876447,94219233.25,53.21706930703332,49.797142541916394,NaN,NaN,4.909913896213686,-111.43545217271165,-0.21442832964677955,-0.10653434091747727,0.10789398872930227,8775733864,8695728477.4,17.37385074918754,36.40106023465255,NaN,NaN,-1.4455272851992231,3.0661124532117974
2015-06-12T09:30:00-04:00,210.64,211.482,209.68,210.01,135382369,96191651.4,47.22251264853786,48.99288910092473,NaN,NaN,-67.91135190509127,-95.5626323690972,-0.2102014743105887,-0.1548578541589336,0.05534362015165509,8640351495,8671517946,16.54065994820553,33.16078457305666,NaN,NaN,-2.150130218430653,2.3209349286914476
2015-06-15T09:30:00-04:00,208.64,209.45,207.79,209.11,124384184,98585355.65,44.240957727468924,48.65565236489414,NaN,NaN,-141.7532287952789,-88.14156137273781,-0.25447350930546264,-0.26274826648017324,-0.008274757174710573,8515967311,8640243243.8,15.506169575001323,30.4249286485128,NaN,NaN,-3.681654064897319,1.4634222153216239
2015-06-16T09:30:00-04:00,208.93,210.35,208.72,210.25,85308227,99123282.75,48.66251576301996,48.150203693018476,NaN,NaN,-76.31883402804839,-67.74425502958908,-0.19605486515930012,-0.25334333862383573,-0.05728847346453561,8601275538,8647037125,16.724597404640633,27.970556079391567,NaN,NaN,-3.570084861649756,0.744349775754284
2015-06-17T09:30:00-04:00,210.59,211.32,209.36,210.59,126708635,101852984,49.93757584234601,47.80299257326145,NaN,NaN,-34.546360677309266,-63.12397230190281,-0.12694137699355906,-0.21596519470648445,-0.08902381771292539,8727984173,8652262476.2,17.707515220802364,25.77158577985855,NaN,NaN,-3.091019688649308,0.1964398522680566
2015-06-18T09:30:00-04:00,211.31,213.34,210.6315,212.78,165867949,106303504.95,57.294983808528706,48.33687741903892,NaN,NaN,74.56562963547088,-49.19282915405136,0.06360439209426931,-0.00951832759508875,-0.07312271968935806,8893852122,8675886127.8,22.17960120939486,24.368926932723895,NaN,NaN,-0.2359880206534686,0.13466444185069587
2015-06-19T09:30:00-04:00,211.46,211.55,210.36,210.81,130478689,109589210.15,50.15447087070082,48.25002942220743,NaN,NaN,2.397596716917504,-35.13103942964961,0.05464638949537711,-0.004814732820136669,-0.05946112231551378,8763373433,8700490515.4,26.650524287326178,23.483006209281942,NaN,NaN,-0.16217179056989087,0.09225926579061206
2015-06-22T09:30:00-04:00,211.905,212.59,211.64,211.89,70696027,110252336.75,53.57070122040708,48.46584646910941,NaN,NaN,83.87198108876414,9.994002547159003,0.1156322056006181,0.08507913468525885,-0.030553070915359252,8834069460,8764110945.2,36.76673917895262,23.463143112913713,NaN,NaN,1.0412686189370077,0.22783203052581144
2015-06-23T09:30:00-04:00,212.14,212.44,211.57,212.04,68476797,107460747.4,54.04182593642496,48.56029785278562,NaN,NaN,77.05937194695954,40.66964374216059,0.15764649844116935,0.16650505213610245,0.008858553694933092,8902546257,8824365089,44.56472187648042,24.145895895875828,NaN,NaN,2.1328441684292216,0.49997662165487
2015-06-24T09:30:00-04:00,211.72,212.17,210.47,210.5,92307318,107415414.25,48.59041955463305,48.75978152323734,NaN,NaN,17.38165455328746,51.05524678827994,0.07735618927246324,0.10555379028551215,0.028197601013048905,8810238939,8840816042.2,46.50445997426645,25.195755840070667,NaN,NaN,1.3370999601062565,0.619565670005068
2015-06-25T09:30:00-04:00,211.1,211.25,209.77,209.86,97107361,108522054.3,46.49149886592007,48.89956060795147,NaN,NaN,-29.743855935972498,30.193349673991253,-0.01812373728870486,0.005542929402167829,0.02366666669087269,8713131578,8804671933.4,42.94865774478529,26.19203740970778,NaN,NaN,0.033900606375632886,0.5358992323437202
2015-06-26T09:30:00-04:00,210.29,210.58,209.16,209.82,104174840,107484815.75,46.35671969615839,49.33631203664362,NaN,NaN,-56.26513340341042,18.46080364992567,-0.07978710028230651,-0.07606720866201044,0.0037198916202960605,8608956738,8773788594.4,40.12550172819693,27.316221144110205,NaN,NaN,-1.04736927975383,0.30971801632978446
2015-06-29T09:30:00-04:00,208.045,209.828,205.33,205.42,202621332,112948944.85,34.50647752744119,48.93353948667818,NaN,NaN,-225.10693372983738,-43.33497931379466,-0.3950855642896755,-0.49013706374179833,-0.09505149945212282,8406335406,8688241783.6,33.54730092418045,28.233298561512363,NaN,NaN,-6.36460357879538,-0.6437564972595248
2015-06-30T09:30:00-04:00,207.26,207.32,205.28,205.85,182925106,117518649.55,36.22234421796849,47.89357664189929,NaN,NaN,-211.61103935110717,-101.06906157340799,-0.5436893332368095,-0.7746631659981347,-0.23097383276132522,8589260512,8625584634.6,29.70596877890324,29.060447757165985,NaN,NaN,-9.932224713550761,-1.9706805281582729
2015-07-01T09:30:00-04:00,207.73,208.03,206.56,207.5,135979873,119926597.75,42.45266726669025,47.124690781874776,NaN,NaN,-127.8002295945428,-130.10543840297404,-0.5009253137837477,-0.8571304749910098,-0.35620516120726214,8725240385,8608584923.8,28.744286966098485,29.872621772659624,NaN,NaN,-10.859173547669402,-3.240465245231291
2015-07-02T09:30:00-04:00,208.07,208.27,206.81,207.31,104373652,117551139.35,41.94454082147572,46.74769279422748,NaN,NaN,-106.47995051896848,-145.45265731957323,-0.45674022384312823,-0.9271304410111725,-0.47039021716804424,8620866733,8590131954.8,27.69615360583751,30.66944274820477,NaN,NaN,-11.744610480687713,-4.4553431360107805
2015-07-06T09:30:00-04:00,205.77,207.65,205.53,206.72,117975369,117364674,40.330253405720946,46.46835677124549,NaN,NaN,-122.04268025668469,-158.6081666902281,-0.43846675204658914,-1.0184736572262807,-0.5800069051796916,8502891364,8568918880,26.499878826545086,31.454707694743604,NaN,NaN,-12.960076582970478,-5.670305057005023
2015-07-07T09:30:00-04:00,206.96,208.17,204.11,208.02,173820249,121602519.95,45.32349086303141,46.22985499267487,NaN,NaN,-103.90584965100379,-134.36794987446137,-0.3157773670623517,-0.9747286140076312,-0.6589512469452795,8676711613,8622994121.4,34.29125522485046,32.709468967615734,NaN,NaN,-12.465780623390726,-6.641087280774409
2015-07-08T09:30:00-04:00,206.42,206.7645,204.25,204.53,164020059,124551788.4,36.49431772915466,45.26962227030407,NaN,NaN,-142.53085737231174,-120.55191347870229,-0.4390405800517889,-1.2077519720100156,-0.7687113919582267,8512691554,8607680329.8,33.21736411623522,33.81731531728951,NaN,NaN,-15.043500030663438,-7.841431959329984
2015-07-09T09:30:00-04:00,207.04,207.35,204.77,204.9,144113107,125029879.5,37.87602765976737,43.88255397396398,NaN,NaN,-109.01685834314814,-116.79523922842336,-0.4626636106228892,-1.3470409052368382,-0.884377294613949,8656804661,8593993185,32.2453799829387,34.53629951539979,NaN,NaN,-16.60499783964035,-9.093369942231465
2015-07-10T09:30:00-04:00,207.29,207.98,206.49,207.48,129456890,127808901.65,46.60058596699741,43.62870505227088,NaN,NaN,-50.4072346439574,-105.58069605342116,-0.2805042059146722,-1.2350075520072892,-0.954503346092617,8786261551,8627072148.6,37.040289812052485,35.27842562430881,NaN,NaN,-14.981477479795501,-9.93452816188347
2015-07-13T09:30:00-04:00,208.99,209.9,208.94,209.77,106069400,126343253.2,52.9205688011432,43.58226702232345,NaN,NaN,24.033575582595937,-76.36544488556505,0.0032187488777213336,-0.9504799099954653,-0.9536986588731866,8892330951,8704960066,46.61945036699019,35.982190709168634,NaN,NaN,-11.359583118264984,-10.138107441366543
2015-07-14T09:30:00-04:00,209.72,211.05,209.65,210.68,81709575,124209522.75,55.190138886300986,43.66428937588603,NaN,NaN,50.238128600709224,-45.53664923522244,0.24765083088162232,-0.6441351202711587,-0.891785951152781,8974040526,8764425848.6,52.55470813798576,36.55290401356187,NaN,NaN,-7.716525409845966,-9.792167151149318
2015-07-15T09:30:00-04:00,210.73,211.28,210.04,210.61,97914141,124839818.45,54.970613723421536,44.12001753079949,NaN,NaN,53.72614975413658,-6.285247809932768,0.39153686448940805,-0.402364870541021,-0.793901735030429,8876126385,8837112814.8,58.61232330034485,37.41775139399605,NaN,NaN,-4.956677255397449,-9.101382880327623
2015-07-16T09:30:00-04:00,211.87,212.3,211.58,212.3,106683266,123838550,59.19099929246142,45.02712470412387,NaN,NaN,92.68856193127108,34.055836244951074,0.576286535826169,-0.07354356524771788,-0.6498301010738868,8982809651,8902313812.8,63.156468425211706,38.861166442597934,NaN,NaN,-1.229669964095813,-7.976852463723079
2015-07-17T09:30:00-04:00,212.29,212.55,211.8,212.48,89029973,119996651.2,59.62504813551957,45.974862449792525,NaN,NaN,99.21364116008314,63.980011405759186,0.6792857146248011,0.19927704220711462,-0.4800086724176865,9071839624,8959429427.4,66.61446659304949,40.753235361515976,NaN,NaN,1.8697945783671188,-6.570188600567336
2015-07-20T09:30:00-04:00,212.75,213.18,212.21,212.59,70446821,116995057.8,59.90570141818586,47.78909272770286,NaN,NaN,104.46589330449696,80.0664749501394,0.7196304153038489,0.4195293467121246,-0.30010106859172425,9142286445,9009420526.2,69.32795948050506,43.308996686967724,NaN,NaN,4.460078112695773,-4.994436212958321
2015-07-21T09:30:00-04:00,212.43,212.74,211.39,211.75,77965048,117358508.85,56.66637421373203,49.24938058454312,NaN,NaN,84.09129617024198,86.83710846404594,0.656322603130896,0.5203021853218956,-0.13602041780900026,9064321397,9027476700.4,70.26792794095527,46.20627948425716,NaN,NaN,5.765308007081103,-3.4573298958098317
2015-07-22T09:30:00-04:00,210.93,211.77,210.89,211.37,88667920,118368065,55.21189242529733,50.16075381015791,NaN,NaN,67.79456095445593,89.65079070410982,0.5592263374936524,0.5630125040580651,0.0037861665644128295,8975653477,9047382118.8,71.31170003969358,49.24680898951395,NaN,NaN,6.458912763245834,-2.0407238016590226
2015-07-23T09:30:00-04:00,211.53,211.65,209.75,210.18,90509128,118278155.5,50.81335043555165,50.794240211163334,NaN,NaN,44.6107190431534,80.03522212648629,0.39307517286948507,0.49513013265126915,0.1020549597817841,8885144349,9027849058.4,68.7607340027877,52.17999330358182,NaN,NaN,5.83206402479238,-0.9160398264516794
2015-07-24T09:30:00-04:00,210.3,210.37,207.6,208,117754979,119310536.4,43.91173273093804,51.050060162964556,NaN,NaN,-9.633896520069955,58.26571459045567,0.12827626896800948,0.26240029599179593,0.13412402702378645,8767389370,8966959007.6,61.388613309932815,54.67204576668094,NaN,NaN,3.146866161957324,-0.33562468525039324
2015-07-27T09:30:00-04:00,206.94,207.55,206.26,206.79,132361082,120719848.5,40.614372642697504,50.713694575797845,NaN,NaN,-58.95287806676488,25.581960316203293,-0.12286116434769294,-0.019452428410829725,0.10340873593686321,8635028288,8865507376.2,51.484304651028694,55.900120725693675,NaN,NaN,-0.16719321439740306,-0.3115630465571089
2015-07-28T09:30:00-04:00,207.79,209.5,206.8,209.33,123544845,116766024.15,49.232359229607965,51.62355468297308,NaN,NaN,-11.274943197494498,6.508712442656,-0.1126745485655276,-0.037434449770046285,0.07524009879548131,8758573133,8804357723.4,46.603671972352835,56.85628557255922,NaN,NaN,-0.38244552421987915,-0.3216891147946475
2015-07-29T09:30:00-04:00,209.48,211.04,209.31,210.77,105791255,112909331.6,53.36432041893016,52.72986130862757,NaN,NaN,40.542569147074595,1.058314081179732,-0.009171702840346713,0.06377547024504793,0.07294717308539464,8864364388,8782099905.6,44.93393154571367,57.76261068418601,NaN,NaN,0.7875372983203973,-0.1632281986353554
2015-07-30T09:30:00-04:00,210.16,211.02,209.42,210.82,91304374,110675556.65,53.50582158713599,53.22309242435176,NaN,NaN,37.80923555627728,-0.3019826161954867,0.05870850923354383,0.14633280962732442,0.0876243003937806,8955668762,8796204788.2,46.2482275602988,58.420320523346454,NaN,NaN,1.7495771825040578,0.11002971295598932
2015-07-31T09:30:00-04:00,211.42,211.45,210.16,210.5,103266857,110620216.9,52.409800575258544,53.18660897964571,NaN,NaN,42.86538298603146,10.19787328502479,0.07695640759565402,0.18381980988834812,0.1068634022926941,8852401905,8813207295.2,47.86362042581969,58.50918981326286,NaN,NaN,2.214564829951443,0.4106775868124827
2015-08-03T09:30:00-04:00,210.46,210.53,208.65,209.79,113965728,110419734.85,49.96428424524402,52.813333648141636,NaN,NaN,2.7767909242886497,22.5438070832355,0.03807486016706453,0.15445697750152476,0.11638211733446023,8738436177,8833888873,49.838371626015906,58.315165776693576,NaN,NaN,1.9042983406945588,0.6240519802242078
2015-08-04T09:30:00-04:00,209.7,210.2483,208.8,209.38,81820823,105819763.55,48.55530392166565,52.3550972337305,NaN,NaN,-9.696586730021567,22.859478376730085,-0.01551756329972144,0.09698516320980843,0.11250272650952987,8656615354,8813497317.2,47.9114578578552,57.55081824508717,NaN,NaN,1.2503357002992068,0.7135210830920649
2015-08-05T09:30:00-04:00,210.45,211.31,209.73,210.07,85786817,101908101.45,51.05673265272101,51.77407818803476,NaN,NaN,18.644771720919216,18.479918891499004,-0.005286277609693635,0.10589487949741283,0.11118115710710647,8742402171,8789104873.8,45.63836019930748,56.29952480037973,NaN,NaN,1.3812958564534932,0.8089174792865546
2015-08-06T09:30:00-04:00,210.29,210.415,207.65,208.35,116030803,100503986.25,45.16175242112461,50.740985637006546,NaN,NaN,-72.52927681494238,-3.5877835827449247,-0.10937638969779351,-0.02553933001513542,0.08383705968265809,8626371368,8723245395,40.10571703131256,54.40604268882709,NaN,NaN,-0.2320708662872078,0.6602048584903029
2015-08-07T09:30:00-04:00,208.16,208.34,206.87,207.95,117857956,99924039.55,43.89253442767436,49.59718799482715,NaN,NaN,-135.58975519346006,-39.27881121864323,-0.1951757563072592,-0.1601326357014159,0.03504312060584329,8508513412,8654467696.4,35.29382971295115,51.975033419716105,NaN,NaN,-1.9361188406645056,0.2893014728967588
2015-08-10T09:30:00-04:00,209.28,210.67,209.28,210.57,80270676,98634103.35,53.175104475911525,49.34781158498283,NaN,NaN,-0.6556319388252222,-39.965295791266,-0.07183890366899973,-0.054755508980406375,0.017083394688593354,8588784088,8624537278.6,33.41494662137535,49.34267761117467,NaN,NaN,-0.6381708680564774,0.15680542418915364
2015-08-11T09:30:00-04:00,208.97,209.47,207.76,208.67,126081377,100852693.45,47.09067958275284,48.76772495337251,NaN,NaN,-78.56512130592397,-53.73900270644648,-0.11217714713074758,-0.12313803922484112,-0.010960892094093542,8462702711,8585754750,31.104320315091044,46.4707219165602,NaN,NaN,-1.4856711205415893,-0.0778340822009525
2015-08-12T09:30:00-04:00,207.11,209.14,205.36,208.92,172123672,104563170,47.93484860140473,48.562117679504865,NaN,NaN,-106.71435313537246,-78.81082767770481,-0.11552552091902443,-0.15536779324287409,-0.03984227232384965,8634826383,8564239592.4,29.87030188161384,43.69283390790493,NaN,NaN,-1.8988304877611888,-0.33797642585241483
2015-08-13T09:30:00-04:00,208.73,209.55,208.01,208.66,89383253,103698169.35,47.09330919455456,48.78937314119177,NaN,NaN,-53.820584325438,-75.06908917980394,-0.12779753623829265,-0.19958919262171548,-0.07179165638342283,8545443130,8548053944.8,28.940112497645856,41.37508384988443,NaN,NaN,-2.4814555588136384,-0.644187730561161
2015-08-14T09:30:00-04:00,208.43,209.5087,208.26,209.42,72786528,102885997.1,49.86405830110791,49.45006497393536,NaN,NaN,-31.382513356066113,-54.22764081232515,-0.07963410433810805,-0.1713342868060579,-0.09170018246794984,8618229658,8569997194,32.0304213277408,39.98552075536387,NaN,NaN,-2.170197671454312,-0.862189150688754
2015-08-17T09:30:00-04:00,208.71,210.59,208.16,210.59,79072643,103317288.2,53.869341344298036,49.78127798212751,NaN,NaN,18.99621091845728,-50.29727224086865,0.03023103276091514,-0.05391139151680591,-0.08414242427772105,8697302301,8591700836.6,35.03956331296497,39.15951299397902,NaN,NaN,-0.7126160715807375,-0.8408215679590374
2015-08-18T09:30:00-04:00,210.26,210.68,209.699,209.98,71692678,103003669.7,51.55675341998467,49.652166053631404,NaN,NaN,50.40940613834028,-24.502366752015803,0.05934594705342325,-0.009959990460941981,-0.06930593751436523,8625609623,8624282219,39.3784350057611,38.76269181255383,NaN,NaN,-0.15659766537788875,-0.7430752961617304
2015-08-19T09:30:00-04:00,209.09,210.01,207.35,208.32,172945975,107217572.45,45.79520127785984,49.10140746011168,NaN,NaN,-50.51366936687605,-13.262229998316519,-0.030821874261055954,-0.10783328034068518,-0.07701140607962922,8452663648,8587849672,36.446911916457594,38.06259783799374,NaN,NaN,-1.4065601861330923,-0.837858851871925
2015-08-20T09:30:00-04:00,206.51,207.17,203.9,203.97,194327884,112408510.25,34.81546349259294,47.844669097064134,NaN,NaN,-254.00800585744994,-53.299714304718904,-0.36262632355826974,-0.5302943105274665,-0.1676679869691967,8258335764,8530428198.8,32.35818169553728,36.95506650011642,NaN,NaN,-6.621697452693315,-1.6641215091321235
2015-08-21T09:30:00-04:00,201.73,203.9404,197.52,197.63,346588470,123850184.8,25.296062738829463,46.082653275177385,NaN,NaN,-379.099734256253,-122.84315848475629,-0.9546608447366759,-1.3609940428900416,-0.40633319815336566,7911747294,8389131726,24.943048931671427,35.17682916480611,NaN,NaN,-15.7960772085547,-3.682972323335348
2015-08-24T09:30:00-04:00,187.49,195.84,182.4,189.55,507244330,142594347.2,18.393520462818728,43.92824017097403,NaN,NaN,-423.1104762512449,-211.26449591869672,-1.787633975454625,-2.640875667471647,-0.8532416920170219,7404502964,8130571858.6,17.183199021224667,32.98195353361821,NaN,NaN,-27.424459141529635,-7.074613297363103
2015-08-25T09:30:00-04:00,195.43,195.45,186.92,187.27,369833070,154908758.45,16.985099709577355,41.49455210360662,NaN,NaN,-260.9883660894201,-273.5440503642488,-2.353740101366691,-3.7954168187253856,-1.4416767173586946,7034669894,7812383912.8,12.166837890422812,30.591130511555015,NaN,NaN,-36.197199914599906,-11.234982814111218
2015-08-26T09:30:00-04:00,192.08,194.79,188.37,194.46,339256990,166582045.2,34.11744178497882,40.705672772453354,NaN,NaN,-167.97075325010908,-297.0354671408954,-2.113185014016126,-4.083157984878852,-1.969972970862726,7373926884,7596636560,10.028942903996551,28.442789502461014,NaN,NaN,-35.27142662418938,-14.66876050126524
2015-08-27T09:30:00-04:00,197.02,199.42,195.21,199.27,274143910,175724022,42.64513926815189,40.61657311820175,NaN,NaN,-84.8341738712985,-263.20070074366515,-1.526710264780287,-3.8783608018380846,-2.3516505370577976,7648070794,7474583566,9.059140437212832,26.568883125622563,NaN,NaN,-30.6543882741928,-16.952421611683462
2015-08-28T09:30:00-04:00,198.5,199.835,197.92,199.28,160414352,178581396.75,42.661755989098,39.86561965485792,NaN,NaN,-62.95473780634403,-199.97170145368332,-1.0570088533203679,-3.6729116037082576,-2.6159027503878898,7808485146,7453931136.4,8.902271711864415,24.817977774943213,NaN,NaN,-27.517204760241015,-18.461676347191684
2015-08-31T09:30:00-04:00,198.11,199.125,197.01,197.67,163298816,181048051.15,40.62124523087245,39.40351720115218,NaN,NaN,-65.61824704422011,-128.47325561227836,-0.7860967102334477,-3.5985236381796994,-2.8124269279462517,7645186330,7502067809.6,12.69689502383865,23.503161682710896,NaN,NaN,-25.926748833021275,-19.52811527373877
2015-09-01T09:30:00-04:00,193.12,194.77,190.73,191.77,256000392,189757029.6,34.17109442068434,38.42039190252929,NaN,NaN,-107.48985941107561,-97.77355427660947,-0.9259695959404413,-3.969888922871803,-3.043919326931362,7389185938,7572971018.4,18.10789648661074,22.662989868782102,NaN,NaN,-27.0929697954102,-20.60880877683469
2015-09-02T09:30:00-04:00,194.62,195.46,192.42,195.41,160269331,193481155.3,40.453250881853705,37.94610202305066,NaN,NaN,-77.63020272546456,-79.70544417168057,-0.7050512268351645,-3.9252333604753176,-3.220182133640153,7549455269,7608076695.4,20.727681583613972,22.07638766063697,NaN,NaN,-25.597826933629552,-21.321525656376814
2015-09-03T09:30:00-04:00,196.26,198.05,194.96,195.55,152087836,195284006.95,40.687699790769464,37.29064784374077,NaN,NaN,-54.40408048419185,-73.61942549425925,-0.4913316638591576,-3.8343467134641003,-3.3430150496049427,7701543105,7618771157.6,21.551017828425458,21.327858839257306,NaN,NaN,-24.41436838146132,-21.763360331388885
2015-09-04T09:30:00-04:00,192.85,193.86,191.61,192.59,207080961,199745157.2,37.34023820342837,36.10999761939294,NaN,NaN,-80.35978003552393,-77.10043394009523,-0.4900426193336336,-3.9555683237719848,-3.465525704438351,7494462144,7555966557.2,20.22267129271819,20.269509409239674,NaN,NaN,-24.594613045170124,-22.167825004786206
2015-09-08T09:30:00-04:00,195.94,197.61,195.17,197.43,116025739,201532910.35,45.26929996425943,35.66089380112685,NaN,NaN,-36.71777959099512,-71.32034044945024,-0.12307379812119557,-3.6193679520898456,-3.49629415396865,7610487883,7549026867.8,20.07542592894015,18.890723046609605,NaN,NaN,-21.93191751956592,-22.134123935469024
2015-09-09T09:30:00-04:00,199.32,199.47,194.35,194.79,149347735,202696228.25,42.13715724725789,35.399604941798145,NaN,NaN,-38.133482729732116,-57.44906511318154,-0.0232167045460967,-3.525315034651271,-3.5020983301051745,7461140148,7563417709.8,21.354245415926826,17.812675439428833,NaN,NaN,-20.871283462809252,-21.953718153660486
2015-09-10T09:30:00-04:00,194.56,197.22,194.25,195.85,158611063,202020597.8,43.81797931357481,36.04264178615399,NaN,NaN,-38.73079097795762,-49.669182763680155,0.14016353080006994,-3.326893916605087,-3.467057447405157,7619751211,7577476898.2,22.656251048911344,17.119680393241264,NaN,NaN,-19.490878521755896,-21.601883920531257
2015-09-11T09:30:00-04:00,195.375,196.82,194.53,196.74,119691212,203535995.75,45.25587802335985,37.46834287790616,NaN,NaN,-31.223794499284793,-45.033125566698736,0.32362571496285275,-3.062525303701591,-3.3861510186644437,7739442423,7585056761.8,23.392617554717248,17.008935294887394,NaN,NaN,-17.942825673828704,-21.079161313859466
2015-09-14T09:30:00-04:00,196.95,197.01,195.43,196.01,79451983,203869268.5,44.25538379647381,39.3156188303101,NaN,NaN,-24.44361403341727,-33.849892366277416,0.4059352608894029,-2.8787319425526903,-3.284667203442093,7659990440,7618162421,26.6761376117462,17.687002337067504,NaN,NaN,-16.98373381592058,-20.494100242725338
2015-09-15T09:30:00-04:00,196.61,198.99,195.9612,198.46,113806176,205605945.15,48.380017202632786,41.558112936956924,NaN,NaN,10.140513753876967,-24.478233697303,0.6225444527825368,-2.5064866374639223,-3.129031090246459,7773796616,7650824167.6,29.86984903944405,18.951503133426165,NaN,NaN,-14.92961397621112,-19.699173633223307
2015-09-16T09:30:00-04:00,198.82,200.41,198.41,200.18,99581557,207000389.1,51.11470475322279,42.772203148974356,NaN,NaN,61.63865409839161,-4.5238063316782515,0.8639692498597031,-2.04906952792183,-2.913038777781533,7873378173,7733271772.6,37.294549749947286,20.899046479565502,NaN,NaN,-12.392557111033456,-18.65537127291047
2015-09-17T09:30:00-04:00,200.02,202.89,199.28,199.73,276046620,212155421.35,50.36296093835282,43.32347612541728,NaN,NaN,104.06695240709386,24.035742345332046,0.9678386095418969,-1.7032405158541621,-2.671079125396059,7597331553,7728787841,37.06472301085929,22.89944523482597,NaN,NaN,-10.523875835177813,-17.493729067520093
2015-09-18T09:30:00-04:00,195.71,197.56,194.96,195.45,223657456,213621899.95,43.76952515624237,43.40260249449902,NaN,NaN,3.8860370381206493,31.05770865281313,0.7334183300996959,-1.7543062127714393,-2.487724542871135,7373674097,7655634175.8,33.44369988145985,24.652404389797066,NaN,NaN,-10.782247671856918,-16.534946010996784
2015-09-21T09:30:00-04:00,196.44,197.68,195.21,196.46,105726209,201578786.9,45.58011642567824,43.75680757984229,NaN,NaN,22.178188081784537,40.38206907585352,0.6351771898890664,-1.6937530555098022,-2.3289302453988685,7479400306,7619516149,31.792253558445537,26.01635857084042,NaN,NaN,-10.469701588579253,-15.668482522079994
2015-09-22T09:30:00-04:00,193.88,194.46,192.56,193.91,153890876,183911114.2,41.91085479471167,44.30964760655853,NaN,NaN,-75.56021826931678,23.241922671214773,0.3988018783362941,-1.8304278974785007,-2.2292297758147948,7325509430,7529858711.8,28.08485468113578,26.728998441877923,NaN,NaN,-11.284688306250102,-15.042226205532867
2015-09-23T09:30:00-04:00,194.11,194.67,192.91,193.6,92790620,170058991.7,41.47375280743502,44.38254060124291,NaN,NaN,-89.61559414022707,-7.008926976508964,0.23028054551464905,-1.9413790939214834,-2.1716596394361325,7232718810,7401726839.2,23.811321874421182,26.94925846264987,NaN,NaN,-12.073006599594006,-14.61805197611303
2015-09-24T09:30:00-04:00,192.15,193.45,190.56,192.9,159378840,161065084.2,40.44792713892414,44.36541398325396,NaN,NaN,-141.88117762568768,-56.19855298306527,0.08770919391342025,-2.062023147044357,-2.1497323409577773,7073339970,7296928522.6,20.99711337074831,26.90969385853007,NaN,NaN,-13.015291585760666,-14.389086206062693
2015-09-25T09:30:00-04:00,194.64,195,191.81,192.85,155054777,155110627.55,40.37111539537806,44.581905211250366,NaN,NaN,-94.29815126598338,-75.83539064388609,0.010158188132193047,-2.137034605792536,-2.147192793924729,6918285193,7205850741.8,18.905836735518008,26.815634247301485,NaN,NaN,-13.817365205170928,-14.30741177736387
2015-09-28T09:30:00-04:00,191.78,191.91,187.64,188.01,178515871,156015703.5,33.69970710528541,43.755505721323644,NaN,NaN,-193.6262361484418,-118.99627548993135,-0.3282837349246064,-2.5575474625804873,-2.229263727655881,6739769322,7057924545,16.100920299162638,26.53174098803166,NaN,NaN,-16.559948402280046,-14.629202723780466
2015-09-29T09:30:00-04:00,188.27,189.74,186.93,188.12,159045572,155803041.3,33.96678700716872,43.17190784703156,NaN,NaN,-183.70666812625097,-140.6255654613182,-0.49585968484309095,-2.8490883337097443,-2.3532286488666534,6898814894,6972585637.8,14.742077024817164,26.059443245809543,NaN,NaN,-18.7206496627536,-15.213695143633771
2015-09-30T09:30:00-04:00,190.37,191.825,189.44,191.63,163452044,151175623.9,41.99615981652274,43.04177788295642,NaN,NaN,-103.16967104844696,-143.33638084296214,-0.32944532331769727,-2.765035303013775,-2.435589979696078,7062266938,6938495263.4,14.225591241738556,25.457253259582917,NaN,NaN,-18.337698486081422,-15.659981335412008
2015-10-01T09:30:00-04:00,192.08,192.49,189.82,192.13,131078964,149716105.55,43.05833686418056,42.884810657300754,NaN,NaN,-80.11620403788719,-130.98338612540206,-0.15375631642406073,-2.6277853752261535,-2.474029058802093,7193345902,6962496449.8,16.44510188408175,24.96100214025181,NaN,NaN,-17.721036859925132,-15.954417838913882
2015-10-02T09:30:00-04:00,189.77,195.03,189.12,195,211003342,152661880.85,48.848551677979536,43.2128940774083,NaN,NaN,-36.49081515958361,-119.42191890412212,0.17013425544763905,-2.261361239492544,-2.431495494940183,7404349244,7059709260,24.919381881238166,24.835519588072664,NaN,NaN,-15.455269910329333,-15.883110991973233
2015-10-05T09:30:00-04:00,196.46,198.74,196.33,198.47,126320842,148623874.9,54.829276693137366,43.67355546958721,NaN,NaN,76.40473067564336,-65.41572553930509,0.6078386460326812,-1.6716971873993316,-2.279535833432013,7530670086,7217889412.8,36.249350023634456,25.29119822980055,NaN,NaN,-11.559278151188591,-15.265420586146856
2015-10-06T09:30:00-04:00,198.31,198.98,197,197.79,110274530,148336314.45,53.50893502761698,43.84457191775822,NaN,NaN,75.34131481671703,-13.606128950711494,0.8277054537497337,-1.2449040162448455,-2.072609469994579,7420395556,7322205545.2,42.42033068226931,25.657325439252126,NaN,NaN,-8.777646427243928,-14.33859570630358
2015-10-07T09:30:00-04:00,198.9,199.825,197.48,199.41,124307295,147084292.45,56.214130050165906,44.26251256860201,NaN,NaN,91.805550009604,25.388915260898706,1.0444042219911616,-0.7671041925056272,-1.8115084144967888,7544702851,7418692727.8,47.48398621027355,26.401558524924575,NaN,NaN,-5.612639723435368,-13.092030565893836
2015-10-08T09:30:00-04:00,198.95,201.55,198.59,201.21,153055231,146806500.85,59.06431670872296,45.354997679493486,NaN,NaN,113.8979454093821,64.19174515035256,1.2568643879594474,-0.24042792954747938,-1.4972923175069268,7697758082,7519575163.8,52.215624330564715,27.742410271289206,NaN,NaN,-2.056125576443127,-11.51547271025802
2015-10-09T09:30:00-04:00,201.38,201.9,200.58,201.33,107069240,146175402.25,59.2547355356562,46.33175618734906,NaN,NaN,117.01525222127268,94.89295862652384,1.3454520437730775,0.18452273720942003,-1.1609293065636574,7804827322,7599670779.4,55.633474743521965,29.44535464165181,NaN,NaN,0.8922608846933617,-9.74293933955068
2015-10-12T09:30:00-04:00,201.42,201.76,200.91,201.52,56395585,145022582.35,59.57537053567395,47.593507311703505,NaN,NaN,106.69676496446505,100.95136548428817,1.3531555778317041,0.5305151657259728,-0.8226404121057314,7861222907,7665781343.6,58.285633924268495,31.60255315901843,NaN,NaN,3.424168848257674,-7.861923884149487
2015-10-13T09:30:00-04:00,200.65,202.16,200.05,200.25,88038718,143734209.45,56.381584159331204,48.65835240826751,NaN,NaN,89.62747817130895,103.80859815520655,1.2135007749243902,0.6942355565497564,-0.5192652183746338,7773184189,7736339070.2,60.96745291234474,34.25656251887011,NaN,NaN,4.775908591296512,-6.056519244800059
2015-10-14T09:30:00-04:00,200.18,200.87,198.94,199.29,99106161,143710439.65,54.02394361886164,49.6280678711202,NaN,NaN,69.33275538477407,99.31403923024057,1.0058232188006904,0.7380138051262293,-0.26780941367446115,7674078028,7762214105.6,61.93395463174441,37.18062260894127,NaN,NaN,5.311472701858556,-4.4325203952773995
2015-10-15T09:30:00-04:00,200.08,202.36,199.64,202.35,134142195,136615218.4,59.79499933375028,51.0154881524325,NaN,NaN,99.21404876652558,96.37725990166925,1.0206516534178303,1.0080051530978267,-0.012646500320003584,7808220223,7784306533.8,62.78134513911344,40.31458749491237,NaN,NaN,7.458709334925616,-2.733773290962683
2015-10-16T09:30:00-04:00,202.83,203.29,201.92,203.27,114580052,131161348.2,61.36519355760108,52.99159432759791,NaN,NaN,108.74559994272715,94.72332944596016,1.0352691291839515,1.2814399111599357,0.2461707819759843,7922800275,7807901124.4,63.7104841300584,43.71527062569064,NaN,NaN,9.71606591394918,-0.9552248331181314
2015-10-19T09:30:00-04:00,202.5,203.37,202.13,203.37,76523897,129701232.6,61.541013443403436,54.96118193018611,NaN,NaN,98.38085520108876,93.0601474932849,0.9942980357059975,1.4890433266084813,0.49474529090248376,7999324172,7835521377.4,64.81772923436507,47.29210292637264,NaN,NaN,11.628241219492624,0.8424131743976908
2015-10-20T09:30:00-04:00,202.85,203.84,202.5471,203.09,78448484,125929113,60.707951025227196,56.297738445093565,NaN,NaN,92.29231587923502,93.59311503487011,0.8941159577771391,1.6123902381239077,0.7182742803467685,7920875688,7865059677.2,66.01207419352147,50.99113742292856,NaN,NaN,13.02397664928902,2.5826365279535946
2015-10-21T09:30:00-04:00,203.61,203.79,201.65,201.85,102038033,126391483.65,57.026349291427024,57.29545361846832,NaN,NaN,75.18189866196806,94.7629436903089,0.6987704635761307,1.591737359816932,0.8929668962408013,7818837655,7894011602.6,67.18783098117785,54.61561807272114,NaN,NaN,13.283283307168215,4.111300353555683
2015-10-22T09:30:00-04:00,202.98,205.51,201.85,205.26,174911723,127168127.8,63.56933161692798,58.34693789982178,NaN,NaN,95.8014613956553,94.08042621613484,0.7491782147955113,1.8294396647351903,1.080261449939679,7993749378,7931117433.6,68.68310544863547,57.74159832753524,NaN,NaN,15.428244183200377,5.728006614933497
2015-10-23T09:30:00-04:00,207.25,207.95,206.3,207.51,144442340,126637505.95,67.12596672012512,59.22527290174935,NaN,NaN,132.2667788917518,98.78466200593978,0.8752408628759252,2.1743125285345855,1.2990716656586603,8138191718,7974195722.2,70.37121557230667,60.178874438154686,NaN,NaN,18.398198410799235,7.5380340143428874
2015-10-26T09:30:00-04:00,207.3,207.37,206.56,207,69032965,121163360.65,65.56351452486851,60.08631429441017,NaN,NaN,124.22252221484723,103.95299540869146,0.8639825192025896,2.3790498146618972,1.5150672954593076,8069158753,7988162638.4,70.91856502231465,62.214462605300774,NaN,NaN,20.383518472998414,9.373103222722248
2015-10-27T09:30:00-04:00,206.2,207,205.79,206.6,77905770,117106370.55,64.29936807706176,60.6638312963313,NaN,NaN,114.44745219854434,108.38402267255333,0.772294971319601,2.480436009608809,1.708141038289208,7991252983,8002238097.4,71.49016509620976,63.92918966858194,NaN,NaN,21.67436303766562,11.130426053428444
2015-10-28T09:30:00-04:00,207,208.98,206.21,208.95,135906725,115729104.6,68.1809991466557,61.315022899040784,NaN,NaN,140.18557197247657,121.38475733465505,0.8087407282168597,2.7190669485602825,1.9103262203434228,8127159708,8063902508,73.90959970346296,65.47875933807468,NaN,NaN,23.976476215444915,12.965576076573655
2015-10-29T09:30:00-04:00,208.35,209.27,208.21,208.83,90525498,113701431.3,67.77576053504805,61.92366754185449,NaN,NaN,143.2260090990412,130.86966687533223,0.7641144980547541,2.865469342911865,2.101354844857111,8036634210,8072479474.4,74.23708960779729,66.8075889712372,NaN,NaN,25.743499789773555,14.790993749887926
2015-10-30T09:30:00-04:00,209.06,209.44,207.74,207.93,131076942,109705111.3,64.67117141045591,62.28765331862462,NaN,NaN,123.07467081538219,129.03124526005828,0.6194939484723947,2.8757222804476044,2.2562283319752097,7905557268,8025952584.4,69.1653086167668,67.58470859212993,NaN,NaN,26.393962978837372,16.44856078259499
2015-11-02T09:30:00-05:00,208.32,210.62,208.17,210.39,86270811,107702609.75,68.86879033857355,63.17959661714194,NaN,NaN,132.39614638132724,130.6659700933543,0.6327955432805643,3.047222761075915,2.4144272177953505,7991828079,8010486449.6,67.5141202595505,68.05232768835891,NaN,NaN,28.21298465943044,18.129192765000052
2015-11-03T09:30:00-05:00,209.97,211.66,209.7,211,95246052,106951185.85,69.82616877205163,64.30832698522693,NaN,NaN,135.14375073679136,134.80522980100372,0.6248774400454971,3.1955240178522217,2.5706465778067247,8087074131,8029650679.2,68.51706670921831,68.52254997960705,NaN,NaN,30.001001309700005,19.825165414242903
2015-11-04T09:30:00-05:00,211.35,211.5,209.7201,210.36,96224477,105547044.95,67.48136593489932,64.85735317102329,NaN,NaN,114.06685184256841,129.58148577502206,0.522878019368763,3.2242441020176784,2.7013660826489154,7990849654,8002388668.4,65.4227612282252,68.71122255740075,NaN,NaN,30.848866473812897,21.399979851324332
2015-11-05T09:30:00-05:00,210.43,210.98,209.09,210.15,78408744,101814720.6,66.69000812713439,65.2376970688471,NaN,NaN,94.10092196492191,119.75646834819823,0.3935070804236389,3.193249933178464,2.799742852754825,7912440910,7977550008.4,62.64677012351617,68.63524298550486,NaN,NaN,31.341019061821996,22.820128309966854
2015-11-06T09:30:00-05:00,209.74,210.32,208.46,210.04,110471473,101984832.25,66.25173548718675,65.57417721483162,NaN,NaN,77.2444559556588,110.59042537625355,0.25924692664430626,3.1238015110602078,2.8645545844159015,7801969437,7956832442.2,60.34671578777542,68.31588488217703,NaN,NaN,31.63968429323693,24.080064879005437
2015-11-09T09:30:00-05:00,209.31,209.49,206.95,208.08,131008660,105715486,58.832654634961834,65.44022747266982,NaN,NaN,43.70550543740496,92.85229718746908,0.010306892593494155,2.877438200157769,2.867131307564275,7670960777,7892658981.8,53.76228096215072,67.44089965136483,NaN,NaN,29.84867351252006,24.904151826650384
2015-11-10T09:30:00-05:00,207.51,208.6,207.19,208.56,75874602,105107280.2,60.01361371922428,65.65360350322676,NaN,NaN,38.054987306181935,73.43454450134719,-0.14177081253216972,2.689917791899063,2.831688604431233,7746835379,7824611231.4,47.8058159366872,66.05647000532979,NaN,NaN,28.641941887695776,25.438121835371156
2015-11-11T09:30:00-05:00,208.88,208.94,207.66,207.74,67845971,103544270.7,57.005093404542656,65.18472934519924,NaN,NaN,32.54803806907596,57.13078174664871,-0.3078047604274139,2.4469326538969653,2.7547374143243792,7678989408,7762239182.2,43.09301873471163,64.22860666862094,NaN,NaN,26.76858750883294,25.628188360151412
2015-11-12T09:30:00-05:00,206.5,207.06,204.82,204.84,121315200,102902920.95,47.866070340744706,63.80902246095777,NaN,NaN,-45.934991354071514,29.123599082850028,-0.6059216284357474,1.9973353787796952,2.6032570072154426,7557674208,7691285841.8,38.4494138698033,61.948477975584986,NaN,NaN,22.182807167620737,25.135991046932745
2015-11-13T09:30:00-05:00,204.35,204.67,202.435,202.54,153577050,104852770.85,42.10113503879016,62.13313821195218,NaN,NaN,-118.35296250728652,-9.99588460973904,-0.9315261168166749,1.438849361194599,2.370375478011274,7404097158,7611711386,34.021606933637855,59.31298096925093,NaN,NaN,16.21732326596754,23.861895649652002
2015-11-16T09:30:00-05:00,202.32,205.69,202.18,205.62,117645231,106908837.55,50.66936195450889,61.15956634605554,NaN,NaN,-85.49380542748167,-35.835746782716356,-0.9118284200189843,1.2305899529875433,2.1424183730065276,7521742389,7581867708.4,32.50953299159893,56.528650104635865,NaN,NaN,13.699278783638144,22.41009324022145
2015-11-17T09:30:00-05:00,205.99,207.04,204.88,205.47,121123744,109042600.55,50.27912013791585,59.880860702574125,NaN,NaN,-52.32619912708619,-53.91198406936998,-0.8807874016992794,1.0414341208824283,1.9222215225817076,7400618645,7512624361.6,29.260121404702346,53.3394016547244,NaN,NaN,11.610313728917518,20.86726759574946
2015-11-18T09:30:00-05:00,206.04,208.9,205.99,208.73,121342544,110007826.1,57.87294376284575,59.17351664741682,NaN,NaN,10.466564955088351,-58.3282786921675,-0.624638104407722,1.141423892072055,1.766061996479777,7521961189,7481218717.8,27.8981029271728,50.02947403467979,NaN,NaN,12.290865227505051,19.64206725742883
2015-11-19T09:30:00-05:00,208.59,209.05,208.2,208.55,88220465,105673263.2,57.352096261178986,58.650725565325615,NaN,NaN,34.26807143499852,-42.28766613435349,-0.4589321553008401,1.192396802353727,1.651328957654567,7433740724,7456432021,26.836344137020518,47.00597657184077,NaN,NaN,12.656638039367968,18.64414879770585
2015-11-20T09:30:00-05:00,209.45,210.12,208.86,209.3108,94011519,103151722.15,59.030432875290415,57.94798574651968,NaN,NaN,65.66709312488867,-5.483655007918455,-0.29751526699159037,1.2794348739150792,1.5769501409066695,7527752243,7481163038,29.710750109448355,44.30573584683348,NaN,NaN,13.472774790701953,17.905381082419577
2015-11-23T09:30:00-05:00,209.38,209.98,208.52,209.07,64931172,102946632.5,58.24909083355645,57.12105160805573,NaN,NaN,51.23502469428011,21.862111016433904,-0.21049009351643955,1.3138375240111202,1.5243276175275597,7462821071,7469378774.4,29.12360824872114,41.49191738536939,NaN,NaN,13.90655863153347,17.33412073229299
2015-11-24T09:30:00-05:00,207.87,209.83,207.41,209.35,98874365,103995062.25,58.929825712314525,56.51022730644253,NaN,NaN,32.88499148774594,38.90434913940033,-0.14093822027099234,1.3481548421888192,1.4890930624598115,7561695436,7501594132.6,33.020484624778035,39.177469056551736,NaN,NaN,14.455818049501396,16.922934634751336
2015-11-25T09:30:00-05:00,209.5,209.74,209.01,209.32,51980062,99798729.1,58.819168721693565,55.94802449176819,NaN,NaN,51.64774001638704,47.140584151660065,-0.10544654629059913,1.3572848795965626,1.4627314258871618,7509715374,7499144969.6,32.87250998101648,37.05073618923033,NaN,NaN,14.880039337972434,16.631092449497206
2015-11-27T09:30:00-05:00,209.43,209.8,208.86,209.56,37317779,97138343.15,59.474776039552395,55.463955959794305,NaN,NaN,51.577153177752244,50.60240050021081,-0.07569257431172649,1.3681157079975037,1.4438082823092302,7547033153,7521803455.4,35.741520765773416,35.29322225908732,NaN,NaN,15.409987871519926,16.456648938357596
2015-11-30T09:30:00-05:00,209.75,209.89,208.56,208.69,112822700,96225631.05,55.99470327016367,55.26124514802301,NaN,NaN,33.18011846762071,44.10500556875722,-0.12175972331654861,1.2916086281635444,1.413368351480093,7434210453,7503095097.4,34.43295504570165,33.912556122198104,NaN,NaN,14.965441122470585,16.243619250373737
2015-12-01T09:30:00-05:00,209.44,210.82,209.11,210.68,97858418,96805011.4,61.538421198062736,55.37015996794003,NaN,NaN,82.38122059640263,50.33424474918172,-0.030139132424180426,1.3756944359498675,1.405833568374048,7532068871,7516944657.4,36.29246413980526,33.09017385099225,NaN,NaN,16.118233304826173,16.22570697243837
2015-12-02T09:30:00-05:00,210.615,211,208.23,208.529,108441259,97464771.75,53.66822719796362,55.13181238175582,NaN,NaN,45.969129728636304,52.951072397359795,-0.12122168907908293,1.2543064570251943,1.3755281461042772,7423627612,7489331092.6,34.20927931143821,32.455621035044146,NaN,NaN,14.796059362992352,16.02147159966037
2015-12-03T09:30:00-05:00,208.83,209.15,204.7511,205.61,166224154,100964755.6,45.21700945057564,54.942593746743746,NaN,NaN,-69.36816706423149,28.747890981236083,-0.3707800180037375,0.9120531235996054,1.282833141603343,7257403458,7438868709.4,30.737085221807092,31.904740417330135,NaN,NaN,10.77404167823522,15.271838753742491
2015-12-04T09:30:00-05:00,206.08,209.97,205.93,209.62,192913879,106690012.35,55.56821173547453,55.90452779650691,NaN,NaN,25.125220834918327,23.457504512669303,-0.26354795556865906,0.9533981971425192,1.2169461527111782,7450317337,7419525546.2,29.50101962985545,31.58184132420282,NaN,NaN,10.81570467177252,14.635248170603925
2015-12-07T09:30:00-05:00,209.23,209.7295,207.2,208.35,102027111,106267794.25,52.203930494980284,56.01413983511202,NaN,NaN,24.75267662855202,21.772016144855563,-0.27466445576948595,0.8736155829993208,1.1482800387688068,7348290226,7402341500.8,28.408062688935033,31.28887915972683,NaN,NaN,9.665775068925337,13.925323441792697
2015-12-08T09:30:00-05:00,206.49,208.289,205.78,206.949,103372367,104885979.6,48.701065240761196,55.90142162817239,NaN,NaN,-38.74828988792175,-2.4538859520093084,-0.3671108950346964,0.6893914199754363,1.0565023150101327,7244917859,7344911298.4,25.06575495182959,30.989281555950196,NaN,NaN,7.534554519540783,13.012356452899567
2015-12-09T09:30:00-05:00,206.19,208.68,204.18,205.34,162401537,109212326.35,44.969104549719404,54.979718827234805,NaN,NaN,-71.93662082166071,-26.035036062068713,-0.5181245234612994,0.4088466606835084,0.9269711841448078,7082516322,7276689040.4,21.786581864753273,30.55274433720595,NaN,NaN,4.516598990145415,11.79867681536326
2015-12-10T09:30:00-05:00,205.42,207.43,205.14,205.87,116128884,111626472,46.425440981028494,54.1992434500812,NaN,NaN,-61.10755432622957,-24.382913514468328,-0.5602436539781849,0.22666661667207677,0.7869102706502616,7198645206,7264937390,21.27038384325249,30.155175744793947,NaN,NaN,2.5951802538776914,10.483891592293894
2015-12-11T09:30:00-05:00,203.35,204.14,201.51,201.88,211173305,116119377.25,38.22426724096159,52.71308876191485,NaN,NaN,-182.41876147920541,-65.89170997729309,-0.8190808002647896,-0.23694072968072533,0.5821400705840643,6987471901,7172368302.8,17.71067721874158,29.298027681172034,NaN,NaN,-2.0662676619104436,8.691011698836132
2015-12-14T09:30:00-05:00,202.07,203.05,199.95,202.9008,182385177,117559783.6,41.091420916727664,51.4875409107128,NaN,NaN,-192.11158051345,-109.26456140569348,-0.8785395287093852,-0.5160343403026673,0.36250518840671797,7169857078,7136681673.2,16.56007448693161,28.40063241247278,NaN,NaN,-4.796606517677559,6.764209096477033
2015-12-15T09:30:00-05:00,204.7,206.11,204.58,205.0308,154069569,119381000.5,46.654955277911625,50.61076445111259,NaN,NaN,-80.250102139453,-117.56492385599975,-0.7371258806537097,-0.5589021624104191,0.17822371824329053,7323926647,7152483430.8,19.06733028883788,27.403978531334197,NaN,NaN,-5.201061382989824,5.0548847422674825
2015-12-16T09:30:00-05:00,206.365,208.39,204.8,208.03,197017008,123175663.7,53.33761930214411,50.21922520685905,NaN,NaN,-17.278939407321076,-106.63338757313181,-0.4200720832807767,-0.34686638585768037,0.07320569742309635,7520943655,7240168897.4,31.387937617276663,27.29793764820992,NaN,NaN,-3.195746743818945,3.876223101397993
2015-12-17T09:30:00-05:00,208.4,208.48,204.84,204.86,173092476,125763160.3,46.681261676268015,49.305402752338736,NaN,NaN,-50.07018395075844,-104.42591349803759,-0.40229742937007523,-0.4296660892894977,-0.02736865991942246,7347851179,7270010092,35.013731572825506,27.245952705856503,NaN,NaN,-3.8756692715158083,2.7688099052674504
2015-12-18T09:30:00-05:00,202.77,202.93,199.83,200.0208,251393535,133921813.8,38.73435153507702,48.07252048554683,NaN,NaN,-193.70180682108472,-106.68252256641344,-0.6786444485367232,-0.8756742205903265,-0.19702977205360328,7096457644,7291807240.6,37.60733944473046,27.47269444864428,NaN,NaN,-7.520425901758878,1.2989190756922608
2015-12-21T09:30:00-05:00,201.41,201.88,200.09,201.67,99094290,134175952.35,42.33712102932886,46.70099904492299,NaN,NaN,-156.1747950834498,-99.4951654804134,-0.7092333690296588,-1.0835714833406769,-0.37433811431101804,7195551934,7296946211.8,38.233230557631764,27.61132062134617,NaN,NaN,-9.01652585891811,-0.17471591496636352
2015-12-22T09:30:00-05:00,202.715,203.85,201.55,203.5,111026246,136480706.05,46.12315124040593,46.16206504795458,NaN,NaN,-93.87128173779129,-102.21940140008105,-0.5710276327119894,-1.0881226552010048,-0.5170950224890154,7306578180,7293476518.4,37.95637730236903,27.87897047784123,NaN,NaN,-8.86061427238919,-1.4155585374553388
2015-12-23T09:30:00-05:00,204.69,206.07,204.58,206.02,110987228,137086349.2,50.90362877628504,46.56825214264811,NaN,NaN,-17.78128489656392,-102.31987049792961,-0.2889339731571574,-0.8782624889354622,-0.5893285157783048,7417565408,7272800869,36.27091185009489,28.274243808433216,NaN,NaN,-7.049596096130317,-2.2204210458374787
2015-12-24T09:30:00-05:00,205.72,206.33,205.42,205.68,48542150,136914453.6,50.25571441489356,46.188788048320895,NaN,NaN,-5.651223053323763,-93.43607831844267,-0.11330194620943579,-0.7309559485400996,-0.6176540023306638,7369023258,7277035284.8,36.88901236057347,28.801957574913075,NaN,NaN,-5.864212837741872,-2.740962730395249
2015-12-28T09:30:00-05:00,204.86,205.26,203.94,205.21,65899939,138343561.6,49.32115751532875,45.9828756926315,NaN,NaN,-30.609189764248107,-60.817554907075376,-0.02164298738834114,-0.6447077365660903,-0.6230647491777491,7303123319,7318368419.8,42.72819179625024,29.824823939721306,NaN,NaN,-5.208396683249905,-3.093453295088771
2015-12-29T09:30:00-05:00,206.51,207.79,206.47,207.4,92640672,137334460.2,53.6466208667422,46.336129665915855,NaN,NaN,51.05644261677391,-19.37130736703063,0.18238267958019394,-0.3950863997025067,-0.5774690792827006,7395763991,7358410831.2,47.769863532108324,31.446545981169784,NaN,NaN,-3.2925619402331607,-3.1218973872522553
2015-12-30T09:30:00-05:00,207.11,207.21,205.76,205.93,63317679,135607423.25,50.5291267280536,46.73327410722544,NaN,NaN,29.28355900015865,5.259660780559356,0.21215392312009873,-0.3122766753825772,-0.5244305985026759,7332446312,7363584457.6,48.40187809960986,33.34763856937383,NaN,NaN,-2.6457143824808385,-3.0538712437134814
2015-12-31T09:30:00-05:00,205.13,205.89,203.87,203.87,114877859,135929253.25,46.455036450416024,46.73538806932455,NaN,NaN,-26.227550152598678,3.5704077293524046,0.09300924878557482,-0.40816903752070743,-0.5011782863062823,7217568453,7323585066.6,43.97169076129508,34.969160492091156,NaN,NaN,-3.3501241785590823,-3.0961930915485674
2016-01-04T09:30:00-05:00,200.49,201.03,198.59,201.0192,222353534,138735722.25,41.47165188043723,46.96734411500138,NaN,NaN,-154.9965996480806,-26.29866758959896,-0.1639062726248901,-0.7060611270873949,-0.5421548544625048,6995214919,7248823398.8,37.13090887865568,36.35631989637074,NaN,NaN,-5.55802276470317,-3.4478830448563675
2016-01-05T09:30:00-05:00,201.4,201.9,200.05,201.36,110845849,134632320.75,42.26894607763406,47.051453055066126,NaN,NaN,-109.5690006456104,-42.09062976587143,-0.2896519243619803,-0.9042197599149802,-0.6145678355529999,7106060768,7209410888.6,34.11755410710151,37.61042558352573,NaN,NaN,-7.079283528039859,-3.966654542454009
2016-01-06T09:30:00-05:00,198.34,200.06,197.6,198.82,152112604,137136595.4,38.102855794221426,46.44058880623111,NaN,NaN,-152.90509369806057,-82.88293702883831,-0.5097767987213305,-1.251788833954663,-0.7420120352333325,6953948164,7121047723.2,28.527669612116284,38.28616410661705,NaN,NaN,-9.703158417296287,-4.786155096002906
2016-01-07T09:30:00-05:00,195.33,197.44,193.59,194.05,213436073,142639780.7,31.770070278006017,44.90004959022125,NaN,NaN,-212.19208561836163,-131.17806595254237,-0.9186689376097527,-1.8903482072455233,-0.9716792696357707,6740512091,7002660879,23.073229343413587,37.69225637276969,NaN,NaN,-14.276578891316042,-6.141929923904782
2016-01-08T09:30:00-05:00,195.19,195.85,191.58,191.923,209817228,145010565.25,29.421839037325356,43.667233687439634,NaN,NaN,-211.78678779347499,-168.28991348071764,-1.25367802148611,-2.5387767964934085,-1.2850987750072984,6530694863,6865286161,18.62350285251881,36.521525749890635,NaN,NaN,-18.82654073799996,-7.954017183061236
2016-01-11T09:30:00-05:00,193.01,193.41,189.82,192.11,187941323,148601187.2,29.912321138357427,43.037088659102515,NaN,NaN,-197.71217865393007,-176.83302928188752,-1.3742854482024316,-3.002955585260338,-1.6286701370579064,6718636186,6809970414.4,17.186251441590485,35.06287660680921,NaN,NaN,-22.228507614335165,-9.993230101814653
2016-01-12T09:30:00-05:00,193.82,194.55,191.14,193.6608,172330490,146659046.45,34.00815174258139,42.44216228147769,NaN,NaN,-144.03287280093693,-183.72580371295285,-1.2640208248180353,-3.2086961680804507,-1.9446753432624153,6890966676,6766951596,16.14286233239794,33.48499316214965,NaN,NaN,-23.814739311443788,-11.967731417475958
2016-01-13T09:30:00-05:00,194.45,194.86,188.38,188.83,221168886,148598231.9,28.433920267171388,41.17864578338951,NaN,NaN,-154.13178229482384,-183.9711414323055,-1.4192081712007867,-3.7186855572633988,-2.299477386062612,6669797790,6710121521.2,14.859433411131334,31.835211455632674,NaN,NaN,-27.140700505752907,-14.135298430086952
2016-01-14T09:30:00-05:00,189.55,193.26,187.66,191.93,240795609,152934533.9,35.7156498542943,40.09379014610446,NaN,NaN,-127.57786219525264,-167.0482967476837,-1.2232807017384237,-3.8285782632356415,-2.605297561497218,6910593399,6744137782.8,19.01007573160385,30.602294590026172,NaN,NaN,-27.479790842982965,-16.041654489072098
2016-01-15T09:30:00-05:00,186.77,188.76,185.52,187.81,324846450,159326006,31.175584274437355,38.730923707500445,NaN,NaN,-147.89754620523297,-154.2704484300353,-1.2755275382327276,-4.199706984288127,-2.9241794460554,6585746949,6755148200,20.363373924918704,29.421891844622262,NaN,NaN,-29.356631800209453,-17.943794104948864
2016-01-19T09:30:00-05:00,189.96,190.11,186.2,188.06,195244373,160433600.85,31.74258146238529,37.4753111322902,NaN,NaN,-119.70610659766591,-138.66923401878245,-1.1987959801070511,-4.422674421189214,-3.223878441082163,6780991322,6767619227.2,21.954101208746636,27.938028231229147,NaN,NaN,-30.611874148290298,-19.753519825426213
2016-01-20T09:30:00-05:00,185.03,187.495,181.02,185.65,286547840,162191316.1,29.241649079209495,35.73209886175215,NaN,NaN,-134.5637084706442,-136.7754011527239,-1.212268345254973,-4.739213872650879,-3.526945527395906,6494443482,6688314588.4,19.312311821066388,25.905345966154723,NaN,NaN,-32.470089561589845,-21.57017264487816
2016-01-21T09:30:00-05:00,186.21,188.87,184.64,186.69,195772941,167025248.65,31.740963200450665,34.39008718120908,NaN,NaN,-100.35324325908907,-126.01969334557694,-1.0586385933808429,-4.85024376912196,-3.791605175741117,6690216423,6692398315,19.847176728297583,23.86572443963242,NaN,NaN,-33.191293297083,-23.23033273805028
2016-01-22T09:30:00-05:00,189.78,190.76,188.88,190.52,168319598,169889916.25,40.12814356756463,33.93816626100541,NaN,NaN,-61.582168930437724,-112.82055469261395,-0.6278618637714839,-4.576432505455472,-3.948570641683988,6858536021,6681986839.4,19.492410162903624,22.11720439689017,NaN,NaN,-31.087210948738964,-24.352743911005806
2016-01-25T09:30:00-05:00,189.92,190.15,187.41,187.64,130371686,170859139.15,36.49663518800175,33.582807925831446,NaN,NaN,-71.96502267805609,-97.6340499871786,-0.4727423057633917,-4.539498523888227,-4.066756218124835,6728164335,6710470316.6,23.520105660098068,21.145004166993196,NaN,NaN,-30.48704765279755,-25.229073016976056
2016-01-26T09:30:00-05:00,188.42,190.53,188.02,190.2,141036757,175483869.5,41.55936841785036,33.53212380727547,NaN,NaN,-55.22107895130424,-84.73704445790625,-0.15028537959293686,-4.254612942616006,-4.10432756302307,6869201092,6728112270.6,25.98983598126226,20.564452872290392,NaN,NaN,-28.32235656333417,-25.670970666455787
2016-01-27T09:30:00-05:00,189.58,191.56,187.06,188.13,185681707,181472957.9,38.861487422352084,33.58631178071337,NaN,NaN,-58.22737594340729,-69.46977795245888,-0.03498161052262372,-4.148054576176349,-4.113072965653726,6683519385,6765927451.2,31.12405071684084,20.749908665485005,NaN,NaN,-27.39545006349589,-25.917324866032946
2016-01-28T09:30:00-05:00,189.96,190.2,187.16,189.11,143798780,184030863.3,40.82018709779961,34.23274869641291,NaN,NaN,-55.849089876955745,-60.56894727603221,0.13916176360608912,-3.939120761146114,-4.078282524752203,6827318165,6793347799.6,34.663455992415535,21.57778199755657,NaN,NaN,-26.040484099461253,-25.934919042236988
2016-01-29T09:30:00-05:00,190.02,193.88,189.88,193.7208,210529336,191391446.15,49.085009765230645,35.637260891263296,NaN,NaN,4.344147352316446,-47.383684019481386,0.5724477748230976,-3.3627228062233314,-3.935170581046429,7037847501,6829210095.6,39.07327093720892,23.03847971789158,NaN,NaN,-22.09276837897144,-25.386040376056194
2016-02-01T09:30:00-05:00,192.53,194.58,191.84,193.65,136061564,192450631.4,48.97191339122712,36.998660337896844,NaN,NaN,33.07125604787411,-26.376428274295346,0.8453723026588427,-2.8784552027228756,-3.7238275053817183,6901785937,6863934416,43.079305948847306,24.887983611267064,NaN,NaN,-19.036854335998257,-24.47901379890506
2016-02-02T09:30:00-05:00,191.96,191.97,189.54,190.16,182564890,190461199.2,43.63476482925387,37.68627555837344,NaN,NaN,-14.3249501368338,-18.19720251140126,0.7833460740895002,-2.744644912769843,-3.527990986859343,6719221047,6833938407,40.596138498393955,26.63464619455249,NaN,NaN,-18.030598919849115,-23.55781167332564
2016-02-03T09:30:00-05:00,191.41,191.78,187.1,191.3,205054934,195171653.45,45.715893907434605,38.92070224696367,NaN,NaN,-16.201575499333334,-9.792042422586466,0.8083210971933505,-2.5175896153676547,-3.3259107125610052,6924275981,6882089726.2,45.97918170539415,28.85748535842841,NaN,NaN,-16.573130163805587,-22.56000002910849
2016-02-04T09:30:00-05:00,190.71,192.75,189.96,191.6,139531794,194542612.95,46.27802902676274,39.675157902139986,NaN,NaN,39.2992484599528,9.237625244795243,0.8310684224773417,-2.287075184464328,-3.1181436069416697,7063807775,6929387648.2,50.704578946755724,31.12137844522497,NaN,NaN,-15.23307328792437,-21.51329620893933
2016-02-05T09:30:00-05:00,190.99,191.6696,187.2,187.95,180788308,192910224.7,40.74908512151985,40.35897939121731,NaN,NaN,-37.723987948969615,0.82399818453803,0.5972530724235279,-2.3715772664122596,-2.9688303388357875,6883019467,6898422041.4,47.75910259618449,33.07821620745824,NaN,NaN,-15.708769436645673,-20.684078098611664
2016-02-08T09:30:00-05:00,185.77,186.12,182.8,185.42,191526694,191995698,37.41254097688193,40.763976499395646,NaN,NaN,-166.33366322352194,-39.05698566974118,0.2850007178361813,-2.6125794415405608,-2.897580159376742,6691492773,6856363408.6,44.018799529435164,34.65426608750742,NaN,NaN,-17.150225746093028,-20.179242048251858
2016-02-09T09:30:00-05:00,183.36,186.94,183.2,185.43,184513136,191824288.65,37.434347134933354,41.34916921766163,NaN,NaN,-133.13054960566564,-62.81810556350755,0.1014016445957493,-2.7708281036320557,-2.872229748227805,6876005909,6887720381,47.33066097894713,36.65557674164176,NaN,NaN,-18.29506050112408,-19.91007325580503
2016-02-10T09:30:00-05:00,186.41,188.34,185.12,185.27,148214057,190618467,37.21095528686849,41.739882938120054,NaN,NaN,-90.01812349249472,-77.58141516213983,-0.003015595230832613,-2.875999242266346,-2.8729836470355132,6727791852,6848423555.2,43.83104934198374,38.3687104997622,NaN,NaN,-19.29420107722,-19.82209151600717
2016-02-11T09:30:00-05:00,182.34,184.1,181.09,182.86,219058885,190512966.95,33.92681368189682,41.2969308034295,NaN,NaN,-175.4024274385049,-120.52175034183135,-0.19591234206581998,-3.117874074617788,-2.921961732551968,6508732967,6737408593.6,35.781908781162514,39.53224611535212,NaN,NaN,-21.123288154343516,-20.00797675005522
2016-02-12T09:30:00-05:00,184.96,186.65,183.96,186.63,127632393,184854806.15,42.4791597766598,41.72425398833364,NaN,NaN,-73.62579052936503,-127.70211085791043,-0.03931467729524574,-2.971105079171025,-2.931790401875779,6636365360,6688077772.2,32.89141696578061,40.20162549432945,NaN,NaN,-20.209715763587745,-20.036796609131297
2016-02-16T09:30:00-05:00,188.77,189.81,187.63,189.78,120250668,174625017.05,48.479723954348245,42.218565098083495,NaN,NaN,23.409293391021293,-89.75351953500179,0.28865286002032287,-2.5709743268503757,-2.8596271868706986,6756616028,6701102423.2,34.39821935100163,40.80222430645369,NaN,NaN,-17.519629928596828,-19.677201369054945
2016-02-17T09:30:00-05:00,191.16,193.32,191.01,192.88,136009496,171663273.2,53.60879101986914,43.27194392647756,NaN,NaN,110.08263786752306,-41.11088204036405,0.7029903317668547,-1.9808892721621305,-2.683879603928985,6892625524,6704426346.2,34.80055790661433,41.06483196286608,NaN,NaN,-13.537964305593322,-18.800167502846143
2016-02-18T09:30:00-05:00,193.2,193.27,191.72,192.09,102342997,162453031.05,52.18305290274946,44.0835771982597,NaN,NaN,102.61297211919022,-2.5846629180270613,0.8998895808047442,-1.5590176279230548,-2.458907208727799,6790282527,6716924481.2,36.380514364762995,41.18747898946232,NaN,NaN,-10.764029232986202,-17.652147750009007
2016-02-19T09:30:00-05:00,191.17,192.18,190.45,192,114792988,158404033.4,52.01333854716407,44.29274353982637,NaN,NaN,71.36185250296245,46.768193070266406,0.9928023146208753,-1.2179043154517046,-2.21070663007258,6675489539,6750275795.6,40.52248022881759,41.29099393886295,NaN,NaN,-8.585823029320128,-16.35695850419631
2016-02-22T09:30:00-05:00,193.87,194.95,193.79,194.78,103640292,155170068.1,56.69805655821092,44.84461090889664,NaN,NaN,138.75927651695656,89.24520647953072,1.1965615740703135,-0.715004662484688,-1.9115662365550015,6779129831,6778828689.8,43.89049995058294,41.34893636755835,NaN,NaN,-5.251349066711493,-14.770442870269907
2016-02-23T09:30:00-05:00,194,194.32,192.18,192.32,111455289,154224248.25,51.87221858854198,45.433000463131506,NaN,NaN,86.63974546980913,101.89129689528829,1.1219841269847488,-0.5090860778240653,-1.6310702048088142,6667674542,6761040392.6,42.284049721444006,41.46950145491907,NaN,NaN,-3.8182080235626357,-13.20583789216887
2016-02-24T09:30:00-05:00,190.63,193.53,189.32,193.2,150812152,154713018,53.40020951670308,45.98188014950783,NaN,NaN,57.25283608405788,91.32533653859524,1.087453865902233,-0.27175287243102275,-1.3592067383332558,6818486694,6746212626.6,40.9389350240324,41.109483834821795,NaN,NaN,-2.1883371275535968,-11.631909211509544
2016-02-25T09:30:00-05:00,193.73,195.55,192.83,195.54,110728317,150965348.5,57.28381627445451,46.768007810057235,NaN,NaN,109.01857045823874,92.60645620640494,1.1705298003521416,0.10395551210692133,-1.0665742882452203,6929215011,6773999123.4,44.50183879799796,40.66643096705339,NaN,NaN,0.3919384233585321,-9.914216692242677
2016-02-26T09:30:00-05:00,196.57,196.68,194.9,195.0892,129833663,150267092.65,56.3101928102617,47.87951550211022,NaN,NaN,116.63565346568299,101.66121639894905,1.1421938316196016,0.3611680012792817,-0.7810258303403199,6799381348,6798777485.2,47.54095083778383,40.6508486985962,NaN,NaN,2.2260623469991803,-8.179891115208125
2016-02-29T09:30:00-05:00,195.11,196.23,193.33,193.56,125918102,146036530.95,53.018269548765424,48.994210400101906,NaN,NaN,85.99324413690704,91.10800992293916,0.974088199238208,0.43658441870744014,-0.5375037805307679,6673463246,6777644168.2,45.26426377920791,40.73981043072282,NaN,NaN,2.860791255002706,-6.602650776606578
2016-03-01T09:30:00-05:00,195.01,198.21,194.4542,198.11,141799687,146323437.1,60.430588091373316,50.63679903984762,NaN,NaN,131.31906008654,100.04387284628532,1.1129302223373867,0.8536589973909656,-0.25927122494642113,6815262933,6807161846.4,48.942141455243025,40.85491617902967,NaN,NaN,5.774195173664609,-4.834529926567837
2016-03-02T09:30:00-05:00,197.74,199.06,197.25,199,102414960,142315940.6,61.703355603986815,52.38625620535607,NaN,NaN,140.88304206457772,116.76991404238929,1.200773518379086,1.2416956730274364,0.04092215464835042,6917677893,6827000086.2,51.31008299544738,41.38913286856279,NaN,NaN,8.536936592856884,-2.924320423792877
2016-03-03T09:30:00-05:00,198.79,199.795,198.11,199.775,95172197,136821803.75,62.82470333316364,54.45039118044656,NaN,NaN,138.17717736928725,122.601635424599,1.2419710724991027,1.5933859952722287,0.3514149227731261,7012850090,6843727102,53.27766540235663,42.638829770076654,NaN,NaN,11.14188331764718,-0.9148627464442978
2016-03-04T09:30:00-05:00,200.01,201.35,199.03,200.43,129293601,136309894.1,63.78972202483436,55.97257419817331,NaN,NaN,136.40940216588555,126.55638516463951,1.2412835124408312,1.9030193133241653,0.661735800883334,7142143691,6912279570.6,60.34949702793074,44.60012120308738,NaN,NaN,13.579768035785126,1.1557987938741912
2016-03-07T09:30:00-05:00,199.34,201.07,199.25,200.59,100218998,132281428.6,64.03531779092557,57.08368804364312,NaN,NaN,122.81960669773693,133.9216576768055,1.179960337499086,2.1366862227571914,0.9567258852581054,7242362689,7026059459.2,68.79244648908048,47.056851712950156,NaN,NaN,15.661093299639278,3.2279837232692032
2016-03-08T09:30:00-05:00,199.32,199.92,198.21,198.4,123974866,128903837.2,58.215170127122434,57.41271512273264,NaN,NaN,91.36420539079309,125.93068673765613,0.9311857177555027,2.120708032452484,1.189522314696981,7118387823,7086684437.2,72.19035517938748,49.72755151814824,NaN,NaN,15.898901603980908,5.0381148490851615
2016-03-09T09:30:00-05:00,199.36,199.79,198.43,199.38,94801213,124418241.05,59.968574687524324,57.96882382164513,NaN,NaN,89.43605460917406,115.64128924657538,0.7781409742873553,2.1621985325561752,1.38405755826882,7213189036,7145786665.8,75.0431980941311,52.48917178453168,NaN,NaN,16.582350494531372,6.687291369863192
2016-03-10T09:30:00-05:00,199.96,201.07,197.38,199.54,156838697,124849473.05,60.26176569776443,58.55799718954516,NaN,NaN,85.43462607001027,105.09277898671999,0.6390166960071739,2.1828284282777872,1.5438117322706133,7370027733,7217222194.4,77.98310498969067,55.164930696022616,NaN,NaN,17.228417978660573,8.19316659969139
2016-03-11T09:30:00-05:00,201.26,202.81,201.12,202.76,137964528,120794755.2,65.70547538334378,59.201384248483215,NaN,NaN,126.96052321888399,103.20300319731969,0.7097362231540831,2.430982011213217,1.721245788059134,7507992261,7290391908.4,80.51500588406897,57.780966834128755,NaN,NaN,19.398052209315956,9.79386454392347
2016-03-14T09:30:00-04:00,202.16,203.04,201.77,202.5,73611974,118093734.25,64.93199853344231,60.134225673118955,NaN,NaN,120.0982142125322,102.65872470027875,0.6845714452181837,2.576960094581864,1.8923886493636801,7434380287,7328795428,81.70423506373129,60.59669435857785,NaN,NaN,20.973277982668176,11.390923606601286
2016-03-15T09:30:00-04:00,201.36,202.2,201.05,202.17,93169090,116739655.35,63.90375168065095,60.88447868482952,NaN,NaN,99.54461132543214,104.29480588720655,0.5945999084208107,2.6356385348896936,2.041038626468883,7341211197,7373360102.8,83.00081077792831,63.6011140552847,NaN,NaN,22.018153457898116,12.909099299643689
2016-03-16T09:30:00-04:00,201.6,203.82,201.55,203.34,129303179,116404339.5,65.96182789672005,61.5043366578485,NaN,NaN,110.75387897638703,108.55837076064915,0.5630964895744737,2.744909238436975,2.181812748862501,7470514376,7424825170.8,84.37769934883123,66.44938980891564,NaN,NaN,23.484653213879323,14.419892715963066
2016-03-17T09:30:00-04:00,203.24,205.23,202.77,204.63,134278505,118001114.9,68.12009382456553,62.347901016013054,NaN,NaN,126.9006264738288,116.85157084141285,0.5762659244726906,2.9021451544533647,2.325879229980674,7604792881,7471778200.4,85.52928520763086,69.16284226390472,NaN,NaN,25.360357197874556,15.982816213378992
2016-03-18T09:30:00-04:00,204.17,204.78,203.8,204.38,138372404,119180085.7,67.2304023743506,63.36305336069771,NaN,NaN,122.74426165314114,116.0083185282643,0.5171524462144794,2.9723197877487735,2.455167341534294,7466420477,7463463843.6,84.34364365478486,71.95422654073164,NaN,NaN,26.701267566081437,17.51402354947934
2016-03-21T09:30:00-04:00,204.07,204.94,203.8,204.67,72926659,117644404.05,67.75647936605213,63.886331308889055,NaN,NaN,116.36913298053776,115.26250228186541,0.449115107980695,3.016561226510163,2.567446118529468,7539347136,7484457213.4,84.91236296970823,74.52352807747914,NaN,NaN,27.976205747494088,19.00862100633859
2016-03-22T09:30:00-04:00,203.76,205.23,203.57,204.56,97471939,116945236.55,67.31504139487974,64.28716600823854,NaN,NaN,105.47355313329298,116.44829064343757,0.3525004071898987,3.0080716275168413,2.6555712203269426,7441875197,7504590013.4,85.45792043596099,76.96265932323013,NaN,NaN,28.950561405877746,20.428898206272756
2016-03-23T09:30:00-04:00,204.11,204.33,203.01,203.2092,81052455,113457251.7,61.975296393846364,64.22649408400159,NaN,NaN,77.64475403325274,109.82646565481073,0.1630502944510952,2.8593840883908115,2.6963337939397163,7360822742,7482651686.6,81.97929659176648,79.0127758367594,NaN,NaN,28.45100920331074,21.574914062992466
2016-03-24T09:30:00-04:00,202,203.16,201.74,203.12,84360853,112138878.5,61.62764620700954,64.0720600970141,NaN,NaN,50.0870554425035,94.46375144854565,0.005484772054955123,2.70318975900841,2.697704986953455,7276461889,7416985488.2,72.47023084505372,79.87854253798248,NaN,NaN,27.93892969368231,22.484059153091014
2016-03-28T09:30:00-04:00,203.61,203.86,202.705,203.24,62408185,108767604.6,61.93698056948916,63.92217886691151,NaN,NaN,59.73960453834821,81.86282002558707,-0.11049810740717092,2.559582352694491,2.670080460101662,7338870074,7391475407.6,69.11619187843853,79.9016672086509,NaN,NaN,27.573261344998883,23.21108803764928
2016-03-29T09:30:00-04:00,202.76,205.25,202.4,205.1208,92922863,107117842.65,66.49582440849223,64.51365417272366,NaN,NaN,83.84231352405679,75.35745613429084,-0.08171578768553056,2.567935725494749,2.6496515131802796,7431792937,7369964567.8,66.32853644365812,79.48296587038452,NaN,NaN,28.409474311222056,23.953714648159675
2016-03-30T09:30:00-04:00,206.3,206.87,205.59,206.02,86365310,104346123.8,68.44190416654268,65.11889199265353,NaN,NaN,138.19881082557913,81.90250767274807,-0.02616343443766489,2.6169472201331985,2.6431106545708634,7518158247,7385221177.8,67.3348409777139,78.93236893349756,NaN,NaN,29.662889652403358,24.769311077337345
2016-03-31T09:30:00-04:00,205.91,206.41,205.33,205.52,94584110,103954581.3,66.14134651594237,65.53886205109481,NaN,NaN,116.71742823888111,89.71704251387374,-0.0459783324047649,2.5856377390649072,2.631616071469672,7423574137,7397771456.8,68.17736745713972,78.23195910974393,NaN,NaN,30.13403964365394,25.53570087252543
2016-04-01T09:30:00-04:00,204.35,207.14,203.98,206.92,114423478,104917145.35,69.25733122457666,65.7925660397543,NaN,NaN,116.33164646523176,102.96596071841938,0.009365121540480636,2.6433224733952727,2.633957351854792,7537997615,7450078602,71.47918475416125,77.58654331475053,NaN,NaN,31.41179798785485,26.37514331757249
2016-04-04T09:30:00-04:00,206.83,207.07,205.89,206.25,63496969,101627313.75,66.12117527976798,65.87750723592043,NaN,NaN,118.54753708284797,114.72754722731933,-0.023208730010300993,2.6049464393419157,2.6281551693522167,7474500646,7477204716.4,73.04134781542109,76.96776565415693,NaN,NaN,31.651712751144938,27.128938950939983
2016-04-05T09:30:00-04:00,204.67,206.2642,203.89,204.1892,99662158,101599471.75,57.496909613026276,65.41987565966153,NaN,NaN,54.55178863670209,108.8694422498484,-0.19788457972798978,2.3807994446922294,2.578684024420219,7374838488,7465813826.6,71.2758722370849,76.1302700440967,NaN,NaN,29.310358885256978,27.440570370128125
2016-04-06T09:30:00-04:00,204.29,206.49,203.98,206.42,91839761,99992716.5,63.10660923685742,65.21593146967133,NaN,NaN,81.55138816285442,97.53995771730347,-0.17813950721815086,2.356009640397531,2.5341491476156817,7466678249,7455517827,69.6374296838258,75.07739363945346,NaN,NaN,28.915728027225196,27.65130717828485
2016-04-07T09:30:00-04:00,205.14,205.56,203.09,203.95,113859037,100945607.7,54.52556272880601,64.24489353425994,NaN,NaN,12.932134153034788,76.7828989001342,-0.3371582946466014,2.11270127930743,2.4498595739540314,7352819212,7441366842,67.34601639786938,73.7785887244705,NaN,NaN,25.677958021595376,27.36940015590064
2016-04-08T09:30:00-04:00,205.34,205.85,203.87,204.4992,95040598,97855702.75,55.95951840708408,63.439830393740905,NaN,NaN,33.05774783925032,60.12811917493791,-0.40644003609791257,1.9418095288316408,2.3482495649295534,7447859810,7423339281,64.4370972613504,72.35669255351088,NaN,NaN,23.537312345745832,26.821959040164238
2016-04-11T09:30:00-04:00,205.25,206.07,203.91,204.0201,83757486,95145350.65,54.34945163694872,62.48218555594781,NaN,NaN,22.83263486867375,40.98513873210307,-0.48054181690379805,1.7475722937998057,2.2281141107036038,7364102324,7401259616.6,60.96387573695609,70.64608632260003,NaN,NaN,21.303608811795442,26.03362329325441
2016-04-12T09:30:00-04:00,204.22,206.25,203.7,205.92,115350567,97232280.3,59.344897268076856,61.91288954689045,NaN,NaN,59.28770361133104,41.93232172702886,-0.40086269297363764,1.7270357444865567,2.1278984374601944,7479452891,7422182497.2,62.999145414698404,69.04188810679555,NaN,NaN,20.906217662512866,25.30113677457705
2016-04-13T09:30:00-04:00,207,208.1,206.84,208.0008,96336433,97390647.45,63.992277161845394,62.05695960174753,NaN,NaN,201.28955353268097,65.87995480099417,-0.2165153259779955,1.8572542799876999,2.0737696059656954,7575789324,7444004712.2,65.04612110345722,67.83237557191633,NaN,NaN,22.084736795400755,24.84165106326615
2016-04-14T09:30:00-04:00,208.07,208.6,207.6,208.01,65212883,94186132.65,64.01186536592125,62.227260970241225,NaN,NaN,188.62954218227875,101.01943640684297,-0.1079389157274262,1.9388459613064128,2.046784877033839,7641002207,7501641311.2,69.79852443045368,67.6415393994449,NaN,NaN,23.01500627918984,24.580701808398103
2016-04-15T09:30:00-04:00,208.01,208.1721,207.4,207.78,75761615,91260288.15,63.08787057315298,62.30946739907436,NaN,NaN,144.40292334189058,123.28847150737104,-0.06756519863908661,1.9623283787349806,2.029893577374067,7565240592,7525117467.6,71.49833851331718,67.81169273050764,NaN,NaN,23.501272916009782,24.426497680914057
2016-04-18T09:30:00-04:00,207.14,209.28,207,209.2392,82530960,88468215.95,66.40147679978804,62.3027282841669,NaN,NaN,155.7029607565492,149.86253668494612,0.0358987271922282,2.0747669863643523,2.038868259172124,7647771552,7581851313.2,75.13981513731926,68.44106978005489,NaN,NaN,24.920630534489728,24.497088088567725
2016-04-19T09:30:00-04:00,209.74,210.2,208.94,209.9,88316060,89237686,67.81071070169953,62.25764303667811,NaN,NaN,178.66534452040605,173.73806486676114,0.1224487803922516,2.191929234662439,2.0694804542701872,7736087612,7633178257.4,77.891814440664,69.19513931312274,NaN,NaN,26.522924102701978,24.786493233444048
2016-04-20T09:30:00-04:00,209.95,210.92,209.39,210.1,81100314,88419104.75,68.24484270941709,62.40789276478345,NaN,NaN,166.07156687041717,166.69446753430836,0.16417418407064943,2.274698184358499,2.1105240002878496,7817187926,7681457977.8,80.12098292028723,70.04825470334757,NaN,NaN,27.964060498106345,25.24043141411009
2016-04-21T09:30:00-04:00,210.12,210.25,208.65,208.97,85695041,88651234.05,63.06923762164293,61.96588607885961,NaN,NaN,115.6579524084297,152.10014957953857,0.0903653721658686,2.2234807154951852,2.1331153433293166,7731492885,7699556113.4,80.89850189607608,70.72106307062721,NaN,NaN,27.752931055205256,25.599359934266545
2016-04-22T09:30:00-04:00,208.55,209.29,207.91,208.97,99251724,89395777.6,63.06923762164292,61.74789053185068,NaN,NaN,83.09103646220372,139.8377722036012,0.019919131238355092,2.1580142573772605,2.1380951261389054,7731492885,7732806572,82.27052214469617,71.38028980843256,NaN,NaN,27.579701962786928,25.882265938340886
2016-04-25T09:30:00-04:00,208.26,208.66,207.54,208.61,66166494,89583693.05,61.35014101405147,62.02312134620962,NaN,NaN,57.962099318104514,120.28959991591225,-0.06774636569178805,2.0534121690241705,2.1211585347159585,7665326391,7736317539.8,82.41416038939903,72.17588181931214,NaN,NaN,26.973579853787033,26.038167926261764
2016-04-26T09:30:00-04:00,209.04,209.52,208.36,208.9192,75864174,88730758.6,62.30061158539148,61.965550085390625,NaN,NaN,75.80853007291894,99.71823702641481,-0.11874780018463182,1.9727237844851686,2.0914715846698004,7741190565,7737338130.4,82.45864876915122,73.09168318254967,NaN,NaN,26.701066627367137,26.13286774070539
2016-04-27T09:30:00-04:00,208.47,209.81,208.05,209.35,77329437,88278964.95,63.642170061826604,62.61673632346352,NaN,NaN,73.54831933180594,81.21358751869259,-0.13606445299368186,1.9213910184276983,2.05745547142138,7818520002,7737604545.6,82.47111484874837,74.17204735761246,NaN,NaN,26.809521891531183,26.22953261939479
2016-04-28T09:30:00-04:00,208.46,209.76,206.96,207.4475,97216169,88410567.9,54.43026586608725,62.50750399910661,NaN,NaN,30.515867369181997,64.18517051084305,-0.27995600624569983,1.7075104636142555,1.9874664698599553,7721303833,7735566735.2,81.99113477669309,75.42590718013695,NaN,NaN,24.284237700352538,25.951633345245895
2016-04-29T09:30:00-04:00,206.72,207.13,205.03,206.3308,142424137,89810600.85,49.86759260214571,62.18737121090639,NaN,NaN,-45.88125736099613,38.390711746203074,-0.44485322534562965,1.4313999381779183,1.876253163523548,7578879696,7705044097.4,74.9545442223723,76.42524064338095,NaN,NaN,20.712883283188106,25.20324047923764
2016-05-02T09:30:00-04:00,206.92,208.18,206.41,207.97,62188015,89745153.15,55.733488183466555,61.92941341914851,NaN,NaN,6.741049876734159,28.14650185792899,-0.43738319394648584,1.3295241710904406,1.7669073650369265,7641067711,7700192361.4,73.86932052241337,77.20168172250344,NaN,NaN,19.27798312374461,24.356775142738634
2016-05-03T09:30:00-04:00,206.52,206.8,205.28,206.1592,106422142,90083152.35,48.92336025992945,60.8530622118688,NaN,NaN,-58.94588712980382,1.1956184173844377,-0.5414423560310508,1.090104419998113,1.6315467760291638,7534645569,7658883362.2,65.21204363534804,77.21353333192421,NaN,NaN,15.796094233810928,23.133820727177532
2016-05-04T09:30:00-04:00,204.99,205.85,204.42,205.01,92243810,90103354.8,45.15257835216493,59.50597028231478,NaN,NaN,-98.79154243815671,-33.27235393660809,-0.6664950796519484,0.7984279264642282,1.4649230061161767,7442401759,7583659713.6,53.02513875177258,76.01543435487557,NaN,NaN,11.642947385659582,21.492267392674968
2016-05-05T09:30:00-04:00,205.56,205.98,204.47,204.97,67619222,87791364.05,45.0225033527561,58.21558690942929,NaN,NaN,-102.8500338725975,-59.94553418496399,-0.7258450607077038,0.557616680231547,1.2834617409392508,7374782537,7514355454.4,44.73111057122392,74.1034895018689,NaN,NaN,8.317305953364992,19.610130044202116
2016-05-06T09:30:00-04:00,204.06,205.77,203.88,205.72,89315004,87505084.35,48.04472874216973,56.904390619599404,NaN,NaN,-106.22523916481123,-72.014330545727,-0.6888323093864688,0.4224213542061648,1.1112536635926336,7464097541,7491399023.4,42.36714050149563,71.76258417073865,NaN,NaN,6.408153461611836,17.72413338954636
2016-05-09T09:30:00-04:00,205.57,206.4,205.36,205.8892,74374922,87035956.15,48.72948085759133,55.541445630734536,NaN,NaN,-78.70512574392737,-89.10356566985931,-0.6288568448283959,0.3251826075571387,0.9540394523855346,7538472463,7470879973.8,40.31621628116166,69.07861287363134,NaN,NaN,5.041154818164782,15.91227930792042
2016-05-10T09:30:00-04:00,206.72,208.5,206.64,208.45,77472207,85142038.15,57.795601035307435,54.79507122544099,NaN,NaN,11.23398745527367,-75.06759075284381,-0.4035731926916962,0.4495729615209143,0.8531461542126105,7615944670,7487139794,42.683986836834826,66.40454172481331,NaN,NaN,6.6328624816345005,14.586648332736717
2016-05-11T09:30:00-04:00,207.91,208.54,206.5,206.5,81726989,84411565.95,50.47607489133995,53.895559601847914,NaN,NaN,-23.269680239599978,-59.96321831313247,-0.37343620544917333,0.3863508974011438,0.7597871028503171,7534217681,7505502978.4,45.322207862476176,63.863377865270465,NaN,NaN,5.606499555389577,13.30376993597284
2016-05-12T09:30:00-04:00,207.29,207.4899,205.37,206.56,89586308,85630237.2,50.68303462155074,53.01083081612705,NaN,NaN,-53.974703324310674,-50.1881522034751,-0.33806855688933923,0.3372014067386431,0.6752699636279823,7623803989,7555307268.8,51.80208668604029,61.687061046795044,NaN,NaN,4.869187363684388,12.09882956850306
2016-05-13T09:30:00-04:00,206.21,206.86,204.38,204.76,96474630,86665887.95,44.654130628892524,51.81825864575855,NaN,NaN,-97.12470493407513,-48.36804535732788,-0.4192067898058208,0.1512614763707063,0.5704682661765271,7527329359,7567953632.4,53.315009528942895,59.60855027104817,NaN,NaN,2.2636273280933863,10.693800677015965
2016-05-16T09:30:00-04:00,204.96,207.34,204.89,206.78,77486827,86413681.3,51.61060931863382,51.054687055275856,NaN,NaN,-45.507047329177496,-41.72842967437791,-0.3243763190393289,0.164997867377366,0.4893741864166949,7604816186,7581222377,54.91411815633571,57.64108379870421,NaN,NaN,2.3422145905874516,9.50071695038332
2016-05-17T09:30:00-04:00,206.46,206.8,204.23,204.8508,114924940,87744125.3,45.7024247405835,49.77327667518706,NaN,NaN,-85.55545546354232,-61.086318258141105,-0.3755126425652049,0.019983383210188777,0.39549602577539367,7489891246,7556011692.2,51.31741222404416,55.415819325511045,NaN,NaN,0.3662430996341336,8.195792114562007
2016-05-18T09:30:00-04:00,204.44,206.3,203.63,204.91,123493379,89863778.55,45.90706203027951,49.16447640120081,NaN,NaN,-94.4219431456899,-75.3167708393591,-0.3877065623229724,-0.08913717712832181,0.2985693851946506,7613384625,7571845081,53.38252412372672,53.37234713601345,NaN,NaN,-1.088837064622006,6.869416517535719
2016-05-19T09:30:00-04:00,204.06,204.54,202.78,204.2,115430507,91350551.85,43.776160727694375,48.729374124454274,NaN,NaN,-138.87446937168247,-92.29672404883345,-0.423057797743454,-0.23025286198466688,0.1928049357587871,7497954118,7546675106.8,49.76829040264863,51.57332900603319,NaN,NaN,-2.944961913202536,5.467362456001683
2016-05-20T09:30:00-04:00,204.92,206.1,204.86,205.49,104990408,91637486.05,48.45745299100254,48.20965732499256,NaN,NaN,-50.594960083858794,-82.99077507879018,-0.34247085788150605,-0.23528363659309548,0.10718722128841057,7602944526,7561798140.2,51.87650638382568,50.00241371041978,NaN,NaN,-3.0543390292445602,4.249976529537934
2016-05-23T09:30:00-04:00,205.51,205.84,204.985,205.21,58682576,91263290.15,47.53235530032887,48.11029982787823,NaN,NaN,-53.52768092845512,-84.59490179864571,-0.2928537882332742,-0.25888001400318217,0.03397377423009203,7544261950,7549687293,50.06438886979047,48.92043837002281,NaN,NaN,-3.4181770454429965,3.154526018826372
2016-05-24T09:30:00-04:00,206.17,208.24,206.14,207.87,93537808,92146971.85,56.10558678271676,48.89265757291764,NaN,NaN,78.69267348320693,-51.745276009295864,-0.07695763738266873,-0.06222327249824389,0.014734364884424842,7637799758,7579268995.4,54.26664058831708,49.009117072633124,NaN,NaN,-0.9285401199961956,2.5712308561374337
2016-05-25T09:30:00-04:00,208.67,209.77,207.8691,209.28,79221525,92241576.25,59.85060666696453,49.951807809646816,NaN,NaN,179.19821988059846,2.9787565959618063,0.1522447094758667,0.20504025172925822,0.05279554225339152,7717021283,7599996327,56.99732837032161,49.88527548685439,NaN,NaN,2.410306280414636,2.548241631034177
2016-05-26T09:30:00-04:00,209.44,209.71,208.97,209.34,55280699,90144802.75,60.00697397768709,50.80625389789806,NaN,NaN,184.9060431920539,67.73485910870906,0.29127111380439646,0.4168844345088871,0.12561332070449066,7772301982,7654865899.8,63.25250465162165,51.3770872118634,NaN,NaN,5.07786232692254,2.909616016161086
2016-05-27T09:30:00-04:00,209.53,210.25,209.47,210.24,64211214,86234156.6,62.374143276069155,51.780872642075046,NaN,NaN,178.2505786856826,113.50396686261733,0.41943196232867686,0.6499032736153367,0.23047131128665987,7836513196,7701579633.8,67.57664476600519,53.324260675066505,NaN,NaN,8.04738767143276,3.643583395485611
2016-05-31T09:30:00-04:00,210.56,210.69,209.18,209.84,109879380,88618724.85,60.65576296124444,51.98516992249911,NaN,NaN,150.96344134257623,154.4021913168236,0.4501451542727667,0.7931527541276182,0.3430075998548515,7726633816,7738054007,70.49596272951914,55.310830381686806,NaN,NaN,9.98780168490222,4.549900293973698
2016-06-01T09:30:00-04:00,209.12,210.48,208.89,210.27,69936215,86794428.5,61.87181992519083,52.799151710631314,NaN,NaN,125.9652467679971,163.85670597378166,0.47011269578142006,0.9306484695816266,0.46053577380020655,7796570031,7769808061.6,72.79266881652364,57.273006164118776,NaN,NaN,11.953709387476492,5.60758730733124
2016-06-02T09:30:00-04:00,209.8,210.93,209.2399,210.91,63044749,85334475.45,63.67158351226922,53.72690520282549,NaN,NaN,125.24775344644429,153.0666126869508,0.4946285677283496,1.0788214834606435,0.5841929157322939,7859614780,7798326761,74.69768815691374,58.908406269181164,NaN,NaN,14.140240611658713,6.826537779378022
2016-06-03T09:30:00-04:00,210.25,210.69,208.86,210.28,101757126,87041370.65,60.637311034606824,54.8685609460908,NaN,NaN,97.44353680946206,135.57411141043247,0.4385342909527774,1.1323607794232657,0.6938264884704883,7757857654,7795437895.4,74.13145114576366,60.39529495609694,NaN,NaN,15.16851325162018,8.018248561126901
2016-06-06T09:30:00-04:00,210.7,211.77,210.51,211.35,64887045,85819972.7,63.79323520336294,55.73874850928574,NaN,NaN,125.05597597022738,124.9351908673414,0.44234620945061653,1.246759250283759,0.8044130408331425,7822744699,7792684196,73.55904923458849,61.727075747400704,NaN,NaN,16.97812710315229,9.298231209987671
2016-06-07T09:30:00-04:00,211.525,212.34,211.5,211.68,60974761,85149964.65,64.73238051073932,57.098031064296876,NaN,NaN,127.81057669811065,120.30461793844829,0.43527307578953933,1.3485043855700667,0.9132313097805274,7883719460,7824101324.8,75.85016670331481,63.47941535306289,NaN,NaN,18.75436329645483,10.649107222340122
2016-06-08T09:30:00-04:00,211.84,212.52,211.6899,212.37,66170920,84584900.3,66.67857598908344,58.581710632782865,NaN,NaN,119.74174877774719,119.05991834039833,0.44373047125603815,1.467894398850575,1.024163927594537,7949890380,7854765394.6,77.86610025646026,65.22824221968672,NaN,NaN,20.83389287255932,12.104076600942864
2016-06-09T09:30:00-04:00,211.51,212.22,211.19,212.08,73786869,84187894.3,65.05371575161266,60.10153599163417,NaN,NaN,97.34760363907786,113.47988837892504,0.3979260888150571,1.5215715386133581,1.123645449798301,7876103511,7858063140.8,78.07804056536213,67.25036723130911,NaN,NaN,22.150091681866154,13.539221612503335
2016-06-10T09:30:00-04:00,210.46,210.86,209.43,210.07,113829158,85400036.8,55.042036419699386,60.57186337939823,NaN,NaN,45.906611203156736,103.17250325766398,0.20983928080774095,1.3859445508079773,1.1761052700002363,7762274353,7858946480.6,78.1384260150569,69.1262186335399,NaN,NaN,20.418358808251373,14.521955497610197
2016-06-13T09:30:00-04:00,209.36,210.37,208.35,208.4492,117751153,86463862.95,48.55314847339812,60.64477717747461,NaN,NaN,11.867810932977248,80.53487025021394,-0.03320800521070266,1.1345952634868581,1.1678032686975608,7644523200,7823302180.8,69.78504534941275,70.53483695351292,NaN,NaN,16.820095695939617,14.850261240228685
2016-06-14T09:30:00-04:00,208,208.74,206.9199,208.04,125059286,88842485.9,47.04521521063272,59.9976077794686,NaN,NaN,-26.795328824639792,49.613689145663855,-0.22056534449280285,0.8920965880815572,1.11266193257436,7519463914,7750451071.6,56.492226909597385,70.69380740503296,NaN,NaN,13.42122179402378,14.646112747913698
2016-06-15T09:30:00-04:00,208.54,209.36,207.53,207.75,109124496,88552463.7,45.95590125482443,59.0051288214586,NaN,NaN,-23.611947087305776,20.94294997265326,-0.35508594417265593,0.6688045023585403,1.0238904465311962,7410339418,7642540879.2,43.327093928811834,69.71736208778225,NaN,NaN,10.309540583674853,14.02660243873672
2016-06-16T09:30:00-04:00,206.73,208.57,205.59,208.37,149533065,89854448,48.691218383342516,58.1968605647197,NaN,NaN,-57.561187364598254,-10.038808228081969,-0.3905543202002708,0.5356975462808578,0.9262518664811286,7559872483,7579294673.6,37.77119905908209,67.89726883117228,NaN,NaN,8.439417233165177,13.228433123655071
2016-06-17T09:30:00-04:00,207.17,207.2,205.75,206.52,117055748,89935710.05,41.87991910957507,56.73298740997012,NaN,NaN,-111.1012483165219,-41.440380132017694,-0.518818847855895,0.2777283066612597,0.7965471545171547,7442816735,7515403150,33.147040940581604,65.43801141507059,NaN,NaN,4.592220589708275,11.994688475948386
2016-06-20T09:30:00-04:00,208.82,209.61,207.75,207.85,82789603,88825669.8,47.55943452708836,55.79753537895897,NaN,NaN,-41.447259691562294,-52.103394256925604,-0.4943997030642988,0.17854752568678123,0.67294722875108,7525606338,7491619777.6,31.59635529216449,62.65946802668811,NaN,NaN,3.0435279759707647,10.71595126166587
2016-06-21T09:30:00-04:00,208.3,208.92,207.78,208.44,72461663,89514624.15,49.89838925210632,54.94229033088151,NaN,NaN,-55.63228215005141,-57.87078492200792,-0.4216597165727386,0.14587258303515682,0.5675322996078954,7598068001,7507340595,33.800892866092894,59.87434117308592,NaN,NaN,2.490731622050539,9.540919884577965
2016-06-22T09:30:00-04:00,208.65,209.5,207.93,208.1,95560471,89615757.3,48.55440351091985,53.86249175935655,NaN,NaN,-54.014521710899906,-63.95129984672675,-0.3808356924863273,0.0914876839999863,0.4723233764863136,7502507530,7525774217.4,36.389621282887944,57.13805068208408,NaN,NaN,1.641054192222233,8.41236764281286
2016-06-23T09:30:00-04:00,209.81,210.87,209.27,210.81,102731356,90791248.85,58.21499377999585,53.689469098312905,NaN,NaN,40.43847615794369,-44.351367142218365,-0.16664416189939724,0.26401817411206707,0.4306623360114643,7605238886,7534847498,37.681406588140575,54.534476070825285,NaN,NaN,4.056426159012721,7.7900902879842695
2016-06-24T09:30:00-04:00,203.63,206.905,202.72,203.13,333444400,104699433.9,37.00649209640618,51.77613030495886,NaN,NaN,-223.25562698337419,-66.78224287558882,-0.5177032222047263,-0.21646669174444355,0.30123653046028276,7271794486,7500643048.2,34.81137616098772,51.76678513699666,NaN,NaN,-2.6972782074469035,6.291894788636959
2016-06-27T09:30:00-04:00,201.59,201.6,198.65,199.6,248988660,113938306.2,31.35260719936609,49.39186078271791,NaN,NaN,-299.79321928726995,-118.45143479473036,-0.9386240509114796,-0.8720435331790668,0.06658051773241286,7022805826,7400082945.8,28.047679619758085,48.352321773885464,NaN,NaN,-10.529889873099226,3.888782694103219
2016-06-28T09:30:00-04:00,201.48,203.23,201.12,203.1997,159382399,116413457.15,41.215574775167894,47.57307498172395,NaN,NaN,-176.5716823845184,-142.63931484162376,-0.9241274054284825,-1.0885787390531902,-0.16445133362470776,7182188225,7316906990.6,23.909655527021428,44.498290007496976,NaN,NaN,-12.188928072486545,1.5919668703046814
2016-06-29T09:30:00-04:00,204.84,206.93,204.72,206.66,137328614,119783077.1,48.82685626475262,46.41401358980538,NaN,NaN,-62.082580947495074,-144.25292668894278,-0.6442693697198054,-0.9697880457744645,-0.3255186760546591,7319516839,7280308852.4,22.347343215718823,40.51752591109388,NaN,NaN,-10.108741744807483,-0.07956293185419905
2016-06-30T09:30:00-04:00,207.21,209.54,206.56,209.475,165021948,124881937.05,54.040271232911365,46.34245893360624,NaN,NaN,10.75965584740919,-150.1886907510497,-0.25247169444307715,-0.6411082941085056,-0.3886365996654284,7484538787,7256168832.6,21.356100945853242,36.461645549007905,NaN,NaN,-6.327398797739681,-0.9721109126949821
2016-07-01T09:30:00-04:00,209.36,210.49,209.29,209.9208,106055333,125096847.4,54.82518674289101,46.79046166714145,NaN,NaN,51.751641809688856,-95.18723699243708,0.03832752167533898,-0.3407271975712547,-0.3790547192465937,7590594120,7319928759.4,30.16680651573097,33.63177134660206,NaN,NaN,-3.322243176996599,-1.3078440933094988
2016-07-05T09:30:00-04:00,208.95,209.08,207.71,208.41,109803713,127342680.8,51.60843364888417,47.11640584130226,NaN,NaN,11.810598365864571,-32.86647346181017,0.12562568762636828,-0.2220226097136333,-0.3476482973400016,7480790407,7411525675.6,40.48269492952895,32.48823334802574,NaN,NaN,-2.159754709925479,-1.4295456099689245
2016-07-06T09:30:00-04:00,207.83,209.8,207.06,209.66,96021491,129095017.3,54.012598263806254,47.69188419908668,NaN,NaN,31.68113055513703,8.784089126120914,0.2566985036046735,-0.026775167834159674,-0.2834736714388332,7576811898,7490450410.2,47.657587890712776,32.797554345304384,NaN,NaN,-0.41524694323566197,-1.2846458004356014
2016-07-07T09:30:00-04:00,209.87,210.6495,208.63,209.526,85593827,130066162.65,53.70457376194348,48.04998101184389,NaN,NaN,63.219200082612716,33.84444533214246,0.31942865402493714,0.11581214609233825,-0.2036165079325989,7491218071,7524790656.6,50.45616177647985,33.703623110832794,NaN,NaN,0.827866188559686,-0.9828583734362746
2016-07-08T09:30:00-04:00,211.05,212.94,210.7785,212.65,133970972,133075367.8,59.502927822129465,49.30876734845492,NaN,NaN,147.7042451856508,61.23336319979079,0.5432244337508149,0.47541403425591966,-0.06781039949489517,7625189043,7552920707.8,52.68772244722631,35.099386075593124,NaN,NaN,3.8599703744749476,-0.29102569516324295
2016-07-11T09:30:00-04:00,213.19,214.07,212.95,213.4,73633937,131065606.75,60.77316504068962,50.25260524228357,NaN,NaN,178.39359706792786,86.56175425143859,0.7035000327167776,0.8115646414010769,0.10806460868429926,7698822980,7574566479.8,54.39013599794853,36.72751326886341,NaN,NaN,6.678570419315781,0.7046308926194746
2016-07-12T09:30:00-04:00,214.53,215.3,213.4308,214.95,101275629,130241830.55,63.332888368777716,51.21221232204582,NaN,NaN,187.10702876072725,121.62104033041112,0.8650112134083335,1.1893286254447162,0.32431741203638265,7800098609,7638428120.2,59.06953003734589,38.53241592395291,NaN,NaN,9.835779143560083,2.0090806427538475
2016-07-13T09:30:00-04:00,215.44,215.45,214.35,214.92,87324129,128355072.7,63.24686370327076,52.26167376435661,NaN,NaN,167.3234162522869,148.7494974698411,0.9160267054508238,1.4693507938499124,0.5533240883990886,7712774480,7665620636.6,60.90863165103112,40.28377380739171,NaN,NaN,12.31495512922933,3.4813484265360595
2016-07-14T09:30:00-04:00,216.4,216.67,215.66,216.12,91230870,127460391.4,65.2784597302713,52.766207046519135,NaN,NaN,162.99301022259425,168.7042594978374,0.9715192404541698,1.7677231389668009,0.7962038985126311,7804005350,7728178092.4,64.82438278844701,42.22255782169931,NaN,NaN,15.011696750887513,5.128541044300553
2016-07-15T09:30:00-04:00,216.78,217.0125,215.308,215.83,107155401,125341508.2,64.35267294920166,54.71950567886167,NaN,NaN,136.01879453473217,166.36716936765367,0.9296062809132755,1.9582117496542253,1.0286054687409498,7696849949,7742510273.6,65.6727638090018,44.42694265370032,NaN,NaN,16.969939381223615,6.820169378146704
2016-07-18T09:30:00-04:00,215.97,216.6,215.67,216.4092,58725918,122425016.7,65.407870120685,57.152024458955886,NaN,NaN,121.37349198156033,154.96314835038018,0.8821901436831461,2.1313431483448824,1.2491530046617363,7755575867,7753860851,66.36465133250206,47.163869204610606,NaN,NaN,18.90960843302906,8.547232100272755
2016-07-19T09:30:00-04:00,215.92,216.23,215.63,216.19,54345728,121002822.95,64.62817428402639,58.824352995302924,NaN,NaN,102.2524027522346,137.99222314868163,0.7808476409785265,2.2252125558848945,1.444364914906368,7701230139,7734087157,63.946583148464086,50.02364974899937,NaN,NaN,20.32968613109956,10.230439818962298
2016-07-20T09:30:00-04:00,216.75,217.37,216.24,217.085,58159457,120287712.65,66.3898764396771,60.07885443636896,NaN,NaN,102.81663807135159,125.09086751249458,0.7203436098767537,2.3447944272523102,1.6244508173755565,7759389596,7743410180.2,64.60147639802412,53.041802119164025,NaN,NaN,22.03367781763791,11.916616675915956
2016-07-21T09:30:00-04:00,216.96,217.22,215.75,216.265,67777310,118898554.6,63.280178504552936,60.738847812914784,NaN,NaN,84.51636766666394,109.39553900130852,0.5775189606467879,2.3463495181840415,1.7688305575372536,7691612286,7720931567.4,61.691772746750765,55.92292153351385,NaN,NaN,22.701632629198755,13.457333240670641
2016-07-22T09:30:00-04:00,216.41,217.3,216.1,217.24,62787477,116901360.65,65.35793913059024,61.49118726917901,NaN,NaN,82.41662366902412,98.67510482816691,0.5038208709299421,2.3986066461996813,1.8947857752697392,7754399763,7732441530.2,62.62016767930794,58.24101875948363,NaN,NaN,23.837084215639077,14.940154808523275
2016-07-25T09:30:00-04:00,217,217.06,215.97,216.65,55873147,103022798,63.03360181795841,62.307270709827165,NaN,NaN,71.96362324678473,88.7931310812118,0.3762903916032083,2.3651487647737497,1.9888583731705414,7698526616,7721031680,61.040912076227436,59.709462841390675,NaN,NaN,24.20544618519029,16.26376786233285
2016-07-26T09:30:00-04:00,216.53,217.17,215.76,216.75,70080493,94077389.65,63.27201517147037,62.968657631803175,NaN,NaN,67.71531631436069,81.88571379363701,0.26488071795214596,2.319959270610724,2.055078552658578,7768607109,7734507074,62.25173709021141,60.75190206992629,NaN,NaN,24.576239797010825,17.45126385300113
2016-07-27T09:30:00-04:00,217.19,217.27,215.62,216.52,84083893,90312464.35,62.27714896015326,63.5809844316753,NaN,NaN,62.56713650146128,73.83581347965895,0.14775198637931375,2.23976853563272,2.0920165492534064,7684523216,7719533798,60.01957583120047,61.4350030738349,NaN,NaN,24.64798116494267,18.479366326135636
2016-07-28T09:30:00-04:00,216.29,217.11,215.75,216.77,65035718,86697819.55,62.95891223407479,63.82784046109996,NaN,NaN,60.281991170125025,68.98893818035117,0.06347446372116838,2.1713596289048667,2.1078851651836983,7749558934,7731123127.6,61.179841815678486,62.04158302872435,NaN,NaN,24.874411518137943,19.392944210707395
2016-07-29T09:30:00-04:00,216.46,217.54,216.13,217.12,79519436,82422693.95,63.941451803978715,64.05414665847775,NaN,NaN,66.76689767574831,65.85899298169602,0.010442504616177128,2.12093829595392,2.1104957913377427,7829078370,7746058849,62.682882798054635,62.63392208587477,NaN,NaN,25.30806461023356,20.237961410639706
2016-08-01T09:30:00-04:00,217.19,217.65,216.405,216.94,73311422,80785498.4,63.01567970662684,64.03148889689555,NaN,NaN,65.76207514185022,64.61868336070911,-0.0540724800570862,2.042905191266385,2.0969776713234713,7755766948,7757506915.4,63.83859432484984,62.9745695349822,NaN,NaN,25.465527508197518,20.984756567433678
2016-08-02T09:30:00-04:00,216.65,216.83,214.57,215.5492,92295506,79910088.05,56.24012673134033,63.5310076846148,NaN,NaN,17.27126121887124,54.529872341611224,-0.19955000582148097,1.8475401640466202,2.047090169868101,7663471442,7736479782,60.15360981679327,62.92063940396521,NaN,NaN,23.883809135565002,21.398906934309583
2016-08-03T09:30:00-04:00,215.48,216.245,215.13,216.18,53993626,77808694.8,58.423632524653996,63.04137716992785,NaN,NaN,15.764808801780426,45.16940680167505,-0.2586785075440634,1.723742035438022,1.9824205429820854,7717465068,7743068152.4,60.91489306953212,62.64139013832844,NaN,NaN,23.037520268661584,21.632994553502726
2016-08-04T09:30:00-04:00,216.31,216.78,214.25,216.4097,46585528,75858279.85,59.22155905376118,62.67486903453924,NaN,NaN,-3.132495756795945,32.48650941629086,-0.28559318440361636,1.625429062477565,1.9110222468811813,7764050596,7745966484.8,61.265491694001696,62.32658498725699,NaN,NaN,22.508221369335317,21.758026955764525
2016-08-05T09:30:00-04:00,217.21,218.23,217.07,218.18,71892161,72754339.3,64.8246241296613,62.63320860660898,NaN,NaN,165.74653091471728,52.28243606408464,-0.19193753057482477,1.6711003336626504,1.8630378642374752,7835942757,7747339362.2,61.44192577750692,61.974961733328776,NaN,NaN,23.535648127600368,22.01197283745536
2016-08-08T09:30:00-04:00,218.4,218.52,217.74,218.05,39906479,71067966.4,64.12780099171351,62.59746765715806,NaN,NaN,189.1485254849491,76.95972613270442,-0.14845555553395573,1.6774684198200305,1.8259239753539862,7796036278,7755393228.2,62.52046503898805,61.873096154080486,NaN,NaN,24.210483782347044,22.326045829582743
2016-08-09T09:30:00-04:00,218.13,218.76,217.8,218.18,51251728,68566771.35,64.53831371542125,62.46521317685408,NaN,NaN,187.64159102049487,111.03379209302913,-0.1217699144807276,1.6737115822530768,1.7954814967338044,7847288006,7792156541,67.05107611555326,62.04806756247545,NaN,NaN,24.887506774932337,22.691968821775543
2016-08-10T09:30:00-04:00,218.31,218.4038,217.23,217.64,57941092,67097619.5,61.39535120218404,62.3305826552563,NaN,NaN,116.62206546440588,131.20524342555422,-0.1494910920630257,1.6086176316550223,1.758108723718048,7789346914,7806532910.2,68.64717057428474,62.5448816930136,NaN,NaN,24.668606449438123,22.97434562572734
2016-08-11T09:30:00-04:00,218.26,218.94,217.95,218.65,72504270,66161289.5,64.84388698425713,62.29386464480394,NaN,NaN,166.07005230642014,165.04575303819746,-0.11060212023979465,1.6198560734183047,1.7304581936580994,7861851184,7826093027.8,70.72505045301051,63.12380189113521,NaN,NaN,25.396552996153343,23.320375250073912
2016-08-12T09:30:00-04:00,218.29,218.71,217.99,218.46,61313544,63869196.65,63.69125192083747,62.34083965215245,NaN,NaN,132.69101395274194,158.43464964580238,-0.10833093336281463,1.595044526954581,1.7033754603173956,7800537640,7819012004.4,68.94370732628443,63.688287266139284,NaN,NaN,25.709815325595436,23.661723832291273
2016-08-15T09:30:00-04:00,218.89,219.5,218.88,219.09,49813482,63423574.85,65.85835167590518,62.525577973897775,NaN,NaN,164.12992373279235,153.43092929537104,-0.07655273161409992,1.6076845457997706,1.6842372774138705,7850351122,7829874973.2,70.18437487216308,64.2549042505644,NaN,NaN,26.562902544666045,24.076177934059096
2016-08-16T09:30:00-04:00,218.6,218.68,217.96,217.96,53213621,63366969.5,59.050447997363676,62.29509933369852,NaN,NaN,77.66219369833117,131.43504983093828,-0.14009057959506177,1.5091240529200434,1.6492146325151051,7797137501,7819844872.2,67.50292394445974,64.7894291157972,NaN,NaN,25.428481431123085,24.26936414792538
2016-08-17T09:30:00-04:00,218,218.53,217.02,218.37,75134339,64215713.6,60.640256804260474,62.12948108871178,NaN,NaN,54.260991956365466,118.96283512933022,-0.16144142493782931,1.4474128513428184,1.6088542762806477,7872271840,7836429857.4,69.57298534145988,65.38893936763873,NaN,NaN,24.897515882126072,24.35910010995405
2016-08-18T09:30:00-04:00,218.34,218.9,218.21,218.86,52989266,63476311.4,62.51339064799014,62.02747672042688,NaN,NaN,93.56607756423571,104.46204018089331,-0.1497576569624659,1.4216572050775653,1.5714148620400312,7925261106,7849111841.8,71.08951572576903,65.98941314818975,NaN,NaN,24.953018976793498,24.443945662359685
2016-08-19T09:30:00-04:00,218.31,218.75,217.74,218.54,75443004,64109087.75,60.48883212264195,61.8469876072851,NaN,NaN,64.52435975820678,90.8287093419863,-0.16933189546912364,1.3597499927036267,1.5290818881727504,7849818102,7858967934.2,72.24722732790954,66.59002979126545,NaN,NaN,24.450244945239966,24.44484555991401
2016-08-22T09:30:00-04:00,218.26,218.8,217.83,218.53,61368766,64383868.7,60.42297631206316,62.14576257733673,NaN,NaN,62.03792154331128,70.41030890409007,-0.18730251551753208,1.2949537437758352,1.4822562592933672,7788449336,7846587577,68.53470836648546,67.18867968767204,NaN,NaN,24.012816160050477,24.38312707421922
2016-08-23T09:30:00-04:00,219.25,219.6,218.9,218.97,53399159,63549802,62.364547854194704,62.42725652944679,NaN,NaN,108.35222310951151,76.54831478632615,-0.17418111994734486,1.264529859359186,1.438710979306531,7841848495,7855529775.8,69.7440636937048,67.8193347322558,NaN,NaN,24.132453250437568,24.3473165279647
2016-08-24T09:30:00-04:00,218.8,218.91,217.36,217.85,71728949,62932054.8,54.97188461861298,62.12370835550763,NaN,NaN,24.359647734799783,70.56804594201301,-0.24141825812771134,1.1369381566468917,1.378356414774603,7770119546,7835099317,63.71839219453983,67.99454191086566,NaN,NaN,22.16867868829292,24.03608255086873
2016-08-25T09:30:00-04:00,217.4,218.19,217.22,217.7,69224776,63141507.7,54.04782647633974,61.353937094556095,NaN,NaN,-6.965460931666548,50.46173824283257,-0.2930445116245912,1.012050775243864,1.3050952868684553,7700894770,7790226049.8,52.90650446790583,67.38486896017987,NaN,NaN,20.269191866505583,23.497955310245423
2016-08-26T09:30:00-04:00,217.92,219.12,216.25,217.29,122506348,65290853.3,51.49959002026425,60.45192202516686,NaN,NaN,-23.70529749679561,32.81580679183209,-0.3481045163921106,0.8699646413783171,1.2180691577704277,7578388422,7735940113.8,43.328144907571776,66.01398895079299,NaN,NaN,17.924753466840613,22.70178361833045
2016-08-29T09:30:00-04:00,217.44,218.665,217.4,218.3608,70502167,65150390.55,57.17812562611492,59.92619430450212,NaN,NaN,25.770941735600772,25.562410830289984,-0.30713579631264887,0.8341494123796167,1.1412852086922656,7648890589,7708028364.4,39.38042050051189,64.03751354971861,NaN,NaN,17.385402626497047,21.942300619497107
2016-08-30T09:30:00-04:00,218.26,218.59,217.35,218,58114543,63441342.4,54.847921496757586,59.45852075411451,NaN,NaN,-1.1693284516296538,3.6581005180617496,-0.2987871228031953,0.7678013051882715,1.0665884279914668,7590776046,7657813874.6,33.471841825496995,61.52499006766234,NaN,NaN,16.266088746040005,21.131413209003234
2016-08-31T09:30:00-04:00,217.61,217.75,216.465,217.38,85269453,65005133.75,51.00150022123938,58.46977884247038,NaN,NaN,-122.6711892385528,-25.748066876608767,-0.32718225595965955,0.6576106080418924,0.984792864001552,7505506593,7604891284,28.601224354732338,58.51614534635676,NaN,NaN,14.179865617598967,20.138334981659767
2016-09-01T09:30:00-04:00,217.37,217.73,216.03,217.39,97844207,67568067.7,51.06111360179931,57.56762610539623,NaN,NaN,-178.07195123649305,-59.96936493757407,-0.3361683327390468,0.5645824480777435,0.9007507808167903,7603350800,7585382490,27.039252839343433,55.52297002586097,NaN,NaN,12.481983300150407,19.044570455729858
2016-09-02T09:30:00-04:00,218.39,218.87,217.7,218.37,79293856,67938152.45,56.629918067916684,56.908452276254195,NaN,NaN,28.88717335296028,-49.450870767622895,-0.26984879447033805,0.5634397877288677,0.8332885821992058,7682644656,7606233736.8,31.35432398318494,52.74939496236254,NaN,NaN,12.53626141194294,18.114812020903155
2016-09-06T09:30:00-04:00,218.7,219.12,217.86,219.0308,56702089,68777932.95,59.9400614567815,56.97199609478404,NaN,NaN,80.23969015710702,-38.55712108332165,-0.17956129368876927,0.6088369650882441,0.7883982587770134,7739346745,7624324968,34.9491073741753,50.42412235019936,NaN,NaN,13.56412377046688,17.464713699412258
2016-09-07T09:30:00-04:00,218.84,219.22,218.3,219.01,76554855,70043089.3,59.78538309460474,56.91093368695149,NaN,NaN,96.96772910667787,-18.929709571660144,-0.12207302147298149,0.6358069819357866,0.757880003408768,7662791890,7638728136.8,37.7443094180817,48.1506454985295,NaN,NaN,14.360125079060303,17.02120103936198
2016-09-08T09:30:00-04:00,218.62,218.94,218.15,218.51,74102880,70851178.7,56.041571064611375,56.44866085956729,NaN,NaN,45.263653890822404,14.657259054214899,-0.118459495912688,0.6098056335179081,0.7282651294305961,7588689010,7655364620.2,40.903044588534094,45.994468988727,NaN,NaN,14.00381274317953,16.59014556847877
2016-09-09T09:30:00-04:00,216.97,217.03,213.25,213.28,221589073,78305418.85,32.86124939423539,54.47526209325253,NaN,NaN,-372.2562129765165,-24.179593293789786,-0.4503906015141521,0.16527687753790588,0.615667479052058,7367099937,7608114447.6,35.408099797398734,43.36310273654765,NaN,NaN,3.874903438270522,14.77368240702045
2016-09-12T09:30:00-04:00,212.39,216.81,212.31,216.34,168110913,83645287.3,46.74163185656829,53.49802320357433,NaN,NaN,-224.48055060899938,-74.8531380861817,-0.44515923996838835,0.05921842909157249,0.5043776690599608,7535210850,7578627686.4,32.47600099533611,40.787480781465554,NaN,NaN,1.4485409948677475,12.870090776712921
2016-09-13T09:30:00-04:00,214.84,215.1499,212.5,213.23,182828839,90296055.15,38.11651464281695,51.76602083133305,NaN,NaN,-252.1398487268077,-141.32904586296465,-0.6216155903544275,-0.2726418188830735,0.348973771471354,7352382011,7501234739.6,26.316298032608444,37.68549751995867,NaN,NaN,-4.499681843374815,10.38869468812896
2016-09-14T09:30:00-04:00,213.29,214.7,212.5,213.15,134185491,94344648.65,37.922660887255766,50.54821913623611,NaN,NaN,-197.863845642284,-200.29536081275702,-0.707915836198075,-0.5359210237762397,0.17199481242183523,7218196520,7412315665.6,21.3142718934091,34.65663178416362,NaN,NaN,-8.61952310731722,7.673235003065219
2016-09-15T09:30:00-04:00,212.96,215.73,212.75,215.28,145736123,97874737.85,45.823072335895766,49.960736697632974,NaN,NaN,-117.62374065012465,-232.87283972094642,-0.5905334604126146,-0.566172013093933,0.02436144731868159,7363932643,7367364392.2,19.315518214045994,32.25727562317363,NaN,NaN,-8.682380629554254,5.336718484119579
2016-09-16T09:30:00-04:00,213.48,213.69,212.57,213.37,155236354,102987092.25,40.807761690175994,49.197034674055246,NaN,NaN,-145.6815214651438,-187.5579014186719,-0.6081175580964548,-0.7357855003018869,-0.12766794220543212,7208696289,7335683662.6,18.03208691647083,30.450414338094994,NaN,NaN,-10.733845252507484,3.0409236646014275
2016-09-19T09:30:00-04:00,214.13,214.88,213.03,213.41,80250490,103227466.55,40.953515189174595,48.0381339285595,NaN,NaN,-105.03137446134515,-163.66806618914106,-0.5835437717899271,-0.857097656942841,-0.2735538851529139,7288946779,7286430848.4,16.22689924120496,28.79659139100164,NaN,NaN,-12.166305034931213,0.8684624218110506
2016-09-20T09:30:00-04:00,214.41,214.59,213.38,213.42,69665279,103642292.2,40.99263395528376,47.04847053273995,NaN,NaN,-90.74397459420378,-131.38889136262026,-0.5344189546364819,-0.9415775784485163,-0.4071586238120344,7358612058,7287676857.8,16.454761826771758,27.581085676806985,NaN,NaN,-13.233950485576557,-1.1461679935300362
2016-09-21T09:30:00-04:00,214.24,216.03,213.44,215.82,110284425,106486555.5,49.619439683747885,46.94975192291912,NaN,NaN,-40.580234999915355,-99.93216923414654,-0.31873896564710796,-0.8055823308709193,-0.4868433652238114,7468896483,7337816850.4,25.264137151639915,27.34272230515752,NaN,NaN,-11.1425600386518,-2.5742239999760024
2016-09-22T09:30:00-04:00,217,217.53,216.71,217.18,76678713,106734043.7,53.746150374348396,47.141540263815486,NaN,NaN,32.83453197739735,-69.84051470864215,-0.07561562287138002,-0.5813628938130364,-0.5057472709416564,7545575196,7374145361,30.945631523476678,27.62174935402418,NaN,NaN,-7.994326126751142,-3.3485243038010224
2016-09-23T09:30:00-04:00,216.72,216.88,215.88,215.99,73630921,106954350.95,49.89499739477716,46.66047450144838,NaN,NaN,3.894065566323058,-39.92539730234877,0.009401055585898765,-0.4939959514592829,-0.5033970070451816,7471944275,7426794958.2,38.26987582367381,28.11571734263052,NaN,NaN,-6.729509173947708,-3.831522142393406
2016-09-26T09:30:00-04:00,215.02,215.23,214.01,214.24,89827305,105320398.8,44.80996438014002,45.57975328168827,NaN,NaN,-54.85176448188694,-29.889475306457133,-0.044896493529857806,-0.5595176239575039,-0.5146211304276461,7382116970,7445428996.4,40.66845433331623,28.5242421254263,NaN,NaN,-7.400977784564539,-4.341444376989282
2016-09-27T09:30:00-04:00,214.05,215.68,213.62,215.57,78494829,105720031.9,49.05910965561432,44.81359089318896,NaN,NaN,-33.3692051478776,-18.414521417191906,0.012993598472545331,-0.4983791323369644,-0.5113727308095097,7460611799,7465828944.6,43.26739451393241,28.91874820370136,NaN,NaN,-6.51105039864235,-4.651388094368292
2016-09-28T09:30:00-04:00,215.83,216.82,214.71,216.64,87411015,107184855.5,52.24462695042961,44.54238059931883,NaN,NaN,13.012822846968357,-7.695909847815163,0.12154382857859025,-0.35944294508627195,-0.4809867736648622,7548022814,7481654210.8,45.27021046661236,29.230688623564095,NaN,NaN,-4.730518865309389,-4.66269249021702
2016-09-29T09:30:00-04:00,216.4,216.87,214.04,214.68,128070615,109324913.6,46.507512373568865,45.517113669271225,NaN,NaN,-18.56577916850859,-17.975972076996342,0.0625119250265091,-0.4028468673817258,-0.4653587924082349,7419952199,7456529611.4,42.69329153133343,29.751059461702283,NaN,NaN,-5.136979977750024,-4.730447845578878
2016-09-30T09:30:00-04:00,215.65,217.12,215.36,216.3,117202914,110292848.95,51.27058011945058,45.84060997376282,NaN,NaN,28.924663510597686,-12.969852488141417,0.12986209577795454,-0.3030311726857917,-0.43289326846374626,7537155113,7469571779,44.46064883645754,30.607105736068096,NaN,NaN,-3.8644842839647047,-4.606738765348282
2016-10-03T09:30:00-04:00,215.82,216.04,215.04,215.78,83512057,110503759,49.73960098025968,46.6708304264373,NaN,NaN,7.715383073429613,-0.45642297707810703,0.13602971247905982,-0.2628561278649215,-0.39888584034398133,7453643056,7483876996.2,46.41278212615473,32.04256888560712,NaN,NaN,-3.345864977867627,-4.426613938565331
2016-10-04T09:30:00-04:00,215.91,216.17,213.99,214.68,119948052,113666057.15,46.571525429678005,47.28860646518175,NaN,NaN,-18.617749202752993,2.4938682119468147,0.06620168870051824,-0.3161337294683335,-0.38233541816885175,7333695004,7458493637.2,43.49163318208694,33.62666612051268,NaN,NaN,-3.9143691702207097,-4.353436114516099
2016-10-05T09:30:00-04:00,215.41,216.13,215.33,215.63,72815963,113479112.55,49.55957354274364,47.55549940852803,NaN,NaN,39.181210998438374,7.727545842240818,0.08307689392777451,-0.2784893007591336,-0.3615661946869081,7406510967,7430191267.8,40.435728803630695,35.1352525911973,NaN,NaN,-3.4594149580769633,-4.225718806453365
2016-10-06T09:30:00-04:00,215.37,216.04,214.735,215.78,62927376,112920337.35,50.03472864677562,48.21456847685657,NaN,NaN,44.1749807724632,20.275697830435178,0.1021678971321136,-0.2338563232717661,-0.3360242204038797,7469438343,7440088496.6,41.97123946842049,36.84519205919371,NaN,NaN,-2.954909495558636,-4.044174619182689
2016-10-07T09:30:00-04:00,216.1,216.3,214.19,215.04,89788255,106330296.45,47.64997003947803,48.69288668044967,NaN,NaN,14.40925701275169,17.372616530865976,0.06461635554525846,-0.2552537759723066,-0.31987013151756505,7379650088,7408587491.6,38.56369792028794,38.44067767912821,NaN,NaN,-3.215717035302619,-3.9258235357712503
2016-10-10T09:30:00-04:00,216.155,216.7,215.985,216.16,51855023,100517501.95,51.42367963831712,49.43796137209491,NaN,NaN,94.19446953622096,34.66843382342425,0.11208445904873399,-0.17976455770664757,-0.29184901675538155,7431505111,7404159902.6,38.09554138692998,39.98644764771093,NaN,NaN,-2.3425143920017106,-3.699636515232745
2016-10-11T09:30:00-04:00,215.66,215.74,212.58,213.43,130367373,97894428.65,43.24130053671972,48.98238000445004,NaN,NaN,-90.43730293952756,20.304523076069337,-0.03560059628493695,-0.33634976211155276,-0.3007491658266158,7301137738,7397648449.4,37.37690198533504,40.851645135832015,NaN,NaN,-4.13083131877516,-3.7612357728816614
2016-10-12T09:30:00-04:00,213.59,214.32,213.01,213.71,73866117,94878459.95,44.22160843562898,48.302055580255804,NaN,NaN,-111.53519932147785,-9.83875898791391,-0.10568966714282652,-0.43286124975514895,-0.32717158261232243,7375003855,7391347027,36.6562423938067,41.25954591228416,NaN,NaN,-5.266623509657857,-3.9762911638496896
2016-10-13T09:30:00-04:00,212.16,213.59,211.21,213.01,101356960,92659501.8,42.25666532918821,47.75646043271373,NaN,NaN,-167.4728960345415,-52.16833434931484,-0.18576931571531097,-0.5593832272564612,-0.3736139115411502,7273646895,7352188737.4,32.466971416183185,40.84505274032055,NaN,NaN,-6.7955828128885605,-4.379047113712385
2016-10-14T09:30:00-04:00,214.15,214.69,213.03,213.12,93346237,89564995.95,42.68763145021614,47.604865223433464,NaN,NaN,-100.17171608008643,-75.08452896788246,-0.2157972438060871,-0.6433604662987591,-0.427563222492672,7366993132,7349657346.2,32.210693713046695,40.24092698172986,NaN,NaN,-7.91973578917315,-4.884859781635352
2016-10-17T09:30:00-04:00,213.09,213.39,212.17,212.38,58275674,88466255.15,40.497868258309104,46.9933479807688,NaN,NaN,-155.20924689111195,-124.96527225334906,-0.2666327782276259,-0.7608541952772043,-0.49422141704957845,7308717458,7325099815.6,29.75674971321743,39.27588092453593,NaN,NaN,-9.49726948391292,-5.54377545338929
2016-10-18T09:30:00-04:00,214.24,214.31,213.27,213.71,76869656,88826474,45.872150499205326,46.53817109139563,NaN,NaN,-79.59428680423675,-122.7966690262909,-0.1951349603324346,-0.7381401174651216,-0.543005157132687,7385587114,7341989690.8,33.50868976401654,38.43577230292194,NaN,NaN,-9.353982382724823,-6.088090729008652
2016-10-19T09:30:00-04:00,214.02,214.64,213.6,214.28,66519224,86638213.95,48.038255794657175,46.64750990718766,NaN,NaN,-46.97371541929402,-109.88437224585411,-0.09876567340968112,-0.6664622488947884,-0.5676965754851073,7452106338,7357410187.4,36.82643678296631,38.01671124946715,NaN,NaN,-8.61862627840792,-6.449595807494261
2016-10-20T09:30:00-04:00,213.87,214.53,213.11,213.88,73639830,86486269.8,46.628070900092354,46.31590210580493,NaN,NaN,-60.354570450225694,-88.46070712899096,-0.05353729575927635,-0.6346181951842027,-0.5810808994249264,7378466508,7378374110,41.127259123553465,37.77861198425972,NaN,NaN,-8.387200840455042,-6.726396526488658
2016-10-21T09:30:00-04:00,212.96,214.08,212.76,213.98,89089092,87259178.35,47.04658251334081,46.12354364388216,NaN,NaN,-68.52489103006272,-82.13134211898623,-0.010703141334129862,-0.5944598260925886,-0.5837566847584588,7467555600,7398486603.6,44.99615659934312,37.67742444663032,NaN,NaN,-8.083452273534242,-6.9202616332094555
2016-10-24T09:30:00-04:00,215,215.32,214.48,214.89,60146592,85775142.7,50.82544531759455,46.42739506444763,NaN,NaN,18.72883044429889,-47.34372665190405,0.08010162551858269,-0.4836296528602304,-0.5637312783788131,7527702192,7442283550.4,52.34096997612148,38.309519931918494,NaN,NaN,-6.788405964676008,-6.901425109133249
2016-10-25T09:30:00-04:00,214.68,214.98,213.98,214.17,66542329,85177517.7,47.91212427931837,46.30972011706011,NaN,NaN,-14.879624864197115,-34.40079426389614,0.09200794713929317,-0.4487213444546967,-0.5407292915939899,7461159863,7457398100.2,54.59434628787613,39.32084975222175,NaN,NaN,-6.445659353946756,-6.836315715535179
2016-10-26T09:30:00-04:00,213.21,214.42,212.93,213.74,75705478,84592240.85,46.208591381666,46.0364245981237,NaN,NaN,-55.74742467895309,-36.15553611582796,0.07213552053614136,-0.4505598909238131,-0.5226954114599545,7385454385,7444067709.6,52.2480081154513,40.05490465558109,NaN,NaN,-6.608217626308872,-6.803730274217135
2016-10-27T09:30:00-04:00,214.58,214.62,213.08,213.17,77220213,82049720.75,43.97647616512346,45.77403217852695,NaN,NaN,-55.917010048446116,-35.26802403547204,0.02428765126578991,-0.4923358473777171,-0.516623498643507,7308234172,7430021242.4,49.818371197391436,40.858809889659916,NaN,NaN,-7.347572278148254,-6.881421989064438
2016-10-28T09:30:00-04:00,213.14,213.93,211.71,212.54,140623183,83220734.2,41.58544306394764,45.071300994643416,NaN,NaN,-113.7644728823999,-44.315940405939465,-0.042470835421105635,-0.569712042919889,-0.5272412074987833,7167610989,7370032320.2,41.04077119653845,41.06918344748908,NaN,NaN,-8.638985517715147,-7.132502493157396
2016-10-31T09:30:00-04:00,212.93,213.19,212.36,212.55,61272507,82108756.7,41.63968396944085,44.95689981126635,NaN,NaN,-108.11696826646623,-69.68510014809249,-0.07664243609169097,-0.623044252613397,-0.546401816521706,7228883496,7310268581,34.516090706135955,40.86483978468915,NaN,NaN,-9.703296663064444,-7.499758803144117
2016-11-01T09:30:00-04:00,212.93,212.99,209.6,211.01,122781818,82250445,36.083020078108895,44.37557207144349,NaN,NaN,-200.3156142051301,-106.7722980162791,-0.18734057144944427,-0.7805775308335114,-0.5932369593840672,7106101678,7239256944,28.681369976865,40.29520604062189,NaN,NaN,-12.278314911026502,-8.182409675698743
2016-11-02T09:30:00-04:00,210.65,211.1,209.23,209.74,103330806,83776187.15,32.25974680051456,43.66150646225252,NaN,NaN,-245.5556698791929,-144.73394705632705,-0.32254332072013003,-0.9964161102842297,-0.6738727895640997,7002770872,7162720241.4,23.976848293621458,39.688768674724614,NaN,NaN,-15.73656200837911,-9.26157429465308
2016-11-03T09:30:00-04:00,209.99,210.24,208.46,208.78,88939346,85076785.65,29.69813218345145,42.73368508605504,NaN,NaN,-230.39492882626882,-179.62953081189158,-0.4454989184742437,-1.2307464376569044,-0.7852475191826607,6913831526,7083839712.2,20.284054172560772,38.836865850404195,NaN,NaN,-19.514084115625494,-10.726218554791997
2016-11-04T09:30:00-04:00,208.91,209.89,208.38,208.55,109122059,86043475.85,29.101899927258273,41.91968734812284,NaN,NaN,-195.0300597972547,-195.88264819486255,-0.5067304265784974,-1.4186605524057825,-0.911930125827285,6804709467,7011259407.8,17.59829403811213,37.96840473075382,NaN,NaN,-22.793347978596984,-12.450094186764137
2016-11-07T09:30:00-05:00,211.45,213.19,211.3,213.15,109794861,88940467.75,50.504506545517735,42.25056992285944,NaN,NaN,-12.765957446819739,-176.81244603093324,-0.21667035686694858,-1.1827680719109708,-0.9660977150440222,6914504328,6948383574.2,15.663435816343707,36.69374373449148,NaN,NaN,-18.5036422319104,-13.314886764642175
2016-11-08T09:30:00-05:00,212.69,214.77,212.38,214.11,106772138,87760706,53.64926153307855,42.651356047032394,NaN,NaN,52.1587144468565,-126.31758030053592,0.04656457928984459,-0.9078919909317165,-0.954456570221561,7021276466,6931418531.8,15.178522670391928,35.14746415502187,NaN,NaN,-13.980404933346527,-13.409960788742797
2016-11-09T09:30:00-05:00,212.37,217.1,212.34,216.3792,258428972,96988848.75,60.1021847359072,43.613792749590594,NaN,NaN,122.18086418783868,-52.770273487129614,0.3626307864700905,-0.5011680871339479,-0.8637988736040384,7279705438,6986805445,23.504750452192056,33.88871353563892,NaN,NaN,-7.694282634686586,-12.593435338163339
2016-11-10T09:30:00-05:00,217.3,218.31,215.22,216.92,172113313,100526666.4,61.478603098140276,44.64465136279056,NaN,NaN,171.0498852014121,27.518689318406565,0.5841129389035461,-0.13365769997460575,-0.7177706388781518,7451818751,7094402890,36.53757624938852,33.28452922492787,NaN,NaN,-2.3659126288305914,-11.132360665401517
2016-11-11T09:30:00-05:00,216.08,216.7,215.32,216.42,100552732,100886991.15,59.43697767465752,45.25976081686649,NaN,NaN,125.95280408213469,91.71526209428444,0.6669484417637832,0.11591491332657711,-0.5510335284372061,7351266019,7203714200.4,46.508525759116715,32.867926066570384,NaN,NaN,1.166841002378612,-9.375331855718642
2016-11-14T09:30:00-05:00,217.03,217.27,215.72,216.59,94579982,102702206.55,59.924278364198884,46.117771822929384,NaN,NaN,127.29680039570182,119.72781366278875,0.6997782611136392,0.3236892979548429,-0.37608896315879625,7445846001,7309982535,54.064519409272734,32.83008128952729,NaN,NaN,4.1076177022432585,-7.449196204581227
2016-11-15T09:30:00-05:00,217.04,218.28,216.8,218.28,91652580,103441352.75,64.49121511487255,47.42367351815842,NaN,NaN,156.82009523289588,140.6600898199966,0.7949524062264144,0.6176015446242218,-0.17735086160219263,7537498581,7413226958,59.97930556243843,33.38231682145494,NaN,NaN,8.168814727415443,-5.21805178572456
2016-11-16T09:30:00-05:00,217.56,218.14,217.42,217.87,65617697,103396276.4,62.62662036619238,48.75582667537763,NaN,NaN,137.8883643551141,143.8015898534517,0.7883846296092427,0.8081299254093608,0.01974529580011805,7471880884,7451662047.2,61.94384893128968,34.248422373876245,NaN,NaN,10.876045928689535,-2.9188949693796893
2016-11-17T09:30:00-05:00,218.05,219.06,217.92,218.99,69797191,103204144.45,65.55625282686457,50.468027372728834,NaN,NaN,139.62945076366088,137.51750296590146,0.8142354188196486,1.0375395693246787,0.2233041505050302,7541678075,7469633912,62.86185827690611,35.80707145104536,NaN,NaN,14.09632899056588,-0.48814868938746514
2016-11-18T09:30:00-05:00,219.07,219.27,218.29,218.5,86265751,103062977.4,63.22130612711845,52.009571812562946,NaN,NaN,121.2281144503991,136.57256503955435,0.7544481499831471,1.166364337983964,0.411916188000817,7455412324,7490463173,63.947345920563976,37.909303966361655,NaN,NaN,16.046090840205128,1.8738855291257623
2016-11-21T09:30:00-05:00,219.17,220.18,219,220.15,72402638,103675779.7,67.42833383493053,54.24852279519306,NaN,NaN,130.59938483843186,137.23308192810035,0.77896901350075,1.3856274548767544,0.6066584413760044,7527814962,7506856965.2,64.81891965501167,40.4905575148007,NaN,NaN,19.09331909794289,4.333804610385352
2016-11-22T09:30:00-05:00,220.51,220.79,219.73,220.58,67428957,103720111.1,68.44146369904779,56.83293114508829,NaN,NaN,124.5501670503807,130.77909629159734,0.7754141790650189,1.575926165207278,0.8005119861422592,7595243919,7518406032.8,65.45254871415177,43.45310754483858,NaN,NaN,21.884943017347275,6.841110097094198
2016-11-23T09:30:00-05:00,219.98,220.76,219.75,220.7,56620237,102765849.05,68.73374329974042,59.62118908196607,NaN,NaN,110.7635894601802,125.35414131261055,0.7328975898162714,1.7166339734125984,0.983736383596327,7651864156,7554402687.2,67.42202133483755,46.82010519928692,NaN,NaN,24.23437799674068,9.325862654186553
2016-11-25T09:30:00-05:00,221.1,221.56,221.01,221.52,37872255,100798451.15,70.72873216633718,62.594534241900284,NaN,NaN,116.10904513315592,120.65006018650953,0.7111912601443207,1.8727254587767277,1.161534198632407,7689736411,7584014354.4,68.98821719929688,50.49081399651441,NaN,NaN,26.8339465098415,11.827017490708688
2016-11-28T09:30:00-05:00,221.16,221.48,220.36,220.48,76572511,97595917.55,65.05883671279128,63.63412925384839,NaN,NaN,95.17467342261368,115.43937198095246,0.583344476240861,1.8907147939334834,1.3073703176926224,7613163900,7615564669.6,70.60948465671127,54.41553177082638,NaN,NaN,27.44959690984406,14.058814550585168
2016-11-29T09:30:00-05:00,220.52,221.44,220.17,220.91,69886690,98026626.7,66.26305369472135,64.53511440825145,NaN,NaN,88.97995802044115,107.11548661735432,0.48815525732860054,1.9175643893533731,1.4294091320247726,7683050590,7646611795.2,72.15231916567677,58.48508866334672,NaN,NaN,28.304077992361286,16.093852185124614
2016-11-30T09:30:00-05:00,221.63,221.82,220.31,220.38,113291793,97552125.45,63.36434588255579,64.76812591872634,NaN,NaN,82.98765027629362,98.80298326253691,0.35604758177867124,1.8744686092481118,1.5184210274694405,7569758797,7641514770.8,71.48883530651781,61.912523295798565,NaN,NaN,28.211534495850298,17.824949658085426
2016-12-01T09:30:00-05:00,220.73,220.73,219.15,219.57,79040487,96337609.5,59.10858342840874,64.5988387994598,NaN,NaN,56.84906426696012,88.0200782238929,0.18904498515868484,1.7547272589177965,1.5656822737591116,7490718310,7609285601.6,67.27615675004844,64.10813618870284,NaN,NaN,26.914053687961243,19.12339309092483
2016-12-02T09:30:00-05:00,219.67,220.25,219.26,219.68,74840347,95632659.55,59.506334958105526,64.60379289113466,NaN,NaN,50.36865144880769,74.87199948702325,0.06720685906368296,1.6496908475887153,1.5824839885250324,7565558657,7584450050.8,64.13958232485155,65.36749737196962,NaN,NaN,25.94682776424329,20.098169472827465
2016-12-05T09:30:00-05:00,220.65,221.4,220.42,221,67837821,93568447.65,64.02810941262271,64.8969236803078,NaN,NaN,79.74119397977543,71.78530359845561,0.057130099203420937,1.6538966125293086,1.5967665133258877,7633396478,7588496566.4,64.4305625835569,66.10792902727563,NaN,NaN,26.344931775975038,20.99056408756283
2016-12-06T09:30:00-05:00,221.22,221.7441,220.662,221.7,59877377,91072573.45,66.18458863020513,65.01787893140298,NaN,NaN,89.57344919567008,71.90400183350138,0.07793427630529193,1.6941843587075027,1.6162500824022108,7693273855,7590541219.4,64.5869259055512,66.4370447660694,NaN,NaN,27.302949266005527,21.89233339876893
2016-12-07T09:30:00-05:00,221.52,224.67,221.38,224.6,110738050,91270869.05,73.32043380088388,65.78172274816666,NaN,NaN,161.0932743356845,87.52512664537957,0.2572246695095881,1.937780919289196,1.6805562497796078,7804011905,7637391841,68.05250006679762,66.87337699003425,NaN,NaN,30.61811004431913,23.138872919561816
2016-12-08T09:30:00-05:00,224.57,225.7,224.26,225.15,99714387,83335139.8,74.42281759221027,66.4150488028342,NaN,NaN,204.596342416826,117.07458227535274,0.37589467687901523,2.150424595878377,1.7745299189993617,7903726292,7719993437.4,73.05850260602477,67.60170872782844,NaN,NaN,33.643513141141895,24.63953580835897
2016-12-09T09:30:00-05:00,225.41,226.53,225.37,226.51,88005766,79129762.45,76.95813629866352,67.39625095794456,NaN,NaN,215.0102215692668,150.00289629944456,0.5011836906280347,2.401009532284405,1.8998258416563705,7991732058,7805228117.6,77.05402275279832,68.5378999301309,NaN,NaN,37.069060442187734,26.415182184620225
2016-12-12T09:30:00-05:00,226.4,226.96,225.76,226.25,102016125,79202932.1,75.41899071936828,67.96701216397584,NaN,NaN,193.87526661507408,172.82971082650428,0.5195265978187269,2.5492340889297793,2.0297074911110524,7889715933,7856492008.6,79.06498866657877,69.55547628809997,NaN,NaN,39.32287222479271,28.259137904644867
2016-12-13T09:30:00-05:00,227.02,228.34,227,227.76,110477485,79997807.25,78.1519106249886,68.66061551582875,NaN,NaN,193.06577496703795,193.52817598077786,0.5816493505552685,2.756769179305138,2.1751198287498696,8000193418,7917875921.2,81.19067440376956,70.67962812307267,NaN,NaN,42.17375452049475,30.246940278337707
2016-12-14T09:30:00-05:00,227.41,228.23,225.365,225.88,142501812,82540268.85,68.01313377882374,68.60914340719184,NaN,NaN,128.11323884302112,186.9321688822452,0.4502883081046103,2.7379802138806326,2.2876919057760223,7857691606,7928611861.4,81.54364776335726,71.68831572510979,NaN,NaN,41.269384719697044,31.8215751985319
2016-12-15T09:30:00-05:00,226.16,227.81,225.8904,226.81,124972554,85508011.7,70.08091262977659,68.5628705831518,NaN,NaN,116.33547706040702,169.2799958109614,0.38284287133324657,2.7662454949425808,2.383402623609334,7982664160,7944399435,82.07631501175732,72.62317985457125,NaN,NaN,41.2013528526169,33.16154343482976
2016-12-16T09:30:00-05:00,226.01,226.08,224.67,225.04,156420152,89839159.75,61.881741956170394,68.33593524339317,NaN,NaN,66.84521078205586,139.64699365351922,0.1858138305418331,2.6156699117866253,2.4298560812447922,7826244008,7911301825,77.05544056124668,73.08360527632378,NaN,NaN,38.339020720647035,33.90118304708937
2016-12-19T09:30:00-05:00,225.25,226.02,225.08,225.53,90341147,90042929.55,63.16649805034521,68.1147526973663,NaN,NaN,65.64383280250861,114.00070689100612,0.06169729801745305,2.5069777037666086,2.4452804057491555,7916585155,7916675669.4,77.2982657217733,73.45117288747352,NaN,NaN,36.47581767261799,34.268987993593456
2016-12-20T09:30:00-05:00,226.15,226.57,225.88,226.4,89838810,90914738.15,65.39654959988654,68.25991010574707,NaN,NaN,75.94272238317865,90.57609637423427,0.013897398481040657,2.462652153850456,2.4487547553694156,8006423965,7917921778.8,77.35810447163601,73.8704063992677,NaN,NaN,35.63661581625611,34.464363396830976
2016-12-21T09:30:00-05:00,226.25,226.45,225.77,225.77,67909039,90938742.25,62.44807800984521,68.49844543299253,NaN,NaN,62.447545767012464,77.44295775903255,-0.07932113498689652,2.349603336635795,2.4289244716226914,7938514926,7934086442.8,78.16223554784852,74.64798345625341,NaN,NaN,34.03280992415924,34.40271290073501
2016-12-22T09:30:00-05:00,225.6,225.74,224.92,225.38,56219071,90918683.95,60.62582565692139,68.57840905433652,NaN,NaN,40.90836490348528,62.3575353276482,-0.18062349050934312,2.2031451084860123,2.3837685989953554,7882295855,7914012781.8,74.61815831978842,75.39645317017747,NaN,NaN,32.17624831120707,34.084646530802445
2016-12-23T09:30:00-05:00,225.43,225.72,225.21,225.71,36697822,90859962.3,61.645679078390714,68.40823545903423,NaN,NaN,41.957323781611144,57.379957927559246,-0.23532179679524123,2.089616353001304,2.3249381497965453,7918993677,7932562715.6,75.71403583492835,76.20241554527544,NaN,NaN,30.932524453787835,33.634343376943214
2016-12-27T09:30:00-05:00,226.02,226.73,226,226.27,42672487,89164961.1,63.37913828970919,68.20784614899881,NaN,NaN,59.077737547162975,56.06673887649013,-0.2427278036363143,2.0215283952511527,2.264256198887467,7961666164,7941578917.4,76.25076410359375,77.03554684513561,NaN,NaN,30.363711400623018,33.1671102374689
2016-12-28T09:30:00-05:00,226.57,226.59,224.27,224.4,64095014,88875377.3,54.51821072894423,66.86483021528885,NaN,NaN,18.52829331288428,44.583853062431245,-0.3746273755866474,1.7959719794041575,2.170599354990805,7897571150,7919808354.4,72.10688953068906,77.32514609255644,NaN,NaN,27.119652409551616,32.303187690623574
2016-12-29T09:30:00-05:00,224.48,224.89,223.84,224.35,48696080,85645591.65,54.29961449101633,65.42745856520357,NaN,NaN,-11.795472450434882,29.73524941894177,-0.46064070907453303,1.5947984686476389,2.055439177722172,7848875070,7901880383.2,68.79143599554794,77.02035562037952,NaN,NaN,24.4471414996219,31.180895377623333
2016-12-30T09:30:00-05:00,224.73,224.83,222.73,223.53,108998328,87143483.7,50.708645685081336,63.55249494994769,NaN,NaN,-50.42342766106193,11.468890906032325,-0.5614741839721951,1.353596447756928,1.915070631729123,7739876742,7873396560.6,63.774216238817715,76.07179801223803,NaN,NaN,21.09305827140203,29.73977579102029
2017-01-03T09:30:00-05:00,225.04,225.83,223.8837,225.24,91366522,87969792.45,57.08268031669907,62.24275849261418,NaN,NaN,-8.628053895340837,1.3518153706419276,-0.5035723763195625,1.28560516132967,1.7891775376492325,7831243264,7855846478,60.83037219823153,74.76932540735609,NaN,NaN,19.988428890911074,28.34672623386183
2017-01-04T09:30:00-05:00,225.62,226.75,225.61,226.58,78744433,88515123.05,61.30535746678764,61.03943326702839,NaN,NaN,60.25157585044916,1.5865830312991633,-0.3716784695179245,1.324579450751827,1.6962579202697514,7909987697,7845510784.6,59.10014416258374,73.19143039012853,NaN,NaN,20.365271050037258,27.20651835045832
2017-01-05T09:30:00-05:00,226.27,226.58,225.48,226.4,78379012,89440204.8,60.445021237553725,60.498853799794816,NaN,NaN,41.61485599278793,6.203895567279893,-0.2964775635617174,1.3256609658176046,1.622138529379322,7831608685,7832318291.6,56.87638971198722,71.42948338645925,NaN,NaN,20.410368021069072,26.235639731974143
2017-01-06T09:30:00-05:00,226.53,227.75,225.9,227.21,71559922,87481298.4,62.963818341557584,59.99048992206489,NaN,NaN,100.67651682501234,28.69829342236934,-0.19689766844521284,1.376016443822806,1.5729141122680188,7903168607,7843176999,58.26826608053786,69.72890846280072,NaN,NaN,21.20335306735613,25.516741637028712
2017-01-09T09:30:00-05:00,226.91,227.0701,226.4163,226.46,46939676,84842562.85,59.204511626071124,59.79925918420064,NaN,NaN,67.72705690834664,52.32839033625105,-0.18636442381341212,1.3399585825012537,1.5263230063146658,7856228931,7866447436.8,61.16134844878223,68.59361616905326,NaN,NaN,20.764019573549795,24.83778134224601
2017-01-10T09:30:00-05:00,226.48,227.45,226.01,226.46,63771939,83630871.5,59.204511626071124,59.51626015389536,NaN,NaN,62.936226716827576,66.64124645868473,-0.18390805459132187,1.2964379380755133,1.4803459926668352,7856228931,7871444570.2,61.774195465285345,67.48475400787555,NaN,NaN,20.408398983891214,24.205012433909612
2017-01-11T09:30:00-05:00,226.36,227.1,225.59,227.1,74650016,82262566.05,61.48057611790514,59.23654776232525,NaN,NaN,57.093991133851695,66.00972951536525,-0.14538041283402192,1.2986204766243077,1.4440008894583296,7930878947,7875622820.2,62.30971524172877,66.40986906288218,NaN,NaN,20.73968455802982,23.709965594498215
2017-01-12T09:30:00-05:00,226.5,226.75,224.955,226.53,72113181,80344350.85,58.35773137841791,58.94438014579473,NaN,NaN,20.914986216734746,61.8697555601546,-0.16315170076427954,1.2400612635029802,1.4032129642672597,7858765766,7881054236.4,63.03467967030437,65.32932935734331,NaN,NaN,20.155753221982838,23.202220969853162
2017-01-13T09:30:00-05:00,226.73,227.4,226.69,227.05,62717865,76355153.5,60.33702802379039,58.923751743428234,NaN,NaN,106.69989816153507,63.07443182745915,-0.14534535756270506,1.2215312673138783,1.3668766248765833,7921483631,7884717241.2,63.54397035851957,64.53831593153839,NaN,NaN,20.202370242516025,22.773670865947857
2017-01-17T09:30:00-05:00,226.31,226.78,225.8,226.25,61240814,73168566.5,55.9323807149433,58.51565900318199,NaN,NaN,39.74984126861644,57.4789886995131,-0.19008112712425707,1.129275215971262,1.319356343095519,7860242817,7885520018.4,63.66213102754868,63.67746558815413,NaN,NaN,19.004207319148748,22.235176073547983
2017-01-18T09:30:00-05:00,226.535,226.8,225.9,226.75,54793302,68087224,57.99624004513502,58.13116627142669,NaN,NaN,54.86453341010707,55.86465003816901,-0.18827576205975305,1.0840116405208278,1.2722874025805808,7915036119,7897281456,65.43001139031831,62.90455468006302,NaN,NaN,18.554121000938466,21.709311063175196
2017-01-19T09:30:00-05:00,226.84,227,225.41,225.91,66608787,66900606,53.465894710978084,58.056000841571965,NaN,NaN,16.02833833043377,47.65151947748542,-0.24248050665284504,0.9691867692645246,1.2116672759173697,7848427332,7880791133,60.95248388422672,62.107811419601425,NaN,NaN,16.865873596359688,21.017391425058694
2017-01-20T09:30:00-05:00,226.7,227.31,225.9719,226.74,129168623,68867096.65,57.03705241125097,58.25153212158872,NaN,NaN,69.6483391057795,57.398190055294364,-0.22182163990356019,0.9343902260379195,1.1562118659414797,7977595955,7904557170.8,64.70159765830769,61.81568010979855,NaN,NaN,16.421749779453457,20.360871189972233
2017-01-23T09:30:00-05:00,226.35,226.805,225.27,226.15,75061645,69224726.95,53.872148290583574,58.47749659341031,NaN,NaN,10.292413716449364,38.11669316627722,-0.24543819008003465,0.8494141283414365,1.0948523184214711,7902534310,7900767306.6,63.652057163721466,61.806954461577384,NaN,NaN,15.129811348531641,19.613576926909293
2017-01-24T09:30:00-05:00,226.4,228.08,226.27,227.6,95555295,71191538.15,59.77901131410274,58.670091664653434,NaN,NaN,124.78650423492327,55.12402575953858,-0.16482025777321296,0.8888269962049549,1.0536472539781678,7998089605,7928336664.2,67.75029888772261,62.30123493939818,NaN,NaN,15.766196973860481,19.063951219330892
2017-01-25T09:30:00-05:00,228.7,229.57,228.51,229.57,84437712,73578532.65,66.12569645202643,59.014401592170486,NaN,NaN,264.4031316099631,97.03174539950979,0.010464547462699425,1.066727938306542,1.0562633908438426,8082527317,7961834903.8,71.8965649083992,63.21526499267071,NaN,NaN,18.483367163646207,18.981010639947367
2017-01-26T09:30:00-05:00,229.4,229.71,229.01,229.33,59970719,74443444.25,64.78449205579031,59.3243637934731,NaN,NaN,220.822734146789,137.99062456278085,0.0948351076561007,1.1748072754139685,1.0799721677578678,8022556598,7996660757,75.43287448473536,64.54072819072415,NaN,NaN,20.21376119486644,19.157117862078664
2017-01-27T09:30:00-05:00,229.42,229.59,228.76,228.97,59711118,74224249.45,62.72921440275759,59.3076063692731,NaN,NaN,175.3035487271318,159.1216664870513,0.10992526812575965,1.2173787529150673,1.1074534847893076,7962845480,7993710662,74.57679613916072,65.7056231949115,NaN,NaN,21.00295855298944,19.420809389351632
2017-01-30T09:30:00-05:00,228.17,228.2,226.41,227.55,79737252,75776308.05,55.27958386996177,59.02725438669386,NaN,NaN,46.310828187402485,166.32534938124192,0.01290349951744596,1.123582859186115,1.110679359668669,7883108228,7989825445.6,73.39542665398005,66.57948592385421,NaN,NaN,19.3412579154498,19.409444893079943
2017-01-31T09:30:00-05:00,226.98,227.6,226.32,227.53,75880805,74120431.9,55.180186616260514,58.73980260027882,NaN,NaN,18.27415621879112,145.0228797780155,-0.05998649317737348,1.035696243196952,1.0956827363743256,7807227423,7951653009.2,62.85950912546408,66.65700832815268,NaN,NaN,17.993538718281165,19.207172582394403
2017-02-01T09:30:00-05:00,228.255,228.59,226.94,227.62,79117651,73507988.35,55.56736304127696,58.31743023766252,NaN,NaN,55.800166794305056,103.30228681488389,-0.10677347800585468,0.9622158888670072,1.0689893668728618,7886345074,7912416560.6,54.24059930132945,66.08064290383845,NaN,NaN,17.004511780819094,18.89250675359793
2017-02-02T09:30:00-05:00,227.2,228.1,226.82,227.77,69657560,73053644.7,56.245773147085295,58.166576078281615,NaN,NaN,37.33946356742021,66.60563269901013,-0.13067453396299045,0.9056461994191238,1.0363207333821143,7956002634,7899105767.8,51.65312032995051,65.26767437952746,NaN,NaN,16.36597603117291,18.5315737932515
2017-02-03T09:30:00-05:00,228.82,229.55,228.46,229.34,80563168,73162852.5,62.67025769749461,58.333235340689065,NaN,NaN,143.21664642038553,60.18825223766087,-0.048059283913052475,0.9762466284907987,1.0243059124038512,8036565802,7913849832.2,54.25617225601218,64.60426022934837,NaN,NaN,17.6793334459247,18.409825172204815
2017-02-06T09:30:00-05:00,228.87,229.326,228.54,228.93,57790108,72474361.8,60.18497801839868,58.63699229093588,NaN,NaN,110.53731077831681,73.03354875584373,-0.029261942274039443,0.9877284845613019,1.0169904268353414,7978775694,7932983325.4,57.45728736067019,64.16105711028561,NaN,NaN,18.055259346172964,18.359172911343123
2017-02-07T09:30:00-05:00,229.38,229.6556,228.72,228.94,57931151,73023935.55,60.22640749387648,58.79628996584598,NaN,NaN,105.8229866452436,90.54331484113422,-0.024579704289561244,0.9862657964733899,1.010845500762951,8036706845,7978879209.8,63.97044825927474,64.05680260092535,NaN,NaN,18.373297896157744,18.36119076631664
2017-02-08T09:30:00-05:00,228.61,229.39,228.31,229.24,51566218,72413649.5,61.52001724877081,59.37158443283118,NaN,NaN,85.81567634684806,96.54641675164282,-0.010426845847754995,0.9978119434532573,1.0082387893010123,8088273063,8019264807.6,68.53530920983246,64.59843298132577,NaN,NaN,18.995322763722108,18.451781051660276
2017-02-09T09:30:00-05:00,229.56,230.95,229.52,230.6,65955245,71978910.95,66.79283330611241,60.06842592532128,NaN,NaN,144.9674007410566,118.07200418637008,0.07659058633184257,1.1039770222158154,1.0273864358839728,8154228308,8058909942.4,72.2519397362661,65.13774312975137,NaN,NaN,21.135843827258956,18.835218591031516
2017-02-10T09:30:00-05:00,231,231.77,230.6216,231.51,66015892,71674046.5,69.77705886164652,61.20449096611149,NaN,NaN,167.3482217088399,122.89831924406096,0.17582400996764957,1.2471664483435347,1.0713424383758852,8220244200,8095645622,75.17777272501554,65.96100852698666,NaN,NaN,23.92061151103759,19.561703293889526
2017-02-13T09:30:00-05:00,232.08,233.07,232.05,232.77,55182050,71297255.75,73.34844067556419,62.17373592050159,NaN,NaN,194.821075700204,139.7550722284384,0.29944764419463565,1.4456519936191796,1.146204349424544,8275426250,8154975733.2,79.02457182120696,66.76631373652125,NaN,NaN,27.545870848462968,20.70229865882859
2017-02-14T09:30:00-05:00,232.56,233.71,232.16,233.7,71108983,71790664.2,75.63683253758441,62.85310278375573,NaN,NaN,190.95319241613618,156.78111338261692,0.41013570390574006,1.658873979306719,1.248738275400979,8346535233,8216941410.8,82.138065413871,67.49784948691209,NaN,NaN,31.377813388839975,22.22737219168736
2017-02-15T09:30:00-05:00,233.45,235.14,233.39,234.92,86785826,73390290.4,78.27243764992247,63.81652746905088,NaN,NaN,211.87004017435513,181.99198614811831,0.5244858853966112,1.9043456321467431,1.379859746750132,8433321059,8285951010,84.83738462278066,68.16960021105818,NaN,NaN,35.57545709590536,24.1342414637185
2017-02-16T09:30:00-05:00,234.96,235.155,233.85,234.72,84722437,74295972.9,76.80555931138363,64.82198067680989,NaN,NaN,173.40395398241873,187.67929679639076,0.5433204963569975,2.059010367196379,1.5156898708393813,8348598622,8324825072.8,86.11071406107683,68.99345149119505,NaN,NaN,38.45971375012701,26.180737504634
2017-02-17T09:30:00-05:00,233.95,235.09,233.93,235.09,77204104,71697746.95,77.64040383630807,66.41918210297747,NaN,NaN,146.16785162393538,183.44322277940984,0.5364381877861317,2.186237605572046,1.6497994177859143,8425802726,8365936778,87.32317408784813,69.9882905936142,NaN,NaN,41.082721993568896,28.309592431624697
2017-02-21T09:30:00-05:00,235.52,236.69,235.51,236.49,88946051,72391967.25,80.50035948873844,68.22776587958305,NaN,NaN,160.2480211147225,176.52861186231354,0.5783073368523217,2.3726835888513165,1.7943762519989948,8514748777,8413801283.4,88.57378618583817,71.8250246693552,NaN,NaN,44.35472111420592,30.601753671993443
2017-02-22T09:30:00-05:00,236.02,236.54,235.83,236.28,62115185,70719961.75,78.87073635458731,69.8922925448195,NaN,NaN,135.10509499088027,165.35899237726238,0.5444735869665145,2.474968235707138,1.9304946487406234,8452633592,8435020955.2,89.0877541064225,74.31410715543328,NaN,NaN,46.495544155263616,32.87229516960347
2017-02-23T09:30:00-05:00,236.88,236.9,235.56,236.44,74615902,70228871.25,79.21596325915914,71.53302040996763,NaN,NaN,118.2078994069955,146.62656422379047,0.487335917875245,2.53966454608468,2.052328628209435,8527249494,8453806642.2,89.53648341536388,77.02006166153423,NaN,NaN,48.34102769778485,35.08211410220081
2017-02-24T09:30:00-05:00,235.46,236.7932,235.41,236.74,82381612,71349415.9,79.87976631595116,72.76227102557168,NaN,NaN,103.64076391777945,132.6739262108626,0.4264107905269632,2.585342116368139,2.1589313258411758,8609631106,8506013139,90.68311330859785,79.62198602243322,NaN,NaN,50.07373415052177,37.22377410910381
2017-02-27T09:30:00-05:00,236.64,237.31,236.35,237.11,56515440,71189632,80.69854141918537,74.22752555419929,NaN,NaN,103.49745059717324,124.13984600551017,0.36980091358961253,2.6211824678281914,2.251381554238579,8666146546,8554081903,91.59626139810497,82.06048416796428,NaN,NaN,51.773974396191115,39.30237415011628
2017-02-28T09:30:00-05:00,236.67,236.95,236.015,236.47,96961938,72050866.3,75.01227896147489,75.28365923045634,NaN,NaN,86.03740423585334,109.29772262973631,0.25356464376104526,2.5683373589398855,2.31477271517884,8569184608,8564969069.2,91.79247062551846,84.04777147983881,NaN,NaN,51.65976639171722,41.06771589891641
2017-03-01T09:30:00-05:00,238.39,240.32,238.37,239.78,149158170,75714734.55,82.05496384660559,76.75044113030167,NaN,NaN,136.40463691216172,109.55763101399262,0.3575508503249636,2.761711278085045,2.404160427760081,8718342778,8618110906.4,92.68967240626559,85.7730831367269,NaN,NaN,53.98454263147242,42.912976860710124
2017-03-02T09:30:00-05:00,239.56,239.57,238.21,238.27,70245978,75271150.9,72.07498126825382,77.12773741331178,NaN,NaN,109.66211875693186,107.84847488397986,0.28570103958208604,2.761286727237689,2.475585687655603,8648096800,8642280367.6,93.06118868411068,87.25945806157293,NaN,NaN,52.32132416128664,44.2570264750782
2017-03-03T09:30:00-05:00,238.17,238.61,237.73,238.42,81974300,75886987.9,72.43365788251636,77.31749448623104,NaN,NaN,94.22309046347321,105.96494019311861,0.21269325698311237,2.741452258884493,2.528759001901381,8730071100,8666368366.4,93.4200934056027,88.56248096732917,NaN,NaN,51.17100990692062,45.24473839391283
2017-03-06T09:30:00-05:00,237.5,238.12,237.01,237.71,55391533,74628406.15,67.98263953726045,76.9342229763522,NaN,NaN,75.03030918129622,100.2715119099432,0.08741890682257214,2.638032635429596,2.550613728607024,8674679567,8668074970.6,93.44595885507258,89.5925800411767,NaN,NaN,48.762821329823495,45.7473216704715
2017-03-07T09:30:00-05:00,237.36,237.77,236.76,237,65103737,74994087.6,63.763026981079065,76.0860940080304,NaN,NaN,58.837747741171455,94.83158061100684,-0.06424727224406723,2.47030463830194,2.534551910546007,8609575830,8676153215,93.57471313797484,90.40948345004128,NaN,NaN,45.40955541198494,45.699069347830566
2017-03-08T09:30:00-05:00,237.34,237.64,236.4,236.56,78168795,76005969.8,61.226760703238206,74.86854565469581,NaN,NaN,45.312484250228465,76.61315007862018,-0.20712754489113072,2.2756424794320935,2.4827700243232242,8531407035,8638766066.4,85.22958632277174,90.43749785718349,NaN,NaN,41.885102860933856,45.154216992559604
2017-03-09T09:30:00-05:00,236.7,237.24,235.74,236.86,90683918,77961854.8,62.32705473613571,73.83436675646381,NaN,NaN,31.68067277547447,61.01686088232871,-0.28931380481760227,2.1211277683012213,2.4104415731188236,8622090953,8633564897,84.10585112410278,90.29429336168535,NaN,NaN,39.333296139954726,44.322656870758905
2017-03-10T09:30:00-05:00,237.97,238.02,236.59,237.69,81991652,78763675.15,65.26401338566477,72.95033886713215,NaN,NaN,58.25030854913982,53.82230449946203,-0.29466712735084544,2.042107663930267,2.3367747912811123,8704082605,8628367198,82.92912472698039,89.98043269305194,NaN,NaN,38.01011857233859,43.420865685270286
2017-03-13T09:30:00-04:00,237.62,237.86,237.24,237.81,57256824,78325721.75,65.68059096811035,71.89178397280156,NaN,NaN,64.53746915628652,51.72373649446009,-0.296221358536477,1.9664980931105163,2.2627194516469933,8761339429,8645699170.4,83.74577676864145,89.63557487753789,NaN,NaN,37.053479235893775,42.51123904964507
2017-03-14T09:30:00-04:00,237.18,237.24,236.19,236.9,59880778,78560658.15,59.82164568167088,70.53113463902181,NaN,NaN,10.94468459190471,42.14512386460675,-0.36036996283570977,1.812256998102356,2.1726269609380657,8701458651,8664075734.6,84.5876581535627,89.3141394523336,NaN,NaN,34.47888772717305,41.363760289291925
2017-03-15T09:30:00-04:00,237.56,239.44,237.29,238.95,96081750,79809296.5,66.96975705828933,69.65640562467397,NaN,NaN,113.21550172022192,55.72572735860545,-0.27066709076921525,1.8342930974765466,2.104960188245762,8797540401,8717302407.8,86.73134472611065,89.11377240310124,NaN,NaN,34.36905633631763,40.364516867438454
2017-03-16T09:30:00-04:00,239.11,239.2,238.1,238.48,78343951,79387202.75,64.15178556501144,68.53297842817827,NaN,NaN,103.5735429701566,70.10430139754186,-0.2494390744660846,1.7931613451631563,2.042600419629241,8719196450,8736723507.2,87.41894927299839,88.88061782912985,NaN,NaN,33.387274058308044,39.36776789470554
2017-03-17T09:30:00-04:00,237.75,237.97,237.03,237.03,89002111,79601186.45,56.2832825106342,66.78903136328175,NaN,NaN,10.177566128723297,60.48975291345855,-0.33421536730355905,1.6248312104997922,1.9590465778033512,8630194339,8721945854,83.85794584785326,88.32788100411186,NaN,NaN,29.917854325397492,38.01778024194724
2017-03-20T09:30:00-04:00,237.03,237.36,236.32,236.77,52536979,78367830.2,54.98105616832302,65.35822973519949,NaN,NaN,-42.87924830281516,39.006409421638224,-0.4042842297389615,1.4536912906296493,1.8579755203686108,8577657360,8685209440.2,75.61211936376968,87.17214162827267,NaN,NaN,26.749041024818617,36.40796035378601
2017-03-21T09:30:00-04:00,237.47,237.61,233.58,233.73,131809275,80510991.4,42.576926776605866,62.53836994448522,NaN,NaN,-182.4914986712998,0.31917276899731634,-0.6379532940516914,1.0605339028039964,1.6984871968556878,8445848085,8634087327,65.90081666589091,85.25865193253162,NaN,NaN,19.136274336267014,33.940576636997584
2017-03-22T09:30:00-04:00,233.77,234.61,233.05,234.28,97569204,82283692.35,44.99478518133299,60.60407022399087,NaN,NaN,-224.91655075672472,-67.307237726392,-0.7313550392602057,0.7842933977804307,1.5156484370406365,8543417289,8583262704.6,57.93424482876805,82.74958451429286,NaN,NaN,14.027649764712061,31.095872798099652
2017-03-23T09:30:00-04:00,234,235.34,233.6,234.03,100410277,83573411.1,44.08611092582547,58.5792454413701,NaN,NaN,-174.99970502330694,-123.0218873250847,-0.7813308974425903,0.5389848152373986,1.320315712679989,8443007012,8528024817,50.75314123747294,79.70194507371215,NaN,NaN,9.741036452960925,28.04518189165126
2017-03-24T09:30:00-04:00,234.38,235.04,232.96,233.86,112504853,85079573.15,43.44362197512212,56.826458472645925,NaN,NaN,-171.65210274188271,-159.38782109920592,-0.7945822096014383,0.32708795067819096,1.1216701602796293,8330502159,8468086381,44.33181956462204,76.1937922672514,NaN,NaN,6.134740415743367,24.915118823664418
2017-03-27T09:30:00-04:00,231.93,233.92,231.61,233.62,87454452,86626523.75,42.501907386242436,55.30780707301473,NaN,NaN,-178.54392655968834,-186.52075675058055,-0.786776854989405,0.13819909154287302,0.924975946532278,8243047707,8401164450.4,38.478205949806764,72.25832746809654,NaN,NaN,2.9171841537430585,21.772556727961366
2017-03-28T09:30:00-04:00,233.27,235.81,233.14,235.32,93483915,86452622.6,50.660421522358305,54.553068560094744,NaN,NaN,-84.68646272540968,-166.95974956140253,-0.6405832677599219,0.12424686183237554,0.7648301295922975,8336531622,8379301157.8,36.77002373943965,68.79693014071567,NaN,NaN,2.5278234548013625,19.02330911750994
2017-03-29T09:30:00-04:00,234.99,235.81,234.725,235.54,60786374,82034032.8,51.61719065830908,53.7880782688214,NaN,NaN,-49.063098165967716,-131.78905904325111,-0.5083044503736799,0.12944956662519758,0.6377540169988775,8397317996,8350081299.2,34.561704965161525,65.25806255793415,NaN,NaN,2.5026184674065295,16.66321045320945
2017-03-30T09:30:00-04:00,235.47,236.52,235.27,236.29,56737890,81358628.4,54.83276457698613,53.04298906820151,NaN,NaN,-13.246633857185378,-99.43844481002682,-0.35669952485386136,0.19187961093155081,0.5485791357854122,8454055886,8352291074,34.88022396449182,61.8259982177564,NaN,NaN,3.451734955921625,14.775856810739763
2017-03-31T09:30:00-04:00,235.9,236.51,235.68,235.74,73733094,80946568.1,52.09827143185613,52.07282338704049,NaN,NaN,-10.744685508442936,-67.25696136333885,-0.28307872246880006,0.1947307326994121,0.47780945516821216,8380322792,8362255200.6,36.383873054586516,58.4430050953239,NaN,NaN,3.4520650757096143,13.158172277164027
2017-04-03T09:30:00-04:00,235.8,236.03,233.91,235.33,85546486,82454315.75,50.092793895945654,51.37790540234583,NaN,NaN,-49.38912451732298,-41.42600095486577,-0.25261651517079076,0.16203881120472374,0.4146553263755145,8294776306,8372600920.4,37.98503859126929,55.11424655516009,NaN,NaN,2.8793263491518504,11.68976571601943
2017-04-04T09:30:00-04:00,235,235.58,234.555,235.48,56466195,82022438.65,50.838405288905676,50.225665990247,NaN,NaN,-39.029806132045415,-32.29466963619293,-0.2144885025203661,0.1465446982250569,0.361033200745423,8351242501,8375543096.2,38.459415148059875,51.66625158529933,NaN,NaN,2.612892518794035,10.393069544987231
2017-04-05T09:30:00-04:00,236.26,237.39,234.54,234.78,108800604,83554029.1,47.28789539310495,49.02110240653939,NaN,NaN,-17.339429566746166,-25.949935916348625,-0.22731059657426023,0.07689495502759769,0.3042055516018579,8242441897,8344567876.4,35.390116200262284,47.949906365818165,NaN,NaN,1.3903843810204979,9.106971664420556
2017-04-06T09:30:00-04:00,234.94,236.04,234.425,235.44,69135757,82476621.05,50.77837672369783,48.627894850329646,NaN,NaN,-28.201831030819324,-28.940975351075405,-0.1840849654631973,0.07409934477286129,0.2581843102360586,8311577654,8316072230,32.79701407744629,44.30269695364625,NaN,NaN,1.3163385498599225,7.99402407662618
2017-04-07T09:30:00-04:00,235.15,236,234.64,235.2,74412311,82097654,49.494901708951986,48.23602667466029,NaN,NaN,-25.127903502889374,-31.817618949964697,-0.16501199561646268,0.05191931571548025,0.21693131133194293,8237165343,8287440740.2,30.38774029306157,41.07238416288137,NaN,NaN,0.9038940749718709,6.981148362104135
2017-04-10T09:30:00-04:00,235.36,236.255,234.73,235.34,67615302,82615577.9,50.28431334717074,48.7865542868435,NaN,NaN,-10.975339043000758,-24.13486185510025,-0.13745047456414655,0.04511821812675976,0.1825686926909063,8304780645,8289441608,30.770478931849013,38.563074324735524,NaN,NaN,0.7685493074202407,6.093634211435008
2017-04-11T09:30:00-04:00,234.9,235.18,233.34,235.06,88045276,84023802.8,48.6466088037436,49.04739883130139,NaN,NaN,-63.149300071995405,-28.95876064309025,-0.1325034559120802,0.01693937280080604,0.14944282871288625,8216735369,8262540181.6,28.50152213295705,36.46073698932045,NaN,NaN,0.22574617388070048,5.255364491784393
2017-04-12T09:30:00-04:00,234.74,234.96,233.77,234.03,81864436,83312937.1,43.087352283623204,48.97605892828694,NaN,NaN,-78.52782402504108,-41.19643953474923,-0.18955134582558403,-0.0874963535690938,0.10205499225649023,8134870933,8241025988.8,26.79954462328604,34.749765802592826,NaN,NaN,-1.8237182122832687,4.244066962631869
2017-04-13T09:30:00-04:00,233.64,234.49,232.51,232.51,92880394,84039759.25,36.46475314935632,48.4775682978751,NaN,NaN,-150.54288485147134,-65.6646502988796,-0.3133045281418213,-0.2895756679207864,0.023728860221034903,8041990539,8187108565.8,23.07984843968339,33.23176786509721,NaN,NaN,-5.791528898063851,2.810410411103909
2017-04-17T09:30:00-04:00,233.11,234.57,232.88,234.57,68405367,83009922.05,48.10610126489382,48.87786786063591,NaN,NaN,-73.6871127363719,-75.3764921455761,-0.24319862826852787,-0.28026942511462494,-0.03707079684609707,8110395906,8161754678.4,21.564150949014973,32.02362107932637,NaN,NaN,-5.556484927539642,1.6151396484405447
2017-04-18T09:30:00-04:00,233.72,234.49,233.08,233.87,83225821,84544364.15,45.08323372413847,48.47949730362022,NaN,NaN,-81.80626767528184,-89.54267787203231,-0.230843131738116,-0.32562471151874206,-0.09478157978062607,8027170085,8106232566.4,18.672256211690197,30.730923398772838,NaN,NaN,-6.367757997304708,0.4747256990483657
2017-04-19T09:30:00-04:00,234.52,234.95,233.18,233.44,68699868,81388893.8,43.28394486789484,47.884265461447775,NaN,NaN,-69.91006929090236,-90.8948317158137,-0.23757525733363166,-0.39175065144766563,-0.15417539411403397,7958470217,8054579536,16.46063290121758,29.437989679919703,NaN,NaN,-7.594437840349312,-0.6780119494370169
2017-04-20T09:30:00-04:00,234.15,235.845,233.78,235.34,92572186,81139042.9,52.335981693779445,47.70592382693301,NaN,NaN,26.48278164030016,-69.89271058274545,-0.10668158677784753,-0.2875273775863434,-0.18084579080849586,8051042403,8037813830,15.806218185075906,28.075560695675712,NaN,NaN,-5.563129392955255,-1.3758858699396224
2017-04-21T09:30:00-04:00,235.25,235.31,234.13,234.59,110389847,81638021.4,49.010735092239386,47.485385516960385,NaN,NaN,-3.592483060420709,-40.502630224535324,-0.06526205615225097,-0.2624233609988096,-0.1971613048465586,7940652556,8017546233.4,15.028389323827113,26.55016900062147,NaN,NaN,-5.0316428815615275,-1.8981368715998945
2017-04-24T09:30:00-04:00,237.18,237.41,236.61,237.17,119209877,81973272.6,58.72579216104007,48.10202825018141,NaN,NaN,189.22796457501974,12.080385237742997,0.13056710266921423,-0.03395242651004082,-0.16451952917925505,8059862433,8007439538.8,14.641459656051737,24.88277050524878,NaN,NaN,-0.9096724723085086,-1.756927671701125
2017-04-25T09:30:00-04:00,237.91,238.95,237.81,238.55,75050935,81353096.75,62.807704321292576,48.95697818106619,NaN,NaN,266.0546756783802,81.6525739084754,0.3360327515153213,0.2555214102148966,-0.08051134130042471,8134913368,8028988195.4,19.405969303070535,23.521810087749543,NaN,NaN,3.955546665429989,-0.940859909253823
2017-04-26T09:30:00-04:00,238.51,239.53,238.35,238.4,84702455,80914023.75,62.08892445954256,50.01419454295459,NaN,NaN,230.00313852083116,141.6352154708221,0.4383606045364579,0.4674394143701477,0.029078809833689767,8050210913,8047336334.6,23.330178852217912,22.66038599146066,NaN,NaN,7.388038913260978,0.2489827796768629
2017-04-27T09:30:00-04:00,238.77,238.95,237.98,238.6,57410326,80745221.35,62.70183052460951,50.86586981444828,NaN,NaN,169.33209664874312,170.2050784725107,0.4920165599487535,0.6440995097696316,0.1520829498208781,8107621239,8058652101.8,25.731930568868123,22.155737169419364,NaN,NaN,10.270068430303432,1.6805664440520869
2017-04-28T09:30:00-04:00,238.9,238.93,237.93,238.08,63532845,81084969.1,59.98640030976294,51.61526257164906,NaN,NaN,134.51515453305962,197.82660599120678,0.4652830558126211,0.7336867695866545,0.2684037137740334,8044088394,8079339269.4,30.04628813420831,22.13134772950128,NaN,NaN,11.79312884905403,3.1252182161952216
2017-05-01T09:30:00-04:00,238.68,239.17,238.195,238.68,66882521,80742440.45,62.02971328540448,52.45421971009433,NaN,NaN,128.01608335421818,185.58422974704644,0.45997971957053885,0.8433783632372069,0.3833986436666681,8110970915,8089560965.8,32.143826881064896,22.22944401158813,NaN,NaN,13.681761722855478,4.633295860003829
2017-05-02T09:30:00-04:00,238.84,238.98,238.3,238.77,57375732,79333902.75,62.340368947297705,53.43234543463391,NaN,NaN,108.3502441213352,154.04334343563744,0.4347910116699822,0.9268874082541458,0.49209639658416365,8168346647,8096247621.6,33.547548249098256,22.589874448455358,NaN,NaN,15.298246939649513,6.1568602999532125
2017-05-03T09:30:00-04:00,238.29,238.8775,237.7,238.48,73137731,80167479.55,60.619345405842886,54.6846306576496,NaN,NaN,83.42144864638311,124.72700546074785,0.3732172828326008,0.9586180001249147,0.5854007172923139,8095208916,8105247222.2,35.48205835323088,23.210054000594276,NaN,NaN,16.17027854225348,7.587348620281822
2017-05-04T09:30:00-04:00,238.83,238.9225,237.78,238.76,61462732,77800585.95,61.718235126946695,56.48845079890605,NaN,NaN,78.310971572944,106.52278044558803,0.3275913550728564,0.9948899111333844,0.667298556060528,8156671648,8115057304,37.614027992474085,24.24820968293647,NaN,NaN,17.204401274956115,8.961213285235292
2017-05-05T09:30:00-04:00,239.19,239.72,238.68,239.7,62001269,77443861.55,65.22636583875104,57.71132683989585,NaN,NaN,96.23128972728264,98.86600748443263,0.33572599775125267,1.0869560532495939,0.7512300554983412,8218672917,8149974208.6,44.62763426717308,25.89560134851919,NaN,NaN,19.122321315777864,10.412800146741374
2017-05-08T09:30:00-04:00,239.75,239.92,239.17,239.66,48385730,76142532.5,64.95359131593665,59.13063809645286,NaN,NaN,92.7079096692112,91.80437274743124,0.3138237950533369,1.1435097993150123,0.8296860042616754,8170287187,8161837463,46.81536278460782,27.90582324658473,NaN,NaN,20.630856075682715,11.872522422304423
2017-05-09T09:30:00-04:00,239.96,240.19,239.04,239.44,51363200,75329927.4,63.38357302177912,60.5663258217303,NaN,NaN,83.62602959455288,86.85952984207478,0.262040781844893,1.1572369815677916,0.8951961997228987,8118923987,8151952931,45.21250186463525,29.959528172543138,NaN,NaN,21.501122463034232,13.248036713837251
2017-05-10T09:30:00-04:00,239.39,239.87,239.15,239.87,54293799,73642353.55,65.1563559899172,61.482066842883,NaN,NaN,79.83466100754801,86.14217231430776,0.23512784414997823,1.1891060049103714,0.9539781607603932,8173217786,8167554705,48.22567736176414,32.27520382802087,NaN,NaN,22.727132038741964,14.60219318882364
2017-05-11T09:30:00-04:00,239.35,239.57,238.13,239.38,62358346,72667049.05,61.50223587234306,62.3743168986047,NaN,NaN,56.33826453978043,81.74763090767503,0.16596565400845376,1.1614352282709604,0.9954695742625066,8110859440,8158392263.4,46.60463635135522,34.530650044272875,NaN,NaN,22.834290205820203,15.778207048394577
2017-05-12T09:30:00-04:00,239.09,239.4273,238.67,238.98,53912730,70718665.85,58.61245736715465,62.36622155618431,NaN,NaN,52.9340100888935,73.0881749799972,0.07931336767644082,1.0946112838580575,1.0152979161816167,8056946710,8126047022,41.323831611327584,36.43653375536401,NaN,NaN,22.15759891922459,16.689548744227437
2017-05-15T09:30:00-04:00,239.47,240.44,239.45,240.3,61918937,70394344.35,64.53457983750502,62.48956980734234,NaN,NaN,92.23067186735746,72.99272741962645,0.09582669448537295,1.1350812842883329,1.03925458980296,8118865647,8115762714,39.78039280832581,37.8918497200251,NaN,NaN,23.221463025069124,17.62267935577625
2017-05-16T09:30:00-04:00,240.64,240.67,239.63,240.08,51241791,68795142.85,62.91865699447244,62.548836416980194,NaN,NaN,99.96191848735916,76.25990519818771,0.07763896238300694,1.1363032927817187,1.0586643303987118,8067623856,8105502687.8,38.245672596377716,38.95724213032223,NaN,NaN,23.65210824668644,18.484026340191992
2017-05-17T09:30:00-04:00,238.1,238.64,235.75,235.82,172174107,73968854.8,41.3352400916917,61.0226513860575,NaN,NaN,-107.98866676884707,38.69523964290869,-0.21934560692653693,0.7844823217405406,1.0038279286670775,7895449749,8049949080.4,31.22193286791685,39.34938515168285,NaN,NaN,15.906481918942763,18.115805708584958
2017-05-18T09:30:00-04:00,235.73,237.75,235.43,236.77,107047656,74692628.3,45.8003858458977,60.00936463863855,NaN,NaN,-133.4218192489062,0.743222885171366,-0.34251624924102,0.5756826171158025,0.9181988663568225,8002497405,8028276673.4,28.985544922968685,39.27361777945145,NaN,NaN,11.429332372273745,17.16059523196907
2017-05-19T09:30:00-04:00,237.33,239.08,237.27,238.31,115011373,74923704.6,52.157422432780784,59.30420100630829,NaN,NaN,-41.064718312607646,-18.056522795128863,-0.31185379538203883,0.5283816221292739,0.8402354175113127,8117508778,8040389087,31.92056792168431,39.257670710924266,NaN,NaN,10.084399336425651,16.149710104034295
2017-05-22T09:30:00-04:00,238.9,239.71,238.82,239.52,61010602,72013740.85,56.47686785430908,58.88537949966625,NaN,NaN,56.68524835192326,-25.165607498215707,-0.2067281647610374,0.581825211560016,0.7885533763210534,8178519380,8052319833.6,34.7799203510023,39.345697289631694,NaN,NaN,10.589286200158043,15.355363832051973
2017-05-23T09:30:00-04:00,239.95,240.24,239.51,240.05,48341683,70678278.25,58.2547213427112,58.716477780871124,NaN,NaN,100.9722997751348,-24.963531240660572,-0.10336615289779061,0.6593456851988151,0.7627118380966057,8226861063,8084167275,41.806122891812784,39.797416185244685,NaN,NaN,11.59977870499927,14.818851671044444
2017-05-24T09:30:00-04:00,240.32,240.73,239.93,240.61,49181099,68902210.45,60.108888174993616,58.60152442716019,NaN,NaN,127.2931164301784,22.092825399144516,-0.004377828278642637,0.7572395527483025,0.7616173810269451,8276042162,8160285757.6,54.4396963120023,40.99924963663956,NaN,NaN,13.021241580348446,14.562050229516444
2017-05-25T09:30:00-04:00,241.2,242.08,240.96,241.76,64071661,69235277.2,63.676844355914426,58.49084432124329,NaN,NaN,191.68011325044606,87.11321189901496,0.1243424219699415,0.917045408489372,0.7927029865194305,8340113823,8227809041.2,62.26559971267527,42.25910431131829,NaN,NaN,15.409339620448897,14.683091571078224
2017-05-26T09:30:00-04:00,241.54,241.9,241.45,241.71,46629905,68390130.2,63.4112818543527,58.380679359701574,NaN,NaN,170.91048262231402,129.50825208599932,0.18808574086904128,1.027810162605732,0.8397244217366908,8293483918,8263004069.2,65.58394381852284,43.599717242312224,NaN,NaN,17.1901578035527,15.04124389000315
2017-05-30T09:30:00-04:00,241.34,241.79,241.16,241.5,35201897,66806099,62.23727731197227,58.29880109471537,NaN,NaN,137.64544843606052,145.70029210282675,0.19712173624297935,1.086126592040415,0.8890048557974357,8258282021,8278956597.4,67.00047001626855,45.156000681714595,NaN,NaN,18.284622944240443,15.504583754894192
2017-05-31T09:30:00-04:00,241.84,241.88,240.64,241.44,91796016,68527113.2,61.884741319161655,58.06511433251855,NaN,NaN,112.88796768957248,148.0834256857143,0.18051792854168036,1.1146522664745362,0.9341343379328558,8166486005,8266881585.8,64.82550567469673,46.34170270406692,NaN,NaN,19.075990978620144,16.014784786855042
2017-06-01T09:30:00-04:00,241.97,243.38,241.64,243.36,68962024,68318327.85,68.10981598952056,58.53708434088843,NaN,NaN,173.9496872942593,157.41473985853048,0.2746615255193472,1.2774612448320397,1.0027997193126925,8235448029,8258762759.2,63.3367599499318,47.53685438967953,NaN,NaN,21.763117523819346,16.835975177849942
2017-06-02T09:30:00-04:00,243.42,244.35,243.08,244.17,88666128,69678497.65,70.31266806905583,59.37281367673851,NaN,NaN,194.69641426270775,158.0180000609828,0.36182067128495277,1.4550755584188835,1.0932548871339307,8324114157,8255562826,62.725325551426494,49.065532528258025,NaN,NaN,24.718127782892516,17.96199697857031
2017-06-05T09:30:00-04:00,243.97,244.3,243.76,243.99,44698825,68813375.45,69.1692279961839,59.703859973787004,NaN,NaN,165.51346837636726,156.93859721179345,0.3760289222193194,1.56329103990808,1.1872621176887606,8279415332,8252749108.8,62.157115264488105,50.66386984655533,NaN,NaN,26.77248316951875,19.220637862991513
2017-06-06T09:30:00-04:00,243.34,243.98,243.12,243.21,50375430,68912860.45,64.29022006803905,59.801828764756046,NaN,NaN,119.87462810416744,153.38443314541485,0.3046205013079999,1.5680377443237603,1.2634172430157604,8229039902,8246900685,60.92178840137901,52.283592404055426,NaN,NaN,27.09801529781602,20.34597749653787
2017-06-07T09:30:00-04:00,243.6,243.92,242.83,243.66,54144311,69051916,65.78949299995534,61.54856111534631,NaN,NaN,105.36838139763442,151.88051588702723,0.26109399133018085,1.5897847321784866,1.3286907408483057,8283184213,8270240326.6,63.996965763361246,54.62466618230145,NaN,NaN,27.803571191120348,21.411348024335368
2017-06-08T09:30:00-04:00,243.77,244.33,243.17,243.78,65950691,69634760.6,66.19706222911609,63.00546657129047,NaN,NaN,102.45448713265047,137.58147585470547,0.21567013946035685,1.598278415173752,1.382608275713395,8349134904,8292977701.6,66.74266964854498,57.321603662699765,NaN,NaN,28.496935602008428,22.423574821145806
2017-06-09T09:30:00-04:00,244.09,245.01,241.95,243.41,132256362,73129661.4,63.678013628713344,63.828365942428505,NaN,NaN,83.22953821878788,115.28810064592149,0.13967605268054473,1.557203341564076,1.4175272888835313,8216878542,8271530578.6,61.9439344782973,59.46612984531498,NaN,NaN,28.399032543055274,23.277211638561443
2017-06-12T09:30:00-04:00,243.13,243.42,242.38,243.36,86108102,74739430,63.32730873519615,64.31768314820616,NaN,NaN,63.57762467424605,94.90093190549726,0.06860817295031629,1.5032875050714267,1.4346793321211104,8130770440,8241801600.2,55.93993316653981,60.97755933213909,NaN,NaN,28.225216940397768,23.984069538823775
2017-06-13T09:30:00-04:00,243.98,244.61,243.5799,244.55,60066953,74646830.8,67.86369383200002,65.0040383260125,NaN,NaN,96.554819858095,90.23697025628276,0.08333097128158595,1.5388430462230929,1.455512074941507,8190837393,8234161098.4,54.4784516482303,61.88272567188319,NaN,NaN,29.333163252830236,24.74822578368184
2017-06-14T09:30:00-04:00,244.86,244.87,243.29,244.24,78602311,76014856.8,65.58760949203803,65.39537556294425,NaN,NaN,84.15807070856822,85.99490811846951,0.055137487297226784,1.5244339340630404,1.4692964467658136,8112235082,8199971272.2,48.386514453894584,61.450355539161215,NaN,NaN,29.641805477009324,25.447308597014338
2017-06-15T09:30:00-04:00,242.68,243.91,242.36,243.77,66464888,70729395.85,62.182434578928834,65.28863200744527,NaN,NaN,50.994062918847895,75.70282327570901,-0.008813637695610055,1.458279399646301,1.467093037341911,8045770194,8139298330.2,39.86680252071082,59.8504414540209,NaN,NaN,28.967983070709103,25.95026209325645
2017-06-16T09:30:00-04:00,242.77,242.83,241.6337,242.64,84553097,69604667.9,54.814012632453604,64.67454134873819,NaN,NaN,3.232543307277497,59.70342429340694,-0.1339241057420737,1.299687905164319,1.4336120109063928,7961217097,8088166041.2,34.37376528109482,57.62114298706176,NaN,NaN,26.18035347552826,25.98313229072385
2017-06-19T09:30:00-04:00,243.59,244.73,243.48,244.66,65123802,67110289.35,63.20720466597769,64.74382187402429,NaN,NaN,88.97886057683795,64.78367147392531,-0.08947868653829572,1.321763652733523,1.4112423392718187,8026340899,8067280133,32.40943116140055,55.150354497428324,NaN,NaN,26.244480886709727,26.02046780443612
2017-06-20T09:30:00-04:00,244.25,244.26,242.99,243.01,56906368,66905077.65,54.329927725068565,64.20419233158908,NaN,NaN,37.830179758558536,53.03874345401802,-0.17509571055121254,1.1923727010828031,1.3674684116340157,7969434531,8022999560.6,28.668819615938872,52.56773406465991,NaN,NaN,23.207121228532177,25.618561150735555
2017-06-21T09:30:00-04:00,243.42,243.59,242.41,242.95,55977569,67286871.95,54.03274592236241,63.19868732679207,NaN,NaN,1.8905889915359861,36.585247110611576,-0.23587600435726674,1.0726234061874322,1.308499410544699,7913456962,7983243936.6,25.790726688614527,49.88587454599438,NaN,NaN,20.77115710897633,24.926074859055667
2017-06-22T09:30:00-04:00,242.96,243.53,242.64,242.84,44148059,67035219.95,53.45544644455648,61.99460006789926,NaN,NaN,-7.423324752245508,24.901769576392894,-0.2805561874652547,0.9578041762131306,1.2383603636783853,7869308903,7947951678.4,23.532210150384955,47.086366303062846,NaN,NaN,18.65885270049216,24.030757407832308
2017-06-23T09:30:00-04:00,242.91,243.51,242.47,243.13,66986801,67180976.95,54.82577538221417,60.970067738329995,NaN,NaN,-12.130246900720383,21.82921153479332,-0.28663641424065256,0.8800648458775697,1.1667012601182223,7936295704,7942967399.8,23.222907365167558,44.30535145311137,NaN,NaN,17.318539467887692,23.071869130697362
2017-06-26T09:30:00-04:00,243.9,244.38,243.045,243.29,56700477,67684505.55,55.602419278780474,60.34951053909724,NaN,NaN,35.539599511168355,11.141359321659401,-0.2758471945852239,0.8218922668866924,1.0977394614719163,7992996181,7936298456.2,22.791260222113863,41.58174229744958,NaN,NaN,16.431243679661474,22.12320835197795
2017-06-27T09:30:00-04:00,243.04,243.38,241.31,241.33,82247666,70036794,45.32296012077772,58.887615333441694,NaN,NaN,-149.66821043029034,-26.358318716110375,-0.3897148571839344,0.6105958899919983,1.0003107471759327,7910748515,7924561253,22.015662884490297,38.583077806101656,NaN,NaN,12.296007116950374,20.719322461259726
2017-06-28T09:30:00-04:00,242.5,243.715,242.23,243.49,70042599,68949123.15,55.16111666312414,58.09933350729941,NaN,NaN,-32.67132888779376,-33.27070229197632,-0.3119288936240894,0.610399630145821,0.9223285237699104,7980791114,7938028083.4,25.162489068297347,35.61306490751254,NaN,NaN,11.898210820858461,19.459163655488116
2017-06-29T09:30:00-04:00,243.66,243.72,239.955,241.35,106949719,70848507.9,46.276924763974584,56.856398588389496,NaN,NaN,-208.4344687198421,-73.47293108549565,-0.3918008242514738,0.4325774934555682,0.824378317707042,7873841395,7938934581.8,25.380763319439808,33.001409824737,NaN,NaN,8.236068810901713,17.85586439197577
2017-06-30T09:30:00-04:00,242.28,242.71,241.575,241.8,86820694,70756236.2,48.16740128823178,55.773548056463476,NaN,NaN,-139.60780829098815,-98.9684433635492,-0.4001219074094917,0.32422593344517736,0.7243478408546691,7960662089,7943807858.8,26.619846683728568,30.907117933107624,NaN,NaN,6.088048757529423,16.17474787276915
2017-07-03T09:30:00-04:00,242.88,243.38,242.21,242.21,39153806,70478985.25,49.89732658781084,54.49023611044996,NaN,NaN,-65.47444518970855,-119.17125230372457,-0.36480084840426896,0.2683467803493329,0.6331476287536019,7999815895,7945171801.6,26.98528983988983,28.94332066108331,NaN,NaN,4.975866289038483,14.574907646521911
2017-07-05T09:30:00-04:00,242.63,243.01,241.7,242.77,54427596,70681593.55,52.2418816043196,53.53696983275579,NaN,NaN,-70.28484998365673,-103.29458021439787,-0.2935732239604566,0.2661810988030311,0.5597543227634877,8054243491,7973870796.8,34.38936282375731,27.943524116073508,NaN,NaN,4.828532405098029,13.1825683263185
2017-07-06T09:30:00-04:00,241.89,242.03,240.34,240.55,66115317,71280143.85,43.54293177337683,52.20557677521636,NaN,NaN,-199.2571573673019,-136.61174591029948,-0.38031792234884765,0.0843569198274281,0.46467484217627575,7988128174,7975338208.8,34.75368563776864,27.578301481577633,NaN,NaN,1.6744581958790579,11.53855259339858
2017-07-07T09:30:00-04:00,241.21,242.28,240.5645,242.11,57972268,70881222.7,49.86094417801502,51.85178617132789,NaN,NaN,-113.25392384994068,-117.57563693631919,-0.3194317211214723,0.06538519077443539,0.38481691189590767,8046100442,8009790018.2,42.786298091297844,28.17919668230642,NaN,NaN,1.2565856569565266,10.069700173906858
2017-07-10T09:30:00-04:00,241.95,242.8,241.76,242.37,36663274,66101568.3,50.84821183058827,50.96900096880007,NaN,NaN,-46.63365913760351,-98.98080710564226,-0.25144000083491613,0.07051691085226253,0.32195691168717866,8082763716,8034210343.6,47.70121855348841,29.271467210312696,NaN,NaN,1.2612658013613574,8.811352406400358
2017-07-11T09:30:00-04:00,242.16,242.55,240.85,242.19,50354614,64313893.9,50.11253184331774,50.66775840581787,NaN,NaN,-78.38097513540863,-101.56211309478229,-0.21006560664400054,0.05937490338217799,0.2694405100261785,8032409102,8040728985,48.96160516082293,30.72095189209013,NaN,NaN,1.0372416070992057,7.700765149357336
2017-07-12T09:30:00-04:00,243.3,244.2,243.3,244.01,59610405,64291066.5,56.90224559943663,50.87272266846602,NaN,NaN,99.10508997904512,-67.68412510224192,-0.059429241253218024,0.195153958459656,0.254583199712874,8092019507,8048284188.2,50.45203579076729,32.48247397081532,NaN,NaN,3.0820428513958285,7.040947678219978
2017-07-13T09:30:00-04:00,244.02,244.55,243.76,244.42,39471637,62334532.8,58.27978396339033,51.21731820552558,NaN,NaN,134.25488240631,-0.9817171475195409,0.06194634902016816,0.3320161359880842,0.27006978696791606,8131491144,8076956782.2,55.73503346297666,34.78267563600044,NaN,NaN,5.1576501428005805,6.771905173160064
2017-07-14T09:30:00-04:00,244.43,245.97,244.31,245.56,60262692,62024423,61.92401487152818,51.72433531190514,NaN,NaN,193.26548143570557,60.322163909609706,0.205064849646584,0.526400849026146,0.32133599937956203,8191753836,8106087461,60.3595037139203,37.43528966091135,NaN,NaN,8.098026499959609,6.961351076988571
2017-07-17T09:30:00-04:00,245.47,245.91,245.33,245.53,33531917,59473364,61.77110139214972,52.1649554628601,NaN,NaN,183.3721269835443,106.32332113383927,0.2791748260178065,0.6703045319018202,0.39112970588401363,8158221919,8121179101.6,62.54277632680634,40.274683668389386,NaN,NaN,10.381489810201078,7.449942324590357
2017-07-18T09:30:00-04:00,245.06,245.72,244.67,245.66,42742498,58354298.8,62.2066224427164,53.370931342998574,NaN,NaN,152.94378117068774,152.58827239505854,0.31572115919192223,0.7857811548739164,0.4700599956819942,8200964417,8154890164.6,66.9249543152352,43.48249019915688,NaN,NaN,12.36755209756497,8.152458006443874
2017-07-19T09:30:00-04:00,246.02,247,246.01,246.99,51034260,58060693.4,66.4213850257471,54.175236226043076,NaN,NaN,191.25087653550185,171.0174297063499,0.40266911355940815,0.9733963876312544,0.5707272740718462,8251998677,8186885998.6,70.45764208840004,46.71785827202136,NaN,NaN,15.424077615053836,9.191260807673869
2017-07-20T09:30:00-04:00,247.28,247.42,246.47,247.1,47135183,57618574.1,66.7516430103476,55.63771610078401,NaN,NaN,168.02716459558687,177.77188614420527,0.43787455798768327,1.1180704715564502,0.680195913568767,8299133860,8220414541.8,73.6354725677738,50.16462321833093,NaN,NaN,18.007644700270127,10.450744220901905
2017-07-21T09:30:00-04:00,246.44,246.91,246.18,246.88,88711019,59846722.1,65.3669189395656,56.866253075879285,NaN,NaN,128.78130645899773,164.8750511488637,0.41674543828349875,1.2011277114231405,0.7843822731396417,8210422841,8224148342.8,73.9712565235825,53.5468667783205,NaN,NaN,19.786464704309118,11.784418575674364
2017-07-24T09:30:00-04:00,246.79,246.98,246.28,246.82,46622256,58828494.85,64.971065408501,57.942948705928586,NaN,NaN,112.3418273491486,150.66899122198456,0.37067550759008994,1.247726657627254,0.8770511500371642,8163800585,8225264076,74.07750205436695,56.910596222211716,NaN,NaN,21.16452300257347,13.124433493802808
2017-07-25T09:30:00-04:00,247.68,247.8,247.16,247.42,54915591,58739250.55,67.11568371230956,59.00536314221358,NaN,NaN,121.27100457185925,144.33443590221887,0.35266303530425813,1.3178799441674869,0.9652169088632288,8218716176,8228814427.8,74.43510184041045,59.77100615197266,NaN,NaN,22.95353055236309,14.528590216454276
2017-07-26T09:30:00-04:00,247.75,247.79,247.13,247.43,47575422,57005638.35,67.15178048271994,60.69170947859523,NaN,NaN,107.21099642317876,127.52645987975423,0.31472446590014247,1.3586224912384068,1.0438980253382644,8266291598,8231673012,74.73728118381874,62.62697726240481,NaN,NaN,24.46001379152408,15.947365012892819
2017-07-27T09:30:00-04:00,247.96,248,245.68,247.2,70766568,57041836.8,65.37432286748631,61.79980795641461,NaN,NaN,81.1387222698165,110.14877141460015,0.25025184731738426,1.3567128344849948,1.1064609871676105,8195525030,8210951246,68.42354093160156,64.45820889385507,NaN,NaN,25.3162861795453,17.2857823224146
2017-07-28T09:30:00-04:00,246.65,247.06,246.13,246.91,50088359,54198768.8,63.1061898223585,62.67537781296962,NaN,NaN,66.29336603183121,97.65118332916684,0.1681285275516171,1.3166216466071319,1.1484931190555148,8145436671,8197954012,64.72983133532273,65.6745383782718,NaN,NaN,25.496631510351612,18.458760777834176
2017-07-31T09:30:00-04:00,247.37,247.48,246.53,246.77,65838659,53149667.05,61.98808059238448,63.523631295045824,NaN,NaN,68.05684412800026,88.79418668493717,0.08843658100917162,1.2590388453169794,1.1706022643078078,8079598012,8181113497.4,60.19552834846885,66.47696146310366,NaN,NaN,25.376864178174397,19.447061263597064
2017-08-01T09:30:00-04:00,247.46,247.5,246.716,247.32,55050401,53944496.8,64.63877074230433,64.07624023382208,NaN,NaN,71.53097664181853,78.84618109892902,0.058278778799236264,1.2434507378068531,1.1851719590076168,8134648413,8164299944.8,55.979316134203344,66.87176720192052,NaN,NaN,25.934051861814222,20.373774206199514
2017-08-02T09:30:00-04:00,247.47,247.6,246.37,247.44,47211216,53583677.8,65.20881893931822,64.57117130353122,NaN,NaN,65.6991364010606,70.5438090945054,0.033174515879251576,1.2266401038566812,1.1934655879774296,8181859629,8147413551,52.037159104473574,66.6076333191703,NaN,NaN,26.554156049160365,21.256685898051064
2017-08-03T09:30:00-04:00,247.31,247.34,246.64,246.96,40855997,52320711.8,60.974558548936045,64.50335299477463,NaN,NaN,55.39251545223448,65.394567730989,-0.02581248929483415,1.161199976358887,1.187012465653721,8141003632,8136509271.4,49.60775023864262,65.83965092807904,NaN,NaN,26.035380356406435,21.939356534958975
2017-08-04T09:30:00-04:00,247.52,247.79,246.97,247.41,60191838,52431690.3,63.375589873336295,64.61795931485939,NaN,NaN,69.92260740385949,66.12041600539466,-0.043535085378503924,1.1325936089305912,1.1761286943090952,8201195470,8147661031.2,52.07212265657795,65.0917470944913,NaN,NaN,26.187986268694658,22.54630363977836
2017-08-07T09:30:00-04:00,247.49,247.87,247.37,247.87,31995021,52198277.65,65.69880413082592,64.86740086401008,NaN,NaN,85.14306626195176,69.53766043218495,-0.033727499592836274,1.1339693198180498,1.167696819410886,8233190491,8178379527,58.14422645231555,64.46455224713989,NaN,NaN,26.93374592079511,23.173081108495037
2017-08-08T09:30:00-04:00,247.51,248.91,246.83,247.26,61719353,52766514.6,60.24158143583017,64.42598632187314,NaN,NaN,88.98570240404698,73.02860558463064,-0.0753866875038347,1.0734634600310926,1.1488501475349273,8171471138,8185744072,59.4699671994715,63.67971832650214,NaN,NaN,26.11309947461921,23.59308373222706
2017-08-09T09:30:00-04:00,246.47,247.31,246.06,247.25,62632619,52917625.3,60.1533691618993,63.954681046983985,NaN,NaN,18.607548463293128,63.61028799707714,-0.10865798882137878,1.013027661508204,1.1216856503295827,8108838519,8171139850,55.70212923404726,62.39876523123596,NaN,NaN,25.405885618713803,23.852055430296595
2017-08-10T09:30:00-04:00,246.29,246.44,243.7,243.76,120479470,56968016.95,38.79974372293367,62.05702567436742,NaN,NaN,-225.72901527810347,7.385981851009578,-0.3567656052789412,0.6757286437309062,1.0324942490098474,7988359049,8140610933.4,48.74903392883477,60.5971779030397,NaN,NaN,16.734532580117804,22.835266451699624
2017-08-11T09:30:00-04:00,244.02,244.8,243.75,244.12,74869947,57698379.7,41.12156958720324,60.353490258560434,NaN,NaN,-237.12671901725417,-54.02388343321316,-0.480011104083397,0.43248036890560115,0.9124914729889981,8063228996,8113017638.6,43.467632006827365,58.41075861392972,NaN,NaN,10.770781435212836,21.11176859220151
2017-08-14T09:30:00-04:00,245.59,246.79,245.55,246.54,73291919,59686379.8,53.80802927681914,59.40294351316826,NaN,NaN,-42.29366642917673,-79.51122997143884,-0.3859762839563542,0.43002111804355536,0.8159974019999096,8136520915,8093683723.4,40.18272190156522,55.964160046869345,NaN,NaN,10.102674797536515,19.53904090724937
2017-08-15T09:30:00-04:00,246.98,247,246.16,246.51,55242746,60311392.2,53.65369073470697,58.438794245453046,NaN,NaN,-23.73346584325282,-102.05506362089879,-0.316157388325747,0.42080066659272575,0.7369580549184728,8081278169,8075645129.6,37.34689595228318,53.29341824461681,NaN,NaN,9.556103016488478,18.112906922854958
2017-08-16T09:30:00-04:00,247.11,247.57,246.45,246.94,56715544,60595456.4,55.618676639280075,57.741962372009745,NaN,NaN,25.152340204820035,-100.74610527259341,-0.23509987491209894,0.44308321127834915,0.6781830861904481,8137993713,8081476168.4,38.84924207429932,51.18096832623808,NaN,NaN,9.786850404187323,16.92347027733101
2017-08-17T09:30:00-04:00,246.24,246.6,243.09,243.09,128490396,64663217.05,39.47919637537088,56.0543199829392,NaN,NaN,-219.5674435436853,-99.5137909257098,-0.42385114336346186,0.14836915698612074,0.5722203003495826,8009503317,8085705022,39.973413285707835,49.41265275126558,NaN,NaN,3.377515328032747,14.988333856002686
2017-08-18T09:30:00-04:00,242.9,244.189,242.2,242.71,136747986,67065065.4,38.29791970064772,54.362165633529436,NaN,NaN,-232.0189154145908,-98.49223020517711,-0.5494053398948817,-0.11453637451901955,0.43486896537586217,7872755331,8047610289,33.92339258700967,47.536071625447065,NaN,NaN,-1.7660871146219381,12.594845145913455
2017-08-21T09:30:00-04:00,242.64,243.2,241.83,242.9,65469736,68007439.4,39.27627459111954,52.55055876558766,NaN,NaN,-192.95373395972496,-128.62424371128677,-0.591138803348002,-0.30405453880914024,0.2870842645388617,7938225067,8007951119.4,29.00210724417687,45.60912813330232,NaN,NaN,-5.288330308544088,10.040105795276663
2017-08-22T09:30:00-04:00,243.57,245.62,243.55,245.44,63140101,68418664.9,50.56184823393484,51.504346572345995,NaN,NaN,-63.89324360495893,-136.656199263628,-0.4268284831901835,-0.24645133944886766,0.18037714374131583,8001365168,7991968519.2,27.284277087877697,43.8410651321169,NaN,NaN,-4.168164402716324,8.010352909849093
2017-08-23T09:30:00-04:00,244.33,245.05,244.16,244.56,50203837,68550085.65,47.28312299581271,50.52638688998005,NaN,NaN,-68.105691803699,-155.3078056653318,-0.35927091149374496,-0.2687114956258654,0.09055941586787958,7951161331,7954602042.8,23.74338496037028,41.993610469383164,NaN,NaN,-4.482505417013764,6.2256588631544
2017-08-24T09:30:00-04:00,245,245.18,243.75,243.99,50741671,67548840.8,45.23690529786654,49.23076656316078,NaN,NaN,-72.2366765894115,-125.84165227447704,-0.33529524079880846,-0.328559635130631,0.0067356056681774495,7900419660,7932785311.4,21.952085282603846,39.842179228385014,NaN,NaN,-5.431607423863152,4.5603351078661785
2017-08-25T09:30:00-04:00,244.9,245.61,244.39,244.56,64445912,68266718.45,47.67547761484933,47.94338609773388,NaN,NaN,-41.80112121090765,-87.79809343374042,-0.2663763631764778,-0.3262348483024198,-0.059858485125941996,7964865572,7951207359.6,26.962832013368654,37.614936768460225,NaN,NaN,-5.377199464600808,3.140687311799466
2017-08-28T09:30:00-04:00,245.17,245.2,244.09,244.57,40565606,67003065.8,47.719461899539795,47.048948987998855,NaN,NaN,-47.32956676761112,-58.67325999531765,-0.2080315617184406,-0.31989793727399274,-0.11186637555555215,8005431178,7964648581.8,30.470325503275674,35.54353379016053,NaN,NaN,-5.321199863231056,1.9318462867951058
2017-08-29T09:30:00-04:00,243.06,245.15,242.93,244.85,51135715,66807331.5,49.01188273665272,46.25312852905267,NaN,NaN,-56.02572229850702,-57.09975573402727,-0.14166800200858762,-0.2889513780662867,-0.14728337605769906,8056566893,7975688926.8,33.303570317796556,33.943636724714054,NaN,NaN,-4.892983433785622,0.9568706124264305
2017-08-30T09:30:00-04:00,244.83,246.32,244.62,246.01,62030805,67548310.95,54.07688750846167,47.34435308516181,NaN,NaN,11.42049448709797,-41.194518475867866,-0.017274893243610367,-0.168876992612212,-0.15160209936860164,8118597698,8009176200.2,41.13837191211415,33.40001800923401,NaN,NaN,-2.9664694939205023,0.3963934543768687
2017-08-31T09:30:00-04:00,246.72,247.77,246.0473,247.49,103803880,70695705.1,59.592137136977435,48.66367933871711,NaN,NaN,83.49107958110096,-10.048967241765363,0.15743014573633815,0.045185582801821056,-0.1122445629345171,8222401578,8073572583.8,52.6558653585529,34.05632039150012,NaN,NaN,0.5194901493927249,0.413978696521991
2017-09-01T09:30:00-04:00,247.92,248.33,247.67,247.84,62006989,70786462.65,60.79137808586914,49.162489967934974,NaN,NaN,121.42428138661795,22.596113277739754,0.28203862578028227,0.24030371929083572,-0.04173490648944653,8284408567,8137481182.8,60.844336031565774,35.53214997221445,NaN,NaN,3.7103964996536685,0.884895525540802
2017-09-05T09:30:00-04:00,247.26,247.52,244.95,246.06,91398777,73756650.45,52.29157386646733,49.065195905917854,NaN,NaN,41.39341744955564,40.3407101211731,0.2321409237748252,0.24844124822908498,0.01630032445425978,8193009790,8174996905.2,64.70360995433724,37.48620097236118,NaN,NaN,3.846298536785897,1.3079530985758154
2017-09-06T09:30:00-04:00,246.84,247.28,246.23,246.9,57916867,73566526.15,55.45671543230772,49.053627248276975,NaN,NaN,79.11376886237296,67.3686083533491,0.24215503067820546,0.3189941128020166,0.07683908212381116,8250926657,8213868858,68.20091391021275,39.58274896064071,NaN,NaN,4.976228997725555,1.8319925127400638
2017-09-07T09:30:00-04:00,247.25,247.27,246.4,246.87,58034730,73336631.7,55.315568293135016,50.184796670974414,NaN,NaN,81.6198962250769,81.40848870094489,0.23312245487044286,0.3682421507118647,0.13511969584142186,8192891927,8228727703.8,69.44711662181226,41.688013484648174,NaN,NaN,5.825772149207662,2.4025324608068637
2017-09-08T09:30:00-04:00,246.54,247.11,246.3,246.58,63832825,70504299.45,53.88776130030695,51.29835678523578,NaN,NaN,64.5998220719299,77.63023719911067,0.19550136406125165,0.3794964009179864,0.18399503685673477,8129059102,8210059208.6,65.95009437738756,43.975635041103736,NaN,NaN,6.112672619345767,2.9325524834552783
2017-09-11T09:30:00-04:00,248.04,249.3,248.02,249.21,71364848,70329044.5,63.171938480716754,53.005189920207,NaN,NaN,156.3386146745914,84.61310385670537,0.32783569683991315,0.5937896579066262,0.26595396106671304,8200423950,8193262285.2,62.88195338748197,46.39562405133982,NaN,NaN,9.469689026674061,3.866429132486533
2017-09-12T09:30:00-04:00,249.63,250.09,249.42,250.05,56896027,69509249.9,65.5571891188956,54.0762856977042,NaN,NaN,174.37771248533332,111.2099628638609,0.4447767900423066,0.8219249486195963,0.3771481585772897,8257319977,8206124322.6,64.25334050251743,49.036271438099796,NaN,NaN,13.012578395727845,5.173021884378149
2017-09-13T09:30:00-04:00,249.72,250.21,249.59,250.17,59228002,69708512.7,65.8969977593829,55.40584818081636,NaN,NaN,155.43882336560011,126.47497376450633,0.49897699933089423,1.0008694077409075,0.5018924084100133,8316547979,8219248587,65.64802677666663,52.02946013926383,NaN,NaN,15.918391212219255,6.708074645498307
2017-09-14T09:30:00-04:00,249.8,250.32,249.6,250.09,95446349,71645052.95,65.43351932176098,56.8484634682374,NaN,NaN,137.85478989763067,137.72195249901708,0.49711037126505875,1.1232803724913367,0.626170001226278,8221101630,8224890527.6,66.25750263510888,55.1941328072999,NaN,NaN,18.126499205886805,8.339278154125235
2017-09-15T09:30:00-04:00,248.69,249.29,248.57,249.19,95432382,69992152.25,60.29560597347448,57.74990120813919,NaN,NaN,91.55986250268852,143.1139605851688,0.4067364880465958,1.1345906112845228,0.727854123237927,8125669248,8224212556.8,66.10572385864114,57.990053653390795,NaN,NaN,18.547006982226147,9.797525129568223
2017-09-18T09:30:00-04:00,249.61,250.12,249.28,249.72,46235238,65466514.85,62.178984957807536,58.78272428372975,NaN,NaN,105.688829754855,132.98400360122153,0.35595774479166253,1.1728013042275052,0.8168435594358426,8171904486,8218508664,64.76160208109943,60.43943055180677,NaN,NaN,19.444126418772708,11.175611028026006
2017-09-19T09:30:00-04:00,250,250.07,249.6,249.97,47108148,64548435.45,63.06888332479072,59.78679575431103,NaN,NaN,100.5138089838549,118.21122290092585,0.313978128237667,1.2093162197329264,0.8953380914952593,8219012634,8210847195.4,62.91125476537759,62.554265155205414,NaN,NaN,20.438110294278207,12.498825208919177
2017-09-20T09:30:00-04:00,250.07,250.19,248.92,250.06,59574083,64370134.55,63.402726989779545,60.45292714583373,NaN,NaN,84.07378740034568,103.93821570787495,0.2687878288238854,1.2313228775251162,0.9625350487012307,8278586717,8203254943,61.04975539484753,63.976506832543514,NaN,NaN,21.352616079561596,13.763652476153808
2017-09-21T09:30:00-04:00,249.88,249.98,249.185,249.39,48211398,64270512.6,59.11832881749343,60.419083694442016,NaN,NaN,69.18503776508886,90.2042652813666,0.17484003943006576,1.181085097988813,1.0062450585587472,8230375319,8205109680.8,61.35062175164341,64.59756086062141,NaN,NaN,20.99221050757399,14.796303623499549
2017-09-22T09:30:00-04:00,249.05,249.63,249.02,249.44,51214032,64294130.65,59.33914873307621,60.31535302638538,NaN,NaN,57.67916136089762,83.42812505300842,0.10080712040004292,1.1322539590588008,1.0314468386587579,8281589351,8236293701.4,66.09291266148733,64.97245919133009,NaN,NaN,20.748781296100297,15.646657576728227
2017-09-25T09:30:00-04:00,249.15,249.5532,248.08,248.93,57064357,63925052.9,56.0155899235288,60.581354173318346,NaN,NaN,33.216457640618266,68.93365063016108,0.007169732691563624,1.0404090045232124,1.0332392718316488,8224524994,8246817803,67.54043725760934,65.17508971299237,NaN,NaN,19.653818808834657,16.21910918131486
2017-09-26T09:30:00-04:00,249.42,249.7,248.805,249.08,54081959,64600870.55,56.782297054556594,60.67603857490756,NaN,NaN,41.901970000756,57.211282833541304,-0.051743412742202066,0.9685600059038961,1.0203034186460982,8278606953,8258736666.8,69.14689340524406,65.24265967692318,NaN,NaN,18.91737723737711,16.604576046466608
2017-09-27T09:30:00-04:00,249.88,250.49,248.87,250.05,81001426,66094156.1,61.460720052538605,61.114977986293525,NaN,NaN,66.26208551583302,53.64894245663877,-0.033355333370801654,0.9786092519325962,1.0119645853033978,8359608379,8274940999.2,71.23150129872022,65.37011572527375,NaN,NaN,19.502813794885764,17.018610010526487
2017-09-28T09:30:00-04:00,249.73,250.44,249.63,250.35,44778841,65231557.9,62.80191703697391,61.751703396055454,NaN,NaN,82.26617593205249,56.265170090031496,-0.010162088576619599,0.9992619745826232,1.0094240631592428,8404387220,8309743379.4,75.11966227164292,66.0250848605777,NaN,NaN,20.363732641692714,17.496484672121664
2017-09-29T09:30:00-04:00,250.34,251.32,250.13,251.23,85578002,64320264,66.48624409091494,61.98843951106959,NaN,NaN,121.60765689959716,69.05086919777139,0.0518645190656013,1.0742547119912444,1.0223901929256431,8489965222,8351418553.6,78.81249775197065,67.1629808866126,NaN,NaN,22.183399466814702,18.166043928506383
2017-10-02T09:30:00-04:00,251.49,252.32,251.2926,252.32,59022985,64171063.8,70.39732724640473,62.33416366303454,NaN,NaN,171.63552006376554,96.73468168240086,0.14826308861864712,1.207719053698952,1.0594559650803048,8548988207,8416311196.2,83.03492513035593,68.50452264574393,NaN,NaN,25.00982655847214,19.143727161358633
2017-10-03T09:30:00-04:00,252.46,252.89,252.23,252.86,66810169,62941633.4,72.13242922712774,62.77955162501631,NaN,NaN,205.22728967980703,129.39974561821106,0.22571432902557165,1.3415988763622693,1.1158845473366976,8615798376,8483749480.8,86.12873857260504,69.9674306311681,NaN,NaN,27.9293391027863,20.398814581562586
2017-10-04T09:30:00-04:00,252.69,253.44,252.56,253.16,55953619,62843471,73.07656977727513,63.325483800410176,NaN,NaN,211.40826449500653,158.42898141404575,0.27139894066082815,1.4551332231627327,1.1837342825019046,8671751995,8546178204,88.26262766888924,71.53922527643813,NaN,NaN,30.637776980308402,21.861523495669132
2017-10-05T09:30:00-04:00,253.54,254.68,253.196,254.66,63522757,63117872.35,77.23039098138344,64.5351113009751,NaN,NaN,224.17488695499,186.81072361863326,0.3707406054687774,1.6471600393378765,1.276419433869099,8735274752,8612355710.4,90.01598949194333,73.24710139310257,NaN,NaN,34.48705661830797,23.665171084617537
2017-10-06T09:30:00-04:00,254.15,254.7008,253.85,254.37,80645998,63958531,74.82677084470346,65.43852457861053,NaN,NaN,181.83212229303152,198.85561669732013,0.38342720640537964,1.7557034418758235,1.3722762354704439,8654628754,8645288416.8,90.7560385299297,75.1038468537333,NaN,NaN,36.897195064901936,25.555460224658166
2017-10-09T09:30:00-04:00,254.63,254.7,253.65,253.95,35803138,62180445.5,71.36271457535864,66.03094109650823,NaN,NaN,141.52552832170568,192.83361834890815,0.3319648350511959,1.7872322792844386,1.4552674442332427,8618825616,8659255898.6,91.05875013821367,77.11438223750731,NaN,NaN,37.88156171127893,27.31633186560399
2017-10-10T09:30:00-04:00,254.6,255.05,253.98,254.62,43057363,61488512.3,73.47248274480907,66.75020936472463,NaN,NaN,133.44722121252926,178.47760465545258,0.31179751173378945,1.8450143339004796,1.5332168221666902,8661882979,8668472819.2,91.26209384695419,79.27240641265779,NaN,NaN,39.35596466824961,29.03627940883908
2017-10-11T09:30:00-04:00,254.51,255.02,254.32,255.02,47674325,60910828.45,74.67217711328436,67.86119852870969,NaN,NaN,120.75678947024801,160.3473096505009,0.2943611038230667,1.9011682019455236,1.606807098122457,8709557304,8676033881,91.43419443178584,81.42123303266796,NaN,NaN,40.942591512653756,30.73718113795546
2017-10-12T09:30:00-04:00,254.66,255.06,254.365,254.64,47080269,58492524.45,71.37001717352382,68.72054627445594,NaN,NaN,102.42576448221628,135.99748515594615,0.22910173982109172,1.8931842728988215,1.6640825330777298,8662477035,8661474337.6,87.8462330157635,82.97504162940197,NaN,NaN,41.32306883959906,32.24945080961883
2017-10-13T09:30:00-04:00,255.14,255.27,254.64,254.95,54800435,56460927.1,72.44072234821337,69.89377001907629,NaN,NaN,99.15994368713382,119.46304943476662,0.18080089594932525,1.8900836530143863,1.709282757065061,8717277470,8674004080.8,88.27272922188205,84.45591962685002,NaN,NaN,41.94299579476583,33.634242950354114
2017-10-16T09:30:00-04:00,255.21,255.51,254.82,255.29,38521675,56075248.95,73.60658221620388,71.09550467347965,NaN,NaN,96.2873437089383,110.41541251221315,0.14716378210355874,1.8932374846945095,1.7460737025909507,8755799145,8701398786.6,89.1677480537716,85.88598067317342,NaN,NaN,42.79286177145939,34.942617067654865
2017-10-17T09:30:00-04:00,255.23,255.52,254.98,255.47,31560964,55297889.75,74.22816941516962,72.00746534223902,NaN,NaN,90.48281614060133,101.82253149782755,0.11393468100651272,1.8884920538490917,1.774557372842579,8787360109,8726494212.6,89.92622125922917,87.22131781320978,NaN,NaN,43.67534549559565,36.19014970021784
2017-10-18T09:30:00-04:00,255.9,255.95,255.5,255.72,40888330,54363602.1,75.10510738350915,72.88626465270582,NaN,NaN,94.56652194164242,96.58447799210643,0.08691079506642208,1.8831958666756066,1.7962850716091845,8828248439,8750232439.6,90.59692363276044,88.32683648186104,NaN,NaN,44.6632177752966,37.40058799665766
2017-10-19T09:30:00-04:00,254.83,255.83,254.35,255.79,61903788,55048221.6,75.35794589658411,73.51995763882505,NaN,NaN,76.1385970617696,91.3270445080171,0.053507587758195196,1.8631695563069286,1.8096619685487334,8890152227,8795767478,91.73382811591595,89.24978865071428,NaN,NaN,45.56106003407247,38.56636971628835
2017-10-20T09:30:00-04:00,256.7,257.14,255.7744,257.11,89176377,56946338.85,79.57135079469835,74.17524503513174,NaN,NaN,111.95139584027883,93.88533493864608,0.0975071218837722,1.9315458709034488,1.8340387490196766,8979328604,8848177704.8,92.81119955696752,89.94809396690081,NaN,NaN,47.66211973154455,39.86576257561067
2017-10-23T09:30:00-04:00,257.48,257.51,256.02,256.11,63915306,57288886.3,69.83019880432633,74.01080000493164,NaN,NaN,104.07809075945498,95.44348434874942,0.039435448003740436,1.883333059024352,1.8438976110206116,8915413298,8880100535.4,93.37738725109773,90.46585458679314,NaN,NaN,46.54317377423317,40.81967846112817
2017-10-24T09:30:00-04:00,256.6,256.83,256.15,256.56,66935910,57931583.85,71.51983530380646,73.89960468539816,NaN,NaN,102.48257621707359,97.84343636404387,0.01287746267001677,1.8599944393581325,1.8471169766881157,8982349208,8919098355.2,93.99917035182455,90.87560763557424,NaN,NaN,46.11254001121315,41.57580153971174
2017-10-25T09:30:00-04:00,256.18,256.31,254,255.29,103715291,59067277.1,61.11685609777999,72.7486379079979,NaN,NaN,42.75503031061268,87.48113803783792,-0.10233187183696568,1.7192021368919086,1.8215340087288743,8878633917,8929175450.8,94.15196195118251,91.1710342398056,NaN,NaN,42.28748318876945,41.677470346719986
2017-10-26T09:30:00-04:00,255.99,256.3,255.48,255.62,69797972,60318233.65,62.63761618065221,71.87798400342282,NaN,NaN,69.66239466477772,86.18589755843956,-0.16472519371067085,1.6156275165905356,1.7803527103012065,8948431889,8940831383.2,94.33173903856841,91.42644141899407,NaN,NaN,39.66245651772991,41.38961122829283
2017-10-27T09:30:00-04:00,256.47,257.89,255.6254,257.71,85562544,60317460.75,70.50549229913224,71.81675384083522,NaN,NaN,141.63633934304846,92.12288625899347,-0.07804917069329731,1.6827912469345847,1.760840417627882,9033994433,8951764549,94.50245591982981,91.67242040339524,NaN,NaN,39.945392825574224,41.183294313618745
2017-10-30T09:30:00-04:00,257.07,257.6,256.41,256.75,54285687,60080595.85,63.853978066665725,71.1297177923964,NaN,NaN,124.31482971879205,96.1702340508609,-0.09694905539938037,1.6396540983786565,1.7366031537780369,8979708746,8964623638.6,94.70447152147969,91.9183045230042,NaN,NaN,37.78918554586031,40.698421632510396
2017-10-31T09:30:00-04:00,257.18,257.44,256.805,257.15,60304781,59755326.45,65.32197572644225,70.46184626476482,NaN,NaN,125.791613552862,100.83204151801858,-0.09401812123436648,1.6190805022350787,1.7130986234694452,9040013527,8976156502.4,94.88597730423204,92.16486044246464,NaN,NaN,36.59504123480409,40.11222443283807
2017-11-01T09:30:00-04:00,258.04,258.43,257.07,257.49,54202736,59667782.3,66.56497290823677,70.11862881724431,NaN,NaN,144.76451404988703,121.23393826587343,-0.08117247065910904,1.6116330351455588,1.6928055058046678,9094216263,9019272971.6,95.50612214094414,92.71199537997755,NaN,NaN,36.046220643080154,39.53136674858694
2017-11-02T09:30:00-04:00,257.41,257.75,256.19,257.59,56449535,59314121.2,66.94030902267855,69.72574215113468,NaN,NaN,98.27487047333334,126.95643342758459,-0.0779170889835743,1.5954091445752,1.6733262335587742,9150665798,9059719753.4,95.99656531529159,93.26369795807823,NaN,NaN,35.72522306477859,38.98763193661432
2017-11-03T09:30:00-04:00,257.77,258.5,257.3,258.45,59589730,58261307.8,70.0537734933171,69.47197009949991,NaN,NaN,140.23741355146365,126.67664826926762,-0.0321643412385062,1.6331208070106413,1.6652851482491475,9210255528,9094971972.4,96.36855746677062,93.77804148757816,NaN,NaN,36.41642535551295,38.6203167107427
2017-11-06T09:30:00-05:00,258.3,259,258.22,258.85,49652598,58953780.8,71.4027833218792,69.27015680712202,NaN,NaN,158.60492438363946,133.5346672022371,0.00854368129228611,1.6759647498645052,1.667421068572219,9259908126,9151011848.4,96.86694229478543,94.27380727583218,NaN,NaN,37.39876437874014,38.445809234742335
2017-11-07T09:30:00-05:00,258.97,259.35,258.09,258.67,57502161,59676020.7,69.87730392622416,68.89674227445882,NaN,NaN,143.2405491812719,137.02445432791905,0.0069220681913335635,1.676073653811386,1.6691515856200525,9202405965,9183490336,97.11413988261852,94.73932272225063,NaN,NaN,37.757423500596076,38.34746841557858
2017-11-08T09:30:00-05:00,258.47,259.22,258.15,259.11,50469579,59815783.4,71.48123875161728,68.6198346212469,NaN,NaN,136.3390861715303,135.3393687522477,0.01840524194940718,1.6921581380568114,1.6737528961074042,9252875544,9215222192.2,97.33534782933766,95.13943127320931,NaN,NaN,38.52612899348887,38.37299135528005
2017-11-09T09:30:00-05:00,257.73,258.39,256.36,258.17,95085497,62216044.8,63.68012445186169,67.48474702533,NaN,NaN,56.913803496064325,127.06715535679393,-0.050610050052388944,1.610490333541918,1.661100383594307,9157790047,9216647042,97.34518833593917,95.46328761456444,NaN,NaN,36.85807697482536,38.1565750152151
2017-11-10T09:30:00-05:00,257.73,258.2926,257.37,258.09,59984662,62475256.15,63.04946804155644,67.00040911370357,NaN,NaN,68.38980562773396,112.697633772048,-0.11146378380434863,1.5217706538388711,1.6332344376432197,9097805385,9194157013.4,91.59534591234,95.33599894751032,NaN,NaN,35.322846764518125,37.75175669368696
2017-11-13T09:30:00-05:00,257.31,258.59,257.27,258.33,50228648,63060604.8,64.19508004710269,66.4772123096533,NaN,NaN,71.70469352651732,95.31758760062357,-0.1433362567498837,1.4540641167058652,1.597400373455749,9148034033,9171782194.8,86.14379995974429,94.7749010623617,NaN,NaN,34.35280096253891,37.26619158923724
2017-11-14T09:30:00-05:00,257.41,257.85,256.52,257.73,61315152,64548314.2,59.2494053292539,66.3438229690443,NaN,NaN,16.62234505821737,69.99394677601266,-0.20865317446746912,1.3365839053714126,1.5452370798388817,9086718881,9148644778,80.78905456096913,93.82040767734647,NaN,NaN,32.085504871074875,36.526093486642615
2017-11-15T09:30:00-05:00,256.62,257.22,255.63,256.44,80811525,66544473.95,50.280375648686764,65.46116293104676,NaN,NaN,-61.057568460908065,30.514615849524983,-0.33506702672719735,1.126403296429885,1.4614703231570823,9005907356,9099251140.4,70.68729580028905,92.13151887461224,NaN,NaN,27.15584976349115,35.18748724047812
2017-11-16T09:30:00-05:00,257.52,259.04,257.4748,258.62,67777027,66838135.9,61.01933456105307,64.78358023546967,NaN,NaN,87.2597840840564,36.583811967123395,-0.27093745191082985,1.122798508268545,1.3937359601793748,9073684383,9082430007.6,67.58786389123,90.20904801542655,NaN,NaN,26.19447294570247,33.902770912653025
2017-11-17T09:30:00-05:00,258.22,258.5882,257.77,257.86,75756833,66167158.7,56.442332803155914,64.25417700236183,NaN,NaN,55.656321375766034,34.037115116729815,-0.27774713708978793,1.0465520388171399,1.3242991759069278,8997927550,9062454440.6,63.99911352414048,88.01580815847375,NaN,NaN,23.815946807149086,32.46179604043817
2017-11-20T09:30:00-05:00,258.14,258.525,257.86,258.3,48075514,65375169.1,58.388374155018624,63.75891974726015,NaN,NaN,62.50022164957858,32.19622074134206,-0.2514489626733605,1.0099879725652272,1.2614369352385877,9046003064,9042048246.8,60.46695487532587,85.557306556409,NaN,NaN,22.581449215851382,31.050317922640062
2017-11-21T09:30:00-05:00,259.18,260.2,259.18,259.99,69176799,65487213.55,64.87882923190301,63.63848091323631,NaN,NaN,173.7583811943317,63.62342796856492,-0.12543283420596585,1.1046458924811304,1.2300787266870963,9115179863,9047740443.2,61.11169954408529,83.10056208520481,NaN,NaN,23.809182979886824,30.015870073675313
2017-11-22T09:30:00-05:00,260,260.15,259.57,259.76,45033392,62553118.6,63.42881300479994,63.38765976910212,NaN,NaN,165.61420604577597,108.95778286990173,-0.0657654254116431,1.1478719449225423,1.2136373703341854,9070146471,9060588266.2,62.594547938425826,80.71470370114298,NaN,NaN,24.27401524856521,29.195605098659584
2017-11-24T09:30:00-05:00,260.32,260.48,260.16,260.36,27746365,60450538.25,65.58939271403713,63.06877542772498,NaN,NaN,188.32610031108834,129.17104611530812,0.0023065807914104397,1.2165205963234484,1.214214015532038,9097892836,9065429956.8,63.16457522038449,78.34299068354396,NaN,NaN,25.361533432206667,28.647880574880595
2017-11-27T09:30:00-05:00,260.41,260.75,260,260.23,52274922,58786157.15,64.69753462911927,62.58982909252784,NaN,NaN,157.90577337006752,149.62093651416842,0.02548582702615798,1.2460712993147354,1.2205854722885774,9045617914,9074968029.6,64.3181773459234,76.01807890148237,NaN,NaN,25.950466262068026,28.262535673050227
2017-11-28T09:30:00-05:00,260.76,262.9,260.655,262.87,98971719,61020458.75,72.78935506888318,62.797832745574915,NaN,NaN,232.64666156008784,183.65022449627025,0.19602890806045137,1.4656216073641417,1.2695926993036903,9144589633,9094685343.4,66.64379741576728,73.84162586813586,NaN,NaN,29.446035242753695,28.431607040150723
2017-11-29T09:30:00-05:00,263.02,263.63,262.2,262.71,77512102,61880824.8,71.7164513945446,62.81463364864116,NaN,NaN,217.6996474535219,192.4384777481083,0.2708603874948121,1.6081681836722055,1.3373077961773934,9067077531,9085064877,64.43701157230001,71.49174470691888,NaN,NaN,31.768633378204004,28.908325088444048
2017-11-30T09:30:00-05:00,263.76,266.05,263.67,265.01,127894389,65565407.45,76.97124691666038,63.76399953898392,NaN,NaN,240.51031748998636,207.41770003695038,0.43815300686202785,1.8849990547549282,1.4468460478929004,9194971920,9110029966.8,67.44921062411896,69.35631772750314,NaN,NaN,35.835641289088755,29.89794168853615
2017-12-01T09:30:00-05:00,264.76,265.31,260.76,264.46,164390902,70962475.8,73.45667274255254,64.50737130334078,NaN,NaN,151.29485224187255,200.01145042310722,0.47174974071181497,2.036533223782669,1.5647834830708542,9030581018,9096567603.2,64.28706487320318,67.40572622470766,NaN,NaN,37.78655308600868,31.024886173889367
2017-12-04T09:30:00-05:00,266.31,266.8,264.08,264.14,94040560,72685017.3,71.41353935243008,65.02297553943559,NaN,NaN,170.83247468277008,202.59679068564773,0.4333901369284039,2.106521154231359,1.6731310173029552,8936540458,9074752112,59.42518816655714,65.4972539537657,NaN,NaN,38.64515434076486,32.113495912014436
2017-12-05T09:30:00-05:00,264.43,265.15,263.04,263.19,77994544,74102114.6,65.58168893950983,65.47528151159673,NaN,NaN,111.63001606155923,178.39346158594202,0.3107476565660092,2.061565588010467,1.7508179314444576,8858545914,9017543368.2,48.96681172369172,63.2242366082459,NaN,NaN,37.45431728203389,32.876470393445786
2017-12-06T09:30:00-05:00,262.87,263.73,262.71,263.24,75898566,75021934.85,65.74026619041278,66.5795594074343,NaN,NaN,83.49557089064315,151.5526462733663,0.2048168305228284,2.006838969597993,1.8020221390751647,8934444480,8991016758,45.011160919201885,61.390226973882534,NaN,NaN,36.56749121716506,33.40375908254854
2017-12-07T09:30:00-05:00,263.09,264.43,262.94,264.07,77218569,76359384.35,68.3473454728977,67.10298875828035,NaN,NaN,87.59605174937079,120.96979312524317,0.16422457338272656,2.007302855803573,1.8430782824208465,9011663049,8954354983.8,40.18008983277281,59.43252882684988,NaN,NaN,36.60658117183303,33.861305095303464
2017-12-08T09:30:00-05:00,264.99,265.52,264.72,265.51,76563873,75433303.15,72.28751420919286,68.23478743014013,NaN,NaN,110.62291113077218,112.83540490302312,0.20526765251432932,2.0996628480637582,1.894395195549429,9088226922,8965884164.6,42.278220725291796,57.881036484074976,NaN,NaN,37.9094902551969,34.439617261002525
2017-12-11T09:30:00-05:00,265.58,266.38,265.4793,266.31,83077533,76587946.7,74.20837366357054,69.3647873950367,NaN,NaN,116.3131767693413,101.93154532033736,0.25401548150846875,2.211914547435015,1.957899065926546,9171304455,9012836964,49.973657865108386,57.13151526905945,NaN,NaN,39.60989055346771,35.178227731354696
2017-12-12T09:30:00-05:00,266.57,267.32,266.345,266.78,85195750,78336301.8,75.2919299696611,70.10858030487655,NaN,NaN,121.41663207880678,103.88886852378687,0.28339827497847603,2.312146909649641,2.028748634671165,9256500205,9092427822.2,59.76575697170795,57.03537651388965,NaN,NaN,41.33500694826765,36.05776761948512
2017-12-13T09:30:00-05:00,267.06,267.56,266.65,266.75,102905409,80415814.65,75.07512118357167,70.9404594605031,NaN,NaN,115.79614136060965,110.34898261778017,0.2665483908555375,2.3619341232405873,2.0953857323850498,9153594796,9136257885.4,63.950509454320894,57.13223090788216,NaN,NaN,42.65164830528769,36.99975057459977
2017-12-14T09:30:00-05:00,267.09,267.22,265.6,265.66,100666692,81408573,67.47278593512435,71.07498754772362,NaN,NaN,89.97481022200384,110.82473431230679,0.15334981751531496,2.2870730042791934,2.1337231867638784,9052928104,9144510896.4,64.69512756989985,57.24155607570468,NaN,NaN,41.53186039813796,37.647194835105225
2017-12-15T09:30:00-05:00,265.45,267.04,265.39,266.51,144610290,85250236.15,70.02213219487321,71.45531594527748,NaN,NaN,88.0493938527969,106.31003085671173,0.10915256117694572,2.2701638882350608,2.161011327058115,9197538394,9166373190.8,66.65971675505946,57.40880889064296,NaN,NaN,41.337753224567656,38.174417462171284
2017-12-18T09:30:00-05:00,268.1,268.6,267.98,268.2,83676072,85646198.1,74.3299823502611,71.56536075109018,NaN,NaN,133.41292989198408,109.72998148124024,0.16387894360802102,2.365860006568141,2.20198106296012,9281214466,9188355193,68.55446816464101,57.54528537270538,NaN,NaN,42.55909108963372,38.80079940895163
2017-12-19T09:30:00-05:00,268.48,268.53,267.09,267.17,82382876,87361566.2,67.92356100979416,71.29444000932229,NaN,NaN,105.10606705968031,106.46786847741495,0.10378234010652987,2.3317089880932826,2.2279266479867528,9198831590,9176821470,66.42152753913925,57.687036513193895,NaN,NaN,41.49330618244857,39.18544323373691
2017-12-20T09:30:00-05:00,268.27,268.33,266.69,267.03,76751500,87740301.25,67.07730345609818,70.58772976213928,NaN,NaN,90.00132826175967,101.30890585764496,0.031428456625504975,2.267212218768634,2.235783762143129,9122080090,9170518528.8,65.22718187415893,57.528320173911034,NaN,NaN,40.38950555000619,39.35745213606109
2017-12-21T09:30:00-05:00,267.74,268.385,267.3,267.58,67032339,88840248.6,68.72579861949887,70.24981018192116,NaN,NaN,97.32689041077488,102.77932189539915,-0.0008525861283148473,2.2347180294827353,2.23557061561105,9189112429,9197755393.8,67.9122709987416,57.78726346859235,NaN,NaN,39.96377277895547,39.44406937076029
2017-12-22T09:30:00-05:00,267.6,267.635,266.9,267.51,78720873,91388974,68.25735024416579,70.02436810275942,NaN,NaN,77.24616788257708,100.6186767013552,-0.04588953140192675,2.178208701358642,2.2240982327605687,9110391556,9180326026.2,64.48096432397625,58.14839033697943,NaN,NaN,39.485422304965624,39.449976932789625
2017-12-26T09:30:00-05:00,267.05,267.4377,266.885,267.19,45244433,91037449.55,66.04122804586324,70.0571923246418,NaN,NaN,64.63942061268126,86.86397484549464,-0.112410542590613,2.0835850545223025,2.1959955971129155,9065147123,9137112557.6,56.81609362657993,58.70905333004288,NaN,NaN,38.46488534662676,39.30924956333779
2017-12-27T09:30:00-05:00,267.38,267.73,267.01,267.32,57750986,88976412.9,66.51683569466157,70.11266157494529,NaN,NaN,67.2122022834436,79.2852018902473,-0.15993605366928998,1.9960755300263031,2.156011583695593,9122898109,9121925861.4,54.370062372619174,59.37754629100125,NaN,NaN,37.74059954500609,39.08515670357612
2017-12-28T09:30:00-05:00,267.89,267.92,267.45,267.87,45116139,87356614.75,68.52529285293988,70.12537210209116,NaN,NaN,80.85804887147043,77.45654601218943,-0.16589624203851816,1.9486412811474452,2.1145375231859633,9168014248,9131112693,55.61490630262516,60.48003318170499,NaN,NaN,37.64744721206318,38.879769633359984
2017-12-29T09:30:00-05:00,268.53,268.55,266.64,266.86,96007424,85762266.5,61.25845476737782,69.33758214196152,NaN,NaN,56.207656794159746,69.23269928886641,-0.24466909292719174,1.8087011570269738,2.0533702499541655,9072006824,9107691572,51.739528037309704,61.15584084684913,NaN,NaN,35.490050386660855,38.39552402668868
2018-01-02T09:30:00-05:00,267.84,268.81,267.4,268.77,86655749,81875508.85,68.13936233415916,68.90408133271785,NaN,NaN,100.26889399771346,73.83724451189369,-0.17804487835599803,1.830814152009168,2.008859030365166,9158662573,9117345775.4,53.18755828476617,61.38540516253897,NaN,NaN,35.60383412625916,37.99671118377018
2018-01-03T09:30:00-05:00,268.96,270.64,268.96,270.47,90070416,81677001.65,72.77433811575199,68.72425334315291,NaN,NaN,174.96405403931277,95.90217119722,-0.03677706049202856,1.9628877047501305,1.999664765242159,9248732989,9154062948.6,58.31082375155486,61.28148136109946,NaN,NaN,37.28730410605842,37.89536731552565
2018-01-04T09:30:00-05:00,271.2,272.16,270.5447,271.61,80636408,81809094.85,75.3627093568195,68.74479535552776,NaN,NaN,233.93030279571613,129.24579129967452,0.10821636000466661,2.1349352152479923,2.0267188552433257,9329369397,9195357206.2,63.19009904664563,61.2271663319798,NaN,NaN,39.587364807105594,38.13708124289421
2018-01-05T09:30:00-05:00,272.51,273.56,271.95,273.42,83523995,82190366.3,78.80767661400729,69.5544304040194,NaN,NaN,269.3840559951802,166.95099272441647,0.29045530914543605,2.389787991675121,2.0993326825296847,9412893392,9244333035,67.97715723227373,61.46159702214936,NaN,NaN,42.83015717155056,38.80752066127369
2018-01-08T09:30:00-05:00,273.31,274.1,272.98,273.92,57319192,81195397.45,79.65402051095373,70.24242242659658,NaN,NaN,230.49973178237377,201.80940772205926,0.402222621221239,2.6021109590562332,2.1998883378349943,9470212584,9323974187,73.91730159473971,61.97999593926937,NaN,NaN,45.65828888855707,39.786201836599886
2018-01-09T09:30:00-05:00,274.4,275.25,274.081,274.54,57253957,80229901.65,80.68414249529215,70.6962910083845,NaN,NaN,202.94939642247326,222.34550820701125,0.4707020222045095,2.788265865590631,2.3175638433861216,9527466541,9397734980.6,77.9895856643793,62.65393290353639,NaN,NaN,48.27645318983366,40.99909488706185
2018-01-10T09:30:00-05:00,273.68,274.42,272.92,274.12,69574318,79554740.9,77.81013110652195,71.4024745867222,NaN,NaN,142.12802341993697,215.77830208313608,0.4410164002926451,2.868834343751928,2.427817943459283,9457892223,9439566827.4,79.90571268176404,63.617088985152456,NaN,NaN,49.48130913563871,42.21083977971569
2018-01-11T09:30:00-05:00,274.75,276.12,274.56,276.12,62361455,78413026.15,81.23747024013205,72.41391507129606,NaN,NaN,156.7618759449671,200.34461671298627,0.504792594010353,3.058808685972224,2.554016091961871,9520253678,9477743683.6,81.48948378242608,64.77868197860012,NaN,NaN,51.73489988362301,43.571419794559596
2018-01-12T09:30:00-05:00,276.42,278.11,276.0819,277.92,90816076,77808559.5,83.68053732071851,73.48211069281174,NaN,NaN,164.534207951359,179.374647104222,0.6098915324543435,3.3163805075298,2.7064889750754566,9611069754,9517378956,82.98857122446718,65.85556056615194,NaN,NaN,54.543929153733295,45.13892113158441
2018-01-16T09:30:00-05:00,279.35,280.09,276.18,276.97,106555142,78102982,77.91424508853471,74.17188889598096,NaN,NaN,145.20767958307724,162.31623666436272,0.5584926650477331,3.404604806385123,2.84611214133739,9504514612,9524239361.6,83.24155621264435,67.19560284391395,NaN,NaN,54.829968642074114,46.523356490225794
2018-01-17T09:30:00-05:00,278.03,280.05,276.97,279.61,113258799,76535407.45,81.69015670818692,75.28966951471837,NaN,NaN,143.48582195608012,150.42352177108407,0.6395309137126075,3.645525783478149,3.0059948697655416,9617773411,9542300735.6,83.91956815615839,69.13156531031241,NaN,NaN,56.47288223901691,47.94471731148167
2018-01-18T09:30:00-05:00,279.48,279.96,278.58,279.14,100728006,77388004.15,79.09746573563771,76.18828594621665,NaN,NaN,129.55901809283137,147.90972070566295,0.5993994673043992,3.7552442038960407,3.1558447365916416,9517045405,9554131372,84.36576080823056,71.27411519857036,NaN,NaN,56.833057782456805,49.214480235906684
2018-01-19T09:30:00-05:00,279.8,280.41,279.14,280.41,140920098,80314865.25,80.86474740261666,77.06967555690785,NaN,NaN,125.13562146943983,141.5844698105575,0.5951015426169688,3.8997216648628523,3.3046201222458835,9657965503,9581673737,85.38264458532223,73.40038221876303,NaN,NaN,57.73235693720575,50.43131976466369
2018-01-22T09:30:00-05:00,280.17,282.69,280.11,282.69,91322408,81043410.65,83.55320886162717,78.66215799221138,NaN,NaN,137.90471200981258,136.25857062224821,0.6765881631110311,4.150355326134672,3.4737671630236413,9749287911,9609317368.4,86.34278605349132,75.87204350563313,NaN,NaN,59.47380604580068,51.72310351911183
2018-01-23T09:30:00-05:00,282.74,283.62,282.37,283.29,97084700,82546028.7,84.18299758907355,79.80813193899097,NaN,NaN,139.90028305493786,135.19709131662034,0.6988154548083885,4.347286481534127,3.6484710267257383,9846372611,9677688968.2,88.37641553018793,78.38553330887756,NaN,NaN,61.044824791624016,53.05477798661357
2018-01-24T09:30:00-05:00,284.02,284.7,281.84,283.18,134816117,85350790.9,83.55132336305022,80.57791659951226,NaN,NaN,125.98471344214987,131.6968696138343,0.6358316728124622,4.443260617741316,3.807428944928854,9711556494,9696445584.8,88.8662124914227,80.56806107601096,NaN,NaN,62.063869382868134,54.34179104322137
2018-01-25T09:30:00-05:00,284.16,284.27,282.405,283.3,84587313,87317934.9,83.69505794653105,81.17308435592024,NaN,NaN,113.92811284260299,128.57068856378862,0.5359698282465652,4.47739123023706,3.941421401990495,9796143807,9752265265.2,90.19092488207083,82.49669149282705,NaN,NaN,62.91828514254883,55.56700448598244
2018-01-26T09:30:00-05:00,284.25,286.6285,283.96,286.58,107743119,89817541.55,87.03097302553876,81.76046267102963,NaN,NaN,132.47100492479308,130.03776525485927,0.6186706854243429,4.714759758770924,4.096089073346581,9903886926,9801449549.8,91.18604024250617,84.1544688507008,NaN,NaN,64.87520687791849,56.896747684830444
2018-01-29T09:30:00-05:00,285.93,286.43,284.5,284.68,90118337,92067651.45,77.18028539692999,81.58376730574221,NaN,NaN,114.58279346834547,125.37338154656584,0.4794774174260237,4.695435845129111,4.215958427703088,9813768589,9814345685.4,91.43149328875518,85.40548254313047,NaN,NaN,63.11029745996542,57.78439765270687
2018-01-30T09:30:00-05:00,282.6,284.736,281.22,281.76,131796419,93857101.2,65.00324658284438,80.46370331199594,NaN,NaN,70.69559539608024,111.53244401479431,0.1423151085686971,4.393852313413959,4.2515372048452615,9681972170,9781465597.2,84.93690172119149,85.90171940433133,NaN,NaN,57.05067441813825,57.679580047768496
2018-01-31T09:30:00-05:00,282.73,283.3,280.68,281.9,118948131,95471720.3,65.28604002629497,79.56912537769402,NaN,NaN,55.3739788578386,97.41029709793206,-0.1062980680745671,4.118664619752053,4.22496268782662,9800920301,9799338358.6,85.53824225767275,86.30404294546769,NaN,NaN,52.58419834213199,56.95166837553471
2018-02-01T09:30:00-05:00,281.07,283.06,280.68,281.58,90102470,95473323,64.01278635743748,78.33879081464441,NaN,NaN,46.69226670996401,83.96312787140428,-0.3154915011514179,3.830598311387348,4.146089812538766,9710817831,9782273163.4,82.16537463166806,86.35232086327066,NaN,NaN,48.67183798315991,55.76883546233831
2018-02-02T09:30:00-05:00,280.08,280.23,275.41,275.45,173174790,100100242.1,45.64722613479135,75.62212572993533,NaN,NaN,-48.24647437253661,47.81963201193836,-0.8590726950427245,3.07224894373536,3.9313216387780847,9537643041,9709024386.4,69.49803779218625,85.38871133239347,NaN,NaN,37.37361421778348,53.14094671311619
2018-02-05T09:30:00-05:00,273.45,275.85,263.31,263.93,294681820,110658133.35,28.878776115056255,72.11959223182973,NaN,NaN,-210.2496124953385,-17.14684918079846,-1.9257654423686046,1.524114835817329,3.4498802781859337,9242961221,9594862912.8,55.21142413816807,83.38655904135945,NaN,NaN,17.091593214646082,47.991039070477605
2018-02-06T09:30:00-05:00,259.94,269.7,258.7,269.13,355026780,125543512.75,39.65476342287888,69.11706414002201,NaN,NaN,-211.70917550534594,-73.62780336108369,-2.192996032574664,0.7086352374676039,2.9016312700422677,9597988001,9578066079,53.46978670055922,81.2115746516738,NaN,NaN,7.643872418779016,42.22715812023495
2018-02-07T09:30:00-05:00,268.5,272.36,267.58,267.67,167376100,131049619.9,37.917629796256264,66.17564728720905,NaN,NaN,-141.26579739430173,-112.95575861151175,-2.3651579212073854,-0.05481613146696418,2.3103417897404213,9430611901,9504004399,46.504003379074824,78.5071634067341,NaN,NaN,0.5009668442314319,36.266273652234446
2018-02-08T09:30:00-05:00,268.01,268.17,257.59,257.63,246449505,139893379.25,28.629679370832775,62.44457099922449,NaN,NaN,-216.30942779216699,-165.55609751193793,-3.0108724610254525,-1.453248786541394,1.5576236744840581,9184162396,9398673312,38.768505680895935,75.17758205641793,NaN,NaN,-10.101862110560687,29.64225425754943
2018-02-09T09:30:00-05:00,260.8,263.61,252.92,261.5,283565310,150953572,35.21690218186711,58.99197766495591,NaN,NaN,-189.78417242106354,-193.86363712164334,-3.024985114117972,-2.2236077181634073,0.8013773959545649,9467727706,9384690245,37.8679708608757,71.71509525694538,NaN,NaN,-14.641997417358935,23.315932589705376
2018-02-12T09:30:00-05:00,263.83,267.01,261.6644,265.34,143735976,153599567,41.032597502174404,55.9098062301774,NaN,NaN,-110.89083356380597,-173.9918813353368,-2.637502109125459,-2.495500240452259,0.1420018686732002,9611463682,9458390737.2,45.10568537130214,68.62432881702497,NaN,NaN,-15.479799272026687,17.77368518088651
2018-02-13T09:30:00-05:00,263.97,266.62,263.31,266,81223640,152332991.9,41.99640923547843,52.941598078207974,NaN,NaN,-90.37379559292835,-149.7248053528533,-2.215547995374739,-2.627433125545224,-0.41188513017048467,9692687322,9477330601.4,46.82013334695386,65.6210374495629,NaN,NaN,-15.702193926270528,12.991416737006933
2018-02-14T09:30:00-05:00,264.31,270,264.3,269.59,120735685,152706836.2,47.06469216564585,50.325143379573326,NaN,NaN,-60.22097074738835,-133.51584002347062,-1.6020721533331348,-2.4144753218369033,-0.8124031685037684,9813423007,9553892822.6,53.18519364829263,62.977770932864466,NaN,NaN,-13.970825757851332,9.139667809170039
2018-02-15T09:30:00-05:00,271.57,273.04,268.77,273.03,111200286,153230450.2,51.443001869186624,47.78314543983388,NaN,NaN,-27.07555303674847,-95.66906507238693,-0.9066348228211911,-1.9456966970302574,-1.0390618742090663,9924623293,9701985002,62.527777661532255,60.930752177080606,NaN,NaN,-10.986531059273853,6.264496542249483
2018-02-16T09:30:00-05:00,272.32,275.32,272.27,273.11,160420135,154205452.05,51.54337798794993,45.95193776776387,NaN,NaN,-8.68125352126891,-59.448481292428006,-0.4086425394878248,-1.5498650485688472,-1.1412225090810224,10085043428,9825448146.4,68.22161988435278,59.272904076766146,NaN,NaN,-8.714570559201027,4.124629813470839
2018-02-20T09:30:00-05:00,272.03,273.67,270.5,271.4,86369662,153957814.75,49.202099831348015,44.82328442837128,NaN,NaN,-19.482280468492693,-41.166770673365335,-0.17381280419164913,-1.3584885143205838,-1.1846757101289347,9998673766,9902890163.2,71.17975280303689,58.29025058261225,NaN,NaN,-7.633434326052417,2.4449063649675167
2018-02-21T09:30:00-05:00,271.9,274.72,269.94,270.05,98883740,154047766.75,47.37261085041049,43.54375377295097,NaN,NaN,-17.98936060539057,-26.689883675857764,-0.09286790494744035,-1.3007605913132352,-1.2078926863657948,9899790026,9944310704,72.64639537716101,57.369404376861404,NaN,NaN,-7.319612847308965,1.0499750489280193
2018-02-22T09:30:00-05:00,271.1,273.05,269.64,270.4,110511290,152832525.4,47.91335459903057,42.393794361636196,NaN,NaN,-18.57670403807256,-18.361030333994613,-0.003916611838827189,-1.2127884511643288,-1.2088718393255016,10010301316,9983686365.8,74.0009035385547,56.78622787021046,NaN,NaN,-6.909540843359083,-0.08709864997013805
2018-02-23T09:30:00-05:00,271.79,274.71,271.25,274.71,92766428,153241481.15,54.15963730665189,43.001823731054806,NaN,NaN,12.117988646837988,-10.52232199727732,0.3381168355331552,-0.7862257949090576,-1.1243426304422128,10103067744,10019375256,75.1996168068155,57.19348351411255,NaN,NaN,-4.6146746510046635,-0.7338952215464988
2018-02-26T09:30:00-05:00,275.93,278.01,275.26,277.9,86491406,152178895.5,58.15903874413279,45.093271061703135,NaN,NaN,59.44405644033779,3.102739995043989,0.7486008955486556,-0.18859151100639338,-0.937192406555049,10189559150,10040278400.4,75.90047287685886,58.67127270973333,NaN,NaN,-1.389622085336084,-0.8275704878021538
2018-02-27T09:30:00-05:00,278.11,278.92,274.36,274.43,99099165,152627936.9,52.766100708264524,46.02979515351639,NaN,NaN,56.46943225836732,18.29308254041599,0.7537383668486373,0.0049805520057475405,-0.7487578148428897,10090459985,10058635644.2,76.52781507932785,60.31827473678823,NaN,NaN,-0.31188017515278543,-0.7539004431379583
2018-02-28T09:30:00-05:00,275.68,276.19,271.29,271.65,121907767,152133504.3,48.8573487552747,46.81120365058914,NaN,NaN,28.00149190239721,27.49125304197355,0.5468594003058345,-0.0651835644605967,-0.6120429647664312,9968552218,10072388082.6,77.0106292230343,62.497319439928184,NaN,NaN,-0.6341194859122896,-0.7367888778200057
2018-03-01T09:30:00-05:00,271.41,273.17,266,267.7,176855077,155028851.6,43.88320398644081,47.90074112313256,NaN,NaN,-22.192704908572754,26.768052867873507,0.14202450538332434,-0.43451233303727577,-0.5765368384206001,9791697141,10028667247.6,71.9440507291596,64.86700122908988,NaN,NaN,-2.515912597715843,-0.9909494092336968
2018-03-02T09:30:00-05:00,265.8,269.72,264.82,269.08,139083217,157477888.95,45.95345559303168,48.6676377953586,NaN,NaN,-31.317076939512912,18.081039750603328,-0.025838770682339418,-0.6088353017735244,-0.582996531091185,9930780358,9994209770.4,68.13917325123943,67.02922997125873,NaN,NaN,-3.398774364291373,-1.3349244028133649
2018-03-05T09:30:00-05:00,267.73,272.89,267.61,272.19,97307387,153684518.8,50.394884496634596,49.336372580677185,NaN,NaN,27.59848411999429,11.711925286534628,0.0740902935501837,-0.49038366415345536,-0.5644739577036391,10028087745,9961915489.4,64.68626762256412,68.42784298920601,NaN,NaN,-2.7655673292503797,-1.5393019637329384
2018-03-06T09:30:00-05:00,273.3,273.39,271.18,272.88,79213163,142911085.95,51.3501188909238,50.00449469892329,NaN,NaN,51.87151435975443,10.79234170681205,0.18202034880510953,-0.3369485216972521,-0.5189688705023616,10107300908,9965283674,64.88612562820478,69.71827100929536,NaN,NaN,-1.9703250762098914,-1.600876694086789
2018-03-07T09:30:00-05:00,270.42,273.18,270.2,272.78,87063502,129512922.05,51.1962477370014,50.29960581116297,NaN,NaN,39.7800486927792,13.14805306488845,0.23847658277568284,-0.2208731420327581,-0.45934972480844094,10020237406,9975620711.6,65.53087813722573,70.60010561564773,NaN,NaN,-1.3700941792406933,-1.5679077633944896
2018-03-08T09:30:00-05:00,273.55,274.24,272.42,274.1,66901150,124489174.55,53.1901841498352,50.42440454549501,NaN,NaN,63.27391803013629,30.241377652630252,0.34978803995474594,-0.02211467486500851,-0.37190271481975445,10087138556,10034708994.6,69.03134949509948,71.06464646090254,NaN,NaN,-0.3073863574033867,-1.387833276824332
2018-03-09T09:30:00-05:00,275.7,278.87,275.34,278.87,113625335,117847966.05,59.611766804304416,51.00071803237747,NaN,NaN,139.43672253156186,64.3921375468452,0.7090202602728144,0.5143726105212636,-0.19464764975155083,10200763891,10088705701.2,71.84519010511902,71.32347290524298,NaN,NaN,2.6076253072850326,-0.8170534790944228
2018-03-12T09:30:00-04:00,279.2,279.91,278.0801,278.52,71924793,107265940.2,58.97248998295507,51.69860304320655,NaN,NaN,163.2357953480784,91.51959979246203,0.8764504259712614,0.900915382712526,0.02446495674126456,10128839098,10108855971.8,72.83705465018367,71.4418516086106,NaN,NaN,4.797705573466414,-0.014945043014303327
2018-03-13T09:30:00-04:00,279.84,280.41,276.03,276.72,91968937,104677588.25,55.666223406878906,52.29100394009715,NaN,NaN,124.30331638580925,106.00596019767299,0.820352593362217,1.0499056984440358,0.22955310508181884,10036870161,10094769822.4,70.95522528463047,71.32105374485842,NaN,NaN,5.744699873679041,0.8078613736561744
2018-03-14T09:30:00-04:00,277.81,278.02,274.67,275.3,105895079,105911160.2,53.13533861218549,52.664002798179645,NaN,NaN,74.22920037361396,112.89579053383996,0.649473445703746,1.0413949122115014,0.3919214665077554,9930975082,10076917357.6,68.53836156497249,70.93087217531684,NaN,NaN,5.843157019111923,1.5271893230069957
2018-03-15T09:30:00-04:00,275.88,276.61,274.43,275,83433038,104046027.85,52.59132182839523,52.55198026401846,NaN,NaN,50.526624998860605,110.34633192758481,0.48560486285860915,0.9989275450810169,0.5133226822224077,9847542044,10028998055.2,62.3948908366035,70.01624889173027,NaN,NaN,5.778537975969802,2.134524844858825
2018-03-16T09:30:00-04:00,274.5,275.39,274.14,274.2,100343673,103503197.2,51.08917914561916,52.04699029269606,NaN,NaN,25.229999618185573,87.50498734490955,0.30170500449497784,0.89045393784113,0.5887489333461522,9747198371,9938284951.2,52.75470327259947,68.36297963428316,NaN,NaN,5.327005475468612,2.5905935063745087
2018-03-19T09:30:00-04:00,273.35,273.38,268.62,270.49,109208442,100942612.55,44.71121365909273,51.47164121775521,NaN,NaN,-72.82160975469853,40.29350632435417,-0.07150678328111937,0.499365454244753,0.5708722375258724,9637989929,9840115117.4,44.704915286108665,66.08991536333893,NaN,NaN,3.0918157356977933,2.662196681992121
2018-03-20T09:30:00-04:00,270.94,271.67,270.18,270.95,59757271,99611993,45.617737267974505,51.24024039723376,NaN,NaN,-67.55373983681775,1.9220950798287704,-0.27752860566989457,0.22396148043850417,0.5014900861083987,9697747200,9772290525.2,40.14696300383363,63.456796347681745,NaN,NaN,1.4784285492133729,2.493086948738014
2018-03-21T09:30:00-04:00,270.9,273.27,270.19,270.43,78709578,98603284.9,44.72500213269046,51.30036883625159,NaN,NaN,-57.310713941753654,-24.385887783244755,-0.42986775910790814,-0.03584461277648643,0.3940231463314217,9619037622,9709903033.2,36.464181241935584,60.92251995573717,NaN,NaN,-0.1203882645534811,2.119733346839229
2018-03-22T09:30:00-04:00,267.91,268.87,263.36,263.67,148785916,100517016.2,35.10655194478471,50.52559000423395,NaN,NaN,-186.00864483455112,-71.69294174992709,-0.9378162521479463,-0.7782471688535111,0.15956908329443514,9470251706,9634444965.6,32.57226023264248,58.38202616869454,NaN,NaN,-4.773235686854055,1.1350234848830456
2018-03-23T09:30:00-04:00,264.17,265.02,257.83,258.05,183534751,105055432.35,29.438380830631473,49.02869688523373,NaN,NaN,-236.9698786322552,-124.13291740001523,-1.567136680910954,-1.7993517678442572,-0.23221508693330334,9286716955,9542348682.4,28.564956787816698,55.80193253764115,NaN,NaN,-10.988332715927248,-0.5968845438041392
2018-03-26T09:30:00-04:00,262.13,265.43,259.41,265.11,141956102,107828667.15,42.087975082913765,48.36711518466159,NaN,NaN,-154.03085314156434,-140.37476607738841,-1.4267608721386338,-2.0156661771065956,-0.5889053049679618,9428673057,9500485308,26.942338262427626,53.0916620115142,NaN,NaN,-11.950963244390051,-2.2188957867449837
2018-03-27T09:30:00-04:00,266.17,266.77,258.84,260.6,129941445,109370781.15,37.46719061826003,47.38646824760864,NaN,NaN,-151.71765953518153,-157.20755001706115,-1.5464315987678252,-2.5219448034277434,-0.9755132046599182,9298731612,9420682190.4,24.128590742042945,50.13435576900115,NaN,NaN,-14.452931843944047,-3.9666152234877066
2018-03-28T09:30:00-04:00,260.75,262.64,258.58,259.83,146452306,110598008.1,36.72583225253136,46.210443112086935,NaN,NaN,-149.0914505308316,-175.56369733487674,-1.5806184255090674,-2.9512862365462524,-1.370667811037185,9152279306,9327330527.2,21.323224277309933,46.726632539159034,NaN,NaN,-16.60689490087883,-5.77236946311501
2018-03-29T09:30:00-04:00,261.12,265.26,259.8389,263.15,124244790,107967493.75,42.05012142702884,44.95603987085297,NaN,NaN,-100.4549241372407,-158.45295319541466,-1.2948166758178743,-2.989188655809528,-1.6943719799916537,9276524096,9288585005.2,20.2698278433471,43.04267809188961,NaN,NaN,-16.56191687663016,-7.31373337933146
2018-04-02T09:30:00-04:00,262.55,263.13,254.67,257.47,186286343,110327650.05,36.40592410664303,43.344142308259244,NaN,NaN,-135.53015160023054,-138.16500778900974,-1.3948423108518146,-3.437924868556422,-2.0430825577046074,9090237753,9249289164.8,19.232118235912267,39.2137540622988,NaN,NaN,-18.52156683024553,-8.914852443747755
2018-04-03T09:30:00-04:00,258.87,261.31,256.84,260.77,119956861,111460123.75,41.33289377383909,42.32033304875641,NaN,NaN,-103.78129103637069,-128.115095367971,-1.1551918179832343,-3.4870723301836506,-2.3318805122004163,9210194614,9205593476.2,18.121182344673286,35.43989385230186,NaN,NaN,-18.385285218307892,-10.26777141154206
2018-04-04T09:30:00-04:00,256.75,264.355,256.6,263.56,123715339,113685232.55,45.19860815796349,41.753423730597696,NaN,NaN,-74.20100126217456,-112.61176371336963,-0.7451158763279273,-3.2632753576103255,-2.518159481282398,9333909953,9212629144.4,18.933183119793213,31.89666682050333,NaN,NaN,-16.955199850017255,-11.223118331324232
2018-04-05T09:30:00-04:00,265.55,266.64,264.32,265.64,82652618,113464688.35,47.95208993646633,41.42205002403134,NaN,NaN,-28.905716633300486,-88.57461693386338,-0.29332969504957696,-2.8848216000943694,-2.5914919050447924,9416562571,9265485797.4,24.954462084516322,29.22235048106853,NaN,NaN,-14.896167762572302,-11.747839678645384
2018-04-06T09:30:00-04:00,263.42,265.11,258,259.72,179521209,119095691.3,41.55277217263729,40.740878097389775,NaN,NaN,-69.81212612913107,-82.44605733224147,-0.34895647463276713,-3.0276874983357516,-2.6787310237029844,9237041362,9257589250.6,24.659777767088087,27.21557008781772,NaN,NaN,-15.277462890347184,-12.252071566031356
2018-04-09T09:30:00-04:00,261.37,264.84,259.9356,261,105442932,118686571.15,43.31423347205211,40.641093798315445,NaN,NaN,-54.59512394223859,-66.25905180064308,-0.2594212982772284,-3.00300764654952,-2.7435863482722915,9342484294,9308038558.8,30.32103860382051,26.18815032479714,NaN,NaN,-15.003524170319013,-12.645136223786736
2018-04-10T09:30:00-04:00,264.27,266.04,262.98,265.15,105573736,120369018.3,48.71125411117074,40.86205928711518,NaN,NaN,-18.082803573643027,-49.119354308097556,0.10015296668284757,-2.618395139918732,-2.7185481066015798,9448058030,9355611242,35.26116714076156,25.839164906006282,NaN,NaN,-12.98836098739792,-12.694168332874048
2018-04-11T09:30:00-04:00,263.47,265.64,263.39,263.76,91140243,120327583.6,47.09393246651722,41.03126859667423,NaN,NaN,-17.937455292673103,-37.866645114197254,0.2563548972964713,-2.3981044849809905,-2.654459382277462,9356917787,9360212808.8,35.73577900981121,25.787136175140255,NaN,NaN,-11.878849601849788,-12.577694228442011
2018-04-12T09:30:00-04:00,265.26,267,265.06,265.93,68890480,118477353.65,49.891057879094674,42.08730473483923,NaN,NaN,16.673477807677994,-28.750806226001565,0.5035052239290363,-2.0250778523661666,-2.528583076295203,9425808267,9362061948,35.93902212870408,26.027619167716075,NaN,NaN,-10.094905686364056,-12.223010151002303
2018-04-13T09:30:00-04:00,267.41,267.54,264.01,265.15,85079176,118559660.55,48.89048132504556,43.476740484440235,NaN,NaN,20.587477091644757,-10.670885581846397,0.6052945161883119,-1.771964931059813,-2.3772594472481248,9340729091,9382799493.8,38.29587900226152,26.722685040176422,NaN,NaN,-8.940392941010021,-11.75406483528912
2018-04-16T09:30:00-04:00,267,268.2,266.07,267.33,63405287,116712741.25,51.8000004599556,44.17045658280036,NaN,NaN,67.45374750703297,13.738888708007915,0.798159061573986,-1.3795606202806425,-2.1777196818546285,9404134378,9395129510.6,39.71602348646322,27.635091127607534,NaN,NaN,-7.1068631756256,-11.090178883908617
2018-04-17T09:30:00-04:00,269.33,270.87,268.75,270.19,64682036,114486420.95,55.38809913639985,45.45052147695322,NaN,NaN,130.76474381767284,43.50839818627109,1.079574378479449,-0.8282517087553174,-1.9078260872347663,9468816414,9399281187.4,40.21497156413385,28.784118329185457,NaN,NaN,-4.457647722831419,-10.14267443232616
2018-04-18T09:30:00-04:00,270.69,271.3,269.87,270.39,57303857,114363750.25,55.6368065840046,46.80130535777273,NaN,NaN,145.30258645561676,76.15640653592905,1.229523793392047,-0.37092134549470757,-1.6004451388867547,9526120271,9433121684.2,44.26431560072428,30.42276770942934,NaN,NaN,-2.2323324517534964,-9.012625577958637
2018-04-19T09:30:00-04:00,269.65,269.88,267.72,268.89,77655909,114311066.8,53.23952958605302,47.60054879770303,NaN,NaN,114.75408549854342,95.77252807410214,1.1779199698216867,-0.1280451766096462,-1.3059651464313329,9448464362,9437652903.2,44.80341328296025,32.175166669401705,NaN,NaN,-0.993898582696723,-7.867093150064078
2018-04-20T09:30:00-04:00,268.81,269.06,265.61,266.61,99953133,111869427.65,49.73185758349129,48.55240118890647,NaN,NaN,69.56421715277007,105.56787608632722,0.9502291431504541,-0.11817871749326514,-1.0684078606437193,9348511229,9439209330.8,45.00019910158148,34.015743874092365,NaN,NaN,-0.8911553458303906,-6.870530606602123
2018-04-23T09:30:00-04:00,267.26,267.89,265.35,266.57,65557954,105970587.8,49.6700290410505,49.147910850850145,NaN,NaN,52.65673416426123,102.60847341777284,0.7648921262057135,-0.11229270288657744,-0.8771848290922909,9282953275,9414973110.2,42.46157537329926,35.75434337613708,NaN,NaN,-0.8229020237566118,-6.006583666195621
2018-04-24T09:30:00-04:00,267.73,267.9762,261.28,262.98,112885452,104517055.3,44.34175727065118,49.08670721604212,NaN,NaN,-7.5845269576698175,74.93861926270432,0.3875212789210688,-0.39278323044095487,-0.7803045093620237,9170067823,9355223392,36.93033209046246,37.03985401689916,NaN,NaN,-2.262088081673317,-5.471655725549578
2018-04-25T09:30:00-04:00,262.91,264.13,260.85,263.63,103840948,103212030.45,45.482098113162074,48.91027922866325,NaN,NaN,-37.82708339492316,38.312685292596335,0.17927340568796657,-0.5562127522520655,-0.735486157940032,9273908771,9304781092,33.01972798657442,37.61594443847475,NaN,NaN,-3.1580353383845337,-5.141138527383143
2018-04-26T09:30:00-04:00,264.79,267.2452,264.29,266.31,67731942,99276012.25,50.02817253857912,49.515664969087666,NaN,NaN,31.489613884244868,21.659790969736626,0.21708649095711618,-0.46412804424363685,-0.681214535200753,9341640713,9283416362.2,31.498354937494184,38.1044142363609,NaN,NaN,-2.6886190818475475,-4.790778606592344
2018-04-27T09:30:00-04:00,267,267.34,265.5,266.56,57053647,95916455.1,50.44330779284758,50.024884563430206,NaN,NaN,40.46116357226295,15.8391802536352,0.25157188650769147,-0.3667496770661387,-0.6183215635738302,9398694360,9293452988.4,33.05873773235923,38.29996417411366,NaN,NaN,-2.1876902721642195,-4.418908844531183
2018-04-30T09:30:00-04:00,267.26,267.89,264.43,264.51,82182324,90711254.15,46.99567641238386,49.90234329923114,NaN,NaN,10.451713864386113,7.398176193660177,0.13480975919378646,-0.44980936458159704,-0.5846191237753835,9316512036,9300164740.6,34.139152016658,38.2198202366777,NaN,NaN,-2.686872355517595,-4.171475060386385
2018-05-01T09:30:00-04:00,263.87,265.1,262.11,264.98,74203365,88423579.35,47.87528535951448,49.95815422015952,NaN,NaN,-48.56856309264335,-0.7986310333345159,0.08988273246400291,-0.47226570819537983,-0.5621484406593827,9390715401,9344294256.2,40.89386515860577,38.588254961591595,NaN,NaN,-2.8750069891641066,-3.9862653359260594
2018-05-02T09:30:00-04:00,264.76,265.68,262.76,263.2,86368943,86556259.55,44.84031912239458,49.597387166109506,NaN,NaN,-63.172750337547185,-5.867764421859322,-0.051458900435627175,-0.6264720662039167,-0.5750131657682895,9304346458,9350381793.6,41.780903151335714,39.005532177493855,NaN,NaN,-3.8584776272079138,-3.968009948966324
2018-05-03T09:30:00-04:00,262.26,263.36,259.05,262.62,136311479,89239202.6,43.864546108723246,49.23839179351506,NaN,NaN,-122.81534326825671,-36.72875585235964,-0.16912349684433292,-0.7864175368237056,-0.6172940399793727,9168034979,9315660646.8,38.25451983340659,39.00257795114708,NaN,NaN,-4.951455030320793,-4.108502103445534
2018-05-04T09:30:00-04:00,261.52,266.7892,261.15,266.02,91222075,84824245.9,50.64483671186847,49.155880097223125,NaN,NaN,-34.41392379558334,-51.7037733259289,-0.011399844251887226,-0.6315438452942317,-0.6201440010423445,9259257054,9287773185.6,35.65177019597027,38.71227414468329,NaN,NaN,-4.071318932432829,-4.10319022187229
2018-05-07T09:30:00-04:00,266.89,268.02,266.11,266.92,55304907,82317344.65,52.28765711579738,48.93441995289437,NaN,NaN,45.454834673736094,-44.7031491640589,0.1511455161695464,-0.4312121058304115,-0.5823576219999579,9314561961,9287383170.6,35.61527439085674,38.383724346592075,NaN,NaN,-2.8717888837048218,-3.9272757449912232
2018-05-08T09:30:00-04:00,266.5,267.325,265.15,266.92,67499247,80413620.2,52.287657115797394,48.695194990879585,NaN,NaN,20.992102155846464,-30.791016114360936,0.25041174461852944,-0.26934294122679603,-0.5197546858453255,9314561961,9272152482.6,34.14528082463252,37.660936148299804,NaN,NaN,-1.877132558977353,-3.6343981469892417
2018-05-09T09:30:00-04:00,267.68,269.865,267.09,269.5,59666143,78839915.2,57.04158222314309,48.966770179243156,NaN,NaN,102.24126383571475,2.2917867202914493,0.4688909729732112,0.06635903037118851,-0.4025319426020227,9374228104,9286128811.8,36.726125405076374,37.08398701416524,NaN,NaN,0.3512971240920309,-3.0650131082633454
2018-05-10T09:30:00-04:00,270.34,272.39,270.22,272.02,72063931,78998587.75,61.116785460001644,49.77997931327961,NaN,NaN,173.23842556706427,61.502540487355645,0.7457398007556988,0.5296428083426008,-0.216096992413098,9446292035,9341780223,45.829556053905925,37.14322679647413,NaN,NaN,3.5318500407683584,-2.122604086973102
2018-05-11T09:30:00-04:00,272.16,273.15,271.58,272.85,59871511,77738204.5,62.38254903505849,50.68801645570875,NaN,NaN,170.92528094090903,102.57038143465411,0.9351091459236601,0.9527894399914771,0.017680294067817043,9506163546,9391161521.4,52.376955286773565,37.85146821886515,NaN,NaN,6.566418818545518,-0.881315100470442
2018-05-14T09:30:00-04:00,273.34,274.08,272.36,272.98,54790606,77307470.45,62.587973238611006,51.99131759627731,NaN,NaN,156.94177458320962,124.86776941654882,1.0129173245873506,1.2838269498020054,0.27090962521465467,9560954152,9440439959.6,57.85171932110308,39.34585302105376,NaN,NaN,9.137203323676472,0.5499018172648311
2018-05-15T09:30:00-04:00,271.59,271.61,270.03,271.1,87036036,78425170.45,57.682243985540005,52.86275658716145,NaN,NaN,95.60568290287851,139.79048556595524,0.8861401443392325,1.3785848056386953,0.4924446612994628,9473918116,9472311190.6,60.97637684009864,41.34275651059121,NaN,NaN,10.082523103503021,1.911704858156001
2018-05-16T09:30:00-04:00,271.14,272.76,271.11,272.24,53942631,78257109.15,59.74281585789089,53.556659681397996,NaN,NaN,117.71169455300046,142.88457170941237,0.8284883459728656,1.5280550937655448,0.6995667477926792,9527860747,9503037719.2,63.765359769514745,43.64754257002125,NaN,NaN,11.463557069330031,3.2762551740380053
2018-05-17T09:30:00-04:00,271.94,273.23,271.13,272.01,56536400,77201133.7,59.11737258030553,54.176235737645,NaN,NaN,107.39578915765254,129.71604442753002,0.7278667083676347,1.6094001332522225,0.8815334248845879,9471324347,9508044181.6,64.21413811486869,45.872928311629074,NaN,NaN,12.454273513095307,4.587400651046192
2018-05-18T09:30:00-04:00,271.62,272.03,270.93,271.33,64367959,75421875,57.21040621923596,54.905859295277295,NaN,NaN,80.4713344286973,111.62525512508769,0.5752102563256409,1.600546245291639,1.025335988965998,9406956388,9488202750,60.99014339028264,47.790856266887964,NaN,NaN,12.807875645751535,5.761754221718384
2018-05-21T09:30:00-04:00,273.01,273.98,271.3512,273.37,58025875,75045271.05,61.24888705540468,55.86111655926944,NaN,NaN,97.1472977218418,99.66635975281413,0.5702149192022212,1.7381046379687746,1.1678897187665533,9464982263,9469008372.2,57.95857691293562,49.0097642493401,NaN,NaN,14.229721464245804,6.9714638277937295
2018-05-22T09:30:00-04:00,273.96,274.25,272.24,272.61,52966358,72049316.35,59.0142605744365,56.87354094870101,NaN,NaN,89.33196082886971,98.41161533801238,0.4780434782320351,1.7654440665565971,1.287400588324562,9412015905,9456627930,56.02424819081257,50.02714603787416,NaN,NaN,14.84294248384986,8.095960778658892
2018-05-23T09:30:00-04:00,271.17,273.39,270.99,273.36,64694184,70091978.15,60.54411763078952,58.06493891456289,NaN,NaN,73.71085748308224,89.61144792402874,0.43133863807382533,1.8265738859168437,1.3952352478430183,9476710089,9446397798.4,54.40837213247879,51.18099263066504,NaN,NaN,15.777683113393447,9.193349683620971
2018-05-24T09:30:00-04:00,272.91,273.22,270.78,272.8,76043827,70507572.4,58.77987550297466,58.646013113927616,NaN,NaN,61.39511912856454,80.41131391821112,0.3309954797591106,1.8089795975419065,1.477984117782796,9400666262,9432266181.4,52.169921535320746,52.36086058347578,NaN,NaN,16.113809541574497,10.18198680618576
2018-05-25T09:30:00-04:00,272.15,272.86,271.58,272.15,56374755,70473627.8,56.714080867943,58.96218623908088,NaN,NaN,55.005433289877175,75.3181336904471,0.19579502154338124,1.7227278947120226,1.5269328731686413,9344291507,9419733205.2,50.19745116848898,53.40244463902094,NaN,NaN,15.863290944758937,10.993601683124785
2018-05-29T09:30:00-04:00,270.31,271.17,267.76,269.02,115908607,72159941.95,47.971197115207495,58.653867667610164,NaN,NaN,-6.686292693251568,54.55141560742843,-0.11287994825144776,1.3858329378543317,1.4987128861057795,9228382900,9372413332.6,43.50876132246645,54.07126467458051,NaN,NaN,13.067178430129648,11.289826932696908
2018-05-30T09:30:00-04:00,270.5,273.11,270.42,272.61,69678449,71933696.15,56.29351790658251,58.60043450214156,NaN,NaN,47.431217653566144,46.171266972367704,-0.08499215207646182,1.392472696010202,1.477464848086664,9298061349,9349622421.4,40.6961148498074,54.35483534920415,NaN,NaN,13.055262681890802,11.542032039724607
2018-05-31T09:30:00-04:00,272.15,272.49,270.255,270.94,93519941,72291246.05,52.11724585503238,57.95761024464375,NaN,NaN,22.7272706596836,35.97454960768798,-0.1831024562279897,1.2485867778016768,1.4316892340296665,9204541408,9295188685.2,34.894068694361366,53.57372910923669,NaN,NaN,11.71006914616173,11.566037340644195
2018-06-01T09:30:00-04:00,272.41,273.94,272.33,273.6,71258411,69038592.65,57.522754736360824,57.61048208045106,NaN,NaN,82.59914633319976,40.21535504861502,-0.07829501254601978,1.3338204683471417,1.4121154808931615,9275799819,9270215396.6,32.59786870590074,52.16093721060291,NaN,NaN,12.305411573610888,11.671662231068009
2018-06-04T09:30:00-04:00,274.53,275.185,274.26,274.9,45392351,66747106.45,59.90503938962799,57.418843948380854,NaN,NaN,144.7828485484898,58.17083810033754,0.06158959230304095,1.4891024712719627,1.4275128789689218,9321192170,9265595529.2,32.17604669270426,50.32696059428871,NaN,NaN,13.559878842317167,11.94140746124646
2018-06-05T09:30:00-04:00,275.05,275.53,274.18,275.1,51135038,66538613,60.27417130918452,57.603981614355455,NaN,NaN,151.73285712654737,89.85466806429733,0.1457870947410278,1.6097467473952065,1.4639596526541787,9372327208,9294384390.8,37.59527183610491,48.65688166543202,NaN,NaN,14.670147322479274,12.331227441422575
2018-06-06T09:30:00-04:00,275.79,277.52,275.09,277.4,62732215,66300261.4,64.34005543437229,57.932355869818416,NaN,NaN,230.94126638919667,126.55667781142343,0.32435204375701976,1.8693997073504534,1.5450476635934336,9435059423,9321784005.6,42.31906661989234,47.12500358331613,NaN,NaN,16.917146728255563,12.986358768113002
2018-06-07T09:30:00-04:00,277.95,278.28,276.34,277.37,72969402,66965424.35,64.24768826394491,58.298806990078376,NaN,NaN,221.9033400396576,166.39189168741822,0.4032695897823966,2.049134650821429,1.6458650610390326,9362090021,9353293728.2,47.26301189974929,45.91420885366474,NaN,NaN,18.683886459704084,13.800291295483156
2018-06-08T09:30:00-04:00,276.85,278.25,276.66,278.19,72139719,66969213.75,65.69726829124893,58.90501142379359,NaN,NaN,190.83236374280537,188.03853516933935,0.4689189672132781,2.23201377005563,1.763094802842352,9434229740,9384979712.4,51.74235949264953,45.253652860976665,NaN,NaN,20.58777888942093,14.76993238033141
2018-06-11T09:30:00-04:00,278.44,279.37,278.31,278.56,58892515,66920263.95,66.36004319101869,59.27009400490887,NaN,NaN,181.04935419427144,195.2918362984957,0.49302395487417905,2.379374746435076,1.8863507915608968,9493122255,9419365729.4,56.100108788010736,45.12090513776774,NaN,NaN,22.355453003857367,15.85357818369226
2018-06-12T09:30:00-04:00,279.03,279.33,278.19,278.92,72329028,67797185.05,67.02757760615796,59.84247379288898,NaN,NaN,147.9817767503676,194.5416202232597,0.4880642226312064,2.496431069849905,2.0083668472186984,9565451283,9457990544.4,60.42330461241828,45.435123453596724,NaN,NaN,24.022060274399752,17.020504196650474
2018-06-13T09:30:00-04:00,279.19,279.48,277.8,278.03,79070610,67398913.75,63.66412586309725,60.06533152376811,NaN,NaN,117.37783703820776,171.82893435306195,0.38426280752875996,2.4886953566296484,2.1044325491008884,9486380673,9468254794.4,61.50812058942731,45.942248343378765,NaN,NaN,24.565063793690086,18.09829842479899
2018-06-14T09:30:00-04:00,279.01,279.33,278.0599,278.73,77097620,68556663.2,65.14556050743089,60.52002330980069,NaN,NaN,108.56695115735677,149.16165657660179,0.3245450549982962,2.5101138678487587,2.1855688128504625,9563478293,9508532448.8,65.50395500733045,46.89467930566517,NaN,NaN,25.42756765764728,19.14533688663446
2018-06-15T09:30:00-04:00,276.6,277.51,275.35,277.13,120143175,71737001.95,59.2039498207408,60.69787109214339,NaN,NaN,51.04234991673739,121.20365381138818,0.1480682607823498,2.3706541388283995,2.2225858780460497,9443335118,9510353524.4,65.67744183437301,48.00039292465688,NaN,NaN,24.54668632146681,19.916958234467653
2018-06-18T09:30:00-04:00,275.49,276.7,274.95,276.56,52917581,71164483.05,57.20236985667744,61.357240573676954,NaN,NaN,31.31064576231331,91.25591212499656,-0.026944917381879208,2.1889047313187007,2.21584964870058,9390417537,9489812580.8,61.896168576553855,49.313779157091695,NaN,NaN,23.24522594272922,20.392425049933593
2018-06-19T09:30:00-04:00,274,275.75,273.53,275.5,97531510,73139764.8,53.57493510117346,61.16305608757631,NaN,NaN,-1.6583530262567174,61.32788616967169,-0.22307549171848384,1.937005284052475,2.160080775770959,9292886027,9435299529.6,53.150483433918716,50.203376913099646,NaN,NaN,21.090923476733042,20.49221053947637
2018-06-20T09:30:00-04:00,276.27,276.72,275.59,275.97,53785486,73180721.2,54.939390444662976,61.36463784397849,NaN,NaN,26.670462071929904,43.186411176416115,-0.3240110922566668,1.7550669104501253,2.079078002706792,9346671513,9407357697.6,49.3049247660366,51.23272377536216,NaN,NaN,19.625675725361027,20.368419851745607
2018-06-21T09:30:00-04:00,275.96,275.98,273.68,274.24,71061404,73499082.2,49.20663515599182,60.77062930252357,NaN,NaN,-17.814124017544337,17.910196141435883,-0.4996494900616071,1.4545161401297833,1.9541656301913903,9275610109,9349784060.8,42.48416465268485,51.93888777156103,NaN,NaN,16.64187057692573,19.836055669628482
2018-06-22T09:30:00-04:00,275.66,275.785,274.49,274.74,56612003,72527491,50.80440553119719,60.12058402692137,NaN,NaN,-11.650618807432206,5.371602396601971,-0.569450706348124,1.2423522472562354,1.8118029536043594,9332222112,9327561459.6,40.173997343464436,52.510169960901045,NaN,NaN,14.564966342724759,19.083042908642238
2018-06-25T09:30:00-04:00,273.44,273.6162,269.1,271,137854162,76601461.35,40.53351824518429,58.710537379492784,NaN,NaN,-124.52060042172572,-25.794646840205836,-0.8385451338061238,0.7636215363467045,1.6021666701528283,9194367950,9288351542.2,36.411779233096816,52.4256347749719,NaN,NaN,9.172812186746961,17.6672956626572
2018-06-26T09:30:00-04:00,271.64,272.56,270.79,271.6,68683211,74240191.55,42.54045239594361,57.153422876747875,NaN,NaN,-122.05627683023644,-49.87423160100177,-0.9395664355817206,0.42770862567567747,1.367275061257398,9263051161,9282384569,35.8613913032644,51.96437225235561,NaN,NaN,5.407534438370827,15.91590120204486
2018-06-27T09:30:00-04:00,272.26,273.865,269.18,269.35,105110674,76011802.8,37.43789135295462,55.238437383105705,NaN,NaN,-143.11244073184687,-83.83081216175712,-1.1096859346470604,-0.019832357051427607,1.0898535775956328,9157940487,9244638363.8,32.51333738429541,50.910824072680334,NaN,NaN,0.40322135425206784,13.699804080931605
2018-06-28T09:30:00-04:00,269.29,271.75,268.49,270.89,76650517,75168331.6,42.519804383138606,53.58290424681211,NaN,NaN,-151.9111292588272,-110.6502132100137,-1.0697987552885817,-0.24739486651509424,0.8224038887734875,9234591004,9236434542.8,31.818046737933855,49.487658875914924,NaN,NaN,-2.1767656846777257,11.431722685844559
2018-06-29T09:30:00-04:00,272.12,273.66,271.1495,271.28,97592499,76485036,43.76559912178573,51.969015384724045,NaN,NaN,-96.62691216952456,-127.64547188243216,-0.9713264358809008,-0.3917541560776385,0.5795722798032623,9332183503,9236426821,31.8173570446544,47.75317660853233,NaN,NaN,-3.8605036744676755,9.247118920085668
2018-07-02T09:30:00-04:00,269.51,272.04,269.24,271.86,63554774,77393157.15,45.65210873526581,50.442196179660314,NaN,NaN,-111.05406311472778,-124.95216442103258,-0.8269569618224212,-0.4541239224747642,0.372833039347657,9395738277,9276700886.4,39.21769038642776,46.23848987810443,NaN,NaN,-4.683093492683932,7.257088575404297
2018-07-03T09:30:00-04:00,272.87,272.98,270.42,270.9,42187071,76945758.8,43.07624597088631,48.971633330216676,NaN,NaN,-88.88102256940394,-118.31711356886608,-0.7577825268808762,-0.5743951192534382,0.18338740762743794,9353551206,9294800895.4,42.251286556267864,44.863001732878764,NaN,NaN,-6.139096870277527,5.343347797449751
2018-07-05T09:30:00-04:00,272.17,273.18,270.96,273.11,56925919,76655444,50.061794786145484,47.894221492982005,NaN,NaN,-57.09542861937422,-101.11371114637156,-0.5353359899083917,-0.4857825797580517,0.04955341015033998,9410477125,9345308223,49.78296723630712,43.74007403494853,NaN,NaN,-5.262672181622667,3.8282020861536914
2018-07-06T09:30:00-04:00,273.14,275.84,272.715,275.42,66493696,76331658.7,56.12286910957802,47.674144299327516,NaN,NaN,2.24478734184557,-70.282527826237,-0.2208805784104258,-0.22654731286269225,-0.005666734452266467,9476970821,9393784186.4,55.748319517819574,43.03085101233757,NaN,NaN,-2.4895822880494576,2.925661461267527
2018-07-09T09:30:00-04:00,276.55,277.96,276.5,277.9,50550399,75252192.7,61.52232378508031,47.98271243707058,NaN,NaN,75.68088841064157,-35.82096771020378,0.14611237521506035,0.17697373456655896,0.03086135935149862,9527521220,9432851729.8,59.88425925393264,42.88714320357891,NaN,NaN,1.785157172131778,2.762732277105277
2018-07-10T09:30:00-04:00,278.41,279.01,278.08,278.9,51966829,74905908.4,63.474166491682944,48.68980039353555,NaN,NaN,107.5788023411199,7.905605380965758,0.43201330325986687,0.5708779884263322,0.13886468516646536,9579488049,9469601684.2,63.35399540159226,43.615965486984166,NaN,NaN,5.885294270960328,3.2088125619417127
2018-07-11T09:30:00-04:00,277.15,278.04,276.52,276.86,77054739,75142193.95,57.10971706565915,48.8448237236067,NaN,NaN,71.76111528164485,40.03403295117552,0.4571095778961665,0.7102516575366735,0.253142079640507,9502433310,9499378105,65.92563320220717,44.803158946710646,NaN,NaN,7.270338278046539,3.7890305213852593
2018-07-12T09:30:00-04:00,278.28,279.43,277.6,279.37,60124687,74194897.8,62.139798249372035,49.76862108741958,NaN,NaN,115.24587105605957,74.50229288626228,0.6067514853943443,1.0115814363834374,0.4048299509890931,9562557997,9529794279.4,68.36756000500553,46.65197290044783,NaN,NaN,10.196990091282162,4.704453317084817
2018-07-13T09:30:00-04:00,279.17,279.93,278.66,279.59,48234964,72751765,62.55432389318953,50.60790097041903,NaN,NaN,128.7748607312345,99.80830756414007,0.6790863471469522,1.2536878849227833,0.5746015377758311,9610792961,9556558707.4,70.3791541530736,48.8094841011342,NaN,NaN,12.604630339124206,5.833050034519015
2018-07-16T09:30:00-04:00,279.64,279.803,278.84,279.34,48201038,69154658.15,61.7272441619659,52.12173853590343,NaN,NaN,118.394189362928,108.35096775459735,0.6676326601873848,1.4091423630100621,0.7415097028226774,9562591923,9563572848,70.90140703423711,51.27302894407279,NaN,NaN,14.27626588401328,7.03922372730391
2018-07-17T09:30:00-04:00,278.47,280.91,278.41,280.47,52315500,69124554.1,64.04151682531702,53.65752885228726,NaN,NaN,119.9693577628728,110.82907883894794,0.6908090615332567,1.6050210297392482,0.9142119682059915,9614907423,9570656722.8,71.4489108642304,53.814994626998946,NaN,NaN,16.387416933816116,8.374679899662796
2018-07-18T09:30:00-04:00,280.56,281.18,280.06,281.06,44593465,66477651.85,65.22391494785793,55.64224482335178,NaN,NaN,119.85036086474065,120.44692795556709,0.6984399540279116,1.787261910740881,1.0888219567129693,9659500888,9602070238.4,73.80287157631592,56.764247069286114,NaN,NaN,18.482165189602057,9.81860636965412
2018-07-19T09:30:00-04:00,280.31,280.74,279.46,280,61412117,66858983.4,61.322511714453306,56.98529534701711,NaN,NaN,94.12391615776694,116.22253697590857,0.5890361675129214,1.8251171661041212,1.2360809985911998,9598088771,9609176393.2,74.31868960209545,59.800007273869085,NaN,NaN,19.143452872429688,11.150727298622058
2018-07-20T09:30:00-04:00,279.77,280.48,279.5,279.68,82372729,67424549.65,60.152747736604816,58.155805962361335,NaN,NaN,80.68120965154793,106.60380675997126,0.4578949774530021,1.8084497204074523,1.3505547429544502,9515716042,9590161009.4,70.3281890497205,62.55078098851667,NaN,NaN,19.363096555254582,12.323922906712419
2018-07-23T09:30:00-04:00,279.45,280.43,279.06,280.2,47047565,66946327.75,61.43997050989225,59.28351037483465,NaN,NaN,72.95854774816934,97.51667843701952,0.37256704418868525,1.8162635481903067,1.4436965040016214,9562763607,9590195346.2,70.33128695009174,64.77318074306409,NaN,NaN,19.900082524597703,13.406231423553173
2018-07-24T09:30:00-04:00,281.79,282.56,280.63,281.61,68026935,63454966.4,64.76384278360709,60.83262443288613,NaN,NaN,95.52286254484852,92.62737939341466,0.37637556913452985,1.9141659654197838,1.537790396285254,9630790542,9593371970,70.63672179644061,66.80071183164786,NaN,NaN,21.31569738167756,14.536155131856656
2018-07-25T09:30:00-04:00,281.33,284.37,281.28,284.01,78882927,63964952.2,69.57179473787886,62.22619585800994,NaN,NaN,116.66447816670764,91.99020285380806,0.49817510117980435,2.1605092727600095,1.6623341715802051,9709673469,9603406486.2,71.63027325253435,68.3612336899498,NaN,NaN,24.090547420131507,15.90106831589592
2018-07-26T09:30:00-04:00,283.2,284.11,283.09,283.34,57919495,61605393.25,66.83026471779576,62.9910098300255,NaN,NaN,116.00434108829823,96.3662878399143,0.49048850812909595,2.275444806741575,1.7849562986124792,9651753974,9614139526.8,72.69453020139899,69.57167731020547,NaN,NaN,25.582061731737916,17.28406737530192
2018-07-27T09:30:00-04:00,283.71,283.82,280.38,281.42,76783177,61612026.25,59.5842027912339,62.85257261617932,NaN,NaN,80.17375278059325,96.26479646572338,0.32115546204277523,2.1864006261659483,1.865245164123173,9574970797,9625990477.8,73.86054222795043,70.56998323692103,NaN,NaN,24.66830087028867,18.33895787458574
2018-07-30T09:30:00-04:00,281.51,281.69,279.36,279.95,63742508,59919526.7,54.694594632221104,62.22546034050348,NaN,NaN,43.07258901526521,90.28760471914254,0.0873682393482742,1.9744554633085158,1.8870872239602416,9511228289,9615683414.2,71.02000483260767,71.11755533913642,NaN,NaN,22.35208402733492,18.912261610692767
2018-07-31T09:30:00-04:00,280.81,282.02,280.38,281.33,68570493,60170312.65,58.16536103319486,62.300863481041745,NaN,NaN,62.680490460627965,83.71913030229844,0.007119111959441593,1.8959861139095437,1.8888670019501022,9579798782,9605485062.2,68.22420404875992,71.28173897103304,NaN,NaN,21.457658616907207,19.275889754437685
2018-08-01T09:30:00-04:00,281.56,282.13,280.1315,280.86,53853326,60753625.4,56.575684952912134,61.90342681700889,NaN,NaN,52.91886812924938,70.97000829480679,-0.09076742391473447,1.7754077220566842,1.8661751459714186,9525945456,9568739459.6,59.183789353939495,70.62575535309975,NaN,NaN,20.250349630174984,19.41509830811444
2018-08-02T09:30:00-04:00,279.39,282.58,279.16,282.39,63426363,61078647.6,60.37249760863994,61.74758208239821,NaN,NaN,61.013048384412336,59.971749754029624,-0.0667351668189613,1.782756187447717,1.8494913542666782,9589371819,9556263028.6,56.448688111646355,69.63072206442638,NaN,NaN,20.35486993588308,19.549351397795675
2018-08-03T09:30:00-04:00,282.53,283.6577,282.33,283.6,53935386,60450732.1,63.11892655343722,61.84698796750331,NaN,NaN,132.3161108515299,70.40022136821696,0.012184067645089058,1.8647214388230395,1.8525373711779505,9643307205,9569930310.2,58.70030225874135,68.7592145804624,NaN,NaN,21.28113043392806,19.796748402957444
2018-08-06T09:30:00-04:00,283.64,284.99,283.2015,284.64,39400887,59893256.5,65.34225979331165,61.93989817950291,NaN,NaN,162.65341343300972,94.31638625176586,0.11049154670395889,1.9906518045578991,1.8801602578539403,9682708092,9604226270.8,63.76308669355899,68.21022713970015,NaN,NaN,22.736239858785627,20.216675753790042
2018-08-07T09:30:00-04:00,285.39,286.01,285.24,285.58,43196646,59454747.35,67.26321079613955,62.08556216866589,NaN,NaN,189.39471430668937,119.65923102097815,0.209164162397534,2.1416154608508577,1.9324512984533238,9725904738,9633447462,67.42696027017803,67.75480490354745,NaN,NaN,24.538295561250788,20.83405001199872
2018-08-08T09:30:00-04:00,285.39,285.91,284.94,285.46,42114551,57707737.95,66.7545421801605,62.473564344787825,NaN,NaN,158.31717232279638,140.73889185968756,0.2347696060141451,2.2259133059710052,1.9911436999568601,9683790187,9665016408.2,70.85538386124344,67.50742592205802,NaN,NaN,25.858410439754763,21.55181578739244
2018-08-09T09:30:00-04:00,285.53,285.97,284.915,285.07,35716976,56487352.4,65.03322584583205,62.82216992401834,NaN,NaN,131.37672149474693,154.81162648175447,0.19546982540200997,2.2354809817093724,2.0400111563073624,9648073211,9676756686.6,72.0342530144556,67.62928763382482,NaN,NaN,26.490376012455606,22.25732439097289
2018-08-10T09:30:00-04:00,283.45,284.055,282.36,283.16,77076044,57929406.4,57.24764628119088,62.52271819339682,NaN,NaN,43.73968350737349,137.0963410129232,0.020100502831458922,2.065136784846686,2.0450362820152272,9570997167,9662294679,68.36581541871392,67.48889681015497,NaN,NaN,24.780856829913624,22.61782902510728
2018-08-13T09:30:00-04:00,283.47,284.16,281.77,282.1,65732909,58805999.95,53.42505545275389,61.71280481262159,NaN,NaN,18.414804883046532,108.24861930293055,-0.1771622217271518,1.8235835048562876,2.0007457265834394,9505264258,9626805912.2,60.25635527146512,66.74744205837099,NaN,NaN,22.177561247620726,22.554933628323486
2018-08-14T09:30:00-04:00,282.92,284.17,282.4833,283.9,43842031,58382326.5,58.49342631554635,60.92149278245499,NaN,NaN,46.67175620416492,79.70402768242566,-0.19488416146551257,1.7571405247515486,1.9520246862170612,9549106289,9591446222.4,53.4529430041078,65.44906132634053,NaN,NaN,21.400060821067573,22.389951798715497
2018-08-15T09:30:00-04:00,282.38,282.54,280.16,281.78,102887320,61297019.25,51.39897896384356,59.81925808574412,NaN,NaN,-40.45618804024217,39.94935560981794,-0.34886546393669526,1.515942856296192,1.8648083202328873,9446218969,9543931978.8,45.94587257231905,63.538442924263386,NaN,NaN,18.417920706422663,21.822518785530807
2018-08-16T09:30:00-04:00,283.4,285.04,283.36,284.06,69967919,61724809.35,57.38523485607757,59.66218894751866,NaN,NaN,66.95580677402157,27.065172665672883,-0.29858668511036934,1.4915749638449256,1.790161648955295,9516186888,9517554714.2,42.38692644130476,61.290327510931554,NaN,NaN,17.801158256165053,21.248038709907128
2018-08-17T09:30:00-04:00,283.83,285.5601,283.37,285.06,65618481,60887096.95,59.728174174125186,60.02173034336895,NaN,NaN,82.48905007913747,34.81504598002567,-0.20392341140336945,1.535257384701083,1.7391807961044525,9581805369,9519716354.6,42.77810542992788,59.273048982168724,NaN,NaN,18.063386840521336,20.793088442852014
2018-08-20T09:30:00-04:00,285.57,285.97,285.06,285.67,39807490,60525093.2,61.13198261028157,60.23363188458943,NaN,NaN,117.00804593275977,54.53369418996832,-0.11082730759190129,1.6006466616145758,1.711473969206477,9621612859,9542986074.8,46.95355421904747,57.75371685147497,NaN,NaN,18.715033330608833,20.496223426817274
2018-08-21T09:30:00-04:00,286.25,287.31,285.7135,286.34,67271983,60487345.6,62.67113276509267,60.669021014030896,NaN,NaN,140.72678115577784,73.3446991802909,-0.019512069424465484,1.6870838824258954,1.7065959518503608,9688884842,9570941785.4,51.52951556314011,57.206983009275014,NaN,NaN,19.71885972792354,20.385171469832454
2018-08-22T09:30:00-04:00,285.88,286.76,285.575,286.17,44993333,58792865.9,62.00025884887893,60.785289674047974,NaN,NaN,111.3046557410225,103.69686793654384,0.012337695328608067,1.7220180710111208,1.7096803756825127,9643891509,9610476293.4,57.157940543609,57.25764389727235,NaN,NaN,20.339940616482686,20.378709919353916
2018-08-23T09:30:00-04:00,285.97,286.94,285.43,285.79,49204851,58357133.7,60.44272757694838,60.594132604298764,NaN,NaN,93.64848034839144,109.03540265141783,-0.008183793419439311,1.6994506339082136,1.707634427327653,9594686658,9626176247.4,59.18486464861442,57.29225549654899,NaN,NaN,20.423650631773867,20.385130021128194
2018-08-24T09:30:00-04:00,286.44,287.67,286.38,287.51,57487399,57392344.8,64.75822250919498,60.55241565543328,NaN,NaN,123.65293459961138,117.2681795555126,0.07358094762585798,1.7996106118599755,1.7260296642341175,9652174057,9640249985,60.967605024832906,57.092578234497125,NaN,NaN,21.76562441039252,20.582343505308813
2018-08-27T09:30:00-04:00,288.86,289.9,288.68,289.78,57072377,57058838.25,69.48909701068445,60.71140752790078,NaN,NaN,188.35176954700665,131.53692427836197,0.2501024822928468,2.038657767100176,1.7885552848073292,9709246434,9657776700,63.12755904878305,56.78547814725463,NaN,NaN,24.480961968509277,21.139289000051736
2018-08-28T09:30:00-04:00,290.3,290.4175,289.4,289.92,46943472,55977487.2,69.75872845146237,60.925992261565206,NaN,NaN,180.0950835640509,139.41058476001658,0.3402605308431257,2.2138809483612363,1.8736204175181106,9756189906,9671237712.8,64.74134860320721,56.34876134310918,NaN,NaN,26.73664905077901,21.938911864441348
2018-08-29T09:30:00-04:00,290.16,291.74,289.8854,291.48,61485514,56359096.6,72.65822998806969,61.47063541458217,NaN,NaN,194.74111719075643,156.09787704996336,0.46140694559380857,2.4503790995103714,1.9889721539165628,9817675420,9705994495,68.5667797963256,56.10108468467132,NaN,NaN,29.608285156239468,23.034536620412506
2018-08-30T09:30:00-04:00,290.94,291.36,289.63,290.3,61229501,56249253.5,67.39454227049487,62.19541369953246,NaN,NaN,151.82181157071443,167.73254329442796,0.4197135340658864,2.513614071498921,2.0939005374330346,9756445919,9738346347.2,71.65004795037584,56.335672722647175,NaN,NaN,30.454290666807342,24.094501484183198
2018-08-31T09:30:00-04:00,289.84,290.81,289.29,290.31,66140838,56859526.1,67.41608552117873,63.19477299013423,NaN,NaN,122.98121043742995,167.59819846199167,0.35312731958512833,2.535309686914445,2.182182367329317,9822586757,9772428887.2,74.48905490838442,57.35229412528427,NaN,NaN,31.13959620796344,25.100943587580375
2018-09-04T09:30:00-04:00,289.84,290.21,288.68,289.81,57594367,57769200.1,65.09998960613224,63.66667036803322,NaN,NaN,91.88916472944753,148.30567749847984,0.24107748072021984,2.4835292182295916,2.2424517375093718,9764992390,9783578078.4,75.35837470785918,58.91696781840936,NaN,NaN,31.06469780712951,25.952908476087394
2018-09-05T09:30:00-04:00,289.41,289.64,287.89,289.03,72452437,59231989.65,61.54765550624457,64.39157583534758,NaN,NaN,63.43182599459259,124.97302598458819,0.08798735036249195,2.352435925462487,2.264448575099995,9692539953,9770848087.8,72.32778200343427,60.80138992063188,NaN,NaN,30.00064046737511,26.53115590341421
2018-09-06T09:30:00-04:00,289.15,289.49,287,288.16,65909863,60421755.25,57.76164535100754,64.41846229927116,NaN,NaN,41.255958386211184,94.27599422367913,-0.08874493273064354,2.1535174091866907,2.242262341917334,9626630090,9732639021.8,64.0072983962155,62.3457022031255,NaN,NaN,28.004215005576594,26.741592918008834
2018-09-07T09:30:00-04:00,286.98,288.7,286.71,287.6,73524824,62312147.65,55.39938030012208,64.10926273684235,NaN,NaN,23.35719421658766,68.58307075285377,-0.2510453173813252,1.928455695190678,2.179501012572003,9553105266,9691970891.2,56.55050089740939,63.32944473651703,NaN,NaN,25.642990040719134,26.58464964982459
2018-09-10T09:30:00-04:00,288.74,289.04,287.88,288.1,50210903,60968890.6,57.08688791292285,63.820327401316725,NaN,NaN,36.67737330373616,51.322303326115026,-0.327573106622264,1.770034629294173,2.097607735916437,9603316169,9648116773.6,49.81152994847529,63.533585860047594,NaN,NaN,24.08620115315432,26.22772843601455
2018-09-11T09:30:00-04:00,287.37,289.55,286.975,289.05,50530492,60208769.75,60.1704225491362,63.64170524303413,NaN,NaN,36.548199902194206,40.25411036066436,-0.3168640274942476,1.7015277015486276,2.0183917290428752,9653846661,9625887627.8,46.76914844875259,63.19355963759134,NaN,NaN,23.566686941786124,25.847579651124775
2018-09-12T09:30:00-04:00,289.06,289.8,288.23,289.12,59810758,61007206.1,60.39623837533573,63.52713235206676,NaN,NaN,48.15281780338339,37.19830872242252,-0.3074753039013445,1.6340475991661947,1.9415229030675392,9713657419,9630111121,47.426181206189945,62.498433970632846,NaN,NaN,23.19562891678937,25.468729546219716
2018-09-13T09:30:00-04:00,290.32,291.0384,289.995,290.83,51034222,58414551.2,65.53655755147494,63.890977350247226,NaN,NaN,99.30336923282889,48.80779089174605,-0.19404455890875405,1.6989672044315967,1.8930117633403507,9764691641,9657723431.2,51.62974473940122,61.95878254854619,NaN,NaN,24.327987447827773,25.30576638930658
2018-09-14T09:30:00-04:00,291.06,291.27,290,290.88,55079875,57670149,65.67683876246377,63.956592796909284,NaN,NaN,97.93268564554106,63.72288917753673,-0.1268435727559991,1.7344572973953518,1.861300870151351,9819771516,9711056681.2,58.52723467128715,61.78447038043578,NaN,NaN,25.2961497964556,25.30439259032787
2018-09-17T09:30:00-04:00,290.82,290.86,289.03,289.34,68244043,57801427.1,57.86438290471895,63.12625607505462,NaN,NaN,50.45535616878199,66.4784857505459,-0.19332227387330714,1.619648027809717,1.812970301683024,9751527473,9740698942,61.78862874042293,61.6888325012672,NaN,NaN,23.908865268857955,25.105031544403595
2018-09-18T09:30:00-04:00,289.58,291.58,289.55,290.91,61930407,58907572.95,62.73158990058644,62.624317607134905,NaN,NaN,89.20953883730306,77.01075353756767,-0.14119033476198473,1.6364823832305433,1.777672717992528,9813457880,9772621185.8,64.9823300567016,61.70604546223108,NaN,NaN,24.148241828513093,24.96834729927638
2018-09-19T09:30:00-04:00,290.97,291.69,290.825,291.22,49080562,57998001.9,63.6250588859096,61.97909109983776,NaN,NaN,109.61152000938336,89.30249397876766,-0.09753684169491916,1.6557516658738791,1.7532885075687983,9862538442,9802397390.4,67.6946259204991,61.6437487568149,NaN,NaN,24.607561563727725,24.91680647991229
2018-09-20T09:30:00-04:00,292.64,293.94,291.2363,293.58,100360646,60766367.55,69.60015594208964,62.1366349335231,NaN,NaN,184.17355816824679,106.27653176585122,0.06956265442396359,1.8402418255987527,1.7706791711747891,9962899088,9842038879.8,70.92354110845945,61.59185541096373,NaN,NaN,26.980640808298734,25.211639955396066
2018-09-21T09:30:00-04:00,293.09,293.22,291.81,291.99,105597145,63585982.25,62.188388670195685,61.76322801559574,NaN,NaN,142.71525973808403,115.23304658435981,0.05303776256349857,1.8369763743791623,1.7839386118156637,9857301943,9849544965.2,71.50431775421521,61.37865989995164,NaN,NaN,26.56666453297286,25.405214895049895
2018-09-24T09:30:00-04:00,291.34,291.5,290.37,291.02,53409645,63382094.55,58.12197796322932,61.264798612531244,NaN,NaN,57.75954174299416,116.69388369920227,-0.038267008371775324,1.7361048513509445,1.7743718597227198,9803892298,9860017930.2,72.33463650364104,61.16267859965035,NaN,NaN,24.894164053529476,25.33220763197555
2018-09-25T09:30:00-04:00,291.53,291.65,290.4833,290.75,44370037,62746977.55,57.00462914522082,60.94029672960098,NaN,NaN,52.46725820375819,109.3454275724933,-0.1268964288926553,1.6157513236069008,1.742647752499556,9759522261,9849230806.4,70.06989849877901,61.001401206460685,NaN,NaN,23.214088198321466,25.029619141453537
2018-09-26T09:30:00-04:00,290.91,292.24,289.41,289.88,79739674,64386787.65,53.43968715465395,60.631585429861445,NaN,NaN,23.1713044286407,92.05738445634476,-0.2472042665877141,1.4336424192649133,1.6808466858526274,9679782587,9812679635.4,62.88532057624793,60.92125993360586,NaN,NaN,20.70186756127859,24.41136891571426
2018-09-27T09:30:00-04:00,290.41,291.91,290.1,290.69,59249455,64274984.7,56.18692658764918,60.68783873611337,NaN,NaN,47.35286207947407,64.69324523859022,-0.273283683061867,1.3392420820252937,1.6125257650871607,9739032042,9767906226.2,55.392819790034544,60.838568425936224,NaN,NaN,19.416619979139718,23.697833353346468
2018-09-28T09:30:00-04:00,289.99,291.28,289.95,290.72,70091385,64718078.9,56.28979555468756,60.630903567668,NaN,NaN,31.269996970972432,42.40419268516791,-0.28809033350133095,1.252412848210497,1.540503181711828,9809123427,9758270523,53.904319181222064,61.13091051398957,NaN,NaN,18.410457187717622,22.942493901113775
2018-10-01T09:30:00-04:00,292.11,292.93,290.98,291.73,62078937,64514983.85,59.718798645710386,60.598644717423305,NaN,NaN,94.11994497000839,49.67627333057075,-0.23185731681111355,1.250681535697936,1.4825388525090495,9871202364,9771732536.2,55.695560389404235,61.768511366893264,NaN,NaN,18.528422442777355,22.311912264208573
2018-10-02T09:30:00-04:00,291.56,292.355,291.14,291.56,47258227,63998176.85,58.88150808633844,60.49044969678064,NaN,NaN,76.4953639456977,54.48189447895866,-0.20882223426652713,1.2215110596758905,1.4303332939424176,9823944137,9784616911.4,57.401736165390126,62.48105100683613,NaN,NaN,18.392313456975295,21.75196957746096
2018-10-03T09:30:00-04:00,292.74,293.21,291.32,291.72,64694594,63610284.7,59.457650424307126,60.056242044840076,NaN,NaN,93.7612432931206,68.59988225185464,-0.18626673361210888,1.1974998769272815,1.3837666105393904,9888638731,9826388140.2,62.450440539906296,63.25395784972935,NaN,NaN,18.43406479180641,21.27798317951031
2018-10-04T09:30:00-04:00,291.18,291.24,287.66,289.44,111545910,65892087.05,48.93526700392979,58.86041549065908,NaN,NaN,-69.56180741793335,45.216948352373144,-0.320484782362241,0.9831606325865891,1.3036454149488301,9777092821,9834000296,63.30397712480196,63.59515373926613,NaN,NaN,15.276993405300257,20.42069892605173
2018-10-05T09:30:00-04:00,289.69,290.27,286.22,287.82,105961360,67513913.85,43.09896127575712,57.80574251716181,NaN,NaN,-160.17780203931756,6.927388550315146,-0.5030794150044,0.6747961461933301,1.17787556119773,9671131461,9806401902.8,58.14361545424795,63.33479564739649,NaN,NaN,10.593810238655651,19.01685768499515
2018-10-08T09:30:00-04:00,287.05,288.22,285.5,287.82,87742172,69390477.3,43.09896127575711,56.40341190110257,NaN,NaN,-201.59534432281157,-52.21566930824885,-0.6018924057195987,0.4255100540482317,1.0274024597678304,9671131461,9766387722.2,51.57863009667506,62.37738850739459,NaN,NaN,6.8875075959022425,17.284093386553305
2018-10-09T09:30:00-04:00,287.39,288.86,286.77,287.4,74338982,70580901.8,41.606905259638395,54.830686642083194,NaN,NaN,-160.3181030992288,-99.57836271723416,-0.6684443304015211,0.191847046765929,0.8602913771674501,9596792479,9720957390.6,45.321785078746935,60.77932844726944,NaN,NaN,3.3672748657891787,15.295976455015573
2018-10-10T09:30:00-04:00,286.83,286.91,277.88,278.3,214756170,78328172.4,23.015421705209533,51.50320562516318,NaN,NaN,-349.84743458468057,-188.3000982927944,-1.2637006841268266,-0.7193344779910831,0.5443662061357435,9382036309,9619636906.2,35.09631745335304,58.22024104333327,NaN,NaN,-9.542408347769417,11.747635768903432
2018-10-11T09:30:00-04:00,277.08,278.9,270.36,272.17,274840490,89518485.8,17.3812174109527,48.30269339236012,NaN,NaN,-362.7656119841684,-246.94085920604138,-1.9667157185748652,-1.914028442082838,0.0526872764920272,9107195819,9485657505.8,26.56209509692097,55.01008228209797,NaN,NaN,-23.339342255486347,6.73521033684775
2018-10-12T09:30:00-04:00,276.77,277.09,272.37,275.95,183186492,95923816.65,28.934112882546003,46.21784588659703,NaN,NaN,-235.08698308097624,-261.92269541437315,-2.0635030053029517,-2.5266914801366624,-0.46318847483371073,9290382311,9409507675.8,23.12080732973952,51.494808769676425,NaN,NaN,-27.994611742566754,1.7738071826456787
2018-10-15T09:30:00-04:00,275.55,277.04,274.3,274.4,102263717,97624800.35,27.251343679383922,44.09261121046582,NaN,NaN,-179.81393737243732,-257.5664140242983,-2.1106897422349933,-3.101550652627452,-0.990860910392459,9188118594,9312905102.4,19.643915620372653,47.89295284979026,NaN,NaN,-31.966477332378386,-3.046233462357759
2018-10-16T09:30:00-04:00,276.6,280.82,276.07,280.4,118255834,100441071.7,41.447323445757796,43.236013802687516,NaN,NaN,-104.37290379543471,-246.37737416353943,-1.637680158060241,-3.03796110796776,-1.4002809499075193,9306374428,9254821492.2,17.90085850016142,44.67977698721264,NaN,NaN,-28.739461853583492,-6.716694661104293
2018-10-17T09:30:00-04:00,280.44,281.15,277.56,280.45,110625987,103518342.95,41.54968354530218,42.19049644251987,NaN,NaN,-82.45098064008978,-192.8980833746213,-1.239400037073181,-2.9495309962489955,-1.7101309591758145,9417000415,9261814313.4,18.834624096312012,42.06847729480389,NaN,NaN,-26.50001080250722,-9.542882681304711
2018-10-18T09:30:00-04:00,279.4,280.07,274.97,276.4,134557525,105228186.9,36.05196403509342,40.74493704826315,NaN,NaN,-97.10231145790299,-139.76542326936823,-1.1676649761938047,-3.1697121794180703,-2.0020472032242655,9282442890,9296863727.6,23.5293175748981,39.89883432292361,NaN,NaN,-26.88733622779802,-12.020661759375184
2018-10-19T09:30:00-04:00,277.13,279.3,275.47,276.25,139901634,106943411.35,35.862695376253725,39.04092967187339,NaN,NaN,-86.21433472849733,-109.99089359887243,-1.0528122696247006,-3.3180625402551414,-2.2652502706304407,9142541256,9267295516.6,22.35460297345371,37.517337364641435,NaN,NaN,-27.23553842182367,-14.194215568296396
2018-10-22T09:30:00-04:00,277,277.36,274.41,275.01,82415812,108393719.7,34.261405140378756,37.282350890019124,NaN,NaN,-89.54030034512887,-91.93616619341076,-0.9841167081651561,-3.495396155836886,-2.51127944767173,9060125444,9241696886.6,21.360326244405385,34.94295094171395,NaN,NaN,-28.055034957187523,-16.174332623852273
2018-10-23T09:30:00-04:00,270.95,274.87,268.61,273.61,146352719,113492853.8,32.49714211774051,35.356600296692946,NaN,NaN,-108.98286036568831,-92.85815750746147,-0.9559205110600795,-3.706180086496829,-2.7502595754367496,8913772725,9163176546,18.624024522727424,31.8124926547726,NaN,NaN,-29.292407310207867,-18.048343293331644
2018-10-24T09:30:00-04:00,273.33,273.76,264.7,265.32,177806697,118396204.95,24.46384185199375,33.608641357268944,NaN,NaN,-135.88537875421662,-103.54503713028683,-1.3921115896696912,-4.4903990625238634,-3.0982874728541723,8735966028,9026969668.6,15.027758200831087,28.3641913030604,NaN,NaN,-33.606905102324816,-20.27099498033067
2018-10-25T09:30:00-04:00,267.38,271.81,266.23,270.08,138061545,122336809.45,34.47917286042528,32.99294218474524,NaN,NaN,-112.00756617620453,-106.52608807394715,-1.260512342179796,-4.673927900578917,-3.4134155583991213,8874027573,8945286605.2,13.361469670202368,25.1654666042,NaN,NaN,-33.18522700731674,-22.115885269900108
2018-10-26T09:30:00-04:00,265.92,271,262.29,265.33,201574596,128910970,30.178994050870926,32.07008738296766,NaN,NaN,-130.27477646932078,-115.33817642211184,-1.3839647885309447,-5.143371544062802,-3.7594067555318573,8672452977,8851268949.4,11.746950421647384,22.32034662741231,NaN,NaN,-34.53500258703421,-23.89004488663355
2018-10-29T09:30:00-04:00,268.8,270.25,259.85,263.86,160749101,133844478.2,28.97463479365814,31.167782349683357,NaN,NaN,-133.43177324510887,-124.11647100210784,-1.448330841153676,-5.569820306973952,-4.121489465820276,8511703876,8741584635.8,10.19866163982789,19.81155209606095,NaN,NaN,-35.98782813296307,-25.618299636109196
2018-10-30T09:30:00-04:00,263.67,268.12,263.12,267.77,157115995,139337366.6,36.2608451047621,32.11388402107997,NaN,NaN,-109.83541702289143,-124.28698233354847,-1.1256484417495347,-5.528550018007195,-4.40290157625766,8668819871,8692594065,9.59062940762567,17.989717235651845,NaN,NaN,-34.49407426101584,-26.88626743966729
2018-10-31T09:30:00-04:00,270.65,273.23,270.12,270.63,128296325,142517453.15,41.02646446407134,33.80283023915987,NaN,NaN,-53.96739600052626,-107.90338578281039,-0.6417300820882144,-5.205064178867929,-4.563334096779714,8797116196,8704824098.6,11.016863981484889,16.87934358454927,NaN,NaN,-31.59825164395677,-27.559408040280072
2018-11-01T09:30:00-04:00,271.6,273.73,270.38,273.51,99495037,141914909.5,45.44952350770776,34.982502426671424,NaN,NaN,-34.860666006446884,-92.47400574885886,-0.07938096030585307,-4.662560297162031,-4.583179336856178,8896611233,8709340830.6,11.571681590416716,16.054406031740502,NaN,NaN,-27.71660760974527,-27.581865121632244
2018-11-02T09:30:00-04:00,274.75,275.23,269.59,271.89,122634107,142748546.85,43.47434727038875,36.14128839745748,NaN,NaN,-31.867110839174696,-72.79247262282964,0.21564921160211448,-4.313617822353535,-4.52926703395565,8773977126,8729645660.4,14.162745131695829,15.662893853977872,NaN,NaN,-25.299570950508592,-27.25582309718601
2018-11-05T09:30:00-05:00,272.44,274.01,271.35,273.39,65622482,141642562.35,45.82213761001901,36.45377512347614,NaN,NaN,-14.7884228664401,-49.063802547095875,0.526282678368263,-3.8714136859953214,-4.3976963643635845,8839599608,8795224806.8,22.101740368277902,15.962956844557624,NaN,NaN,-22.605427184128143,-26.591480823892027
2018-11-06T09:30:00-05:00,273.32,275.3,273.25,275.12,60085894,140929907.95,48.4799803022069,36.948796320397896,NaN,NaN,24.757348544084216,-22.14524943370075,0.8438906264382258,-3.3428330813158027,-4.1867237077540285,8899685502,8841397933,27.2066672770696,16.56095992889745,NaN,NaN,-19.566634934657905,-25.587931411144297
2018-11-07T09:30:00-05:00,277.56,281.1,277.08,281.01,102752099,135329704.4,56.33419476485704,38.39752708680959,NaN,NaN,123.35628522802855,13.319486812010217,1.4127785948533997,-2.420750464187279,-3.8335290590406785,9002437601,8882462214,31.50574732337796,17.13070491093173,NaN,NaN,-14.165975119759516,-23.9562233695179
2018-11-08T09:30:00-05:00,280.11,281.22,279.22,280.5,65584886,124866924.2,55.54459303861424,39.80337691983534,NaN,NaN,117.45922746780394,43.78346550686039,1.6976889079444675,-1.7114179241100942,-3.4091068320545617,8936852715,8890510510.4,32.34904764368392,17.844593815948173,NaN,NaN,-10.178351230238816,-21.98795592104946
2018-11-09T09:30:00-05:00,279.03,279.24,276.18,277.76,98812561,120648227.65,51.37802503627045,41.02599262668475,NaN,NaN,68.54397696279325,63.865683067253975,1.6434892920938409,-1.3547452169372605,-2.9982345090311013,8838040154,8903323116,33.74750286522361,18.72939214600662,NaN,NaN,-8.109221634921736,-20.005279594459783
2018-11-12T09:30:00-05:00,277.19,277.46,271.99,272.57,99673574,120518720.5,44.55966294723472,41.88760125736291,NaN,NaN,7.894255782879881,68.40221879711797,1.219484254963454,-1.4738791903267838,-2.6933634452902377,8738366580,8883076510.4,32.60066873964068,19.727723875786136,NaN,NaN,-8.517190287660377,-18.364123979202724
2018-11-13T09:30:00-05:00,273.09,275.325,271.25,272.06,98176610,119514759.3,43.94253493091218,43.27893647728565,NaN,NaN,-6.34186347986842,62.182376392327434,0.8818066041512846,-1.591105190101132,-2.4729117942524166,8640189970,8831177404,29.804677936764236,20.783218142638507,NaN,NaN,-9.03060247710573,-17.03076376461744
2018-11-14T09:30:00-05:00,274.16,274.61,268.45,270.2,125335931,120250256.5,41.67558206016531,43.79296570583851,NaN,NaN,-33.6077323176566,30.78957288319041,0.5277752453095261,-1.813192737615509,-2.340967982925035,8514854039,8733660691.6,25.39712410407158,21.642907745057734,NaN,NaN,-10.148666840579686,-16.047607061183474
2018-11-15T09:30:00-05:00,268.78,273.54,267.0102,273.02,135101437,120277452.1,46.2067101327177,44.937802568827564,NaN,NaN,-27.017468505350305,1.8942336885595588,0.47951636806299014,-1.7415725228462975,-2.2210888909092876,8649955476,8676281243.8,23.221126225245214,22.46249173102901,NaN,NaN,-9.725802266376682,-15.144492090496788
2018-11-16T09:30:00-05:00,271.79,274.75,271.21,273.73,126668040,119615772.4,47.31645923788296,46.24793288627219,NaN,NaN,20.15165925476155,-7.7842298530467815,0.48969138311803295,-1.6089746620117467,-2.0986660451297796,8776623516,8663997916.2,22.771339271762812,23.360540133310078,NaN,NaN,-9.058000510757132,-14.274993293391123
2018-11-19T09:30:00-05:00,273.05,273.38,268.07,269.1,103061706,120648067.1,41.328803096526535,46.60992988568394,NaN,NaN,-41.14517938409726,-17.592116886442206,0.19405580820961532,-1.8560962848677605,-2.050152093077376,8673561810,8651036962.2,22.280925763198056,24.266989872993822,NaN,NaN,-10.309570872927946,-13.708504376182098
2018-11-20T09:30:00-05:00,265.36,267,263.15,264.12,136021311,120131496.7,36.04525409088847,46.25412914474231,NaN,NaN,-137.1606135518836,-43.75586690084525,-0.30053668937743794,-2.425822954799173,-2.1252862654217353,8537540499,8630507068,21.491388291412733,25.015170180845807,NaN,NaN,-13.154490955179673,-13.62935960175318
2018-11-21T09:30:00-05:00,265.86,267.15,265.01,265.02,75563743,115019349,37.59789143150385,45.69329828215631,NaN,NaN,-112.02524988199458,-59.439370413712844,-0.517971328509236,-2.7727504260582805,-2.2547790975490445,8613104242,8650157108.6,24.25793545207442,25.921331170964216,NaN,NaN,-14.948751278382158,-13.817844126985891
2018-11-23T09:30:00-05:00,263.18,264.8234,263.07,263.25,42807878,110256665.65,35.759233698537045,45.14221874130976,NaN,NaN,-134.1110747132002,-80.85809165528282,-0.7195031092849056,-3.1541579841551766,-2.434654874870271,8570296364,8634225286.2,23.533832810415234,26.59069457658703,NaN,NaN,-16.997688422981625,-14.272107597842425
2018-11-26T09:30:00-05:00,265.78,267.75,265.34,267.5,79981362,104177003.95,42.97088002934128,44.938557485547065,NaN,NaN,-79.53589431773257,-100.79560236978163,-0.5146804282599002,-3.0780054101951464,-2.563324981935246,8650277726,8608956128.2,22.392133426096635,26.611436937859796,NaN,NaN,-16.544446011623172,-14.596727371239675
2018-11-27T09:30:00-05:00,266.34,268.4,265.66,268.4,75502441,99914670.95,44.39445413127749,44.646734187623544,NaN,NaN,-73.7649613432959,-107.31955876162138,-0.2785158993491619,-2.9114698561216983,-2.6329539567725364,8725780167,8619399799.6,24.03247462869753,26.384708891547508,NaN,NaN,-15.748845480628079,-14.761315672580876
2018-11-28T09:30:00-05:00,269.6,274.58,268.3272,274.58,127629633,98440352.85,53.059346780906296,44.4128164744842,NaN,NaN,14.919633838521351,-76.90350928354037,0.30250501680487574,-2.2548226857664417,-2.5573277025713175,8853409800,8682573659.8,33.226421688100245,26.507614203313384,NaN,NaN,-12.176034791229704,-14.391989832387852
2018-11-29T09:30:00-05:00,273.71,275.55,272.43,273.98,82346420,96142857.6,52.208726686181926,44.17454030645332,NaN,NaN,41.231194604760596,-46.252220386189336,0.6358439281806825,-1.7625227923454645,-2.398366720526147,8771063380,8714165487.4,37.312237697469904,26.86212777858381,NaN,NaN,-9.603884738535667,-13.707974818980396
2018-11-30T09:30:00-05:00,273.81,276.28,273.45,275.65,98204190,96078315.25,54.39996117878256,44.390392888061335,NaN,NaN,59.223580338510345,-7.58528937584723,0.9398832607443115,-1.2235126445957576,-2.163395905340069,8869267570,8773959728.6,44.26377699804974,27.61329021664282,NaN,NaN,-6.808377116285117,-12.722318004309642
2018-12-03T09:30:00-05:00,280.28,280.4,277.505,279.3,103017719,95097495.85,58.84175299680652,45.410542177316465,NaN,NaN,118.4206845203406,32.0060263917674,1.333836731010355,-0.49609999157712537,-1.8299367225874803,8972285289,8838361241.2,50.61574256100997,28.90008120388348,NaN,NaN,-2.9847539982336984,-11.33123743201308
2018-12-04T09:30:00-05:00,278.37,278.85,269.9,270.25,177986013,100715672.4,46.696252542921556,45.60723629245998,NaN,NaN,11.339039730790919,49.02682660658476,0.9499705347717202,-0.6424735541228301,-1.5924440888945504,8794299276,8852065063,51.87262058398659,30.47636282154222,NaN,NaN,-3.56961661810487,-10.222434458597622
2018-12-06T09:30:00-05:00,265.92,269.97,262.44,269.84,204185411,107920648.25,46.23068775366802,45.93260098485304,NaN,NaN,-77.2087923418695,30.601141370506593,0.6479243811311544,-0.7825386124806073,-1.4304629936117617,8590113865,8799405876,46.92984538857834,32.01441434186413,NaN,NaN,-4.171513930000305,-9.358017240226577
2018-12-07T09:30:00-05:00,269.46,271.22,262.63,263.57,161018923,110833989.45,39.71034886989203,45.468575180365484,NaN,NaN,-94.44034943332086,3.466832562890306,0.037546942857141774,-1.3835293150403345,-1.4210762578974763,8429094942,8731012188.4,41.41070044070417,33.31366964296834,NaN,NaN,-6.9611400513811645,-9.015606213248661
2018-12-10T09:30:00-05:00,263.37,265.1613,258.62,264.07,151445885,115127039.4,40.431856660059076,44.976817853378066,NaN,NaN,-132.6957940160244,-34.91704230801664,-0.30212957037243116,-1.7987382208630152,-1.496608650490584,8580540827,8673266839.8,37.41033269054287,34.359312030024064,NaN,NaN,-8.893829230313974,-8.998209501400849
2018-12-11T09:30:00-05:00,267.66,267.87,262.48,264.13,121504431,116261632.9,40.523839562127165,44.91932045806383,NaN,NaN,-85.11461578386536,-75.62410236885783,-0.48172074169466605,-2.0987595776089165,-1.6170388359142505,8702045258,8619218833.6,34.09083526108783,35.20287699415905,NaN,NaN,-10.390127995079608,-9.197055000497814
2018-12-12T09:30:00-05:00,267.47,269,265.37,265.46,97976706,116176789.5,42.63830266494353,45.39025249906776,NaN,NaN,-48.73945914447329,-87.63980214391067,-0.46941268405583414,-2.203804690984043,-1.734392006928209,8800021964,8620363371.2,34.22393699465505,36.11234475867636,NaN,NaN,-11.01769505754743,-9.457146437219187
2018-12-13T09:30:00-05:00,266.52,267.49,264.12,265.37,96662717,116101094.85,42.52812110047548,45.74241176113717,NaN,NaN,-59.36933253142047,-84.07191018182087,-0.42702231229136034,-2.2681698972924096,-1.8411475850010492,8703359247,8643012447.6,36.937945085226524,37.018059732472935,NaN,NaN,-11.559455368192745,-9.757476284501124
2018-12-14T09:30:00-05:00,262.96,264.03,259.85,260.47,116961071,115682351.85,36.93241397926088,45.82621035261743,NaN,NaN,-119.12502860528345,-89.00884601621337,-0.673988794894345,-2.6836335786189807,-2.0096447837246356,8586398176,8674473094.4,40.6040264655451,38.23735927926793,NaN,NaN,-13.725772163593428,-10.324375695800024
2018-12-17T09:30:00-05:00,259.4,260.65,253.525,255.36,165492257,117201892.85,32.17751986546091,45.055256055197404,NaN,NaN,-178.32122817650412,-98.13393284830934,-1.1012377095344643,-3.386191920642716,-2.2849542111082517,8420905919,8642546112.8,38.17838591265066,39.36494874259322,NaN,NaN,-17.190774211006428,-11.305289769400938
2018-12-18T09:30:00-05:00,257.2,257.95,253.28,255.08,134515094,117594245.55,31.934903230852612,44.165288133738485,NaN,NaN,-177.20464227991755,-116.55193814751979,-1.3083378060867217,-3.920376468716654,-2.6120386626299323,8286390825,8559415226.2,32.70062978708194,39.98410268247782,NaN,NaN,-20.02889165435346,-12.55151861010844
2018-12-19T09:30:00-05:00,255.17,259.4,249.35,251.26,214992763,123190798.4,28.75000244475956,42.42890639544229,NaN,NaN,-180.19946608840706,-142.84393953630652,-1.589528922579833,-4.5989498158547235,-3.0094208932748905,8071398062,8413690445.8,25.731154497284933,39.44872645456244,NaN,NaN,-23.510056026161223,-14.117023955258837
2018-12-20T09:30:00-05:00,249.86,251.62,244.65,247.17,252053377,128992401.7,25.78489583283732,40.54148990591767,NaN,NaN,-206.53764316743852,-172.27760166351013,-1.9160262633049814,-5.404453722406117,-3.488427459101136,7819344685,8236887533.4,20.126458951627427,38.22117082985941,NaN,NaN,-27.496493623297614,-16.028376764978663
2018-12-21T09:30:00-05:00,246.74,249.71,239.98,240.7,255345633,137981496.2,21.931554365882548,38.22231799071053,NaN,NaN,-200.49750307624123,-188.55209655770167,-2.4013241659990143,-6.490082666599903,-4.088758500600889,7563999052,8032407708.6,15.831488062730756,36.19029304876519,NaN,NaN,-32.40907322889813,-18.368476259824302
2018-12-24T09:30:00-05:00,239.04,240.8355,234.27,234.34,147311588,143206681.7,18.93587688678987,35.37189826856648,NaN,NaN,-206.02847189081157,-194.0935453005632,-2.9482220199488323,-7.77403602553693,-4.825814005588097,7416687464,7831564017.6,12.915988857379546,33.49745349850587,NaN,NaN,-37.75207086628674,-21.13756120360465
2018-12-26T09:30:00-05:00,235.97,246.18,233.76,246.18,218485360,150131881.6,36.3626506700542,34.63378384907596,NaN,NaN,-135.75469193657517,-185.8035552318947,-2.3368591649175547,-7.746887961735041,-5.410028796817486,7635172824,7701320417.4,11.444157961665553,30.60970616834009,NaN,NaN,-35.78243820314284,-23.229686489252963
2018-12-27T09:30:00-05:00,242.57,248.29,238.96,248.07,186267342,155670126.65,38.63060815568642,34.09092102064871,NaN,NaN,-98.96107274387725,-169.55587656298874,-1.6612291680765674,-7.486565256913195,-5.825336088836628,7821440166,7651328838.2,10.929344928859138,28.03824184978871,NaN,NaN,-33.47032865532237,-24.69263537012002
2018-12-28T09:30:00-05:00,249.58,251.4,246.45,247.75,153100189,156943654.45,38.38119795563569,33.99598166963039,NaN,NaN,-68.33306432013296,-141.91496079352763,-1.1179861724016238,-7.222818804338658,-6.104832631937034,7668339977,7621127896.6,10.618574130623799,25.838804256211546,NaN,NaN,-31.81201000423756,-25.70968888927967
2018-12-31T09:30:00-05:00,249.56,250.19,247.47,249.92,144299370,160041301.95,41.155678379576095,34.047683221024464,NaN,NaN,-57.49049884358528,-113.31355994699643,-0.5247443802566707,-6.760763107257873,-6.236018727001202,7812639347,7670855955.6,14.908953011120332,24.231562850538506,NaN,NaN,-29.575591911419625,-26.261960749585377
2019-01-02T09:30:00-05:00,245.98,251.21,245.95,250.18,126925199,161477352.4,41.495581676719404,34.11709337206677,NaN,NaN,-52.29580382639196,-82.56702633411251,-0.05195876545606648,-6.300967183821285,-6.249008418365219,7939564546,7775431372,23.25206103920098,23.457364691832304,NaN,NaN,-27.709044327274242,-26.4686869749695
2019-01-03T09:30:00-05:00,248.23,248.57,243.67,244.21,144140692,163533501.05,36.30931818930441,33.66502305237825,NaN,NaN,-70.94167536187707,-69.60442301917288,-0.07692257320737994,-6.345161634874444,-6.268239061667064,7795423854,7807481578,25.65789021643684,22.845504207673862,NaN,NaN,-27.684530764458675,-26.642378944896524
2019-01-04T09:30:00-05:00,247.59,253.11,247.17,252.39,142628834,161765642.1,46.226430706811286,33.92918802425938,NaN,NaN,-24.587420932399553,-54.72969265687734,0.4906378331716983,-5.654941770202441,-6.14557960337414,7938052688,7830804082.4,27.440360203552316,22.167105287554275,NaN,NaN,-24.250586942324496,-26.30069437310052
2019-01-07T09:30:00-05:00,252.69,255.95,251.69,254.38,103139100,156713326.55,48.33407822204881,34.74359261302995,NaN,NaN,7.088947630687569,-39.64529026671323,1.003678881615686,-4.8909810013545325,-5.894659882970219,8041191788,7905374444.6,32.97394718233559,21.622099624467882,NaN,NaN,-20.829510952296847,-25.51909674155714
2019-01-08T09:30:00-05:00,256.82,257.31,254,256.77,102512587,153788009.75,50.82687258967292,36.075689236187955,NaN,NaN,31.767860590175477,-21.79361837996111,1.4788932715343677,-4.046043293552259,-5.524936565086627,8143704375,7971587450.2,37.52957089407299,21.575755694569477,NaN,NaN,-17.24982747477741,-24.337772560588604
2019-01-09T09:30:00-05:00,257.56,258.91,256.19,257.97,95006554,150966043.2,52.07711227678177,37.514418453754324,NaN,NaN,52.02299720590702,-0.9298581735013073,1.8261734042812403,-3.242219809735076,-5.068393214016316,8238710929,8031416726.8,41.40500079699244,22.197496480991656,NaN,NaN,-13.980076191987095,-22.858101650788388
2019-01-10T09:30:00-05:00,256.26,259.16,255.5,258.88,96823923,149732017.8,53.051940130884326,39.25027114562038,NaN,NaN,60.22615594206874,25.303708087287863,2.052392483627072,-2.502902609482476,-4.555295093109548,8335534852,8139438926.4,47.712111440076775,23.767564834048216,NaN,NaN,-11.027479237499113,-21.168012734604204
2019-01-11T09:30:00-05:00,257.68,259.0098,257.03,258.98,73858110,148526088,53.16468626900568,41.20597046248955,NaN,NaN,74.67029257634682,45.15525078903714,2.134503936776058,-1.8871651721394755,-4.021669108915534,8409392962,8233706981.2,52.51560305033081,26.081075126812745,NaN,NaN,-8.58864561397284,-19.370960288799722
2019-01-14T09:30:00-05:00,256.86,258.3,256.41,257.4,70908227,147238363.5,51.077526692009,43.28782562864144,NaN,NaN,73.56415065132934,58.45029139316549,2.009908462145394,-1.509283531233791,-3.5191919933791853,8338484735,8293165570.6,55.3046330053268,28.90058547985532,NaN,NaN,-7.06908889414816,-17.613550089563784
2019-01-15T09:30:00-05:00,257.82,260.7,257.81,260.35,85208271,145650723.5,54.65679477923806,45.83931976381631,NaN,NaN,103.6995247470661,72.83662422454361,2.0467976195715814,-0.9606949689147086,-3.00749258848629,8423693006,8349163296.8,57.81753024917387,32.10783843641205,NaN,NaN,-4.735914554168838,-15.77388787022165
2019-01-16T09:30:00-05:00,260.83,261.9666,260.6,260.98,77636710,141257946.15,55.407128524989275,47.19963961059739,NaN,NaN,115.11753957860242,85.4555326990827,2.030246379448502,-0.4696846141756623,-2.4999309936241643,8501329716,8401687054.2,60.084392069185874,35.58214087266351,NaN,NaN,-2.580962670877725,-13.889184270315376
2019-01-17T09:30:00-05:00,260.01,263.92,259.96,262.96,96118435,139338113.2,57.772229769897635,48.566898297326766,NaN,NaN,116.95499453783479,96.80130041823591,2.0625938807894295,0.0783113573626224,-1.9842825234268069,8597448151,8454069714,62.26251525365085,39.24879589586292,NaN,NaN,-0.0655615418587965,-11.914381023393007
2019-01-18T09:30:00-05:00,264.98,266.98,262.998,266.46,127900303,134983490.2,61.64477395669121,50.22858229740216,NaN,NaN,132.41259623416272,108.3497611497991,2.216196236810658,0.7859627725865153,-1.4302334642241425,8725348454,8517260812.4,64.76067556814074,43.11608885568556,NaN,NaN,3.2853793364632766,-9.742986686270681
2019-01-22T09:30:00-05:00,264.82,265.06,261.06,262.86,115531183,128157380.5,55.96021534246708,51.28604922332294,NaN,NaN,96.28199562306317,112.89333014414585,1.9795901247105445,1.044254191664038,-0.9353359330465064,8609817271,8571527319.6,66.79363777022452,46.822137767050144,NaN,NaN,4.638184169833838,-7.688533706827179
2019-01-23T09:30:00-05:00,264.01,264.79,260.66,263.41,86030287,119691613.2,56.61840472893819,52.36625086991,NaN,NaN,88.6594507156831,109.88531533786924,1.7711436062748165,1.2785935747970143,-0.49255003147780224,8695847558,8625958230,68.74154238692125,50.07138643474445,NaN,NaN,5.938040021457785,-5.741880317072184
2019-01-24T09:30:00-05:00,263.21,264.2,262.08,263.55,59204139,115286240.75,56.79540975904913,53.829543124891764,NaN,NaN,87.59819514561131,104.38144645127102,1.561072049834386,1.4587900308151802,-0.10228201901920575,8755051697,8676702626.2,70.48009756173508,53.27297267369432,NaN,NaN,7.063001213326137,-3.912611527015281
2019-01-25T09:30:00-05:00,265.61,266.7,263.6595,265.78,96883358,109206140.65,59.62153501174463,54.786336289529864,NaN,NaN,106.43773920258337,102.27799538422074,1.4908151675751635,1.7612369404497485,0.27042177287458513,8851935055,8727600007,72.15307544431437,56.46673804803447,NaN,NaN,8.81564666562115,-2.0942889280672192
2019-01-28T09:30:00-05:00,263.39,263.83,261.79,263.76,85613655,104173456.3,56.045254698073215,55.33713460924589,NaN,NaN,74.95306910732722,90.78608995885364,1.237251455741511,1.816986092551474,0.579734636809963,8766321400,8735794596.2,72.42404610011903,59.28460225644757,NaN,NaN,9.378239230816696,-0.4553563339409459
2019-01-29T09:30:00-05:00,263.92,264.55,262.48,263.41,66136334,99825263.55,55.424907628319836,55.66556568343496,NaN,NaN,73.72992893706733,86.27567662165447,0.9858423553801545,1.812037581035156,0.8261952256550016,8700185066,8753868155.2,73.04699636050664,61.821561218335695,NaN,NaN,9.686838284759995,0.99352861158776
2019-01-30T09:30:00-05:00,265.1,268.52,264.25,267.58,92473671,97233978.6,60.96819303059827,56.30064288013614,NaN,NaN,111.05188406811739,90.75416329214133,1.0351719105351527,2.1201601138239425,1.0849882032887899,8792658737,8773230391,73.73162112714023,64.13060552763196,NaN,NaN,11.528203837707164,2.498482215319103
2019-01-31T09:30:00-05:00,267.51,270.47,267.27,269.93,104012073,96088322.3,63.70731034491852,57.061740752567154,NaN,NaN,136.3090281454846,100.49632989211598,1.1519051775714142,2.5248696752530577,1.3729644976816435,8896670810,8801554213.6,74.74231587250725,66.0613344156627,NaN,NaN,13.916260663134727,4.129593422149906
2019-02-01T09:30:00-05:00,270.15,271.2,269.18,270.06,85782524,93170413.9,63.85840859025488,57.82557806122781,NaN,NaN,146.90925920471463,108.59063389254223,1.160465796056013,2.8235467427516596,1.6630809466956467,8982453334,8827657869.4,75.67136489949888,67.715317404889,NaN,NaN,15.92218523539147,5.81424939547013
2019-02-04T09:30:00-05:00,270.11,272.03,269.36,271.96,60744844,89076214.4,66.08108936820051,58.89726110952718,NaN,NaN,155.16374267883998,124.63276860684478,1.2110894609840532,3.176942772925713,1.96585331194166,9043198178,8883033225,77.55727333275443,69.30479171399097,NaN,NaN,18.288016880903044,7.596216179103403
2019-02-05T09:30:00-05:00,272.44,273.44,271.88,273.1,79552774,87896898.1,67.3774437623976,59.80587889403858,NaN,NaN,167.7096537409365,143.42871356761862,1.2341619099978725,3.5085556994390004,2.274393789441128,9122750952,8967546402.2,80.09351184013627,70.89593325620258,NaN,NaN,20.664932558370314,9.46317566185582
2019-02-06T09:30:00-05:00,272.79,273.34,271.92,272.74,58347791,85688658.3,66.51293324314366,60.59915065962103,NaN,NaN,140.96473466021592,149.4112836860383,1.1402168943650106,3.6996649073973913,2.5594480130323807,9064403161,9021895287,81.53840144480837,72.42836249731847,NaN,NaN,22.438247298014076,11.316757324164142
2019-02-07T09:30:00-05:00,270.94,271.55,268.29,270.14,95481961,85712428.65,60.477542179914664,60.79238726033653,NaN,NaN,85.71579135395008,139.2926363277314,0.8323019999568939,3.599825512978498,2.767523513021604,8968921200,9036345365,81.91427364806081,73.8320595254906,NaN,NaN,22.389836887421698,12.898625833200935
2019-02-08T09:30:00-05:00,268.75,270.58,267.83,270.47,75788861,84660675.55,60.9617314238681,60.743598507992026,NaN,NaN,71.8079695351044,124.27237839380936,0.5915051087584375,3.506904898969651,2.9153997902112136,9044710061,9048796710.4,82.24963193464596,75.0812706945267,NaN,NaN,22.475367323119656,14.266731760332181
2019-02-11T09:30:00-05:00,271.2,271.49,270.03,270.62,68021423,84368841.2,61.19444786275923,61.11747225944147,NaN,NaN,80.42767907985217,109.3251656740118,0.39256411333539987,3.4061049318804635,3.0135408185450636,9112731484,9062703371.6,82.63688250653604,76.21293103283465,NaN,NaN,22.60607781581009,15.45806691111474
2019-02-12T09:30:00-05:00,272.42,274.52,272.34,274.1,72270221,84436940.9,66.22488795804281,61.80364963294893,NaN,NaN,118.17373798767257,99.41798252335902,0.4419044857063712,3.5659214256780274,3.124016939971656,9185001705,9075153522.2,82.99457401826632,77.23100472078788,NaN,NaN,24.106787326794166,16.693598399068943
2019-02-13T09:30:00-05:00,275.03,275.93,274.56,274.99,65277204,83440387.55,67.38919902754583,62.56034886641299,NaN,NaN,128.91120246714553,97.00727608474494,0.4779813665517145,3.7214936481612995,3.243512281609585,9250278909,9112328671.8,84.05108696538531,78.2003611067629,NaN,NaN,25.701313910586425,17.980414900714297
2019-02-14T09:30:00-05:00,273.78,275.64,272.87,274.38,83234396,83720271.85,65.71705067890787,62.99574284263893,NaN,NaN,104.38591089460199,100.74129999287533,0.40703782621057893,3.7523095643728084,3.3452717381622294,9167044513,9151953334.4,85.11277881821204,79.12605420489844,NaN,NaN,26.609124882437047,19.213087755246118
2019-02-15T09:30:00-05:00,276.36,277.41,276.13,277.37,97088659,83768783.05,69.68744054947389,63.97018468916756,NaN,NaN,138.26483820417312,114.03267372668908,0.5015508050155937,3.9722102444317215,3.470659439416128,9264133172,9195837956.6,86.20782310439384,80.1106097052038,NaN,NaN,28.566013065597097,20.549219942439116
2019-02-19T09:30:00-05:00,276.4813,278.58,276.47,277.85,59120804,80329808.1,70.28244845312472,65.03143760522505,NaN,NaN,135.29804415932207,125.00674674258308,0.5334887261514241,4.137520347105408,3.6040316209539838,9323253976,9237942455,87.18200271419217,81.12025301618132,NaN,NaN,30.3647528759384,21.951438932939013
2019-02-20T09:30:00-05:00,277.81,278.92,277.25,278.41,76610767,78383787.3,70.99770841382433,65.74783156116978,NaN,NaN,131.84086824131464,127.74017279331147,0.5284210592045544,4.264557944959677,3.7361368857551223,9399864743,9280915062.6,88.10543030219235,82.14695367154219,NaN,NaN,32.07958298647331,23.398316654872485
2019-02-21T09:30:00-05:00,277.7,278.1,276.345,277.42,64214727,77293009.3,67.88693114064068,66.04637590372135,NaN,NaN,106.13320347734178,123.18457299535073,0.40030290464018803,4.236515516555357,3.8362126119151694,9335650016,9297989284,88.46112709080832,83.12686875856369,NaN,NaN,32.733299369921845,24.73188561416525
2019-02-22T09:30:00-05:00,278.11,279.36,277.4029,279.14,78114616,78238533.15,70.32006222940572,66.50792259223213,NaN,NaN,116.49177770227699,125.60574635688572,0.3738087513420081,4.303473551092679,3.9296647997506713,9413764632,9347333307.8,89.44360993236234,84.11060054662536,NaN,NaN,33.97464485696265,26.052279791707736
2019-02-25T09:30:00-05:00,280.73,281.31,279.43,279.52,69030699,76845900.2,70.84562817697697,66.84824679285903,NaN,NaN,128.28782846561066,123.61034440917324,0.3260317652750677,4.337204506344506,4.011172741069438,9482795331,9391065739.6,90.23702004478793,85.01629674034204,NaN,NaN,35.160549543136106,27.353461184768932
2019-02-26T09:30:00-05:00,279.13,280.3,278.9,279.32,56844101,75407422.5,70.14163058635135,67.04568870885572,NaN,NaN,108.77575732749266,118.30588704280736,0.22966232314626556,4.29825064500227,4.068588321856004,9425951230,9411605190.4,90.59456533033955,85.76637198964227,NaN,NaN,35.98139749812288,28.58602351524807
2019-02-27T09:30:00-05:00,278.52,279.59,277.48,279.2,56921570,74946684.3,69.69413343648253,67.27291729409421,NaN,NaN,87.7580477827573,109.48932295109589,0.11246988256456891,4.209175675061715,4.096705792497146,9369029660,9405438173.8,89.53431323604775,86.33750854615937,NaN,NaN,36.567789143663,29.726275747878773
2019-02-28T09:30:00-05:00,278.96,279.45,278.32,278.68,69268293,73786415.4,67.67912922048751,67.78731636842085,NaN,NaN,80.8790804487472,104.43849834537698,-0.037413995791961696,4.049938297757194,4.087352293549156,9299761367,9398260444,88.23991255139978,86.78933989639788,NaN,NaN,36.577893554917694,30.705078291741476
2019-03-01T09:30:00-05:00,280.44,280.88,278.82,280.42,78880548,72529839.15,70.72878660158646,68.4849631668293,NaN,NaN,96.02011918938754,100.3441666427991,-0.05561787914017202,4.017829944623941,4.073447823764113,9378641915,9391235900.6,86.91559356504875,87.12262286999807,NaN,NaN,37.36920607362651,31.65709654629648
2019-03-04T09:30:00-05:00,281.6,281.87,276.84,279.4,106494637,73565444.8,66.7525565106508,68.88197092739298,NaN,NaN,75.3920555412296,89.76501205792287,-0.16634300277681824,3.8655190702930895,4.031862073069908,9272147278,9349106290,79.23493804334727,86.87962683691316,NaN,NaN,37.010301256983624,32.421840076394645
2019-03-05T09:30:00-05:00,279.54,279.76,278.41,279.02,59114559,73483930.55,65.28016053409914,68.8144903971113,NaN,NaN,63.59943216338984,80.72974702510231,-0.2880318192520277,3.671822299004873,3.9598541182569007,9213032719,9306522587.8,72.2819555624771,86.11443980435679,NaN,NaN,36.31749398491863,32.97836206332664
2019-03-06T09:30:00-05:00,279.15,279.16,276.97,277.33,75039771,73258280.4,59.04266221298192,68.21830919607102,NaN,NaN,32.545414686960804,69.68722040594301,-0.49315799397778726,3.3434066257846666,3.836564619762454,9137992948,9260315245.4,65.55929834437126,84.79359775999865,NaN,NaN,33.96455464763454,33.11924671822777
2019-03-07T09:30:00-05:00,276.83,276.99,274.07,275.01,94885089,75085145.3,51.73468770930315,67.2195689839564,NaN,NaN,-29.392920786213352,47.632820158950906,-0.7789091567518982,2.8629281738225814,3.6418373305744796,9043107859,9208984543.8,58.995151508242245,82.92805295214366,NaN,NaN,29.61353780706535,32.618431159490285
2019-03-08T09:30:00-05:00,272.94,274.65,272.42,274.46,85795799,74600837.2,50.14993729362946,65.82403303711037,NaN,NaN,-78.73136517033781,12.682523287005836,-0.9854823954524625,2.4099843362589013,3.395466731711364,8957312060,9124718572.8,50.122795009602235,80.35055094537282,NaN,NaN,25.507329687464285,31.602559520629427
2019-03-11T09:30:00-04:00,275.26,278.62,275.23,278.44,65098897,74066339,59.75671127119779,65.07219466697273,NaN,NaN,9.981500427675421,-0.39958773570499917,-0.8402594039404656,2.3451424767857816,3.185401880726247,9022410957,9074771308.6,45.73251788315386,77.38987345744151,NaN,NaN,24.560748828236683,30.59658656457332
2019-03-12T09:30:00-04:00,279.06,280.07,278.85,279.49,79667530,74648644.35,61.845746369779036,64.41848309239806,NaN,NaN,76.52314697003887,2.1851552256247997,-0.6672208137785569,2.3513758635030513,3.018596677281608,9102078487,9052580462.2,43.89302134036359,74.23184424588233,NaN,NaN,24.440613489172012,29.71716183951599
2019-03-13T09:30:00-04:00,280.48,282.38,280.3,281.34,80639153,75067090.95,65.26683083195303,64.23133307034895,NaN,NaN,143.00576398702475,24.27722508563759,-0.4332440518360281,2.4770416124865733,2.9102856643226014,9182717640,9061525400.6,44.85587717405063,71.11718353754249,NaN,NaN,25.435606303514657,29.10551104865866
2019-03-14T09:30:00-04:00,281.37,281.84,280.6662,281.16,67518366,75179149.05,64.65934300238709,63.82699598270476,NaN,NaN,127.69505275954435,55.694819794789126,-0.3019002795986587,2.532910314824278,2.8348105944229367,9115199274,9075943683.6,46.45108022811869,68.04628855866794,NaN,NaN,26.045200640397887,28.66832384747855
2019-03-15T09:30:00-04:00,280.54,282.21,280.33,281.31,81308979,75082878.2,64.95210214615946,63.406029837646365,NaN,NaN,124.67671557302442,96.37643594346159,-0.22002221368788089,2.559782827313086,2.7798050410009667,9196508253,9123782922.2,51.46761440941504,65.27704529899844,NaN,NaN,26.624667143910774,28.376372889826012
2019-03-18T09:30:00-04:00,281.55,282.66,281.3,282.33,62199806,73338435.55,66.95663732575117,63.17853031903206,NaN,NaN,145.1597857379613,123.41209300551876,-0.1174176350524454,2.63303299718541,2.7504506322378552,9258708059,9171042342.6,55.86620140321508,62.7964478756324,NaN,NaN,27.698551500106078,28.279541262723164
2019-03-19T09:30:00-04:00,283.51,284.36,281.41,282.4,90268121,74895801.4,67.09572434327595,62.99292966951731,NaN,NaN,150.56169455045134,138.21980252160125,-0.0675599434240195,2.666000702957831,2.7335606463818505,9348976180,9220421881.2,59.950538229011876,60.683321089415564,NaN,NaN,28.620790517134353,28.328291156210476
2019-03-20T09:30:00-04:00,282.16,283.5,280.32,281.55,84609210,75295723.55,63.59520640334888,62.70122089686455,NaN,NaN,99.74698486151644,129.5680466964996,-0.11193486921081641,2.59364205986833,2.7055769290791463,9264366970,9236751747.2,61.22840103653885,58.753927409782634,NaN,NaN,28.46367628145739,28.347631888388605
2019-03-21T09:30:00-04:00,280.64,285.18,280.59,284.73,79550375,76062505.95,69.91833735486112,62.643331664955596,NaN,NaN,147.32068979120325,133.49317410283138,0.044393540325743164,2.761068854486325,2.716675314160582,9343917345,9282495361.4,64.63265922468236,57.1622892426136,NaN,NaN,30.25210299905717,28.619699189912687
2019-03-22T09:30:00-04:00,283.22,283.8034,279.18,279.25,122659286,78289739.45,52.87477846140884,61.65206180429545,NaN,NaN,38.85768389908735,116.32936776804395,-0.23443823189437563,2.4236275242926126,2.6580657561869883,9221258059,9287445322.6,64.99087608625624,56.144856245678525,NaN,NaN,25.809245925595786,28.218205866438844
2019-03-25T09:30:00-04:00,278.87,280.1853,277.64,279.04,85575197,79116964.35,52.34816245597454,60.72834765585798,NaN,NaN,-26.219149907223233,82.05358063900705,-0.4345497328669259,2.1148785901033307,2.5494283229702566,9135682862,9262840283.2,61.6483702736311,55.38531443933238,NaN,NaN,22.25340417485054,27.366091339069087
2019-03-26T09:30:00-04:00,280.99,282.18,279.56,281.12,68125920,79681055.3,56.9243713575531,60.577041166184486,NaN,NaN,44.3552410799737,60.81228994491153,-0.4276978404530034,2.0148060224040023,2.4425038628570057,9203808782,9233806803.6,57.86649939233975,54.83582879990157,NaN,NaN,20.808593986554186,26.429306002995528
2019-03-27T09:30:00-04:00,281.11,281.76,277.93,279.65,72224722,80446212.9,53.047097321166646,60.67078470988902,NaN,NaN,0.0031667731562333725,40.863526327239484,-0.5170623867941315,1.7961758793643412,2.3132382661584727,9131584060,9207250221.6,54.56897034842519,54.51967300277179,NaN,NaN,18.327074498529715,25.271844359500413
2019-03-28T09:30:00-04:00,280.35,281.21,279.07,280.71,56238545,79794725.5,55.40583427529155,61.046205922864885,NaN,NaN,17.958349456499807,14.991058260298772,-0.49941171650849103,1.6889736205228587,2.1883853370313497,9187822605,9176031273.6,50.897116651937985,54.574981691510054,NaN,NaN,17.074784241236127,24.100835771176943
2019-03-29T09:30:00-04:00,282.39,282.84,281.14,282.48,82186806,79960038.4,59.10059360485881,60.99934037526925,NaN,NaN,78.72680138709562,22.96488175790042,-0.3691624573401677,1.7269322653561403,2.096094722696308,9270009411,9185781544,51.98381826123587,55.02150314708734,NaN,NaN,17.21850220876805,23.117645262261387
2019-04-01T09:30:00-04:00,284.7,286.16,284.4,285.83,77617945,78516203.8,65.00958582495963,61.22532890778215,NaN,NaN,169.77631421779535,62.163974582904146,-0.07349316070349321,2.0042282718169417,2.077721432520435,9347627356,9228170442.8,56.49191701754623,55.9214242668861,NaN,NaN,19.392473629541414,22.585477886158532
2019-04-02T09:30:00-04:00,286.04,286.23,285.09,285.97,40070351,77563993.4,65.23563277633511,61.22310047523801,NaN,NaN,157.71137043903238,84.83520045471587,0.10567154252425937,2.209810860675759,2.1041393181515,9387697707,9264948227.8,60.00084707982165,57.00320783158402,NaN,NaN,21.146954251367774,22.37997450975985
2019-04-03T09:30:00-04:00,287.32,287.76,285.75,286.42,68243202,77224164.95,65.99604341707176,61.318579076286916,NaN,NaN,165.84629340984048,118.00382578205271,0.22196394283642729,2.381594246697034,2.159630303860607,9455940909,9329819597.6,65.31462436922388,58.35060384166293,NaN,NaN,22.79092600352349,22.438681866011798
2019-04-04T09:30:00-04:00,286.78,287.459,286.01,287.18,48997505,74929785.75,67.29707032567754,61.48607680339535,NaN,NaN,156.33039898420787,145.67823568759434,0.31203053699062133,2.5496684750988834,2.237637938108262,9504938414,9393242759.4,69.57082623891723,59.64369040091309,NaN,NaN,24.541121272097925,22.73903035259553
2019-04-05T09:30:00-04:00,287.92,288.63,287.6,288.57,58621729,73571082.25,69.58886323629645,61.67409293986287,NaN,NaN,172.80649588114176,164.49417458640357,0.4204318117238035,2.7631777027630164,2.342745891039213,9563560143,9451952905.8,72.88744953735318,60.85949383906581,NaN,NaN,26.73140384702651,23.309369423228528
2019-04-08T09:30:00-04:00,288.1,288.91,287.37,288.79,53566335,72994454.15,69.94783234618441,61.877814940070614,NaN,NaN,147.80839868329957,160.10059147950443,0.45901741928582984,2.9165176651465003,2.4575002458606705,9617126478,9505852730.2,75.524927525913,61.97195021741589,NaN,NaN,28.623163521028417,24.06848286577137
2019-04-09T09:30:00-04:00,287.72,288.08,286.7,287.31,66142316,72318193.45,64.43739443983765,61.93797122839124,NaN,NaN,104.70591262504209,149.49949991670636,0.34228497587282725,2.8853564657017046,2.5430714898288773,9550984162,9538510021.2,76.98573527518,63.097474091604546,NaN,NaN,28.693324187079345,24.72917448310108
2019-04-10T09:30:00-04:00,287.77,288.3899,287.31,288.29,52601499,70916310.75,66.32894362308102,61.681585961835516,NaN,NaN,105.0035745921394,137.33095615316614,0.29053281098859873,2.9062375035646255,2.615704692576027,9603585661,9568038971.6,78.24984279658145,64.0701300610259,NaN,NaN,29.29488502409375,25.381418846100033
2019-04-11T09:30:00-04:00,288.83,288.84,287.578,288.21,55093100,70295047.45,66.02023431716225,62.62054709438933,NaN,NaN,96.6862084869004,125.40211805370464,0.21391305311683828,2.8830960089720747,2.6691829558552365,9548492561,9576749801,78.62286323490726,65.04384342878669,NaN,NaN,29.70450385318578,25.999002418540854
2019-04-12T09:30:00-04:00,290,290.47,288.261,290.16,69727782,69715987.6,69.7196781303074,63.861369642555964,NaN,NaN,113.73400661000298,113.58762019947687,0.25478561047336656,2.9876649689469446,2.732879358473578,9618220343,9587681841,79.10714095519576,66.29089847746988,NaN,NaN,31.143017968129538,26.73386178276781
2019-04-15T09:30:00-04:00,290.24,290.35,289.075,289.97,49596685,69085831.55,68.93219396409738,64.71907125730912,NaN,NaN,104.9976051281897,105.02546148845491,0.23000695930129833,3.0203880576002007,2.7903810982989024,9568623658,9577981277,77.43088764658413,67.68835478134449,NaN,NaN,32.11259832684495,27.502252717635972
2019-04-16T09:30:00-04:00,290.95,291.01,289.5,290.16,52153197,67180085.35,69.30555664135758,65.8803897801799,NaN,NaN,102.95390372504923,104.67505970845632,0.18910482020286778,3.026762123552487,2.8376573033496193,9620776855,9591939815.6,78.1484087475997,69.37260038128552,NaN,NaN,33.02293389959305,28.290921457915555
2019-04-17T09:30:00-04:00,291.4,291.425,288.99,289.45,58268295,65863039.6,66.10838258700572,66.64485751673091,NaN,NaN,90.36871698715923,101.7480881874603,0.08237404338204612,2.940624857577177,2.858250814195131,9562508560,9583724395.4,76.60475308993823,71.20886012685696,NaN,NaN,32.96518422717229,28.958673282095088
2019-04-18T09:30:00-04:00,290.1,290.32,288.66,290.02,68708513,65320946.5,67.4082731363971,67.23826319755507,NaN,NaN,77.64673465672927,97.94019342142607,0.021477018013854376,2.885097086712449,2.8636200686985944,9631217073,9600269297.8,77.56583268256342,73.0361468712375,NaN,NaN,33.25582153925769,29.572551604546888
2019-04-22T09:30:00-04:00,289.17,290.435,289.07,290.27,40160140,61195989.2,67.98820156809572,67.45102146492194,NaN,NaN,78.09023347937739,90.81143879530096,-0.027970580083819918,2.8286568435938193,2.856627423677639,9671377213,9610900671.8,78.18595560559514,74.58572105609814,NaN,NaN,33.65193405364721,30.155320525846935
2019-04-23T09:30:00-04:00,290.68,293.14,290.42,292.88,52246633,59529561,73.32475260253638,68.02881573822204,NaN,NaN,123.86287643040993,94.58449305574499,0.08302366303947561,2.960407002476984,2.8773833394375083,9723623846,9641900709.4,79.92820953631669,76.00910408870493,NaN,NaN,35.581089159516004,30.9304303306568
2019-04-24T09:30:00-04:00,292.79,293.16,292.07,292.23,50392914,58642910.7,70.18668111644004,68.32814700246261,NaN,NaN,126.35022981218053,99.26375827317125,0.08052643056368458,2.978041377642114,2.8975149470784296,9673230932,9652391524.8,80.49592703574935,77.0934828505996,NaN,NaN,36.321006635664006,31.700512659943545
2019-04-25T09:30:00-04:00,292.12,292.78,290.73,292.05,57770862,57920217.7,69.3021708119103,68.47136846576497,NaN,NaN,108.83629200609433,102.95727327695826,0.03683661490072554,2.9435607157043364,2.906724100803611,9615460070,9662981826.8,81.07776542444547,77.91540707813733,NaN,NaN,36.69241526397936,32.413641603377236
2019-04-26T09:30:00-04:00,292.1,293.49,291.2401,293.41,50916423,57654111.6,72.15720973105155,68.65482178681889,NaN,NaN,127.15121109201324,112.85816856401507,0.06781362264260071,2.991491129106862,2.9236775064642613,9666376493,9670013710.8,81.47297796185515,78.52865910845891,NaN,NaN,37.834924342151616,33.188110566059294
2019-04-29T09:30:00-04:00,293.51,294.45,293.41,293.87,57197747,56404658.65,73.06953931319703,68.87780085589122,NaN,NaN,156.92069936419554,128.6242617409787,0.0863760244258378,3.0316475369965588,2.945271512570721,9723574240,9680453116.2,82.0716478492102,78.99628198869443,NaN,NaN,39.05320122147632,34.0259806596903
2019-04-30T09:30:00-04:00,293.49,294.34,291.92,294.02,81112081,56579365.45,73.37589931176247,69.51626548960014,NaN,NaN,129.78842928778417,129.80937231245355,0.07620377571540127,3.0405262322149724,2.964322456499571,9804686321,9696665611.2,82.99087439885831,79.42522049752858,NaN,NaN,40.152594711066065,34.90121123845827
2019-05-01T09:30:00-04:00,294.72,294.95,291.8,291.81,71671870,58159441.4,62.156698694839854,69.21824799472577,NaN,NaN,97.66028367653689,124.07138308532483,-0.10222891958445457,2.836536307019003,2.9387652266034574,9733014451,9708622315,83.65641684901429,79.81140435841665,NaN,NaN,37.87794565503751,35.3264590122553
2019-05-02T09:30:00-04:00,291.68,292.7,289.52,291.18,65030170,57998789.8,59.36988679196379,68.7432231714973,NaN,NaN,29.710051317175044,108.24613494754097,-0.2757053571079435,2.594133530218528,2.8698388873264715,9667984281,9719127157.2,84.2398833755467,80.21262008274803,NaN,NaN,35.14272853308126,35.30021180094472
2019-05-03T09:30:00-04:00,292.82,294.34,291.2998,294.03,56543653,58376097.2,66.65366646805813,68.5242223384795,NaN,NaN,95.93244877127128,102.00238248339258,-0.21426752840089147,2.602004476825357,2.8162720052262484,9724527934,9730757445.4,84.88332701765265,80.62520480149496,NaN,NaN,34.872113084841075,35.23905484150134
2019-05-06T09:30:00-04:00,289.25,293.31,288.9,292.82,107198069,60804914.2,61.60421298740592,68.00079512585869,NaN,NaN,33.01469444874571,77.2211815003026,-0.267422017228804,2.4819944836902437,2.7494165009190477,9617329865,9709508570.4,78.57161849673538,80.70668557650576,NaN,NaN,33.00199462950149,34.91947481121565
2019-05-07T09:30:00-04:00,290.15,290.81,285.81,287.93,144729908,65363092.85,46.329154595816604,66.35962355117718,NaN,NaN,-101.93380779249385,30.876734084247015,-0.6238537985053947,1.9695992527873045,2.593453051292699,9472599957,9643091297.6,62.842401766259144,79.61339936355286,NaN,NaN,25.274046255017918,33.541556446044545
2019-05-08T09:30:00-04:00,287.53,289.43,286.87,287.53,91568287,66634391.4,45.33882771431391,64.87608391741348,NaN,NaN,-114.26085474122512,-11.507493599305377,-0.8637259687403693,1.5137955903672378,2.377521559107607,9381031670,9572694741.4,51.15354160083515,77.79545568575978,NaN,NaN,19.109756704766113,31.479870768719056
2019-05-09T09:30:00-04:00,285.23,287.33,283.3,286.66,103471104,69177871.65,43.1770022728764,63.14527885573342,NaN,NaN,-183.53643814416793,-54.15679149157397,-1.04599203317348,1.070031517640757,2.116023550814237,9277560566,9494609998.4,41.854100367338546,75.24461766324372,NaN,NaN,13.486177964214807,28.90934322521845
2019-05-10T09:30:00-04:00,285.62,288.94,282.3,288.1,112429293,72044681.3,47.62818936110387,61.69099226951972,NaN,NaN,-147.84870130271776,-102.91302150637179,-1.0327941873828792,0.8250308165856381,1.8578250039685174,9389989859,9427702383.4,35.84151147319044,72.22001451092909,NaN,NaN,10.328048023922864,26.254872482176225
2019-05-13T09:30:00-04:00,282.42,283.49,279.93,280.86,127290527,74922818.55,33.44340007397767,58.84232423176553,NaN,NaN,-254.88593133438192,-160.4931466629973,-1.4493585773854671,0.04612678223668354,1.4954853596221507,9262699332,9356776276.8,30.791727414633883,68.71026578795176,NaN,NaN,1.1920449570616372,22.674468550016996
2019-05-14T09:30:00-04:00,281.99,285.1,281.85,283.4,77003230,76293145.8,40.175042650840595,56.698635769937006,NaN,NaN,-162.39372817543043,-172.58513073958463,-1.4860124837315762,-0.3620302450423196,1.1239822386892566,9339702562,9330196797.8,29.135088497884965,65.0416344638186,NaN,NaN,-3.160548404151712,18.98375184227861
2019-05-15T09:30:00-04:00,281.59,285.77,281.36,285.06,73956407,77383306.3,44.150680884041854,54.90210077508925,NaN,NaN,-123.27140122812918,-174.38724003696547,-1.3353970217921685,-0.545264038550954,0.7901329832412145,9413658969,9336722257.6,30.12898282019293,61.40243570637198,NaN,NaN,-4.939232715462773,15.566182619744128
2019-05-16T09:30:00-04:00,285.84,289.21,285.76,287.7,76749643,78307373.7,49.85769889955597,53.309278572839574,NaN,NaN,-41.48715495567832,-145.97738339926752,-1.0097153087401183,-0.47201115268393323,0.5377041560561849,9490408612,9379291866.8,36.39607530033099,58.18265694483454,NaN,NaN,-4.185027162780542,12.744581222240603
2019-05-17T09:30:00-04:00,285.14,288.6,285.1207,285.84,100353024,79889599.25,46.27024092465625,51.395042973658086,NaN,NaN,-57.45384940547247,-127.89841301981846,-0.8762563763957177,-0.5576163144384623,0.31864006195725547,9390055588,9379305012.6,36.39797249562517,54.92025156243561,NaN,NaN,-4.8990234134864865,10.22406627427959
2019-05-20T09:30:00-04:00,284.06,285.43,283.12,283.95,62877610,81025472.75,42.89290978605914,49.217686578964994,NaN,NaN,-93.09100411427772,-95.53942757579763,-0.8701924611729409,-0.7691005145089207,0.10109194666402022,9327177978,9392200741.8,38.34095324482445,51.73097148000461,NaN,NaN,-6.664338282994023,7.8114370518119305
2019-05-21T09:30:00-04:00,285.83,286.93,285.55,286.51,46847085,80755495.35,48.388121099042635,48.23421675069376,NaN,NaN,-46.92728901512066,-72.44613974373569,-0.6583232064570722,-0.72181206140732,-0.06348885495024784,9374025063,9399065242,39.4021657065903,48.569953541260034,NaN,NaN,-6.155586468973292,5.816147977414042
2019-05-22T09:30:00-04:00,285.45,286.69,285.1,285.63,49482472,80709973.25,46.72371565404606,47.33091881227108,NaN,NaN,-52.19158248171529,-58.23017599445291,-0.5465980002686728,-0.7467363552860888,-0.20013835501741606,9324542591,9381241966.4,37.59301010828946,45.23803402217023,NaN,NaN,-6.313638835234331,4.083321289892846
2019-05-23T09:30:00-04:00,283.16,283.21,280.57,282.14,98733847,82758122.5,40.738823967866296,45.47985863368594,NaN,NaN,-117.77565959945537,-73.48787692320832,-0.668816258666231,-1.0361586783502048,-0.36734241968397385,9225808744,9328321992.8,32.78034031515199,41.516392114848756,NaN,NaN,-8.524073306987914,2.282264918909881
2019-05-24T09:30:00-04:00,283.74,284.2,282.09,282.78,55268095,82975706.1,42.200930442743775,44.09390988049579,NaN,NaN,-89.54190924307673,-79.90548889072916,-0.666167546258866,-1.2000518525075563,-0.5338843062486903,9281076839,9306526243,31.018998622904178,38.119776409575095,NaN,NaN,-9.76817881077952,0.560772957525681
2019-05-28T09:30:00-04:00,283.09,284.15,280.13,280.15,70029356,83617286.55,38.04673792324498,43.50230868959782,NaN,NaN,-113.42339150018054,-83.97196636790972,-0.7925589156014244,-1.524582950750471,-0.7320240351490465,9211047483,9283300144,29.217388962448226,35.71798978073146,NaN,NaN,-12.198870481375954,-1.2620332480316951
2019-05-29T09:30:00-04:00,278.91,279.36,276.71,278.27,104972927,84810328.85,35.36667145476383,42.79001181391567,NaN,NaN,-169.1742474462408,-108.42135805413375,-0.9435348138800626,-1.9114425524991248,-0.9679077386190622,9106074556,9229710042.6,25.532538166200396,33.88791810682897,NaN,NaN,-15.079851867057803,-3.236007336463996
2019-05-30T09:30:00-04:00,279.11,280.04,277.805,279.03,62523780,84352924.35,37.28979328172062,42.36949688597597,NaN,NaN,-135.07557945303355,-124.9981574483974,-0.9313762733738933,-2.132128080336429,-1.2007518069625356,9168598336,9198521191.6,23.662148233921172,32.58849295444202,NaN,NaN,-16.786955914493102,-5.171857133325297
2019-05-31T09:30:00-04:00,276.2,277.12,275.24,275.27,86862782,85444554.95,32.187185228615775,41.26656801936967,NaN,NaN,-173.78002362624736,-136.19903025375578,-1.1039386433917746,-2.580675111202254,-1.4767364678104793,9081735554,9169706553.6,22.054697237253137,31.603720509017926,NaN,NaN,-19.995538115129825,-7.289525845011658
2019-06-03T09:30:00-04:00,275.31,276.5521,273.09,274.57,96427952,87438769.9,31.3277246417246,41.11544834563731,NaN,NaN,-175.05525934932948,-153.30170027500634,-1.1854363461511324,-2.958531900499395,-1.7730955543482625,8985307602,9110552706.2,19.174846495181143,30.77394330048559,NaN,NaN,-22.819693012082627,-9.508121154593224
2019-06-04T09:30:00-04:00,277.12,280.68,276.62,280.53,77231889,85940460.9,44.83429392314119,41.4482520079445,NaN,NaN,-77.18958006834458,-146.05493798863915,-0.7778567451937963,-2.745416485840508,-1.9675597406467116,9062539491,9080851107.8,17.910249831814866,29.97216911005201,NaN,NaN,-20.71942137797655,-11.109735472219413
2019-06-05T09:30:00-04:00,282.33,282.99,280.32,282.96,71169717,82262451.35,49.2196419870958,41.81032065816264,NaN,NaN,-14.275355837531713,-115.07515966689732,-0.30860242185404596,-2.353312767964269,-2.044710346110223,9133709208,9086378038.2,18.981018786112273,29.175885964760536,NaN,NaN,-17.477449400494017,-12.019408890544357
2019-06-06T09:30:00-04:00,283.29,285.55,282.57,284.8,69430381,81155556.05,52.31100021553222,41.98555646644665,NaN,NaN,39.714193285282185,-80.11720511923419,0.1377602812924703,-1.872509994494635,-2.0102702757871054,9203139589,9093286288.8,20.379006012120172,28.031809587031187,NaN,NaN,-13.81674886626908,-12.276171744219317
2019-06-07T09:30:00-04:00,285.93,288.85,285.74,287.65,74272199,79695610.8,56.70723262917759,42.73105587391246,NaN,NaN,106.09730692162381,-24.141739009659954,0.6105177468166048,-1.2471230922663494,-1.8576408390829542,9277411788,9132421535.6,27.962348146740666,27.42926499068229,NaN,NaN,-9.255075248755903,-11.844586530581687
2019-06-10T09:30:00-04:00,289.37,290.82,288.8734,288.97,60799053,77114098.8,58.61035990984411,43.85373088275424,NaN,NaN,143.62149656689445,39.59361217358482,0.9760036914289401,-0.6376362247967791,-1.6136399162257191,9338210841,9203002183.4,39.20793660654672,27.49119237366246,NaN,NaN,-4.975389236927899,-10.863272631488288
2019-06-11T09:30:00-04:00,290.99,291.4,288.1805,288.9,58641325,73681638.7,58.46358671936263,44.57340699849139,NaN,NaN,125.58774070265497,80.14907632778474,1.1641634852305152,-0.15843555968757528,-1.3225990449180904,9279569516,9246408188.4,44.904199146861814,27.884194762253284,NaN,NaN,-1.657792943745537,-9.548204104667896
2019-06-12T09:30:00-04:00,288.64,289.26,287.815,288.39,47096312,72186292.8,57.337001260231894,45.33149882750466,NaN,NaN,94.0714181756653,101.81843113042416,1.2005818996232374,0.17812832961095637,-1.022453570012281,9232473204,9266160987.6,47.32314670698183,28.57920451930274,NaN,NaN,0.7227576322825248,-8.080923856532122
2019-06-13T09:30:00-04:00,289.4,289.98,288.62,289.58,48945156,70935730.25,59.30740637374435,46.65782614221024,NaN,NaN,99.33216837668405,113.74202614870453,1.2457363031485496,0.534716808923406,-0.7110194942251435,9281418360,9281816741.8,49.22589042957133,29.753886670332687,NaN,NaN,3.3016195997980247,-6.45484621991353
2019-06-14T09:30:00-04:00,289.26,289.93,288.41,289.26,52324716,69714483.9,58.524642778279365,47.82380559474849,NaN,NaN,92.69910422879464,111.0623856101387,1.1947952295848743,0.7824745427559492,-0.412320686828925,9229093644,9272153113,48.071639231053595,30.971932428057645,NaN,NaN,5.2204631448607675,-4.786944882088631
2019-06-17T09:30:00-04:00,289.52,290.22,289.18,289.37,39205709,66657118.15,58.72630402071573,49.300917458853554,NaN,NaN,93.43693503692067,101.02547330414394,1.1110122033440728,0.9764445673511659,-0.13456763599290678,9268299353,9258170815.4,46.37716888738819,32.197630994124786,NaN,NaN,6.869035241157792,-3.121804864481999
2019-06-18T09:30:00-04:00,291.39,293.57,290.99,292.4,85434823,67784978.8,63.92896507328439,51.34108128874788,NaN,NaN,120.77100547798138,100.06212625920924,1.194851878901521,1.3589972126339944,0.16414533373247348,9353734176,9273003747.4,48.452952059394605,33.83480341506723,NaN,NaN,9.884426045382428,-1.2637718773585094
2019-06-19T09:30:00-04:00,292.55,293.65,291.47,293.06,78674377,69376343.4,64.96492096374315,53.31787612317806,NaN,NaN,113.79568257842712,104.0069791397616,1.2253880298499813,1.6958803710449502,0.47049234119496885,9432408553,9312990817.2,53.660797222741266,35.977564057125804,NaN,NaN,12.706446936465325,0.7319736674734669
2019-06-20T09:30:00-04:00,296.04,296.3093,293.1255,295.86,116570017,72730720.65,69.02878925145436,55.949419267666535,NaN,NaN,128.15444047956746,109.77143356033828,1.354690702122355,2.1638557188479126,0.8091650167255576,9548978570,9366502859.2,59.550389556161015,38.65582779419065,NaN,NaN,16.478862479740812,2.981529212083087
2019-06-21T09:30:00-04:00,294.13,295.52,293.76,294,83309466,71959501.6,63.73964109736523,58.26455615735516,NaN,NaN,106.48631992100913,112.52887669878116,1.2386421292657817,2.357467678307785,1.1188255490420032,9465669104,9413817951.2,63.917248580033196,41.85171365739437,NaN,NaN,18.194986705496966,5.154880282570784
2019-06-24T09:30:00-04:00,294.23,294.58,293.47,293.64,47582730,71575233.35,62.73766339762856,59.54336826267568,NaN,NaN,90.59856395172218,111.96120248174148,1.0677989869185787,2.4535742826902265,1.3857752957716478,9418086374,9443775355.4,66.39123099183618,45.3146408831102,NaN,NaN,19.319936426102807,7.178459731646788
2019-06-25T09:30:00-04:00,293.7,293.73,290.64,290.76,82028656,72175198.35,55.25441596562055,59.97442354685602,NaN,NaN,59.67797506094204,99.74259639833362,0.7083133070834067,2.271166929625906,1.5628536225424994,9336057718,9440240063.8,65.81771503209399,48.66011918639462,NaN,NaN,18.096132849089862,8.738127319852941
2019-06-26T09:30:00-04:00,291.75,292.31,290.345,290.47,51584902,69505797.1,54.5488501047658,60.13426996751556,NaN,NaN,47.77602289483422,86.53866446161503,0.41310833270671776,2.0792390384258965,1.6661307057191788,9284472816,9410652916.4,61.06349800425708,51.566154328690104,NaN,NaN,16.89511259436473,9.903410930497483
2019-06-27T09:30:00-04:00,291.31,292.06,290.89,291.5,40355239,68397370.05,56.66540352064763,60.13128217404914,NaN,NaN,50.10273536843201,70.92832343938794,0.2569661505329841,1.987338393885409,1.730372243352425,9324828055,9365822813.4,54.62507411460349,53.47063475496602,NaN,NaN,16.463759609990422,10.840603598996474
2019-06-28T09:30:00-04:00,292.58,293.55,292.01,293,59350929,67021777.4,59.614876938751316,60.203033390399646,NaN,NaN,69.45587446372829,63.52223434793177,0.22557968777867532,2.012346853075769,1.7867671652970938,9384178984,9349524789.4,52.45950535353048,54.417175379750574,NaN,NaN,16.92281279277571,11.709490626679221
2019-07-01T09:30:00-04:00,296.68,296.92,294.33,295.66,79107474,66155753.5,64.26039865344003,60.6170913856909,NaN,NaN,120.46722009421558,69.49596557643045,0.34754737156780413,2.221201379756849,1.8736540081890447,9463286458,9358564806.2,53.559265522434345,55.03539440657719,NaN,NaN,18.728133091926967,12.712153836000327
2019-07-02T09:30:00-04:00,295.61,296.49,294.68,296.43,61504544,65369386.25,65.49764339133264,61.19999439505523,NaN,NaN,120.20922910410141,81.60221638506232,0.4378332005437453,2.4209455088687264,1.983112308324981,9524791002,9396311463,57.93498321588305,55.79338272864156,NaN,NaN,20.587440739265592,13.837194822181079
2019-07-03T09:30:00-04:00,297.18,298.82,297.02,298.8,40898896,63855845.2,69.04920992764697,61.895837506048274,NaN,NaN,166.1547445157001,105.2779607092355,0.6046388760368093,2.738910903370993,2.1342720273341835,9565689898,9452554879.4,63.45959158158203,56.810075668070894,NaN,NaN,23.315773404881284,15.191277476852537
2019-07-05T09:30:00-04:00,297.44,298.64,296.01,298.46,51677326,62968192.45,67.96829178765154,62.57038386386057,NaN,NaN,140.0940430532,123.2762222461891,0.6363375164981395,2.929693922956858,2.2933564064587184,9514012572,9490391782.8,66.63433606848686,58.13598258503041,NaN,NaN,25.226824926418352,16.624927112504796
2019-07-08T09:30:00-04:00,297.01,298.2579,296.22,296.82,45841772,61546671.1,62.856927280391105,62.86542838240881,NaN,NaN,111.85035967586657,131.75511928861675,0.4972786848663828,2.914954762541697,2.4176760776753143,9468170800,9507190146,67.96508174755124,59.67797636075635,NaN,NaN,25.39095036669438,17.877216148817595
2019-07-09T09:30:00-04:00,295.54,297.52,295.48,297.19,41101279,60561782.4,63.523407581505374,62.83645999013887,NaN,NaN,90.66751593043261,125.79517845586017,0.38562217714820335,2.8997037991105685,2.514081621962365,9509272079,9516387270.2,68.70110919195584,61.12427329879643,NaN,NaN,25.71242655283826,18.996531920820548
2019-07-10T09:30:00-04:00,298.37,299.66,297.78,298.61,58595558,60559494.05,66.04181107406369,62.91338071230463,NaN,NaN,124.05779990999453,126.56489261703878,0.36312376988948625,2.967986334324223,2.604862564434737,9567867637,9525002597.2,69.4101195276937,62.24922489200732,NaN,NaN,26.704377234710336,20.09765267994766
2019-07-11T09:30:00-04:00,299.32,299.58,298.2,299.31,50889481,60749152.5,67.24246179954291,62.785785894310955,NaN,NaN,120.25404281392284,117.38475227668334,0.35091098593200254,3.0435012968497404,2.692590310917738,9618757118,9535616041.2,70.30262508931987,63.01724171580438,NaN,NaN,27.87562920445181,21.208792183448253
2019-07-12T09:30:00-04:00,299.85,300.73,299.51,300.65,40354410,60319615.2,69.46792267090552,63.19494886384955,NaN,NaN,135.8845896160451,116.54286158925235,0.38582875343419065,3.174876252710476,2.7890474992762853,9659111528,9564635832.4,72.65214462055215,63.641162861555735,NaN,NaN,29.524779123832882,22.396790317788913
2019-07-15T09:30:00-04:00,301.13,301.13,300.19,300.75,33910261,59398892.45,69.63372100765173,63.687524407422636,NaN,NaN,132.23691533445074,120.62017272096921,0.3684433055413314,3.2496016312029496,2.8811583256616182,9693021789,9609606030.2,75.84178056952256,64.31620211710477,NaN,NaN,30.932594763208087,23.616190952848793
2019-07-16T09:30:00-04:00,300.65,300.88,299.44,299.71,40567964,59467005.2,65.64145009047294,64.42945541634066,NaN,NaN,106.26150885792653,123.73897130646802,0.24559469585327465,3.1881516954782114,2.9425569996249368,9652453825,9638242379.4,77.63091738187578,65.16000228494632,NaN,NaN,31.079022967436938,24.682309812075673
2019-07-17T09:30:00-04:00,299.75,299.93,297.74,297.74,44102443,57400386.2,58.76822529661915,64.7308393586159,NaN,NaN,60.979406367337276,111.12329259793655,0.003173559289533223,2.9465239487368535,2.9433503894473203,9608351382,9646339128.4,78.12422718334679,66.37862579773845,NaN,NaN,29.240001632063716,25.333408643502537
2019-07-18T09:30:00-04:00,297.19,299.25,296.7,298.83,51701687,56051751.7,61.1896706106141,65.0540012936135,NaN,NaN,50.21298354263972,97.11508074367993,-0.10621038595602617,2.810587407002288,2.916797792958314,9660053069,9654598318.6,78.64165601251491,68.09409593330354,NaN,NaN,28.337130407380368,25.76251175262794
2019-07-19T09:30:00-04:00,300.04,300.07,296.96,297.17,71081238,53777312.75,55.81378086005665,64.7824944308496,NaN,NaN,41.30305597315221,78.19877401510134,-0.3017316104286527,2.539633279922498,2.8413648903511506,9588971831,9640570379.2,75.38038661492627,69.73130173768895,NaN,NaN,25.95145946796365,25.789504283390183
2019-07-22T09:30:00-04:00,297.61,298.5,297.04,297.9,43687404,51796209.65,57.578820382827104,64.30523884009152,NaN,NaN,31.212447929406295,57.993880534092455,-0.38778054319564514,2.356639211356594,2.744419754552239,9632659235,9628497868.4,72.59040309471615,71.09066870713765,NaN,NaN,24.44668203442413,25.59767253353789
2019-07-23T09:30:00-04:00,299.14,300.03,298.22,300.03,44657973,51649971.8,62.309668219807925,64.07752632783976,NaN,NaN,70.5673653352868,50.85505182956449,-0.3104749774648772,2.3563260327211424,2.6668010101860196,9677317208,9633470545,73.03314524489882,72.16910885206735,NaN,NaN,24.50688388226172,25.44184558335558
2019-07-24T09:30:00-04:00,299.19,301.44,299.09,301.44,47213232,49909200.6,65.08545923335345,63.794401278247356,NaN,NaN,102.84796624223083,59.2287638045432,-0.18007554494770295,2.4417065790013908,2.6217821239490937,9724530440,9656706356.6,75.06032096251857,72.99773237927711,NaN,NaN,25.398867252988712,25.4357058218746
2019-07-25T09:30:00-04:00,300.94,301,299.11,300,55394092,50099660.1,60.20856700299618,63.24013522220055,NaN,NaN,82.66440667108436,65.71904843023214,-0.2047035723432411,2.3659026585200422,2.5706062308632833,9669136348,9658523012.4,75.21718063269802,73.61079270529218,NaN,NaN,24.673651332575396,25.326840894831857
2019-07-26T09:30:00-04:00,300.76,302.23,300.62,302.01,45084077,50336102,64.23679351954021,63.3386970964255,NaN,NaN,141.77089660380727,85.81261655636311,-0.10457126531950367,2.439892149213904,2.5444634145334075,9714220425,9683572731.2,77.3341177352358,74.28000956155537,NaN,NaN,25.299742512691726,25.322969697383268
2019-07-29T09:30:00-04:00,301.88,301.93,300.85,301.46,38126462,49274878.65,62.37602098483707,63.25674091094919,NaN,NaN,124.17516839301929,104.4051606490857,-0.09462557899299551,2.4261814407921634,2.520807019785159,9676093963,9692259676.8,78.03483159972136,74.9467040192529,NaN,NaN,25.24741140117137,25.312175655067282
2019-07-30T09:30:00-04:00,299.91,301.17,299.49,300.72,45849045,47611957.2,59.86341364091405,62.81542680858136,NaN,NaN,71.45457122275943,104.58260182658023,-0.15363817391609524,2.32875930239004,2.482397476306135,9630244918,9682845218.8,75.31729319971647,75.36864499582596,NaN,NaN,24.462022353936973,25.190725183477237
2019-07-31T09:30:00-04:00,300.99,301.2,295.2,297.43,104245162,49748988.1,50.18452231368956,61.59700255959183,NaN,NaN,-63.70694620602571,71.27161933692892,-0.41516381610187114,1.963442706178796,2.378606522280667,9525999756,9643139082,65.03108751169205,74.99210659742398,NaN,NaN,20.58450428891004,24.532693627110493
2019-08-01T09:30:00-04:00,297.6,300.87,293.96,294.84,142646576,54836372.1,44.134819514707566,59.787495191291974,NaN,NaN,-126.07575437688604,29.52358712733484,-0.7442924996799243,1.448240897680762,2.192533397360686,9383353180,9585982448.4,53.66857756612445,73.6361375221077,NaN,NaN,15.148889011085462,23.19215011053549
2019-08-02T09:30:00-04:00,293.85,294.12,290.9,292.62,116749695,58089990.55,39.715437994360606,57.6504749760569,NaN,NaN,-264.53381858189175,-51.73735590980497,-1.0732310616873595,0.850994570251487,1.9242256319388464,9266603485,9496459060.4,41.451918667605305,71.17971881482791,NaN,NaN,9.03508367909675,21.169712048901385
2019-08-05T09:30:00-04:00,288.09,288.21,281.72,283.82,178745449,64735174.4,27.822470879406666,54.949119318123586,NaN,NaN,-395.1623071178897,-155.60485101198677,-1.8022810734502914,-0.32862570987401796,1.4736553635762735,9087858036,9378811875,31.351833735097415,67.87406998291517,NaN,NaN,-2.268982911955703,17.82132705449323
2019-08-06T09:30:00-04:00,285.91,288.04,284.28,287.8,120711682,68715694.55,37.00979367917283,53.39494563116314,NaN,NaN,-241.38779346864175,-218.17332395026702,-1.924197677438374,-0.9315917332216941,0.9926059442166799,9208569718,9294476835,26.38818436813024,64.17863835325684,NaN,NaN,-7.343587667402157,14.226339237079605
2019-08-07T09:30:00-04:00,284.4,288.82,282.04,287.97,140572265,72814529.9,37.37646343374714,51.69400226138693,NaN,NaN,-186.21122040862645,-242.67417879078715,-1.8979434171363683,-1.3798233272037805,0.5181200899325877,9349141983,9259105280.4,24.627092296849312,60.3204552307093,NaN,NaN,-10.826172388496621,10.647409004854431
2019-08-08T09:30:00-04:00,289.62,293.62,289.01,293.62,87713904,74655751.05,48.174190819465686,51.14831725848758,NaN,NaN,-74.23651068282813,-232.30633005197555,-1.426148226669267,-1.264565193403996,0.16158303326527096,9436855887,9269805821.8,26.231012153699595,56.809785626335966,NaN,NaN,-9.522793759699097,7.76595146706107
2019-08-09T09:30:00-04:00,292.58,293.24,289.65,291.62,93729958,77324528.45,45.20301467592602,50.26433113656607,NaN,NaN,-72.28039226124163,-193.85564478784553,-1.1847835441420878,-1.3193963969123388,-0.13461285277025103,9343125929,9285110310.6,28.572179993485335,53.6656268333909,NaN,NaN,-9.64156412363194,5.279163525533498
2019-08-12T09:30:00-04:00,289.96,291.6052,287.02,288.07,65527632,78905397,40.43581628086246,48.70191314092711,NaN,NaN,-95.86454841320055,-133.9960930469077,-1.196717992868442,-1.6305103438558035,-0.4337923509873615,9277598297,9323058362.8,34.1524319630246,50.88843302754275,NaN,NaN,-11.517507049083337,2.8796391577310936
2019-08-13T09:30:00-04:00,287.74,294.15,287.36,292.55,94792972,81616647.4,47.9027902084212,47.474579639146235,NaN,NaN,-53.98661944555343,-96.51585824229005,-0.8516064034890738,-1.4983003553487038,-0.64669395185963,9372391269,9355822673,38.61174466659501,48.284963292119635,NaN,NaN,-10.213991647883027,1.0091204712147908
2019-08-14T09:30:00-04:00,288.07,288.74,283.76,283.9,135622053,86192627.9,37.99804207215037,45.88811357265725,NaN,NaN,-117.25818454391406,-82.72525106934756,-1.1367815370116108,-2.0676708731241433,-0.9308893361125327,9236769216,9333348119.6,36.77215083055477,45.53888973482369,NaN,NaN,-13.161117232256892,-1.0151992007097352
2019-08-15T09:30:00-04:00,284.88,285.64,282.39,284.65,101929845,88704035.8,39.17243359234741,44.09780214928634,NaN,NaN,-116.664008416189,-91.21075061601974,-1.1995818310810331,-2.430366624963824,-1.230784793882791,9338699061,9313716754.4,35.19481099145895,42.52893925312535,NaN,NaN,-14.841680435212712,-2.9904108056387315
2019-08-16T09:30:00-04:00,286.48,289.33,284.7138,288.85,85825286,89441238.2,45.40842924039054,42.8858313103973,NaN,NaN,-68.58640273912818,-90.47195271159705,-0.8968047588957571,-2.3517907425024873,-1.4549859836067303,9424524347,9329996438,37.58575869205574,39.639719759720656,NaN,NaN,-13.857535636031809,-4.5428572099806
2019-08-19T09:30:00-04:00,292.19,293.08,291.44,292.33,53640153,89938875.65,49.98384246435359,42.180147654928696,NaN,NaN,-9.98321819753493,-73.29568666846394,-0.42466766889009677,-1.9858205697193512,-1.5611529008292544,9478164500,9370109678.6,43.151298763190674,37.34214872854024,NaN,NaN,-11.392456337827703,-5.521371371101615
2019-08-20T09:30:00-04:00,291.77,292.36,289.95,290.09,51652752,90288614.6,47.23934963595716,41.969778177947816,NaN,NaN,-24.638202126639555,-67.42600320468115,-0.23519834070925905,-1.8551508267158283,-1.6199524860065693,9426511748,9380933774.4,44.587192608691666,35.881870521183075,NaN,NaN,-10.413773715409482,-6.220285991717024
2019-08-21T09:30:00-04:00,292.48,292.86,291.72,292.45,49723430,90414124.5,50.33352193487429,42.41254263653115,NaN,NaN,1.5779171468921738,-43.6587828665199,0.061265333433346836,-1.5433708192148856,-1.6046361526482324,9476235178,9428826966.8,50.540011141212986,35.658401490832254,NaN,NaN,-8.580116935466698,-6.557404697966978
2019-08-22T09:30:00-04:00,293.23,293.93,290.4,292.36,51739292,90231384.5,50.21258412052543,43.16233878840006,NaN,NaN,6.236192999342265,-19.078742583413646,0.252756962677432,-1.2886899493014425,-1.5414469119788745,9424495886,9445986331.8,52.50853275005144,36.44815963957841,NaN,NaN,-7.199790070245775,-6.649174036863949
2019-08-23T09:30:00-04:00,290.92,292.76,283.47,284.85,149318151,95443088.2,41.29606107992074,44.124738088436786,NaN,NaN,-70.9447324116654,-19.550408517921092,-0.10568730957680161,-1.6735560489498766,-1.567868739373075,9275177735,9416117009.4,48.86288956728073,37.69894934187721,NaN,NaN,-8.983372252946895,-6.9826309248757985
2019-08-26T09:30:00-04:00,287.27,288,285.58,288,72620598,97167795,45.655158643099746,44.74226415728871,NaN,NaN,-60.086232951809286,-29.571011468775964,-0.10949333075549861,-1.7047354028174482,-1.5952420720619496,9347798333,9390043776,45.869116628410254,39.090444503325784,NaN,NaN,-8.960345897316211,-7.265161635224429
2019-08-27T09:30:00-04:00,289.54,289.95,286.03,286.87,68262998,98288492.65,44.381982142383244,45.24265835076272,NaN,NaN,-44.71347020670934,-33.58606508478992,-0.16370949241593324,-1.799878937581866,-1.6361694451659328,9279535335,9360648493.4,42.69322206666497,40.380882344026894,NaN,NaN,-9.350064387637495,-7.5630048855691525
2019-08-28T09:30:00-04:00,286.14,289.07,285.25,288.89,59852324,96068850.75,47.21572803189046,45.17419672307877,NaN,NaN,-35.57108362425415,-41.015865239019185,-0.04528088466754565,-1.6927705510003648,-1.6474896663328191,9339387659,9333278989.6,39.92163822071858,41.358784205956816,NaN,NaN,-8.78331060030834,-7.7373342733890365
2019-08-29T09:30:00-04:00,291.72,293.16,290.61,292.58,57998913,91836467.6,52.02440341158458,45.66143877562582,NaN,NaN,79.17778380812224,-26.42754707726319,0.2818285994202048,-1.295203917057563,-1.5770325164777679,9397386572,9327857126.8,39.376294624126345,42.13050667957403,NaN,NaN,-6.768828440467067,-7.598976297257327
2019-08-30T09:30:00-04:00,294.22,294.2399,291.42,292.45,62961780,89147071.85,51.84520621961846,46.47639519982267,NaN,NaN,93.7197034078372,6.505340086637332,0.47816177412875893,-0.9793302988168193,-1.4574920729455783,9334424792,9339706538.2,41.26469479475158,42.63852545326882,NaN,NaN,-5.2261573996261905,-7.2600021690243075
2019-09-03T09:30:00-04:00,290.57,291.58,289.27,290.74,69252354,83672417.1,49.43319028638129,46.58570949110554,NaN,NaN,32.370921126568135,24.996770902312814,0.48031304599581515,-0.8571007654508094,-1.3374138114466245,9265172438,9323181359.2,39.42049607296206,42.69629341086647,NaN,NaN,-4.632242036480591,-6.884607864375205
2019-09-04T09:30:00-04:00,293.14,294.055,292.31,294.04,47003957,79987030.85,53.89135807540776,47.720946348481064,NaN,NaN,101.1854219286225,54.17654932937919,0.6792738550016801,-0.4883214926945243,-1.1675953476962044,9312176395,9329709571.2,40.55083222765658,42.966199224945164,NaN,NaN,-2.7810046723283945,-6.298378836939946
2019-09-05T09:30:00-04:00,296.79,298.83,296.64,297.82,83356779,77126256.55,58.414078363783865,49.09534954644081,NaN,NaN,191.2585419769588,99.54247444962178,1.0202454907905218,0.10771151579194793,-0.9125339749985739,9395533174,9340938674.2,42.53695478181436,43.49063806711341,NaN,NaN,0.2360026918460783,-5.364895761399086
2019-09-06T09:30:00-04:00,298.17,298.76,297.42,298.05,49584290,75219775.85,58.67966240753191,50.04329477266519,NaN,NaN,175.42736224040613,118.79239013607855,1.2034744126223982,0.5918090407794239,-0.6116653718429743,9445117464,9350484852.6,44.24238371578236,43.96611128309388,NaN,NaN,2.7371197792233892,-4.207464969881589
2019-09-09T09:30:00-04:00,299.14,299.24,297.16,298.2,51260290,73096292.45,58.864174135271696,50.67760417773077,NaN,NaN,153.8462158474368,130.81769262399848,1.2703797197468019,0.976309277840528,-0.29407044190627385,9496377754,9382875445,49.69755183960456,44.43370078855202,NaN,NaN,4.83174133569292,-2.916149783370945
2019-09-10T09:30:00-04:00,297.36,298.2,295.97,298.13,57947101,72717265.9,58.73236997920946,51.49853420224879,NaN,NaN,121.63316477730301,148.67014135414544,1.2439330135876296,1.2608458250782633,0.016912811490633617,9438430653,9417527088,54.793177828478186,45.16269973282248,NaN,NaN,6.532448750196738,-1.5663499928612759
2019-09-11T09:30:00-04:00,298.47,300.34,297.75,300.25,68821066,71418670.6,61.541024154813094,52.29907007510157,NaN,NaN,138.55227642152113,156.1435122527252,1.2972869628702772,1.6385215150784802,0.341234552208203,9507251719,9456542152.8,59.73846924856994,45.81973245477655,NaN,NaN,8.79626830996946,-0.08597594959974231
2019-09-12T09:30:00-04:00,301.25,302.46,300.41,301.29,72908745,68283005.2,62.87585834844889,53.20358966281038,NaN,NaN,154.12513219229328,148.71683029579208,1.325981658477954,1.9987116253056456,0.6727299668276916,9580160464,9493467610.8,63.77722734420999,46.624639211502156,NaN,NaN,11.093372794845715,1.5110738710353229
2019-09-13T09:30:00-04:00,301.78,302.17,300.68,301.09,62104838,66291754.85,62.427129168683464,54.71295166915058,NaN,NaN,131.91686156782137,140.01473016127514,1.2555601046997,2.2421800977023167,0.9866199930026167,9518055626,9508055243.2,65.25985726610327,47.7958511899895,NaN,NaN,12.914255917660618,3.140099877696079
2019-09-16T09:30:00-04:00,299.84,301.1378,299.45,300.16,58191175,64910049.3,60.27305225665555,55.7570869272617,NaN,NaN,99.49171107690334,129.14382920716844,1.0772574501832222,2.3331918057316443,1.2559343555484221,9459864451,9500752582.6,63.85089599442444,49.08026400184765,NaN,NaN,13.955486964359206,4.685155175790811
2019-09-17T09:30:00-04:00,299.94,301.02,299.75,300.92,42904427,64373263,61.44388912632699,56.97579456897197,NaN,NaN,91.68450065049147,123.15409638180613,0.9460804957252296,2.438534975204959,1.4924544794797296,9502768878,9513620227.6,65.2736024634047,50.693148315900494,NaN,NaN,15.152432368775443,6.18048048907433
2019-09-18T09:30:00-04:00,300.49,301.22,298.24,301.1,74192091,65500229.95,61.731559772126865,58.01263969327457,NaN,NaN,77.20976175330443,110.88559344816281,0.8121469759632671,2.5076381994338135,1.6954912234705464,9576960969,9527562077.6,66.79830137557315,52.61290996981868,NaN,NaN,16.246690221645558,7.618510450870219
2019-09-19T09:30:00-04:00,301.53,302.63,300.7103,301.08,78099215,66919019.2,61.676496223603266,58.70207489413305,NaN,NaN,86.32546281530853,97.32565957276586,0.6688921308907831,2.5316063870840253,1.8627142561932422,9498861754,9511302335.6,63.307253854307994,54.32226420054594,NaN,NaN,17.172602716074103,8.983380774470774
2019-09-20T09:30:00-04:00,300.36,300.67,297.41,298.28,97455979,69204853.55,54.36525528639201,58.88207839890259,NaN,NaN,44.378117370495126,79.81791073330062,0.3483668695114155,2.2981728430825115,1.949805973571096,9401405775,9487972365.4,58.57681621046959,55.55884430166866,NaN,NaN,16.18195376247131,10.011748344185136
2019-09-23T09:30:00-04:00,297.55,299,297.27,298.21,47541321,64116012.05,54.19230006477197,59.22201481164478,NaN,NaN,30.661324572270097,66.05183343237395,0.10696263299317321,2.0835092648125624,1.9765466318193892,9353864454,9466772366,54.585368523870805,56.64204947673357,NaN,NaN,15.298020147848145,10.766930030422708
2019-09-24T09:30:00-04:00,299.41,299.84,294.81,295.87,97367568,65353360.55,48.623507613199685,58.84573977862993,NaN,NaN,2.5422866707860736,48.22339063643288,-0.21730515533420247,1.7049151876516362,1.9222203429858387,9256496886,9417517967.6,46.63463630968929,57.07660691116447,NaN,NaN,12.994060288249901,11.085091495826592
2019-09-25T09:30:00-04:00,295.96,298.11,294.33,297.62,73434081,65611914.7,52.550515898810566,58.42691388827468,NaN,NaN,-10.427015978935913,30.696035089984782,-0.3150020318909814,1.528467803122112,1.8434698350130934,9329930967,9368111967.2,40.294532572551574,56.916433896217136,NaN,NaN,11.97717115483908,11.21253144711409
2019-09-26T09:30:00-04:00,297.63,297.86,295.45,297,58722357,65555416.35,51.061400303414125,57.88275230940913,NaN,NaN,-22.969926547253763,8.836957217472323,-0.41609712855120984,1.323348424324081,1.7394455528752908,9271208610,9322581338.4,35.50409824905714,56.2922706485939,NaN,NaN,10.710722584706044,11.140844466770083
2019-09-27T09:30:00-04:00,297.83,297.9465,293.69,295.4,84781110,66894526.2,47.33374877886186,57.059150498236995,NaN,NaN,-63.27694220301979,-12.69405469723066,-0.5756155327367272,1.019926136954382,1.595541669691109,9186427500,9279585683.4,31.67457139149343,55.00491490230025,NaN,NaN,8.559398356417297,10.772066451005399
2019-09-30T09:30:00-04:00,295.97,297.55,295.92,296.77,52562761,66374575.25,50.65549643539929,56.482230959393405,NaN,NaN,-41.42981235889792,-27.112282083464265,-0.5725399101198096,0.879866782041347,1.4524066921611567,9238990261,9256610844.8,29.823441178471825,53.221362284442655,NaN,NaN,7.575982433489391,10.315483019931683
2019-10-01T09:30:00-04:00,297.74,298.455,293,293.24,89900420,67406978.55,43.110543270431066,55.16576803908041,NaN,NaN,-124.21374732952397,-52.46348888352627,-0.7791163491311592,0.47851125574720754,1.2576276048783668,9149089841,9235129435.8,28.16597026065918,50.96618378530617,NaN,NaN,4.358930688130302,9.464546972531487
2019-10-02T09:30:00-04:00,291.5,291.51,286.64,288.06,124523974,71282979.4,34.89658275487314,53.167248353824995,NaN,NaN,-305.10830281369493,-111.39974625047807,-1.2097929419918056,-0.2546135726113903,0.9551793693804154,9024565867,9174056415.8,24.070171068410446,48.129965479891915,NaN,NaN,-1.5369940613801685,7.892898253401251
2019-10-03T09:30:00-04:00,287.81,290.45,284.82,290.42,85906799,71410480.4,40.46238152419378,51.59833780779002,NaN,NaN,-236.35513593195458,-154.07678812741824,-1.2744118430707758,-0.6378354344580544,0.6365764086127215,9110472666,9141909227,22.237134805356163,45.05691387555284,NaN,NaN,-4.566869447738972,6.112931438952648
2019-10-04T09:30:00-04:00,291.14,294.63,290.82,294.35,66700681,72266299.95,48.3770347786837,50.74862227364917,NaN,NaN,-97.9719575201933,-161.01579119085295,-1.003107070513587,-0.6173074295292622,0.38579964098432473,9177173347,9140058396.4,22.132630719303663,42.077037784472786,NaN,NaN,-4.400346632723333,4.611034571570365
2019-10-07T09:30:00-04:00,293.47,295.26,292.77,293.08,60656561,72736113.5,46.237917697003375,49.6624814572689,NaN,NaN,-78.00680104550301,-168.33118892817396,-0.8650396596620858,-0.6954999335932825,0.16953972606880327,9116516786,9115563701.4,20.74324992583462,38.896298317503486,NaN,NaN,-4.988716289124061,3.2396415914711616
2019-10-08T09:30:00-04:00,291.04,291.85,288.49,288.53,101575470,74917531.95,39.499217147781515,48.07445698410138,NaN,NaN,-145.98188831754226,-172.6848171257776,-1.025070904671507,-1.1117989047705805,-0.08672800009907347,9014941316,9088733996.4,19.313139185797837,35.504501018233825,NaN,NaN,-7.904870457848502,1.6475684415683527
2019-10-09T09:30:00-04:00,290.75,292.3,288.6559,291.27,65707329,74761845.1,44.72367138953694,46.86354092452522,NaN,NaN,-105.71650735560745,-132.80645803416013,-0.8959883965683717,-1.206713495809538,-0.31072509924116637,9080648645,9099950552,21.74225649545137,32.53557263545836,NaN,NaN,-8.44153094831966,0.20626852872720813
2019-10-10T09:30:00-04:00,291.18,294.21,291,293.24,57255974,73979206.55,48.187936884261774,46.422303895801626,NaN,NaN,-58.163403939181975,-97.1681116356056,-0.6395591697959742,-1.1101740614861342,-0.47061489169015996,9137904619,9105436942.6,22.96392038340909,29.99179436209689,NaN,NaN,-7.681743012623064,-0.9205902628942593
2019-10-11T09:30:00-04:00,296.27,298.74,296.1448,296.28,101228577,75935393.5,53.07520742420545,46.34251156433259,NaN,NaN,30.52717611714407,-71.46828490813813,-0.24701134567180905,-0.7793790737799213,-0.5323677281081123,9239133196,9117828912.4,25.78211696498279,27.93441925074774,NaN,NaN,-5.358855225933439,-1.5546281147569991
2019-10-14T09:30:00-04:00,295.93,296.67,295.57,295.95,40546668,75053168.15,52.49632622333816,46.619141465056764,NaN,NaN,15.150920858557821,-52.83674052732597,-0.004227565621568674,-0.5376521851350731,-0.5334246195135044,9198586528,9134242860.8,29.462995800810177,26.707873500113518,NaN,NaN,-3.739204974750182,-1.8667105233274537
2019-10-15T09:30:00-04:00,297.1,299.7,296.97,298.88,47832356,75299564.6,56.98254850015431,46.9357152222956,NaN,NaN,72.78854295290884,-9.082654273235738,0.34001510560612525,-0.10840573750584781,-0.44842084311197306,9246418884,9180538374.4,38.697834268981104,26.59382362128706,NaN,NaN,-0.8880162192932712,-1.7268970513225705
2019-10-16T09:30:00-04:00,298.37,299.16,297.92,298.4,50563596,74118139.85,56.04869786696923,47.29195076254954,NaN,NaN,75.88809934843691,27.238267067573123,0.5114112777568475,0.1908432540840863,-0.32056802367276116,9195855288,9203579703,42.71747934329907,27.10906512801863,NaN,NaN,1.0955248577251044,-1.323693921458617
2019-10-17T09:30:00-04:00,299.68,300.24,298.515,299.28,46784885,72552423.35,57.426236262615355,48.01284272567479,NaN,NaN,100.78784535940429,59.028516927290376,0.6511121553585311,0.4933221705254027,-0.15778998483312837,9242640173,9224526813.8,46.172999008290674,28.144667100647005,NaN,NaN,3.134808157067636,-0.6867650530977237
2019-10-18T09:30:00-04:00,298.69,299.395,296.99,297.97,64338028,70896525.8,54.67882034786633,48.30022300513672,NaN,NaN,73.31913396056177,67.58690849597392,0.6223789854589074,0.6201837469905058,-0.002195238468401528,9178302145,9212360603.6,44.49415598383435,29.19257530103004,NaN,NaN,4.054733956355181,-0.009408051747308743
2019-10-21T09:30:00-04:00,299.42,300.21,298.935,299.99,39460901,70492504.8,58.01445593595822,49.36478819553152,NaN,NaN,107.06016481587893,85.96875728743814,0.7006751508513379,0.8736487000957709,0.17297354924443298,9217763046,9216195907.2,45.170958210510804,30.40721729744801,NaN,NaN,5.835126767171265,0.8255254938124874
2019-10-22T09:30:00-04:00,300.58,300.9,298.91,299.01,49126038,68080428.3,55.86620050412268,50.86261803476363,NaN,NaN,97.61103327595447,90.93325535204727,0.648900843880073,0.9840996040945242,0.3351987602144513,9168637008,9200639532,42.88673072229111,31.7512572727252,NaN,NaN,6.708416026936134,1.6659384271158655
2019-10-23T09:30:00-04:00,298.73,299.94,298.495,299.88,34991829,66158315.7,57.37520273391091,52.07067669260057,NaN,NaN,87.50364361377126,93.25636420511414,0.6348986812197739,1.1288221117391686,0.49392343051939475,9203628837,9202194241.8,43.195892220465524,33.24831137380444,NaN,NaN,7.866644317901694,2.5517535543709835
2019-10-24T09:30:00-04:00,300.91,301.07,299.4601,300.37,35857459,65015070.8,58.2412225903547,52.77526153629135,NaN,NaN,97.8465797940588,92.66811109204505,0.619607608577718,1.2684329412415423,0.6488253326638243,9239486296,9201563466.4,43.093968570443344,34.74554979174299,NaN,NaN,9.07202787029889,3.483221313789256
2019-10-25T09:30:00-04:00,299.74,302.2,299.6806,301.6,45205412,63036285.9,60.415355012314315,53.78793563024214,NaN,NaN,102.96687533486399,98.59765936690549,0.6501231155760208,1.4614792271338501,0.8113561115578294,9284691708,9222841379,47.58672402943851,36.662940799143264,NaN,NaN,10.710790169943202,4.515731150382677
2019-10-28T09:30:00-04:00,302.94,303.85,302.91,303.3,42146965,62515496.1,63.26229755951317,55.4852985167944,NaN,NaN,128.74790613755346,102.93520763124039,0.7362621658780755,1.7316838189054238,0.9954216530273483,9326838673,9244656504.4,51.78926192188905,38.98266385172121,NaN,NaN,12.94957263829428,5.720565648655763
2019-10-29T09:30:00-04:00,303,304.23,302.86,303.21,44284921,60234721.15,63.003953770915615,56.79103297260716,NaN,NaN,115.86699059552797,106.58639909515509,0.736837715520859,1.916468797428422,1.179631081907563,9282553752,9267439853.2,55.777306905671814,41.41373888102267,NaN,NaN,14.738984117884286,7.008911144259837
2019-10-30T09:30:00-04:00,303.43,304.55,301.99,304.14,49643928,56490718.85,64.61212635494407,57.96418936337018,NaN,NaN,112.26765378534259,111.53920112946938,0.7471681642209398,2.1135912871837377,1.3664231229627979,9332197680,9293153621.8,59.817364375098464,44.046127737571915,NaN,NaN,16.719067306651286,8.396076310315758
2019-10-31T09:30:00-04:00,304.13,304.13,301.73,303.33,69053791,55648068.45,62.08094975613717,58.60745667279388,NaN,NaN,100.26890956373175,112.02366708340396,0.6503255730496011,2.1793300892747993,1.5290045162251982,9263143889,9297885140.4,60.5318744562682,46.528253272663726,NaN,NaN,17.77191850245819,9.735482337764676
2019-11-01T09:30:00-04:00,304.92,306.19,304.74,306.14,71141515,55870110.15,66.92213662310763,59.63787170134884,NaN,NaN,141.09840038787135,119.64997209400542,0.7209233649193281,2.430158722374358,1.70923535745503,9334285404,9307803879.6,62.05509913351785,48.85626065357142,NaN,NaN,20.129131291556064,11.220289331163446
2019-11-04T09:30:00-05:00,307.85,308,306.96,307.37,60606916,55867627.9,68.79987141894635,60.481966195548274,NaN,NaN,159.97320639355505,125.89503214520573,0.7902936531044464,2.697102423835588,1.9068087707311416,9394892320,9321414609,64.10244826198206,50.67087593878576,NaN,NaN,22.694230362533705,12.85942376421634
2019-11-05T09:30:00-05:00,307.59,307.9195,306.71,307.03,43033885,52940548.65,67.65655827774212,61.31109908203206,NaN,NaN,141.03738010043944,130.92911004618804,0.753263089335932,2.8483876324010566,2.0951245430651246,9351858435,9335275545.6,66.10798985765348,52.341626689811086,NaN,NaN,24.520436211403336,14.525282685243052
2019-11-06T09:30:00-05:00,307.03,307.4,306.06,307.1,46487108,51979537.6,67.77529098747513,62.05031727666489,NaN,NaN,119.83485396596578,132.4425500823127,0.675932139448026,2.940039717375157,2.264107577927131,9398345543,9348505118.2,67.9485597494745,53.89702388560993,NaN,NaN,26.074180214757753,16.17512518945944
2019-11-07T09:30:00-05:00,308.57,309.65,307.66,308.18,54272274,51830352.6,69.62784208434515,63.11810454355624,NaN,NaN,136.42886875683516,139.67454192093336,0.6403107588481731,3.0644960264873475,2.4241852676391744,9452617817,9386399903.8,72.54747680362996,55.900832515595326,NaN,NaN,27.934699165617943,17.855064328910654
2019-11-08T09:30:00-05:00,307.8,309.0036,307.03,308.94,49068797,49222363.6,70.89581829183193,64.03820185469009,NaN,NaN,118.26841367560284,135.10854457847967,0.6108184096994251,3.1877082797634557,2.5768898700640306,9501686614,9419880145.8,75.84514048165062,58.09184553496247,NaN,NaN,29.884014259316853,19.57348574754011
2019-11-11T09:30:00-05:00,307.42,308.54,307.27,308.35,35934909,48991775.65,68.50481775715608,64.94096022990676,NaN,NaN,103.81932370598788,123.87776804096625,0.4991676315358564,3.200849409483851,2.7016817779479947,9465751705,9434052022.8,77.09914543386034,60.53558944293169,NaN,NaN,30.94359978185691,21.197787752442512
2019-11-12T09:30:00-05:00,308.75,309.99,308.15,309,46484624,48924389.05,69.71656010854177,65.8224857566661,NaN,NaN,111.78380944681247,118.02705391024082,0.4198706591550163,3.226520101891765,2.8066494427367488,9512236329,9466127601.6,79.67150552190088,63.140990393034215,NaN,NaN,32.17718213798573,22.76627266466297
2019-11-13T09:30:00-05:00,307.91,309.54,307.66,309.1,54459018,49119160.15,69.90837535495507,66.65585381128041,NaN,NaN,94.01602003999817,112.86328712504731,0.32895261850260926,3.21784021586501,2.888887597362401,9566695347,9499797562.4,81.96196255965376,65.91727567797783,NaN,NaN,33.272017403926505,24.26709334170062
2019-11-14T09:30:00-05:00,308.79,309.64,308.09,309.55,52001874,49380009.6,70.80454526952707,67.39793882965274,NaN,NaN,90.35335143695751,103.64818366107178,0.2571032240993967,3.2102666274866465,2.95316340338725,9618697221,9533013443.2,83.89033647996598,68.5103908530155,NaN,NaN,34.449133625040915,25.72167052503495
2019-11-15T09:30:00-05:00,311.02,311.84,310.26,311.79,62706192,49298417.8,74.82387629902081,68.22376588247472,NaN,NaN,122.75922352801791,104.54634563155477,0.31461977970342403,3.34643812801653,3.031818348313106,9681403413,9568956803,85.67499207034513,70.93080014933379,NaN,NaN,36.67254720243386,27.28608147894908
2019-11-18T09:30:00-05:00,311.53,312.28,311.03,312.02,49327980,49791771.75,75.20138799102325,69.09501118391098,NaN,NaN,122.30619186365094,108.2437192630874,0.32121470725823276,3.4333367323858965,3.112122025127664,9730731393,9621952740.6,87.8178798113387,73.21941249973857,NaN,NaN,38.64520627186695,28.90881359222306
2019-11-19T09:30:00-05:00,312.68,312.69,311.22,311.93,67927818,50731860.75,74.72918239391234,69.81765804383728,NaN,NaN,117.69798957592823,109.42655528891055,0.2743934621531232,3.4551138528190677,3.1807203906659445,9662803575,9652066189.8,88.83950288853913,75.29242239355575,NaN,NaN,40.189354050207434,30.520319371935113
2019-11-20T09:30:00-05:00,311.28,311.85,309.06,310.77,79696276,52967083.1,68.73812958521768,70.29317088877161,NaN,NaN,84.34179759286914,107.49171079948476,0.1276361434155735,3.3402655699354113,3.212629426519838,9583107299,9655348580.2,88.94829849955744,77.32216696807642,NaN,NaN,39.992918131477694,31.873547766155482
2019-11-21T09:30:00-05:00,310.89,311.01,309.39,310.27,54664690,53907444.65,66.27186970081826,70.24672325146523,NaN,NaN,72.21490206550409,103.86402092519407,-0.03223715950737027,3.172332977135625,3.204570136642995,9528442609,9637297657.8,84.09336361960499,78.89632871708264,NaN,NaN,39.16775860764524,32.915577886368304
2019-11-22T09:30:00-05:00,311.09,311.24,309.85,310.96,44850228,53889685.45,67.97927288729268,70.18810907063282,NaN,NaN,79.61185111724993,95.23454644304047,-0.11593398955120282,3.0596526497039918,3.1755866392551946,9573292837,9615675542.6,78.56188639889069,79.92914572686183,NaN,NaN,38.88472608563246,33.76831334340604
2019-11-25T09:30:00-05:00,311.98,313.37,311.98,313.37,48762676,54220471,73.10116005130119,70.5770091973156,NaN,NaN,134.94600405101838,97.76250888051396,-0.037466737264919114,3.1287532176740456,3.1662199549389647,9622055513,9593940366.6,73.33952228202797,80.4456837571743,NaN,NaN,40.095950967856666,34.672261575470415
2019-11-26T09:30:00-05:00,313.41,314.28,313.06,314.08,37727953,53892622.6,74.40031066176928,71.05022488833661,NaN,NaN,147.89847644764097,103.80260625485653,0.030123802942639166,3.2038747086172634,3.1737509056746243,9659783466,9593336344.8,73.19390788501582,80.82035148114153,NaN,NaN,41.49715857482856,35.64724686109301
2019-11-27T09:30:00-05:00,314.61,315.48,314.37,315.48,44793179,53650085.15,76.78160220086207,71.56120775380212,NaN,NaN,164.6080050458029,119.85584774544327,0.1313193527242782,3.337900096579972,3.2065807438556937,9704576645,9617630214,75.3166583870996,81.01815016567507,NaN,NaN,43.44424815827708,36.76110418926216
2019-11-29T09:30:00-05:00,314.86,315.13,314.06,314.31,36592740,52027032.6,70.85014845733329,71.5579456227665,NaN,NaN,134.18175981937202,132.24921929621684,0.0839623341530471,3.311533661547003,3.2275713273939557,9667983905,9645538473.2,77.51907911732266,81.13771721108023,NaN,NaN,43.31869983127226,37.697903566692176
2019-12-02T09:30:00-05:00,314.59,314.66,311.17,311.64,76110027,52275458.2,59.54536993400278,70.91798506396982,NaN,NaN,66.09982280779636,129.54681363432616,-0.14993988602282915,3.0401464698654195,3.1900863558882486,9591873878,9649254681.4,77.80309377395119,81.18799923537242,NaN,NaN,39.428224059316484,37.94509220849565
2019-12-03T09:30:00-05:00,308.65,309.64,307.13,309.55,75172709,53003747.85,52.48573440264187,69.6872117992627,NaN,NaN,-57.11289125482686,91.13503457315709,-0.4511474953525587,2.6261519866975505,3.077299482050109,9516701169,9628183812.6,72.23101244595739,80.6565354442336,NaN,NaN,33.6114654362176,37.326002669598786
2019-12-04T09:30:00-05:00,310.7,312.12,310.32,311.46,49190402,53311573.7,57.450518009725776,68.79736484603202,NaN,NaN,21.229005050719774,65.80114029377285,-0.5224521064084238,2.4242343490395797,2.9466864554480034,9565891571,9609405433.6,67.5854917572155,79.62964467263087,NaN,NaN,30.40119875266008,36.33674496717897
2019-12-05T09:30:00-05:00,312.23,312.25,310.58,312.02,40781669,53026301.75,58.80949699753356,67.94057568374679,NaN,NaN,26.034364050048694,38.086412094622005,-0.5308831386927984,2.2830825320820054,2.8139656707748038,9606673240,9589824752.6,63.03315758340657,78.13984618001949,NaN,NaN,28.31230237273991,35.19039602511625
2019-12-06T09:30:00-05:00,314.12,315.31,314.11,314.87,48956767,52760526.4,64.9457187728971,67.23499300330937,NaN,NaN,131.9407704886309,37.63821422847377,-0.35211182102067173,2.373825894498964,2.7259377155196356,9655630007,9587353973,62.461437393702965,76.4817351316879,NaN,NaN,28.591771704384406,34.247735407868845
2019-12-09T09:30:00-05:00,314.44,315.18,313.8,313.88,34904315,52052302.3,61.517431814455925,66.257567562126,NaN,NaN,103.0565493001691,45.02955952694831,-0.309634479980867,2.338894615543552,2.648529095524419,9620725692,9593124335.8,63.298677408710184,74.73036353150016,NaN,NaN,27.656572605311574,33.306140721789234
2019-12-10T09:30:00-05:00,313.82,314.55,312.81,313.53,53109165,52911015.1,60.3054373302171,65.22730005757634,NaN,NaN,70.71510130898871,70.59515803971142,-0.31326127099302603,2.2569525067831364,2.5702137777761624,9567616527,9603307407.4,64.79107804996084,73.01261890017314,NaN,NaN,26.5330175373856,32.33855169544586
2019-12-11T09:30:00-05:00,314.03,314.7,313.4393,314.42,53521450,53262856.4,62.3374162710134,64.77010624941889,NaN,NaN,82.82823642767913,82.91500431510329,-0.26574722747534585,2.23802974343198,2.503776970907326,9621137977,9614356688.6,66.38819057903179,71.40118262013559,NaN,NaN,26.23541220015115,31.46667462468947
2019-12-12T09:30:00-05:00,314.43,317.99,314.17,317.13,96585802,55369195.6,67.75082434693229,64.87574586699846,NaN,NaN,151.58967450666262,108.0260664064261,-0.0719160244766508,2.413881940311512,2.485797964788163,9717723779,9636566796.4,69.3935541180585,70.35119622716797,NaN,NaN,27.766893821848864,30.938134509997955
2019-12-13T09:30:00-05:00,316.87,318.67,316.02,317.32,81546487,56846426.25,68.09705098572469,64.88415858831503,NaN,NaN,163.7013066738198,114.37817364346388,0.04280638584459595,2.539305947093908,2.496499561249312,9799270266,9665294848.2,72.78339465465027,69.93844681686508,NaN,NaN,29.079931865767783,30.672676989393644
2019-12-16T09:30:00-05:00,319.22,320.15,319.17,319.5,82836128,57852923.05,71.83352477632178,64.7936132115308,NaN,NaN,203.3203559764218,134.43093497871442,0.22883058577377557,2.782537793466531,2.5537072076927556,9882106394,9717570988.6,77.63712851819972,70.24541869087736,NaN,NaN,31.454832067590306,30.784413429136023
2019-12-17T09:30:00-05:00,319.92,320.25,319.48,319.57,61131769,58443112.5,71.94713946762369,64.61838669766325,NaN,NaN,177.25506055337155,155.73892682759097,0.31461684828532066,2.9469782680494063,2.6323614197640857,9943238163,9792695315.8,82.47419225803715,70.90829614609318,NaN,NaN,33.362877748014064,31.152765474690028
2019-12-18T09:30:00-05:00,320,320.25,319.53,319.59,48199955,57456719.35,71.98191366370321,64.2755518021519,NaN,NaN,152.69697523576116,169.71267458920738,0.32917089729058535,3.0438250413773176,2.7146541440867322,9991438118,9866755344,85.74717157208745,71.65333280216375,NaN,NaN,34.90846710631703,31.689294279208173
2019-12-19T09:30:00-05:00,319.8,320.98,319.5246,320.9,85388424,57741326.75,74.23480079353315,64.51731268330903,NaN,NaN,147.47109539278026,168.8889587664309,0.3798895668345872,3.189516102629966,2.809626535795379,10076826542,9938575896.6,88.07330616873735,72.40720616297908,NaN,NaN,36.92255781345489,32.43690335552913
2019-12-20T09:30:00-05:00,320.46,321.9742,319.3873,320.73,149338215,62475003,73.40986959922243,65.50763408796759,NaN,NaN,131.4646928966643,162.44163601099982,0.3553007758242832,3.253752505575733,2.8984517297514496,9927488327,9964219508.8,88.77757067923834,73.19109737049959,NaN,NaN,38.34834978639198,33.28139570279525
2019-12-23T09:30:00-05:00,321.59,321.65,321.06,321.22,53015641,62883273.65,74.2964835557236,67.06554474175914,NaN,NaN,124.79913468095273,146.73739175190602,0.3261095683238695,3.3060886901562867,2.979979121832417,9980503968,9983899023.6,89.29976130182298,74.41029371734713,NaN,NaN,39.8010512606531,34.21277506820351
2019-12-24T09:30:00-05:00,321.47,321.52,320.9,321.23,20270007,61458640.2,74.31530604657925,68.27017245867725,NaN,NaN,107.1026420114857,132.70690804352884,0.26418815836058007,3.3102143197831424,3.0460261614225623,10000773975,9995406186,89.60436266928735,75.98307021106655,NaN,NaN,41.01329030793182,35.184277245307555
2019-12-26T09:30:00-05:00,321.65,322.95,321.64,322.94,31024188,61123451.95,77.3674117394576,69.59573779738609,NaN,NaN,117.02748466743506,125.57300992986363,0.2928860044508821,3.412133666986165,3.1192476625352827,10031798163,10003478195,89.82321296985978,77.8966455958132,NaN,NaN,42.99697116485301,36.30037637667119
2019-12-27T09:30:00-05:00,323.74,323.8,322.28,322.86,42554820,61011534,76.90697553398856,70.4501132803212,NaN,NaN,110.29603660447368,118.13799817220233,0.26197669145333613,3.446718526851953,3.1847418353986168,9989243343,9985961555.2,85.61128543357063,79.55020617008947,NaN,NaN,44.51865966998538,37.474416847144646
2019-12-30T09:30:00-05:00,322.95,323.1,320.55,321.08,49782730,61671033.5,67.30862095661502,70.86376964761828,NaN,NaN,76.83763720072984,107.21258703301544,0.08623995682231245,3.2925417814265074,3.206301824604195,9939460613,9988356012.4,85.70992874926398,81.15100983727189,NaN,NaN,43.173429587820166,38.28856152438401
2019-12-31T09:30:00-05:00,320.53,322.13,320.15,321.86,57106998,60720882.05,69.12693972488779,71.49387696152333,NaN,NaN,66.99127419911234,95.65101493664736,-0.007882728827484087,3.19644841356984,3.204331142397324,9996567611,9991568741,85.85009735721101,82.65522550207547,NaN,NaN,42.5340606295604,38.895061396552066
2020-01-02T09:30:00-05:00,323.54,324.89,322.53,324.87,59253833,59924938.25,74.9233907338169,72.39287513743787,NaN,NaN,110.67306135719141,96.36509880578849,0.09641411365629304,3.32484878446769,3.228434670811397,10055821444,10002578234.8,86.3444134181069,84.08066999058084,NaN,NaN,43.77785338784759,39.592603109594286
2020-01-03T09:30:00-05:00,321.16,323.64,321.1,322.41,77783566,61354596.45,64.29824484669976,72.14626231599269,NaN,NaN,73.28984515820493,87.61757090394246,-0.029693308826473253,3.1913180347783054,3.2210113436047787,9978037878,9991826177.8,83.28439666754977,85.07287302983022,NaN,NaN,41.22487354397556,39.82578460022018
2020-01-06T09:30:00-05:00,320.49,323.73,320.36,323.64,55761948,62103610.4,66.83106142401883,72.05583449015656,NaN,NaN,75.68323621688202,80.69501082642412,-0.058048044904381424,3.148451287474302,3.2064993323786832,10033799826,10000737474.4,83.79692860189819,85.85955402606221,NaN,NaN,39.98549781887109,39.84860077431317
2020-01-07T09:30:00-05:00,323.02,323.54,322.24,322.73,42854811,61798512.6,63.255584261161864,71.44312445335943,NaN,NaN,78.16358235948611,80.96019985817539,-0.16008438614228426,3.006393849700828,3.1664782358431123,9990945015,10011034354.8,84.39243109953338,86.34207563901461,NaN,NaN,37.80537698026804,39.55671166087815
2020-01-08T09:30:00-05:00,322.94,325.78,322.67,324.45,68434153,63475004.5,66.86408167804878,71.0800488969612,NaN,NaN,114.30821995739343,90.4235890098316,-0.13474869589163951,2.998042365978563,3.1327910618702024,10059379168,10023596666.2,85.11136615553724,86.53044520312176,NaN,NaN,37.14061135383923,39.211554474158305
2020-01-09T09:30:00-05:00,326.16,326.73,325.52,326.65,48569601,63248026.3,70.81240157379696,70.99651231911075,NaN,NaN,170.19891566245718,102.32875987088474,0.00003277550880920188,3.132832031256214,3.132799255747405,10107948769,10034022131.2,85.70007260762344,86.52708099137433,NaN,NaN,37.91896000217887,39.026898121018384
2020-01-10T09:30:00-05:00,327.2899,327.46,325.2,325.71,53057389,63224823.25,67.13169826752011,70.48914785296697,NaN,NaN,156.18204353239355,118.90719954572246,-0.004040264319261411,3.127748925348328,3.1317891896675896,10054891380,10049392831.6,86.5448007915617,86.41790203586177,NaN,NaN,37.32489453011373,38.783754750889145
2020-01-13T09:30:00-05:00,326.39,327.96,325.92,327.95,47262010,60758633.65,71.00003136844556,70.31701655076861,NaN,NaN,176.10787427452158,138.9921271572504,0.10801827327154268,3.266812031257018,3.1587937579854755,10102153390,10063063544.4,87.26533226448359,86.30988500623644,NaN,NaN,38.13191855377704,38.690635294158845
2020-01-14T09:30:00-05:00,327.47,328.62,326.844,327.45,63036384,59833128.5,69.04661133496768,69.94202567785747,NaN,NaN,166.38920020558064,156.6372507264693,0.11188494568243845,3.2986499400885236,3.186764994406085,10039117006,10072697942.6,87.76268782599026,86.20009404367696,NaN,NaN,38.13708413217067,38.61155655673196
2020-01-15T09:30:00-05:00,327.35,329.02,327.26,328.19,72056598,59294152,70.34693964267123,69.6585709347212,NaN,NaN,153.1752497684804,164.4106566886867,0.12661525037682786,3.34503405737712,3.218418807000292,10111173604,10083056829.8,88.29214389606635,86.10636413130405,NaN,NaN,38.547202977394804,38.602363188255225
2020-01-16T09:30:00-05:00,329.7,330.92,329.45,330.92,54050328,58940079.95,74.58820771820854,69.46005636177482,NaN,NaN,181.56389677975037,166.6836529121453,0.2740910516402195,3.5610326215505665,3.286941569910347,10165223932,10094511862.4,88.86582411986541,86.0379792134473,NaN,NaN,40.330988709683794,38.84930969131645
2020-01-17T09:30:00-05:00,331.7,332.18,330.8539,331.95,95846017,61322383.05,75.98389474388378,69.39412201962448,NaN,NaN,178.43338424805822,171.13392105527822,0.3879234958112816,3.7718459396744493,3.3839224438631677,10261069949,10135747576.2,90.64320838406488,86.39740228133974,NaN,NaN,42.237950762221494,39.33340127287431
2020-01-21T09:30:00-05:00,330.9,332.18,330.82,331.3,77742415,60940082.6,73.2497608965148,69.81848915818875,NaN,NaN,145.13902303870304,164.94015080811454,0.3666038193849226,3.842177218094321,3.475573398709398,10183327534,10151982405,91.23636120825313,86.79214745698182,NaN,NaN,42.93037402400185,39.84725452303539
2020-01-22T09:30:00-05:00,332.24,332.95,331.17,331.34,48914899,55918916.8,73.31339981462807,70.11752202174164,NaN,NaN,132.7621126197817,158.21473329095474,0.30488964854057654,3.856685459385119,3.5517958108445424,10232242433,10190607490.4,92.4608830795371,87.26434643714796,NaN,NaN,43.50138354608453,40.36927295489955
2020-01-23T09:30:00-05:00,330.63,332.1682,329.41,331.72,52004140,55868341.75,73.9474927772028,70.04781502484063,NaN,NaN,105.1144343654878,148.60257021035622,0.2420952504961602,3.8544148739647426,3.6123196234685824,10284246573,10225222084.2,93.35673844532263,87.76522679623481,NaN,NaN,44.1532978007474,40.90984793287782
2020-01-24T09:30:00-05:00,332.44,332.53,327.36,328.77,87578442,59233763.5,61.692450633926605,69.86168686678539,NaN,NaN,66.99274768157943,125.68834039072203,-0.031149031481029432,3.5733833341172954,3.604532365598325,10196668131,10231510924,93.50768152677902,88.4954614290369,NaN,NaN,40.9341972871798,40.91332641206382
2020-01-27T09:30:00-05:00,323.03,325.12,322.66,323.5,84062463,61885677.25,46.7780253467035,68.42932714697716,NaN,NaN,-54.789834974204986,79.04369654626939,-0.5699612919529793,2.892080750657101,3.46204204261008,10112605668,10201818067.8,83.82348289280246,88.49735816410147,NaN,NaN,32.19480608908195,39.66782350878069
2020-01-28T09:30:00-05:00,325.06,327.85,323.6038,326.89,63833953,62949633.9,54.412724143801455,67.79769428145143,NaN,NaN,-9.037200074067258,48.20845192371534,-0.6930209616630925,2.5957658405312145,3.288786802194307,10176439621,10200440485.2,83.39197275390386,88.42589685369937,NaN,NaN,27.691783874779645,37.9569607039234
2020-01-29T09:30:00-05:00,328.38,328.63,326.4,326.62,54040889,63162541.85,53.75136227917004,66.8610714672458,NaN,NaN,9.662714345038522,23.58857226876671,-0.7810370853344564,2.3124904455262367,3.093527530860693,10122398732,10178471745,76.61821702144579,87.81924334412143,NaN,NaN,24.104029960601782,35.9779705977346
2020-01-30T09:30:00-05:00,324.36,327.91,323.54,327.68,75491844,64081784.15,56.01184509623863,65.80388886170593,NaN,NaN,-17.65933690023284,-0.9661819843774104,-0.7558170082298679,2.148756270573358,2.904573278803226,10197890576,10161200545.6,71.68813022154836,86.81839031654464,NaN,NaN,22.010475960959607,33.98261422105246
2020-01-31T09:30:00-05:00,327,327.17,320.73,321.73,113845576,66811371.3,43.237046340161534,64.09712800975174,NaN,NaN,-96.95432841574083,-33.75559720384147,-1.1065839158587432,1.5213433839797972,2.6279272998385403,10084045000,10138675919.4,65.7463830561062,85.3327890497264,NaN,NaN,15.096254789895,31.28456287374425
2020-02-03T09:30:00-05:00,323.35,326.16,323.22,324.12,69242293,66384307.65,48.334362798156356,62.47815168330251,NaN,NaN,-69.58355444890478,-36.71434109878142,-1.1398629557050022,1.2030986052072876,2.34296156091229,10153287293,10146812244.4,66.81629292672174,83.8721433827434,NaN,NaN,11.535239911658646,28.463231022017734
2020-02-04T09:30:00-05:00,328.07,330.01,327.72,329.06,62573190,66724869.75,56.94134330340659,61.613489681048144,NaN,NaN,41.8420602000314,-26.538489043961693,-0.8070691875457809,1.3341250764800634,2.1411942640258443,10215860483,10154696416.8,67.86377856325379,82.45079272111937,NaN,NaN,11.907603220133847,26.09814133603432
2020-02-05T09:30:00-05:00,332.27,333.09,330.67,332.86,65951146,67879686.5,62.162986688621665,61.02892161290175,NaN,NaN,118.77523578711546,-4.715984755546302,-0.3331863374005044,1.7247113422752136,2.057897679675718,10281811629,10186578996.2,71.74761012958345,81.26904030922775,NaN,NaN,14.29175544663505,24.411514780405852
2020-02-06T09:30:00-05:00,333.91,334.19,332.8,333.98,50359688,66975963.25,63.565411882021586,60.24157905317411,NaN,NaN,138.49892525853107,26.515667676206483,0.034014753953204746,2.100416122117224,2.066401368164019,10332171317,10213435144.4,74.53897389341114,80.24569386448101,NaN,NaN,16.594688167449164,23.294825264269182
2020-02-07T09:30:00-05:00,332.82,333.9941,331.6,332.2,64139443,67754455.35,59.77350024565693,59.08369373187219,NaN,NaN,98.33400818030181,65.57333499541501,0.12995174610977367,2.228841050801236,2.0988893046914625,10268031874,10250232519.2,77.77857114311011,79.32679120441279,NaN,NaN,17.06915195394175,22.405443362793836
2020-02-10T09:30:00-05:00,331.23,334.75,331.19,334.68,42070006,67205086.2,63.078231862933876,58.35715594375927,NaN,NaN,108.990480267333,101.28814193866256,0.3224035420385851,2.5018937322396937,2.1794901902011086,10310101880,10281595436.6,80.10238072169625,78.53150688394445,NaN,NaN,18.611326315558696,21.863426641760245
2020-02-11T09:30:00-05:00,336.16,337.02,334.684,335.26,54864533,67585212.35,63.82669959512892,57.67953449950932,NaN,NaN,140.07643859059007,120.9350176167743,0.44327192187386055,2.733580092543434,2.2903081706695736,10364966413,10311416622.6,82.02698975153575,77.7862287890872,NaN,NaN,20.054309868064284,21.60498138837511
2020-02-12T09:30:00-05:00,336.83,337.65,336.43,337.42,43992662,66633026.25,66.5465322000503,57.15089445828415,NaN,NaN,151.34603917370706,127.44917829409262,0.6127586855637577,3.056256527624271,2.443497842060513,10408959075,10336846111.8,83.49321689640504,77.0816915355931,NaN,NaN,22.14235132739137,21.681748522520287
2020-02-13T09:30:00-05:00,335.8621,338.12,335.56,337.06,54501922,65755292.45,65.66041514001608,57.43432049443339,NaN,NaN,129.872336922708,125.72386062692802,0.6416166203295428,3.2455186174724417,2.603901997142899,10354457153,10341303279,83.7435465003967,76.38425331942292,NaN,NaN,23.528549891196572,21.94557728947404
2020-02-14T09:30:00-05:00,337.51,337.73,336.2,337.6,64582210,66281886.55,66.38350788511737,58.8347121043201,NaN,NaN,118.81975173036582,129.8210093369408,0.6367918723054911,3.3998918375247626,2.7630999652192716,10419039363,10371504776.8,85.36329412759657,76.49423983619394,NaN,NaN,24.869117112499282,22.363225835620504
2020-02-18T09:30:00-05:00,336.51,337.6677,335.21,336.73,57342526,64356712,64.04367217075131,59.52263696338794,NaN,NaN,97.27561070379403,127.47803542423303,0.5196741090450447,3.4126926015255776,2.893018492480533,10361696837,10381823768.2,85.88092623385101,76.67202222761874,NaN,NaN,25.326842099772463,22.78659958764221
2020-02-19T09:30:00-05:00,337.79,339.08,337.48,338.34,48814692,62910325.85,66.40365329208636,60.42637203573911,NaN,NaN,113.3116089663607,122.12506949938714,0.4953961298437459,3.5122636547852153,3.0168675249414694,10410511529,10390932791.4,86.34016910557808,77.36644737648533,NaN,NaN,26.397957002245974,23.302507789728462
2020-02-20T09:30:00-05:00,337.7423,338.64,333.6817,336.95,74163362,64172749,62.58444611322069,60.89584353695211,NaN,NaN,75.33712510376452,106.92328668539862,0.3379989210311507,3.4393661762304077,3.101367255199257,10336348167,10376410609.8,81.77355978011617,78.0868352020973,NaN,NaN,26.230440295433784,23.72078386197208
2020-02-21T09:30:00-05:00,335.47,335.81,332.58,333.48,113788208,67261952.4,54.20325121958781,61.67914388548256,NaN,NaN,34.46433055912423,87.84168541268188,-0.028094928833212407,3.0662485941577415,3.094343522990954,10222559959,10350031171,74.10607139299452,78.68395579758933,NaN,NaN,23.513044299025314,23.691106781551113
2020-02-24T09:30:00-05:00,323.14,325.85,321.24,322.42,161088409,70937450.75,37.13380814635929,60.87910426749705,NaN,NaN,-114.64640942991616,41.148453180625495,-0.9901165799818727,1.856697798013613,2.8468143779954858,10061471550,10278517608.4,58.17963071089833,78.06705135360195,NaN,NaN,13.828438029970266,22.28215410275385
2020-02-25T09:30:00-05:00,323.94,324.61,311.69,312.65,218913168,77679986,28.573618649630546,58.852838220798766,NaN,NaN,-187.6799798260815,-15.842664925349613,-2.190642005026439,0.10851187171243737,2.299153876738876,9842558382,10174689917.4,43.54674194834578,76.33012016682281,NaN,NaN,1.3827328420647218,19.296522494083973
2020-02-26T09:30:00-05:00,314.18,318.11,310.7,311.5,194773819,84226979.3,27.76236201331929,56.39565074399145,NaN,NaN,-188.84745611443037,-76.27447794150783,-2.922622270048878,-1.3541239608222213,1.5684983092266567,9647784563,10022144524.2,31.150404590435215,73.43031977116937,NaN,NaN,-7.784878988139403,15.427750853766348
2020-02-27T09:30:00-05:00,305.46,311.5637,297.51,297.51,284353460,95742607.85,20.23553080744685,53.30065923866469,NaN,NaN,-240.00968647440686,-139.34384025714212,-4.135313447044759,-3.6006434995792915,0.534669947465467,9363431103,9827561111.4,22.393493027581172,69.70564256646723,NaN,NaN,-19.761632377405814,10.400696106456039
2020-02-28T09:30:00-05:00,288.7,297.892,285.54,296.26,385764020,111256216.65,19.721057386883018,50.43977046303798,NaN,NaN,-237.34720416847375,-193.70614720266173,-4.763271382501654,-5.4194192806616,-0.6561478981599465,8977667083,9578582536.2,16.14094460824124,65.30295495683374,NaN,NaN,-28.262267206685454,4.877415633150112
2020-03-02T09:30:00-05:00,298.21,309.16,294.46,309.09,238703625,117499119.1,37.332408388006016,48.600783071971705,NaN,NaN,-136.8828062339229,-198.15342656346306,-4.08240209215513,-5.759150513353859,-1.6767484211987291,9216370708,9409562367.8,13.404707127357455,60.53883541438097,NaN,NaN,-27.758741993325415,0.21510740079646506
2020-03-03T09:30:00-05:00,309.5,313.84,297.57,300.24,300139150,129043961.95,32.10108012565517,46.334667395580716,NaN,NaN,-118.12443463696833,-184.24231752564043,-3.9911398775690103,-6.665673268159992,-2.6745333905909816,8916231558,9224297003,11.169580672686692,55.47759190874889,NaN,NaN,-29.664474728473312,-4.05340433195636
2020-03-04T09:30:00-05:00,306.12,313.1,303.33,312.86,176613448,134745974.85,44.124958870463765,44.73312644346739,NaN,NaN,-75.71617804986012,-161.61606191272637,-2.8949542143037763,-6.293226158470702,-3.398271944166926,9092845006,9113309091.6,10.084718254111195,50.234127720013625,NaN,NaN,-25.70201298500529,-7.146062710963349
2020-03-05T09:30:00-05:00,304.98,308.47,300.01,302.46,186366809,140766758,38.13213502362525,42.76682072086805,NaN,NaN,-93.92133239692872,-132.39839109723073,-2.6888503006773217,-6.759334820013578,-4.070484519336256,8906478197,9021918510.4,9.285011633233367,44.915660943787664,NaN,NaN,-25.346255306180833,-9.746090224565847
2020-03-06T09:30:00-05:00,293.15,298.78,290.23,297.46,228667168,149682132,35.62691020109047,40.569920886294696,NaN,NaN,-115.38783008018582,-108.00651627957313,-2.700692873349242,-7.446350611022808,-4.745657737673566,8677811029,8961947299.6,8.79229713667651,39.44630401586481,NaN,NaN,-26.123837786749775,-12.08576844773498
2020-03-09T09:30:00-04:00,275.3,284.19,273.45,274.23,309417350,161946027.35,26.81305713114365,37.91059124060843,NaN,NaN,-166.49527480640478,-113.92900999406952,-4.005759860123147,-9.7528575628275,-5.7470977027043535,8368393679,8792351893.8,7.569059689698008,33.852599262711024,NaN,NaN,-30.881089847536035,-14.770814361992272
2020-03-10T09:30:00-04:00,284.64,288.52,273.5,288.42,276444060,173664730.05,37.056712085458614,35.814381154420744,NaN,NaN,-125.35975964670973,-115.37607499601779,-3.6557941707081785,-10.316840416089576,-6.661046245381398,8644837739,8738073130,7.22271431192128,28.20135249173554,NaN,NaN,-29.80901974977884,-16.91912941739035
2020-03-11T09:30:00-04:00,280.7,281.94,270.88,274.36,256416563,183742331.55,32.24141547597195,33.64702182318869,NaN,NaN,-137.56796780460638,-127.74643294696708,-4.081348551341979,-11.762731934558872,-7.681383383216892,8388421176,8597188364,6.403656989578224,22.817788006697118,NaN,NaN,-31.132640090420495,-18.949630942108943
2020-03-12T09:30:00-04:00,256,266.66,247.68,248.11,392220670,201153731.95,25.562716924846868,31.60126937356434,NaN,NaN,-187.3632250328651,-146.43481147415432,-5.7393107267506736,-14.855521791655235,-9.116211064904562,7996200506,8415132825.8,5.530829051806762,17.919556410897986,NaN,NaN,-35.3489779460541,-21.292394799815394
2020-03-13T09:30:00-04:00,263.09,271.4754,248.5237,269.32,329566100,214906940.85,36.930885813860066,31.586774921242966,NaN,NaN,-140.32014436241016,-151.4212743305992,-5.04094174045432,-15.417388240472462,-10.376446500018142,8325766606,8344723941.2,5.233717778282809,14.13770548713974,NaN,NaN,-33.25544918960576,-23.001402569785448
2020-03-16T09:30:00-04:00,241.18,256.9,237.36,239.85,297240030,226539831.85,30.061282500389737,31.69303662486862,NaN,NaN,-171.71458936741914,-152.4651372428021,-6.125069564358572,-18.032783455466358,-11.907713891107786,8028526576,8276750520.6,4.9568749951669275,11.381286419055531,NaN,NaN,-34.86966928522861,-24.696869243420185
2020-03-17T09:30:00-04:00,245.04,256.17,237.07,252.8,262070471,236776229.1,35.719689910383636,32.26141718894464,NaN,NaN,-138.12609249612157,-155.01840381268443,-5.548494512572782,-18.843332031823763,-13.294837519250981,8290597047,8205902382.2,4.679060097381324,9.490476098123107,NaN,NaN,-33.51155941141599,-25.956110695991015
2020-03-18T09:30:00-04:00,236.25,248.37,228.02,240,327597130,250715351,32.88744041267324,33.16512501788938,NaN,NaN,-143.60351972631264,-156.2255141970257,-5.591906790391006,-20.28472100723974,-14.692814216848733,7962999917,8120818130.4,4.36281772630322,8.202570719460393,NaN,NaN,-33.68707633523545,-27.06053435874022
2020-03-19T09:30:00-04:00,239.25,247.38,232.22,240.51,289322040,261473284.9,33.115001207390264,34.121835290782755,NaN,NaN,-123.07155594385863,-143.3671803792244,-5.159481179800956,-21.142165691599928,-15.982684511798972,8252321957,8172042420.6,8.377711134212063,7.648054042744026,NaN,NaN,-33.72716647118853,-28.012910374804264
2020-03-20T09:30:00-04:00,242.53,244.47,228.5,228.8,347158790,273141814,30.553328881898665,33.6376153260608,NaN,NaN,-123.78604027143739,-140.06035956102986,-5.21957041491234,-22.507147530439397,-17.287577115527057,7905163167,8087921732.8,7.798707327719043,7.247625485626999,NaN,NaN,-34.681320347018065,-28.965540370834805
2020-03-23T09:30:00-04:00,228.19,229.6833,218.26,222.95,326025170,281388652.05,29.332562771432023,33.439864086473435,NaN,NaN,-133.0574359141615,-132.32892887037835,-5.199340469956315,-23.78675270297245,-18.587412233016135,7579137997,7998044017,7.224219458472845,6.965813970326015,NaN,NaN,-35.83839614167969,-29.94737690952693
2020-03-24T09:30:00-04:00,234.42,244.1,233.8,243.15,235494475,282217717.4,38.47396913728946,33.03622196267527,NaN,NaN,-80.8459262652641,-120.87289562420688,-3.45552801501848,-22.906822251789237,-19.451294236770757,7814632472,7902851102,6.664270858439451,6.7214962992066,NaN,NaN,-33.606201380433866,-30.470066119656494
2020-03-25T09:30:00-04:00,244.87,256.35,239.75,246.79,299430255,287450539.2,39.98064454005071,33.168258356705664,NaN,NaN,-55.95387773092479,-103.34296722512929,-1.7717656300602656,-21.666001274346087,-19.89423564428582,8114062727,7933063664,9.073160696271671,6.70636408942362,NaN,NaN,-31.38007019116989,-30.600066701301266
2020-03-26T09:30:00-04:00,249.52,262.8,249.05,261.2,257632816,286114507,45.65442193197436,33.884509194625934,NaN,NaN,-25.37859763633508,-83.80437556362459,0.4774473794714318,-19.297426419946532,-19.774873799417964,8371695543,7956938381.2,11.027324787911624,6.8660089216546965,NaN,NaN,-27.611236202656926,-30.173090915780644
2020-03-27T09:30:00-04:00,253.27,260.81,251.05,253.42,224341217,278043366.85,43.275795063902386,35.06041904696584,NaN,NaN,-28.531796912487636,-64.75352689183464,1.5459642640094131,-17.842418469406198,-19.38838273341561,8147354326,8005376613,15.017861564362391,7.398066198416438,NaN,NaN,-25.323019116805987,-29.480223515927122
2020-03-30T09:30:00-04:00,255.7,262.43,253.53,261.65,170961866,274656278.9,46.45395530123195,35.73165070523537,NaN,NaN,-11.467030888567107,-40.43544588671577,2.8366275030051966,-15.842598354659117,-18.679225857664314,8318316192,8153212252,25.936192380444368,8.734743203310945,NaN,NaN,-22.439612260877993,-28.47442190806296
2020-03-31T09:30:00-04:00,260.56,263.33,256.22,257.75,194881060,269393374.4,45.16262886701421,36.65459451888125,NaN,NaN,-5.327327282617325,-25.331726090186425,3.418295563598651,-14.406356403166,-17.82465196676465,8123435132,8214972784,29.983318036117254,10.419004706635162,NaN,NaN,-20.49530713842998,-27.334548369543963
2020-04-01T09:30:00-04:00,247.98,257.6591,243.9,246.15,189554623,270040433.15,41.47007975836596,37.790834721275466,NaN,NaN,-35.33895703698238,-21.20874195139794,3.0259001825558833,-14.042276738569797,-17.06817692112568,7933880509,8178936340.4,28.987972056354508,12.094514921245716,NaN,NaN,-19.945031257609223,-26.278903067839
2020-04-02T09:30:00-04:00,245.19,252.68,244.59,251.83,177660430,269605114.2,43.88925928151192,38.28786139753631,NaN,NaN,-25.91101091251683,-21.31522460663428,3.139423313493669,-13.143897779258594,-16.283321092752264,8111540939,8126905419.6,27.565123777059,13.689615349729731,NaN,NaN,-18.773252796372674,-25.206667314772382
2020-04-03T09:30:00-04:00,250.76,253.32,245.22,248.19,135561171,264949814.35,42.67203324460713,39.18862930783756,NaN,NaN,-21.47046712805195,-19.902958649747152,2.9621592888065855,-12.58062198174403,-15.542781270550616,7975979768,8092630508,26.63757871017374,15.238237043658787,NaN,NaN,-18.153945112193647,-24.199135571546847
2020-04-06T09:30:00-04:00,257.84,267,248.1698,264.86,188061238,258882008.75,49.56999654784236,40.17793692479889,NaN,NaN,54.25302972382459,-6.758946527268812,3.9013133734805674,-10.666139553699907,-14.567452927180474,8164041006,8061775470.8,25.796061708764867,16.746594301614753,NaN,NaN,-15.508310020764679,-22.95758906429225
2020-04-07T09:30:00-04:00,274.21,275.03,264.89,265.13,201427189,255131165.2,49.67561642359456,41.37709235415041,NaN,NaN,123.33991119913583,18.97450116908182,4.435483122549538,-9.023099023993552,-13.45858214654309,8365468195,8110182083.4,29.555956779994318,18.546104234021264,NaN,NaN,-13.352606130347072,-21.585448645157225
2020-04-08T09:30:00-04:00,267.96,276,265.2542,274.03,153774487,249999061.4,53.15819707478455,42.80874920182144,NaN,NaN,152.3787729889521,56.518047174268716,5.228451550495979,-6.923017708423117,-12.151469258919096,8519242682,8227254518,37.76876747806551,20.645465401439367,NaN,NaN,-10.481943177796634,-19.999233578391426
2020-04-09T09:30:00-04:00,277.58,281.2,275.47,278.2,190282705,239902163.15,54.73864785279896,44.53627198545718,NaN,NaN,166.84231698195075,95.06871275316223,5.828287012739954,-4.866110492994153,-10.694397505734107,8709525387,8346851407.6,44.843270885166646,23.291505655542768,NaN,NaN,-7.629715312282951,-18.23215954037593
2020-04-13T09:30:00-04:00,277.14,277.51,271.41,275.66,115139268,229180821.55,53.55337973856837,46.26633034025263,NaN,NaN,133.259949433758,126.01479606552422,5.8341257383171445,-3.401740332837676,-9.23586607115482,8594386119,8470532677.8,51.041712453294586,26.42132658374432,NaN,NaN,-5.563535280687357,-16.422356074706133
2020-04-14T09:30:00-04:00,280.98,284.9,275.5106,283.79,134143350,221025987.55,56.77931532035105,47.57385506761417,NaN,NaN,147.3941794512052,144.64302601100036,6.134990061592501,-1.5671284941641943,-7.702118555756695,8728529469,8583430370.4,55.91215769318089,29.939032786225848,NaN,NaN,-2.8549855388117216,-14.484160283864075
2020-04-15T09:30:00-04:00,277.57,279.26,275.46,277.76,121775006,214011214.3,53.79493341971186,48.56058998758997,NaN,NaN,111.02614478143316,142.1802727274598,5.687357905939255,-0.592921173332627,-6.280279079271882,8606754463,8631687624,57.842692052693465,33.42257074025598,NaN,NaN,-1.3351214733490677,-12.605726168076217
2020-04-16T09:30:00-04:00,279.15,280.03,275.76,279.1,131798325,204221274.05,54.36891402839008,49.18305370876252,NaN,NaN,104.34631667081825,132.57378146383303,5.251421818590759,0.28399819396656767,-4.967423624624192,8738552788,8675549645.2,59.57536088938125,36.890287604646666,NaN,NaN,0.0866654289984042,-10.792527368494127
2020-04-17T09:30:00-04:00,285.38,287.3,282.4,286.64,146684784,197089411.25,57.56338937529598,50.20359615957635,NaN,NaN,124.8770621957253,124.18073050658795,5.229369553405697,1.56928831713293,-3.6600812362727675,8885237572,8710692082.2,60.959827049514935,40.17185656787184,NaN,NaN,2.209797441996826,-8.93505239556685
2020-04-20T09:30:00-04:00,282.61,286.7912,281.35,281.59,100224647,184742704.1,54.79647285432792,50.799490270511775,NaN,NaN,101.17948385145819,117.76463739012797,4.652504487402013,2.155549372979749,-2.4969551144222644,8785012925,8748817443.4,62.46184755774789,42.78083193767924,NaN,NaN,3.3020411130951777,-7.186896180043703
2020-04-21T09:30:00-04:00,276.73,278.04,272.02,273.04,126385698,174760730.5,50.38101230917797,51.17223194495204,NaN,NaN,50.53099553004962,98.39200060589687,3.524167904146021,1.9082547657602618,-1.6159131383857592,8658627227,8734836995,61.52704052128921,45.03395497233438,NaN,NaN,3.047775058847986,-5.724800288773461
2020-04-22T09:30:00-04:00,278.35,281,276.91,279.1,93524584,167662235.95,53.25602794058161,52.014085386538866,NaN,NaN,69.23822870426788,90.03441739046382,3.0336727026936576,2.1761777399813127,-0.8574949627123448,8752151811,8763916464.6,62.77497617952931,47.44731240970401,NaN,NaN,3.6202578740090336,-4.389791979804533
2020-04-23T09:30:00-04:00,280.49,283.94,278.75,279.08,104709693,157926207.85,53.24506281249502,52.68235706732337,NaN,NaN,72.56868078589031,83.67889021347824,2.5737509415301307,2.3596937142003185,-0.21405722732981214,8647442118,8745694330.6,61.430303143852974,49.86625379304644,NaN,NaN,4.090119268275213,-3.1783760872217126
2020-04-24T09:30:00-04:00,280.73,283.7,278.5,282.97,85165953,149302864.7,55.178096926565125,53.57564733032037,NaN,NaN,73.01662338444142,73.30680245122146,2.4007628456535213,2.7868963297370897,0.3861334840835683,8732608071,8715168430.4,59.144704684302276,52.188191362627045,NaN,NaN,5.003524570919767,-2.009533136058644
2020-04-27T09:30:00-04:00,285.12,288.27,284.62,287.05,77896608,141980634.25,57.17784727795453,54.1190652396141,NaN,NaN,96.77238629121726,72.42538293917329,2.423341066160825,3.4153098167845997,0.9919687506237745,8810504679,8720266781.2,59.41629537680504,54.58963662462992,NaN,NaN,6.3224185268420925,-0.8192543270728245
2020-04-28T09:30:00-04:00,291.02,291.4,285.4,285.73,105283871,138696734.5,56.302636468076145,54.59242381421992,NaN,NaN,95.68486855429722,81.45615754402282,2.217174208303989,3.7634365110037606,1.5462623026997717,8705220808,8729585497.4,59.94047886479125,56.75995963068684,NaN,NaN,7.219782424998577,0.3291794946516613
2020-04-29T09:30:00-04:00,291.53,294.88,290.41,293.21,118745579,134889960.45,60.03573185503191,55.083676298523315,NaN,NaN,123.50409598576577,92.30933100032239,2.4349840273070424,4.589992336833575,2.1550083095265324,8823966387,8743948412.6,60.78128562550833,58.40371092693276,NaN,NaN,9.025413128436732,1.5714985851923855
2020-04-30T09:30:00-04:00,291.71,293.3239,288.59,290.48,122901701,131557314.35,58.08532155066296,55.322724419799314,NaN,NaN,107.88312156943883,99.37221915703209,2.2499880942236734,4.967493427306124,2.7175053330824506,8701064686,8754672926.2,61.4322164149172,59.58863560762922,NaN,NaN,10.065990895945868,2.784997486728597
2020-05-01T09:30:00-04:00,285.31,290.6572,281.52,282.79,125180028,128933294.25,52.874449511514385,55.274229403581174,NaN,NaN,61.186628045867515,97.0062200893173,1.5005553213521061,4.593199484772583,3.092644163420477,8575884658,8723328243.6,58.38226209227206,60.1129605818419,NaN,NaN,9.579985459072958,3.7557100542063626
2020-05-04T09:30:00-04:00,280.74,283.9,279.13,283.57,80873213,126198896.35,53.33176752626219,55.02797598971768,NaN,NaN,25.623098010030688,82.77636243307998,0.9737465200199806,4.309827313445453,3.3360807934254724,8656757871,8692578882,55.47266348613438,60.08156813848143,NaN,NaN,9.292095724106721,4.546622292763557
2020-05-05T09:30:00-04:00,286.64,289.25,283.7134,286.19,79569938,120774331.35,54.91443881856312,55.1079406610642,NaN,NaN,69.37115232385094,77.51361918699072,0.7292954351185541,4.247700087323665,3.5184046522051107,8736327809,8698800282.2,55.95099062945235,59.94644660824992,NaN,NaN,9.452077619484903,5.24740162515232
2020-05-06T09:30:00-04:00,288.04,288.46,283.78,284.25,73632628,114384603.3,53.46849164393396,55.04362477646019,NaN,NaN,50.59030398189583,62.93086078621674,0.381964467678241,3.995860236802912,3.613895769124671,8662695181,8666546041,52.78511978217495,59.46142938630662,NaN,NaN,9.216996712816739,5.814486637675809
2020-05-07T09:30:00-04:00,287.75,289.78,287.13,287.68,75250412,110458399.55,55.68998416704625,54.90981011872807,NaN,NaN,83.3432880563473,58.02289408359843,0.3301883266430621,4.026631177428499,3.6964428507854366,8737945593,8673922222.4,53.434028375324516,58.923872338150154,NaN,NaN,9.57781219642226,6.352104574639587
2020-05-08T09:30:00-04:00,291.09,292.95,289.86,292.44,76622128,104775370.7,58.64096024059238,55.1844163606041,NaN,NaN,124.14208995097893,70.61398646462071,0.5504993427100611,4.384567029173013,3.834067686462952,8814567721,8721658835,57.50456447400589,58.569780689311436,NaN,NaN,10.674055238168222,6.969526098000821
2020-05-11T09:30:00-04:00,290.34,294,289.88,292.5,79514231,102994118.85,58.678317134958114,55.77708099101697,NaN,NaN,119.51064572445041,89.39149600750466,0.6286025308359564,4.619820850007898,3.9912183191719413,8894081952,8769123651.2,61.14179299255189,58.54226300868735,NaN,NaN,11.606042060850362,7.6318855212650405
2020-05-12T09:30:00-04:00,293.79,294.24,286.52,286.67,95870786,101080490.65,53.61123315819163,55.80245279227483,NaN,NaN,66.56549868061735,88.83036527885794,0.23615955704385172,4.286417765476756,4.050258208432904,8798211166,8781500322.6,62.053831088215965,58.49075264502211,NaN,NaN,11.114699830788426,8.129430422625525
2020-05-13T09:30:00-04:00,286.06,287.19,278.965,281.6,144721099,102227795.3,49.599928991860686,55.54208609080094,NaN,NaN,-43.568929235181876,69.9985186354424,-0.38267695677621694,3.571912012462633,3.95458896923885,8653490067,8779659299.8,61.821392091812676,58.51868756987637,NaN,NaN,9.576448333712099,8.336147267066464
2020-05-14T09:30:00-04:00,278.95,285.11,276.37,284.97,121977890,101736773.55,52.1621023324705,55.32665790550847,NaN,NaN,-57.23295865127514,41.883269293917905,-0.5714788420677062,3.240240416654217,3.811719258721923,8775467957,8787163772.6,62.439014542921356,58.753995416920596,NaN,NaN,8.927168651884095,8.420578893468983
2020-05-15T09:30:00-04:00,282.37,286.33,281.34,286.28,111146276,99959848.15,53.15895283773903,55.03959401692165,NaN,NaN,-11.838752283288626,14.6871008470644,-0.6110079181303498,3.047959361058986,3.6589672791893357,8886614233,8801573075,63.654801505883114,59.056745854711885,NaN,NaN,8.63857312240635,8.451720926174321
2020-05-18T09:30:00-04:00,293.05,296.75,292.7,295,120320229,100964627.25,59.2466267663418,55.24987903822633,NaN,NaN,144.22463899066665,19.629899500307676,-0.08062201024883553,3.558189766378291,3.6388117766271266,9006934462,8824143577,65.53655256320951,59.456465404598895,NaN,NaN,10.104118006157988,8.687777651886273
2020-05-19T09:30:00-04:00,294.35,296.205,291.95,291.97,95189316,99404808.15,56.49888755860852,54.997247302767526,NaN,NaN,111.81234953895904,28.679269671976016,0.029498066780509813,3.675684360102764,3.646186293322254,8911745146,8846850373,67.36705661405101,59.92687761806623,NaN,NaN,10.574635423598595,8.95732876213089
2020-05-20T09:30:00-04:00,295.82,297.87,295.57,296.93,85861691,99021663.5,59.78668805232536,55.1187734814577,NaN,NaN,150.1578787127955,67.42463126157149,0.3802668883732774,4.121519903788851,3.7412530154155736,8997606837,8915673727,72.18872685187556,60.69519979213468,NaN,NaN,11.93459926512043,9.382653119700825
2020-05-21T09:30:00-04:00,296.79,297.67,293.6886,294.88,78293925,97700875.1,57.84089362543596,55.473519489594956,NaN,NaN,113.47872608528436,101.5669682088834,0.4152532711510899,4.260319604354436,3.845066333203346,8919312912,8944442718,73.92320544109896,61.80526717419374,NaN,NaN,12.52969905186791,9.832231110010408
2020-05-22T09:30:00-04:00,294.57,295.63,293.22,295.44,63958200,96640487.45,58.24071349974737,55.82415848770104,NaN,NaN,92.71447397462155,122.47761346046543,0.4160969513667303,4.365187522411759,3.9490905710450286,8983271112,8963774093.8,75.04924731458419,63.20359459051158,NaN,NaN,13.132470664813889,10.303693903553762
2020-05-26T09:30:00-04:00,301.93,302.19,298.69,299.08,88951442,97193229.15,60.84033426610995,56.24743673395438,NaN,NaN,152.0475965387021,124.04220497007252,0.5911064553978953,4.687973640292398,4.096867184894503,9072222554,8976831712.2,75.80911501449295,64.62203204658591,NaN,NaN,14.3727463344859,10.88498710797264
2020-05-27T09:30:00-04:00,302.12,303.57,296.87,303.53,104817449,97169908.05,63.80672351859082,56.985881867858446,NaN,NaN,148.61986550854309,131.40370816398934,0.9164504927650823,5.242430300850856,4.325979808085774,9177040003,9029890683.6,78.65391712376727,66.46980328527107,NaN,NaN,16.303645529160296,11.659081168142304
2020-05-28T09:30:00-04:00,304.65,306.84,302.24,302.97,90767807,95771019.45,63.158339109885915,57.519335792347,NaN,NaN,160.4551050646547,133.46315343436117,0.9971509593406633,5.572418507261602,4.575267547920939,9086272196,9047623755.4,79.52072856736295,68.33313901327382,NaN,NaN,17.738615002146897,12.527586001571532
2020-05-29T09:30:00-04:00,302.46,304.96,299.47,304.32,119265702,95589219.5,64.10528901460074,57.90964499049045,NaN,NaN,127.07683827754938,136.18277587281415,1.0399021526210088,5.8751452386972005,4.835243086076192,9205537898,9104868752.6,82.05415658069572,70.08668130660881,NaN,NaN,19.213979139019706,13.482785021206984
2020-06-01T09:30:00-04:00,303.62,306.205,303.06,305.55,56779836,92169209.9,64.98828199710206,58.360356766357874,NaN,NaN,132.48737140251933,144.13735535839373,1.0465981213902733,6.143490737814034,5.0968926164237605,9262317734,9160678077,84.11705989883987,71.72777179991509,NaN,NaN,20.70888451186966,14.515084948444509
2020-06-02T09:30:00-04:00,306.55,308.13,305.1,308.08,74267162,91838907.35,66.797526742204,59.30223487950161,NaN,NaN,139.5245281543843,141.63274168153015,1.1109219143335833,6.48554500934074,5.3746230950071565,9336584896,9213550545.4,85.78427459791142,73.42280347917904,NaN,NaN,22.500363529984828,15.655839031521698
2020-06-03T09:30:00-04:00,310.24,313.22,309.94,312.18,92567574,92488789.15,69.54417058590599,60.72682356479056,NaN,NaN,163.42653584758446,144.59407574933843,1.3056554679511994,7.006692429946156,5.701036961994957,9429152470,9263973038.8,87.1676678119056,75.23325174489996,NaN,NaN,24.86439137571935,16.97134650926422
2020-06-04T09:30:00-04:00,311.11,313,309.08,311.36,75794363,92596875.9,68.32675904919661,61.88144190169957,NaN,NaN,136.1604753841724,139.73514981324197,1.2549603195386014,7.269737361418208,6.014777041879607,9353358107,9317390221,88.44999839515154,77.0911791629164,NaN,NaN,26.54709193235111,18.339310141133776
2020-06-05T09:30:00-04:00,317.23,321.275,317.16,319.34,150524674,96360589,73.23683180003351,63.31557611329203,NaN,NaN,176.1368426813712,149.54715069400635,1.611827872061978,8.029561881957079,6.417734009895101,9503882781,9377059197.6,89.68944735754685,78.95079672374952,NaN,NaN,29.600033420866435,19.9479848953813
2020-06-08T09:30:00-04:00,320.22,323.41,319.63,323.2,73641217,96211543.45,75.23657926736236,64.45771557765065,NaN,NaN,168.30568441228007,156.7108132959585,1.938837786243015,8.84128124269887,6.902443456455854,9577523998,9440100450.4,90.81135937326488,80.75614006732492,NaN,NaN,32.845478051996636,21.79048391775492
2020-06-09T09:30:00-04:00,320.3,323.2849,319.36,320.79,77479228,96109793.3,71.63749161348193,65.53904443871303,NaN,NaN,140.08462211458863,156.82283208799933,1.825435355451818,9.184237650770626,7.358802295318808,9500044770,9472792425.2,91.33775048610553,82.46833248675739,NaN,NaN,34.536492913091834,23.611342345660194
2020-06-10T09:30:00-04:00,321.42,322.39,318.2209,319,95000766,96066292.3,68.99741298513769,66.19695336248535,NaN,NaN,116.69814030027456,147.47715297853736,1.4773421569919734,9.205479991558775,7.728137834566802,9405044004,9467970732,90.51414949968468,83.77729124731518,NaN,NaN,35.200205147484645,25.266894174492258
2020-06-11T09:30:00-04:00,311.46,312.15,300.01,300.61,209243560,99292415.35,49.01268089265277,65.56636673871512,NaN,NaN,4.961997195015469,121.23745734070596,-0.0623434282514328,7.650208549252511,7.712551977503944,9195800444,9436459199.4,85.11263882612221,84.57653648910255,NaN,NaN,28.61119295355044,25.74465114292914
2020-06-12T09:30:00-04:00,308.24,309.08,298.6,304.21,194678879,102927464.8,51.94689902807394,65.11680856216701,NaN,NaN,-5.977978366926004,84.81449313104653,-0.8646906533275756,6.631688660844475,7.49637931417205,9390479323,9413778507.8,81.34970818359551,85.02656940831764,NaN,NaN,24.389249851252888,25.55102238697539
2020-06-15T09:30:00-04:00,298.02,308.28,296.74,307.05,135782724,104159287.2,54.18676337593787,64.64155349858329,NaN,NaN,-14.871599421989268,48.179036364192676,-1.209358731107856,5.9846809002872305,7.1940396313950865,9526262047,9403526117.6,79.63577500576427,85.29990226483702,NaN,NaN,21.76401195900595,25.01002089726547
2020-06-16T09:30:00-04:00,315.48,315.64,307.67,312.96,137627502,105024650.85,58.519823526107686,64.26391778483449,NaN,NaN,51.37873075419644,30.437858092114254,-1.0504177148108402,5.881017487881536,6.931435202692376,9663889549,9436295073.4,81.01273835450438,85.46838949560394,NaN,NaN,21.002726786038924,24.43755030994739
2020-06-17T09:30:00-04:00,314.07,314.39,310.86,311.66,83398944,104435132.25,57.237421029167976,63.84099506478321,NaN,NaN,46.137975553709616,16.32582514280126,-1.0418874672631144,5.629075868613484,6.670963335876598,9580490605,9471384393.6,82.38616495352679,85.6730635231871,NaN,NaN,19.9905985917234,23.80227149305825
2020-06-18T09:30:00-04:00,310.005,312.3,309.51,311.78,80828658,104183480.6,57.33037389020917,63.35707255589809,NaN,NaN,29.91232607751876,21.31589091930192,-1.0350831903875175,5.377109347892201,6.412192538279719,9661319263,9564488157.4,85.40318496501473,85.91227983635272,NaN,NaN,19.215394271991222,23.147003318620104
2020-06-19T09:30:00-04:00,314.17,314.38,306.53,308.64,135549624,107046265.55,54.02136803308715,62.57372155846845,NaN,NaN,10.2558978317117,24.56266615902947,-1.2354038300078116,4.867937750769954,6.103341580777766,9525769639,9591546220.6,86.14589110620483,86.05719635116452,NaN,NaN,17.57274117470337,22.350680155203428
2020-06-22T09:30:00-04:00,307.99,311.05,306.75,310.62,74649389,107580825,55.75553894236255,61.78500814419407,NaN,NaN,-1.9961421300281617,27.137757617421688,-1.225483041696748,4.571487778656831,5.796970820353579,9600419028,9606377616.8,86.54986704660716,86.11188152607134,NaN,NaN,16.698424801595486,21.543215104688006
2020-06-23T09:30:00-04:00,313.49,314.5,311.6101,312.05,68471246,106556815.2,57.01647597683654,60.890172814974825,NaN,NaN,32.07682301693488,23.277376069969357,-1.1166136548861232,4.401203751745925,5.517817406632048,9668890274,9607377761.8,86.5782887700522,86.06978302308183,NaN,NaN,16.321137245370785,20.7972039819284
2020-06-24T09:30:00-04:00,309.84,310.51,302.1,304.09,132813492,107956617.35,48.6969600813874,59.488044317274166,NaN,NaN,-67.27076700340002,0.5956275585474315,-1.548135191504298,3.5826484172516757,5.130783608755974,9536076782,9598494997.2,84.86309741402245,85.81357581014403,NaN,NaN,13.41599629323249,19.74274574068613
2020-06-25T09:30:00-04:00,303.47,307.64,301.28,307.35,89467968,107891625.4,51.79897024704334,57.95676849206058,NaN,NaN,-71.22096475946903,-19.631030608850125,-1.576179516519515,3.1605592131065805,4.736738729626095,9625544750,9591340094.6,83.42938229170868,85.3664283054413,NaN,NaN,11.9015695016986,18.62257770654505
2020-06-26T09:30:00-04:00,306.16,306.39,299.42,300.05,127961017,108326391.15,45.207258183674895,55.81181698608291,NaN,NaN,-117.53071542983314,-45.188353261159094,-2.0201841100642453,2.2115085920457886,4.231692702110034,9497583733,9585702913.4,82.25035269236821,84.7549278282344,NaN,NaN,8.421787252008539,17.16532192732555
2020-06-29T09:30:00-04:00,301.41,304.61,298.93,304.46,79773260,109476062.35,49.396701703557405,54.223189135374014,NaN,NaN,-103.74014019134287,-65.53715287342203,-1.949719835424374,1.794542907829566,3.74426274325394,9577356993,9581090506.4,81.23872872576311,84.0335691310671,NaN,NaN,6.829028352780135,15.688708559533348
2020-06-30T09:30:00-04:00,303.99,310.2,303.82,308.36,113394772,111432442.85,52.83146191957942,53.068478344976995,NaN,NaN,-39.76742418194131,-79.90600231319726,-1.5885934974922629,1.7585208713886118,3.3471143688808747,9690751765,9585462804.6,81.47137249533874,83.38765648789952,NaN,NaN,6.588669547202475,14.388702986343223
2020-07-01T09:30:00-04:00,309.57,311.89,309.07,310.52,72396542,110423891.25,54.66676639980739,53.47234159548804,NaN,NaN,1.9975137732812998,-66.05234615786101,-1.171638657838384,1.8825660465828946,3.0542047044212786,9763148307,9630877109.6,83.72835505831898,83.28877907591357,NaN,NaN,6.957682310802703,13.327128604123148
2020-07-02T09:30:00-04:00,314.24,315.7,311.51,312.23,69344217,110101383.95,56.12231417708055,53.770585534702796,NaN,NaN,36.11563265082951,-44.5850266758013,-0.7675966037815991,2.0947089496942795,2.8623055534758786,9832492524,9672266664.4,85.46597081948994,83.58279783562031,NaN,NaN,7.695315503422044,12.522583875451561
2020-07-06T09:30:00-04:00,316.37,317.68,315.56,317.05,61713828,105660841.65,60.01902975448524,54.18717599031332,NaN,NaN,88.38033648707896,-3.402816292418882,-0.19260614329458647,2.6215478743576455,2.814154017652232,9894206352,9751591188.2,88.0908259177588,84.18673004361993,NaN,NaN,9.528509115929996,12.094858909805623
2020-07-07T09:30:00-04:00,315.38,317.52,313.37,313.78,82909963,106124278.95,56.36201349794503,54.03304670258741,NaN,NaN,73.010703255728,31.947352396995296,-0.05645639546759451,2.7435835233177386,2.800039918785333,9811296389,9798379067.4,89.31642006764913,84.77985016598741,NaN,NaN,9.984241975574564,11.793342204915472
2020-07-08T09:30:00-04:00,314.61,316.3,312.7,316.18,54638596,104982247.35,58.367054379641786,54.11373479904983,NaN,NaN,85.45302119378262,56.99144147214008,0.159474130055012,2.999382581354098,2.839908451299086,9865934985,9833415711.4,90.13513029037075,85.3333476900477,NaN,NaN,10.960374411541892,11.674346805862104
2020-07-09T09:30:00-04:00,316.84,317.1,310.68,314.38,83354158,104399916.95,56.278494429344676,54.038600551845214,NaN,NaN,78.82748601073979,72.35743591963178,0.1456926046356406,3.0220242070936365,2.876331602457996,9782580827,9837302215.4,90.2246190324375,85.67773583772075,NaN,NaN,11.176207877954868,11.603184101875357
2020-07-10T09:30:00-04:00,314.31,317.88,312.76,317.59,57550365,96815257.2,59.089920717661656,54.40064002931482,NaN,NaN,103.92030158864297,85.91836970719447,0.30804889909312516,3.2613927263244022,2.953343827231277,9840131192,9838829949,90.26201453432628,85.97174465401513,NaN,NaN,12.176935426849852,11.685148576871713
2020-07-13T09:30:00-04:00,320.13,322.71,314.13,314.84,102997484,92231187.45,55.780684442081935,54.402436136437636,NaN,NaN,113.8179831166268,91.00589903310404,0.19123859935006227,3.192392076418855,3.001153477068793,9737133708,9807415420.2,83.21275981930935,85.73337985206528,NaN,NaN,12.083168047945696,11.742008501310853
2020-07-14T09:30:00-04:00,313.3,319.76,312,318.92,93656951,90124898.8,59.41246191816192,54.57357798938944,NaN,NaN,100.57715871736067,96.51919012543058,0.34101424807335334,3.4274212871604846,3.086407039087131,9830790659,9811314274.2,83.38617966554993,85.50537205888656,NaN,NaN,13.068499112688942,11.931507160079152
2020-07-15T09:30:00-04:00,322.41,323.04,319.265,321.85,87196524,87603349.9,61.83654258585203,55.51211959685121,NaN,NaN,155.1460223355209,110.45779035377822,0.5758617638268815,3.8062342438707333,3.230372480043852,9917987183,9821724713.8,83.86546348407772,85.43411249246195,NaN,NaN,14.622955592883194,12.315999793336871
2020-07-16T09:30:00-04:00,319.79,321.28,319.09,320.79,54622520,86164528.7,60.43038925825892,56.12864952622375,NaN,NaN,121.91951980425921,119.07619711248212,0.5957745987990188,3.975090728542625,3.3793161297436063,9863364663,9837881481,84.60762588650496,85.5182727492331,NaN,NaN,15.515246392155857,12.773035021739584
2020-07-17T09:30:00-04:00,321.88,322.57,319.735,321.72,62774911,85261841.35,61.2626870428065,57.275465873304576,NaN,NaN,120.22112806181593,122.33636240711671,0.6055659362941532,4.136273550111298,3.5307076138171447,9926139574,9855083157.4,85.37875617900121,85.74173014113546,NaN,NaN,16.490355434304142,13.304080794963093
2020-07-20T09:30:00-04:00,321.43,325.13,320.62,324.32,56308749,81299797.6,63.569723766348254,58.28782459207535,NaN,NaN,131.3731966728225,125.84740511835585,0.7136953284790577,4.422826774415967,3.709131445936909,9982448323,9904146080.4,87.32865546989945,86.17672490857377,NaN,NaN,17.979035178299476,13.971931421154006
2020-07-21T09:30:00-04:00,326.45,326.93,323.94,325.01,57498967,80442276.5,64.17942627103184,59.09839347432198,NaN,NaN,139.4166471993747,133.61530281475865,0.7542743928940658,4.651974437054491,3.8977000441604255,10039947290,9945977406.6,88.71099981581608,86.69384114575072,NaN,NaN,19.393574950119486,14.74645192529193
2020-07-22T09:30:00-04:00,324.62,327.2,324.5,326.86,57792915,79908359.95,65.83062690515587,59.89581208184687,NaN,NaN,132.2698860012299,129.04007554790044,0.8226963450329245,4.926070475451581,4.103374130418657,10097740205,9981928011,89.74629372658609,87.1236939077698,NaN,NaN,21.065053478713747,15.649109290066475
2020-07-23T09:30:00-04:00,326.47,327.23,321.48,322.96,75737989,77054584.8,59.594030629753455,60.14379182846636,NaN,NaN,97.30701316800244,124.11757422064909,0.5361562296614135,4.773569417495423,4.23741318783401,10022002216,10013655521.6,90.56836530931648,87.48815065704312,NaN,NaN,20.850387787432933,16.39214907540454
2020-07-24T09:30:00-04:00,320.95,321.99,319.246,320.88,73766597,76269516.25,56.51867715520861,59.89376664280375,NaN,NaN,54.042214789757566,110.88179156623741,0.15707981311276065,4.43376295422496,4.2766831411121995,9948235619,10018074730.6,90.68044251171129,87.67312327089688,NaN,NaN,19.808224706964136,16.88015987991305
2020-07-27T09:30:00-04:00,321.63,323.41,320.775,323.22,48292970,72286113.9,59.077230649921326,60.08771072508777,NaN,NaN,69.72150380317908,98.55145299230873,0.02159130526792019,4.303672272697099,4.282080967429179,9996528589,10020890783.8,90.75582654908352,87.77593801957076,NaN,NaN,19.6108242863799,17.2702547951226
2020-07-28T09:30:00-04:00,322.43,323.64,320.85,321.17,57494979,71172199.85,55.97002538350247,59.916494368220675,NaN,NaN,54.04062430831527,81.47624841409683,-0.2343272441296893,3.989171912267068,4.223499156396757,9939033610,10000708047.8,85.42270722801425,87.43933637225959,NaN,NaN,18.572729543309936,17.45632261629222
2020-07-29T09:30:00-04:00,322.12,325.73,322.075,325.12,48454159,67925169.2,60.30254374784513,60.20392646239928,NaN,NaN,85.74668920100618,72.17160905405208,-0.168873275115347,4.012407562502574,4.181280837617921,9987487769,9978657560.6,79.89852044216244,86.70175790152564,NaN,NaN,18.88895428403545,17.66098428311268
2020-07-30T09:30:00-04:00,321.9,324.41,319.64,323.96,61861714,67398427.8,58.48257455233704,60.160544593447526,NaN,NaN,52.644146420868275,63.23903570462526,-0.2311438085486781,3.892351076932073,4.123494885480751,9925626055,9959382328.4,75.31357274062609,85.63401205911849,NaN,NaN,18.639547550217294,17.800779035556197
2020-07-31T09:30:00-04:00,325.9,326.63,321.33,326.52,85210755,68191754.7,61.26126697653898,60.55201477448016,NaN,NaN,89.04411031063009,70.23941480879978,-0.13227672852468508,3.958148974824894,4.090425703349579,10010836810,9971902566.6,76.26627925225546,85.13783487575749,NaN,NaN,19.21253061271921,18.00245783229377
2020-08-03T09:30:00-04:00,328.32,329.62,327.73,328.79,53077948,67759960.7,63.58839592954307,60.850295775293105,NaN,NaN,152.54670898523437,86.80445584521084,0.044199873069102225,4.1456755446859574,4.101475671616855,10063914758,9985379800.4,77.28260353930726,84.70186515245446,NaN,NaN,20.37269432823447,18.341063045999586
2020-08-04T09:30:00-04:00,327.86,330.06,327.86,330.06,41917893,65710357.2,64.8602470806255,61.06627466777693,NaN,NaN,151.55601795571926,106.30753457469163,0.19615101989812622,4.346664446489513,4.150513426591386,10105832651,10018739608.6,79.61010004041472,84.39791062076425,NaN,NaN,21.709751623245566,18.82230427132044
2020-08-05T09:30:00-04:00,331.47,332.39,331.18,332.11,42866354,65121745.1,66.87178985288463,61.52637471025019,NaN,NaN,181.24081440693004,125.40635961587641,0.37409526653963354,4.618132509765928,4.244037243226295,10148699005,10050981855.8,81.57493448092127,84.18128980607969,NaN,NaN,23.434097979076267,19.481131943856987
2020-08-06T09:30:00-04:00,331.4799,334.46,331.13,334.33,43679447,63138009.55,68.94501151270583,62.07511217238586,NaN,NaN,183.28163741430365,151.5338578145635,0.5689997171905645,4.9552868897145,4.386287172523936,10192378452,10104332335.2,84.27513225449638,84.10245952575791,NaN,NaN,25.52191369534785,20.34410076549854
2020-08-07T09:30:00-04:00,333.28,334.88,332.3,334.57,57308270,63125904.8,69.16964229996775,62.47510635335868,NaN,NaN,167.55506845675683,167.23604944378886,0.6366614419621097,5.1821139749765734,4.545452533014464,10249686722,10152102317.6,86.22214809408581,84.02342328462836,NaN,NaN,27.313425277691806,21.339718552954718
2020-08-10T09:30:00-04:00,335.06,335.77,332.955,335.57,44282089,60190135.05,70.13885220807428,62.900779634576,NaN,NaN,154.641978368917,167.65510332052537,0.6680732961273224,5.3805441531736165,4.712470857046294,10293968811,10198113128.2,87.79026426714084,83.95765645972298,NaN,NaN,29.106391444626745,22.449243251765008
2020-08-11T09:30:00-04:00,336.85,337.54,332.01,332.8,69600882,58987331.6,64.12527394307742,62.77896870871325,NaN,NaN,123.95541769592776,162.13498326856705,0.4330025056004194,5.253723989046819,4.820721483446399,10224367929,10221820183.8,88.51555032285573,83.8697462165994,NaN,NaN,29.06576885246379,23.394461194721977
2020-08-12T09:30:00-04:00,335.44,338.28,332.8377,337.44,53826128,57318811.8,68.93066911945844,63.445871457977894,NaN,NaN,132.29023502166913,152.3448673915149,0.5151303438739365,5.46463441328882,4.949504069414884,10278194057,10247719194.2,89.26573083805054,83.77670089722325,NaN,NaN,30.448135518409124,24.402128955248713
2020-08-13T09:30:00-04:00,336.61,338.2514,335.83,336.83,41816146,56678493.1,67.64777571058349,64.2408070690761,NaN,NaN,124.84160594764671,140.6568610981835,0.4555500392322882,5.518941618455244,5.063391579222956,10236377911,10256519086,89.51631205930558,83.69354872205142,NaN,NaN,31.218953505048518,25.375961033791544
2020-08-14T09:30:00-04:00,336.41,337.42,335.62,336.84,47260390,55902767.05,67.6584023121724,64.85374790209403,NaN,NaN,107.16750457811055,128.57934832245425,0.34880177485462927,5.499393797791242,5.150592022936613,10283638301,10263309401.8,89.71581227059939,83.61926198787397,NaN,NaN,31.854968477559915,26.301533525758455
2020-08-17T09:30:00-04:00,337.94,338.34,336.8517,337.91,35480974,54861378.3,68.83786948191016,65.77287962340885,NaN,NaN,108.0006256289193,119.25107777445471,0.28493720136799006,5.506763524646601,5.221826323278611,10319119275,10268339494.6,89.86960170639348,83.93689730775819,NaN,NaN,32.71616160779779,27.217908966049787
2020-08-18T09:30:00-04:00,338.34,339.1,336.61,338.64,38733908,53923125.35,69.65105885704904,66.44063070263772,NaN,NaN,100.50810731406682,114.56161569808253,0.2289517457932977,5.508016005520233,5.279064259726935,10357853183,10295036545.4,90.66729513403942,84.70609550003512,NaN,NaN,33.66528658808282,28.138962912054506
2020-08-19T09:30:00-04:00,339.05,339.61,336.62,337.23,68054244,54436191.8,66.06500379522832,66.98223279141567,NaN,NaN,87.32593357702183,105.56875540915307,0.043747990864064334,5.333749248307015,5.290001257442951,10289798939,10297357521.8,90.73559488978809,85.80766851068954,NaN,NaN,33.5478114864349,28.91165556553742
2020-08-20T09:30:00-04:00,335.36,338.8,335.22,338.28,42207826,52759683.65,67.4106169948391,67.4214720784371,NaN,NaN,76.26065431968003,95.85256508355972,-0.05584686138704331,5.220192680709147,5.27603954209619,10332006765,10316483292.6,91.30057733762632,86.88154694535889,NaN,NaN,33.79635515982499,29.609469793292785
2020-08-21T09:30:00-04:00,337.92,339.72,337.55,339.48,55106628,51826685.2,68.9270777060336,67.80280649104357,NaN,NaN,89.66507963143563,92.35208009422476,-0.08686284936546063,5.1674609803893645,5.254323829754825,10387113393,10337178311,91.877774285557,87.92405914151959,NaN,NaN,34.410249900269896,30.295295522860943
2020-08-24T09:30:00-04:00,342.12,343,339.4504,342.92,48588662,51841469.8,72.83013074599346,68.3720838957127,NaN,NaN,121.62835515009209,95.07762599845931,0.06988052048594628,5.341674480362258,5.2717939598763115,10435702055,10360494867,92.48292783288329,88.84354684098162,NaN,NaN,36.08909248860658,31.12298080368175
2020-08-25T09:30:00-04:00,343.53,344.21,342.27,344.12,38463381,50889889.9,74.0544447316196,68.8851306727652,NaN,NaN,141.43716072111494,103.26343667986889,0.19298023307503165,5.513019251220101,5.320039018145069,10474165436,10383757317.6,93.04007607688175,89.66248552640738,NaN,NaN,37.867854083220806,32.08653412933018
2020-08-26T09:30:00-04:00,344.76,347.86,344.17,347.57,50790237,51006693.8,77.23109843716531,69.47699402451231,NaN,NaN,171.6642006141876,120.13109008730206,0.43168956533416925,5.85965097481278,5.427961409478611,10524955673,10430788664.4,94.00717380632784,90.35763135153819,NaN,NaN,40.45036017436506,33.28136642147802
2020-08-27T09:30:00-04:00,348.51,349.9,346.53,348.33,58034142,50815315.2,77.87377636183228,70.09871788607407,NaN,NaN,186.92824566625308,142.26460835661663,0.5576938063157186,6.125078667373259,5.5673848610575405,10582989815,10480985274.4,94.83248751995824,90.97265559624337,NaN,NaN,42.777168761651446,34.63790961293137
2020-08-28T09:30:00-04:00,349.44,350.72,348.15,350.58,48588940,48984224.45,79.70056716379085,70.78169752576811,NaN,NaN,188.7665618059172,162.08490479151297,0.7002685511144424,6.442720549950593,5.742451998836151,10631578755,10529878346.8,95.48475578340616,91.52226213311947,NaN,NaN,45.35735258142311,36.169258608430184
2020-08-31T09:30:00-04:00,350.35,351.3,349.06,349.31,66099183,49635286.2,75.89181808809805,71.62216496469816,NaN,NaN,157.2797205902634,169.21517787954724,0.6195211326498749,6.516853414648494,5.89733228199862,10565479572,10555833850.2,95.78865680478192,92.04176973897134,NaN,NaN,46.42554721698589,37.634442695366715
2020-09-01T09:30:00-04:00,350.21,352.71,349.24,352.6,54999325,50289357.8,78.7278389581277,72.32196281031739,NaN,NaN,149.23612129853652,170.77496999503154,0.692629154856828,6.7631187255696545,6.070489570712827,10620478897,10585096542.4,96.10680304550078,92.53041775378922,NaN,NaN,48.25201539975615,39.15123879599378
2020-09-02T09:30:00-04:00,354.67,358.75,353.43,357.7,69540035,51623041.85,82.21960628948104,73.3628078516672,NaN,NaN,176.1191217543753,171.6659542230691,0.9722696728337237,7.285826661754982,6.313556988921258,10690018932,10618109194.2,96.43408907462062,93.02454468345458,NaN,NaN,51.10778637070838,40.85931702095301
2020-09-03T09:30:00-04:00,355.87,356.38,342.59,345.39,148011129,56839625.95,57.62986943784381,72.64648407492945,NaN,NaN,70.1174009191315,148.3037852736448,0.25342001360356115,6.630332005925709,6.376911992322148,10542007803,10609912791.8,94.31413992116445,93.35299665849494,NaN,NaN,43.75037194202414,41.27232486682031
2020-09-04T09:30:00-04:00,346.13,347.83,334.87,342.57,139156281,60932026.5,53.66995792080291,71.56306182056464,NaN,NaN,-6.79624178374843,109.19122455571164,-0.4485286235940622,5.81625121282957,6.2647798364236325,10402851522,10564167345.2,83.30675030355629,92.88422155829228,NaN,NaN,36.62447521232974,40.60834634475023
2020-09-08T09:30:00-04:00,336.71,342.64,332.88,333.21,114465322,64441188.15,43.087225807979166,69.66564517420251,NaN,NaN,-74.46661269114908,62.841957899429154,-1.5194319540382173,4.365489893875861,5.884921847914078,10288386200,10508748670.8,72.29824776159266,91.57214674597466,NaN,NaN,25.910857737823285,38.50870511518924
2020-09-09T09:30:00-04:00,337.55,342.46,336.61,339.79,91462290,65534258.55,50.47962189056732,68.55240360958388,NaN,NaN,-38.48032506997857,25.298668625726123,-1.7447337621770593,3.7040046451927537,5.448738407369813,10379848490,10460622589.4,64.34618322318593,89.68718876978879,NaN,NaN,20.596185026570513,35.94977367395799
2020-09-10T09:30:00-04:00,341.82,342.53,332.85,333.89,90569548,67371429.55,44.853805322314294,66.9412027758321,NaN,NaN,-79.05611181037321,-25.736378087223557,-2.220686068359586,2.67288082192033,4.893566890279916,10289278942,10380474591.4,53.74433303998665,87.00459989138596,NaN,NaN,14.143044280671624,32.83452661777422
2020-09-11T09:30:00-04:00,335.82,336.97,331,334.06,84680194,69514631.95,45.04385508326875,65.23525830277747,NaN,NaN,-105.29359720256438,-60.818577711562725,-2.4363564323232163,1.8481213498758962,4.2844777821991125,10373959136,10346864858,50.022304974846065,84.01492351204946,NaN,NaN,9.599050277591333,29.515172854890952
2020-09-14T09:30:00-04:00,337.49,340.38,334.2208,338.46,65605686,70431896.75,49.860252948077736,63.59455274578348,NaN,NaN,-61.02579592406868,-71.66448853962679,-2.2020796534636538,1.5318782153695452,3.733957868833199,10439564822,10354207518,50.82357147336116,81.03925520065503,NaN,NaN,7.705990266703044,26.399575342292678
2020-09-15T09:30:00-04:00,341.12,342.02,338.4683,340.17,52920862,71303891.15,51.634325833026146,61.99311568159824,NaN,NaN,-31.670727680383337,-63.10531153747364,-1.8647164289833977,1.4030623326039517,3.2677787615873495,10492485684,10395027414.8,55.130386847183125,78.33142025567656,NaN,NaN,6.852591728698481,23.607149111779222
2020-09-16T09:30:00-04:00,341.51,343.06,338.52,338.82,82211256,73477758.55,50.12640608431961,60.05706622782355,NaN,NaN,-34.572409057943005,-62.32372833506653,-1.6714577405450184,1.1784565859060763,2.8499143264510947,10410274428,10401112602.4,55.75250759593473,75.59894409779135,NaN,NaN,5.69308557095355,21.047997177375557
2020-09-17T09:30:00-04:00,333.56,337.6996,332.991,335.84,91523339,74651213.3,46.87235987111467,57.84267933562944,NaN,NaN,-91.0139866305519,-64.71530329910226,-1.678865125052615,0.7513329201353258,2.430198045187941,10318751089,10407007031.8,56.383358979341644,72.85257777346159,NaN,NaN,3.6963931839397675,18.56919660688473
2020-09-18T09:30:00-04:00,335.37,335.49,327.97,330.65,105877942,77834719.1,41.78478203659521,55.13440896940118,NaN,NaN,-133.4313858576736,-70.34286103012411,-1.948868373016482,-0.005887421082661604,1.9429809519338204,10212873147,10374789834,52.01797440429444,69.7478076749536,NaN,NaN,0.3013716747422868,15.959507330864382
2020-09-21T09:30:00-04:00,325.7,327.13,321.73,326.97,99450829,80051929.15,38.58664947445396,52.4697540684266,NaN,NaN,-180.64229198251545,-94.26616024181347,-2.2685010668476147,-0.8926453816256981,1.3758556852219166,10113422318,10309561333.2,44.50495889107456,66.08468639540307,NaN,NaN,-3.569477138918023,13.169652406609753
2020-09-22T09:30:00-04:00,328.57,330.9,325.86,330.3,63612107,80803101.4,42.849311363656284,49.90700209739293,NaN,NaN,-121.16509562543068,-112.16503383082292,-2.1499526657238865,-1.3115851469329414,0.838367518790945,10177034425,10246471081.4,38.68508060346961,61.983134792400854,NaN,NaN,-5.406014204567554,10.515985747870138
2020-09-23T09:30:00-04:00,330.9,331.2,322.1,322.64,93112240,83535544.35,36.56258933246282,46.64578660046306,NaN,NaN,-139.02102054475998,-133.0547561281863,-2.459431294679995,-2.235921599559049,0.2235096951209461,10083922185,10181200632.8,33.765602599904355,57.50681432992111,NaN,NaN,-9.194934131818345,7.700140050771783
2020-09-24T09:30:00-04:00,321.22,326.797,319.8,323.5,76681332,84830099.1,37.668305625716656,45.219960613882556,NaN,NaN,-137.4600038356763,-142.34395956921122,-2.4716335555706057,-2.866032249342311,-0.39439869377170533,10160603517,10149571118.4,31.664220954809338,53.0318201180386,NaN,NaN,-11.793934747284128,4.915272222478082
2020-09-25T09:30:00-04:00,322.58,329.58,321.64,328.73,71069426,85481863.3,44.0546215416022,44.53315087251108,NaN,NaN,-98.48867803661746,-135.355418005,-2.012352541762516,-2.9098393709748507,-0.8974868292123345,10231672943,10153331077.6,32.20436236115131,49.38164955072396,NaN,NaN,-11.925386647111367,2.509463812536733
2020-09-28T09:30:00-04:00,333.22,334.96,332.15,334.19,64584614,86281647,49.83334900148188,45.01501681490413,NaN,NaN,-31.3499184676455,-105.49694330202598,-1.2623665940141384,-2.4754450717300074,-1.213078477715869,10296257557,10189898125.4,37.387710246137814,46.88803972819147,NaN,NaN,-10.094863628200313,0.7088456067171549
2020-09-29T09:30:00-04:00,333.97,334.77,331.6209,332.37,51531594,85553267.55,48.05162866407694,44.841588727297676,NaN,NaN,-34.11441492451196,-88.08680716184224,-0.8312033320107495,-2.252082642729306,-1.4208793107185564,10244725963,10203436433,39.239903194774016,45.09473401187635,NaN,NaN,-9.194993272936873,-0.7059885189477062
2020-09-30T09:30:00-04:00,333.09,338.29,332.88,334.89,104081136,88007358.1,50.680974921828245,45.25781512726296,NaN,NaN,-1.3410361574371257,-60.550810284377675,-0.343611101970718,-1.850393188181954,-1.506782086211236,10348807099,10256413415.8,45.974794540180056,44.539766976175876,NaN,NaN,-7.630733592208702,-1.6952378151278484
2020-10-01T09:30:00-04:00,337.69,338.74,335.01,337.04,88698745,88965293.6,52.87262732948873,45.81701314485009,NaN,NaN,33.49996972655134,-26.358815571932148,0.1309599452114223,-1.3430821546969582,-1.4740420999083805,10437505844,10311793881.2,51.968462615094275,44.678778236193594,NaN,NaN,-5.670167195855566,-2.263084869517522
2020-10-02T09:30:00-04:00,331.7,337.0126,331.19,333.84,89431112,86036292.75,49.35700515025261,45.78106687357687,NaN,NaN,3.682349960652575,-5.924609972478143,0.23076878312567106,-1.1855811210012916,-1.4163499041269627,10348074732,10335074239,54.265448964642225,44.924626628427966,NaN,NaN,-5.059937566188756,-2.6626352547562697
2020-10-05T09:30:00-04:00,336.06,339.96,336.01,339.76,45713108,81364134.1,55.28106175156066,46.041548010615045,NaN,NaN,79.76616286464946,16.298606293980857,0.671942909692111,-0.5764212670118241,-1.248364176703935,10393787840,10354580295.6,56.15732837189973,44.99797959447915,NaN,NaN,-2.637607415883748,-2.6590598492030524
2020-10-06T09:30:00-04:00,339.91,342.17,334.38,334.93,90128883,80147312.15,50.128807355374974,46.04171952997615,NaN,NaN,55.79763209038822,34.28101569696089,0.6163797292696853,-0.47788951511682853,-1.0942692443865139,10303658957,10366366894.4,57.30657626961311,45.108984499741894,NaN,NaN,-2.2033064085436838,-2.5939522148231426
2020-10-07T09:30:00-04:00,338.12,341.63,338.09,340.76,56999597,78424177.5,55.51786306185595,46.65925547217196,NaN,NaN,102.8097122982583,55.111165388099984,0.9312753841715253,0.06982498582789276,-0.8614503983436326,10360658554,10368737185.4,57.547576272339654,45.192142877813176,NaN,NaN,-0.04848446999496262,-2.230313965561974
2020-10-08T09:30:00-04:00,342.85,343.85,341.86,343.78,45242476,76157823.9,58.046871852006795,47.82083331612993,NaN,NaN,136.54294077722037,75.71975959823378,1.2804099091981451,0.7390619881540488,-0.5413479210440963,10405901030,10362416222.6,56.6295285444893,45.52153960211281,NaN,NaN,2.5323453081743486,-1.549934069313928
2020-10-09T09:30:00-04:00,345.56,347.35,344.89,346.85,59528606,74900244.5,60.50509809910004,49.38643678931893,NaN,NaN,155.79692775392627,106.14267515688853,1.6329750559900533,1.4998708989434704,-0.13310415704658302,10465429636,10385887203.4,59.23033510382663,46.57335218873795,NaN,NaN,5.445800891033153,-0.5505433606929164
2020-10-12T09:30:00-04:00,349.59,354.02,349.06,352.43,80388533,75639386.85,64.56881703185304,50.93783005133299,NaN,NaN,194.46727573712062,129.08289773138276,2.1256688581739422,2.523981915670845,0.39831305749690266,10545818169,10416293269.2,62.377872747784444,48.265694484760445,NaN,NaN,9.287919076197209,0.85495127314853
2020-10-13T09:30:00-04:00,352.28,352.4651,349.09,350.13,73255513,76656119.4,61.74856567164387,52.73682836127449,NaN,NaN,157.8627541263134,149.49592213856778,2.17263674337643,3.11410898671744,0.9414722433410101,10472562656,10450074009,65.55914826395295,50.53666203219249,NaN,NaN,11.540490918317515,2.381456936744099
2020-10-14T09:30:00-04:00,350.75,351.93,347.14,347.93,57958749,75443494.05,59.089934898705245,54.26694473791654,NaN,NaN,126.38027113286704,154.21003390548952,1.939200012572258,3.3654722590563324,1.4262722464840745,10414603907,10460863079.6,66.53252387252596,53.02725509774367,NaN,NaN,12.589389716842062,3.839733048186665
2020-10-15T09:30:00-04:00,343.71,348.02,343.13,347.5,60357659,73885210.05,58.559225310344786,55.30298786425529,NaN,NaN,87.37622873317339,144.37669149668017,1.6507856758286383,3.4897543412698724,1.838968665441234,10354246248,10450532123.2,64.64841651739538,55.34468753747539,NaN,NaN,13.284234417231211,5.188947529478743
2020-10-16T09:30:00-04:00,348.96,350.75,347.1,347.29,89501868,73066406.35,58.28391172833084,55.906599487601646,NaN,NaN,94.98964388564721,132.21523472302434,1.3533090084546715,3.5306049260095733,2.177295917554902,10264744380,10410395072,57.80001500084226,56.802709305668564,NaN,NaN,13.778003449026905,6.415955517985624
2020-10-19T09:30:00-04:00,348.65,349.33,341.04,342.01,68425614,71515145.6,51.7021759101801,56.167352862323305,NaN,NaN,50.75692786694042,103.4731651489883,0.7391064457366943,3.1011789747257694,2.362072528989075,10196318766,10340495191.4,48.21985287575826,57.44413428288173,NaN,NaN,12.320514563712583,7.259463953089475
2020-10-20T09:30:00-04:00,343.46,346.88,342.64,343.38,60051880,71337134.25,53.17957700169335,56.34582443945652,NaN,NaN,46.57181403476901,81.21497713067942,0.3812866323683912,2.8386808194495643,2.457394187081173,10256370646,10297256789.4,43.425125940691245,57.26201509720395,NaN,NaN,11.515309894979671,7.867441944788075
2020-10-21T09:30:00-04:00,343.33,348.6847,342.4,342.73,63574979,69860271.2,52.3611916546876,56.309293319827866,NaN,NaN,43.52420615200272,64.64376413450654,0.07313935494601465,2.5488183807636915,2.475679025817677,10192795667,10252895141.4,39.12648160265001,56.34473073917221,NaN,NaN,10.622079504956115,8.260961596240652
2020-10-22T09:30:00-04:00,342.96,345.24,340.65,344.61,55399292,68796169.2,54.540251563122766,56.67952520646145,NaN,NaN,24.855955999461848,52.139709587764244,-0.026428559716493272,2.4426433261720604,2.4690718858885536,10248194959,10231684883.6,37.22892856352948,55.127836424807015,NaN,NaN,10.435540956103468,8.571615790506769
2020-10-23T09:30:00-04:00,345.93,345.99,343.13,345.78,49143511,67699873.45,55.892430310959156,56.72319438927563,NaN,NaN,35.99637432922082,40.341055676478966,-0.03529376131712114,2.4249546842421523,2.4602484455592735,10297338470,10238203701.6,38.220614836305835,53.84664260083603,NaN,NaN,10.633462349046907,8.866165298869646
2020-10-26T09:30:00-04:00,342.13,342.98,335.62,339.39,91473002,69044292.85,47.57016730799534,56.54043438589137,NaN,NaN,-46.85930017921282,20.81781006724832,-0.4692246278974386,1.8737176606874755,2.342942288584914,10205865468,10240113042,38.52695130470881,52.505240817628575,NaN,NaN,8.393349914138037,8.798620243907987
2020-10-27T09:30:00-04:00,339.76,340.12,337.99,338.22,65994108,69767418.55,46.21333723431642,55.875825398209976,NaN,NaN,-63.955237193515835,-1.2876001784086555,-0.812633382364202,1.3271505606296614,2.1397839429938634,10139871360,10216813184.8,36.16996128224675,50.97826831833623,NaN,NaN,6.139610368380737,8.418761690261237
2020-10-28T09:30:00-04:00,332.1,332.84,326.13,326.66,127094307,70918077.1,35.45348381236715,54.262011966807144,NaN,NaN,-199.54575065550836,-49.901591539910875,-1.742515947505994,-0.03836099138862892,1.704154956117365,10012777053,10180809462,32.827895627016815,49.27815168137391,NaN,NaN,0.199582370916277,7.2445932160691
2020-10-29T09:30:00-04:00,326.91,333.395,325.09,329.98,90596689,71012974.3,39.789363051655954,52.78231660627542,NaN,NaN,-164.97988910610914,-87.86876056102508,-2.037664570744358,-0.8429257573130826,1.1947388134312755,10103373742,10151845218.6,30.39476624243501,47.2184681912745,NaN,NaN,-3.251075074184221,5.745212031747197
2020-10-30T09:30:00-04:00,328.28,329.69,322.6,326.54,120448685,72563852.95,37.01485811190919,50.81417668342228,NaN,NaN,-184.99514200914786,-132.06706382869882,-2.3462652351708955,-1.738092730532344,0.6081725046385517,9982925057,10088962536,25.905567559066796,44.613303534937536,NaN,NaN,-7.016484442191897,3.922112535470184
2020-11-02T09:30:00-05:00,330.2,332.36,327.24,330.2,86068299,74581612.5,41.67481567310178,49.380337397812134,NaN,NaN,-124.58772472567563,-147.61274873799135,-2.188666995460192,-2.127661239686688,0.061005755773503756,10068993356,10061588113.6,24.227977774569283,41.66107707141013,NaN,NaN,-8.650962631605037,2.125958940173724
2020-11-03T09:30:00-05:00,333.69,338.25,330.2935,336.03,93294192,74739877.95,48.24353369679417,48.605594454818494,NaN,NaN,-67.9772156612192,-148.41714443153205,-1.6036531292654528,-1.9435606558083123,-0.3399075265428595,10162287548,10066071351.2,25.083636969756355,38.700442292640865,NaN,NaN,-7.868348517911854,0.6982007318757844
2020-11-04T09:30:00-05:00,340.86,347.94,339.59,343.54,126959700,78237883.1,55.23710115808599,48.36829987251429,NaN,NaN,24.4461972438509,-103.6187548516602,-0.6705420972817931,-1.178085148145101,-0.5075430508633078,10289247248,10121365390.2,34.85478724342788,36.57232591592891,NaN,NaN,-4.7258029971826465,-0.07665694370399134
2020-11-05T09:30:00-05:00,349.24,352.19,348.86,350.24,82039749,80077746.75,60.380630907101185,48.518065528140745,NaN,NaN,88.78466629912221,-52.86584377061392,0.3816702656502822,-0.030455218800454986,-0.4121254844507372,10371286997,10174948041.2,42.659565233565196,35.49086521826626,NaN,NaN,-0.22821697302108848,-0.09830837646357665
2020-11-06T09:30:00-05:00,349.93,351.51,347.65,350.16,74972973,80849965.1,60.29154698133634,49.13159203322333,NaN,NaN,78.86919062750385,-0.09297724328358185,1.0198206602580486,0.8626503408718236,-0.15717031938622505,10296314024,10237625834.6,50.178691263214674,35.630782245941724,NaN,NaN,3.1618218188582827,0.3674245085824032
2020-11-09T09:30:00-05:00,363.97,364.38,354.06,354.56,172304203,85445748.6,63.48270069938192,49.867529440201075,NaN,NaN,150.66940931864815,54.95844956558117,1.6485708929845146,1.9035432968444184,0.2549724038599036,10468618227,10317550808.8,57.78133097753494,36.656225462859126,NaN,NaN,7.051907373303941,1.3223506321140512
2020-11-10T09:30:00-05:00,353.49,355.18,350.51,354.04,85552022,86060574.05,62.83995969794795,50.61601287186254,NaN,NaN,104.77342821606527,89.50857834103806,1.9207288276755936,2.6558834384543957,0.7351546107788021,10383066205,10361706540.2,61.295332020543015,38.239714778422915,NaN,NaN,9.928540277788423,2.5518062957818186
2020-11-11T09:30:00-05:00,356.4,357.56,355.06,356.67,58649048,86095089,64.78210234959973,51.34757364232517,NaN,NaN,127.09250147303891,110.03783918687569,2.1517625611465556,3.4248578122119966,1.273095251065441,10441715253,10392200141.2,63.551558174276806,40.11990260776201,NaN,NaN,12.921733046551301,4.033224403034602
2020-11-12T09:30:00-05:00,355.58,356.7182,351.26,353.21,68118563,86483134.2,60.31586744452175,51.66353343757964,NaN,NaN,95.08340059097243,111.29758604524571,1.9513553971439825,3.7122894974954193,1.7609341003514367,10373596690,10392662079.8,63.58618762928471,41.931729235831924,NaN,NaN,14.13229962570818,5.475949434845113
2020-11-13T09:30:00-05:00,355.27,358.9,354.71,358.1,62959429,85156012.25,64.08451640280917,52.84312980149491,NaN,NaN,117.54052643262001,119.03185320626895,2.0194650709071635,4.285265438985391,2.2658003680782275,10436556119,10420710498.8,65.71611842179944,43.8738126013384,NaN,NaN,16.351799762335993,7.029642338772382
2020-11-16T09:30:00-05:00,360.98,362.78,359.59,362.57,74541138,85461788.45,67.15509456741802,54.33896961100216,NaN,NaN,134.2869980001078,115.75537094256087,2.22089928670587,5.041924476460565,2.821025189754695,10511097257,10429206304.8,66.35801032714025,46.03010181883079,NaN,NaN,19.218177722699373,8.77086167933338
2020-11-17T09:30:00-05:00,359.97,361.92,358.34,360.62,66111009,85764744.9,64.56194931011152,56.418145717983904,NaN,NaN,107.51269079103764,116.30322345755535,2.080567947654911,5.421735124323334,3.341167176668423,10444986248,10441590313.4,67.3185484186308,48.49371987537465,NaN,NaN,20.787564327296774,10.487533486185294
2020-11-18T09:30:00-05:00,360.91,361.5,356.24,356.28,70591299,86115560.9,59.092771528908834,57.79696060921625,NaN,NaN,81.13935006776003,107.11259317649959,1.5761147288702868,5.311310587756282,3.735195858885995,10374394949,10428126252.6,65.1409077057625,50.975587122755186,NaN,NaN,20.46103079068093,11.912318815398956
2020-11-19T09:30:00-05:00,355.6,358.18,354.15,357.78,59940947,86342643.65,60.34317329578315,59.46326883663583,NaN,NaN,65.64823911620506,101.2255608815461,1.2389841137926112,5.283926001126758,4.044941887334147,10434335896,10440274093.8,66.20317808898567,53.85398787489225,NaN,NaN,20.56097295512122,13.147840835359279
2020-11-20T09:30:00-05:00,357.5,357.72,355.25,355.33,70411890,87406062.6,57.26429212576931,60.57680286896922,NaN,NaN,56.57296727314817,89.03204904965173,0.769497341569445,5.006813564295953,4.237316222726508,10363924006,10425747671.2,63.703264821314704,56.67365123537407,NaN,NaN,19.74214020153657,14.089883601956036
2020-11-23T09:30:00-05:00,357.28,358.82,354.865,357.46,63230608,85993942.9,59.21273453883017,61.36031721482893,NaN,NaN,57.82587412294554,73.73982427421927,0.5321946267924975,4.9025595062171305,4.370364879424633,10427154614,10408959142.6,60.843697373763604,59.227941264231724,NaN,NaN,19.607361650293175,14.878094751718484
2020-11-24T09:30:00-05:00,360.21,363.81,359.29,363.22,62415877,85815031.35,63.993574882915894,61.98577962374536,NaN,NaN,84.47528665344475,69.1323434467007,0.683305321954693,5.224496531867999,4.541191209913306,10489570491,10417875991.2,61.823895143436815,61.15430611423237,NaN,NaN,20.928725014774358,15.74247050358361
2020-11-25T09:30:00-05:00,363.13,363.16,361.48,362.66,45330890,81726860.5,63.21774080861199,62.188430330996134,NaN,NaN,84.33091280127478,69.77065599340366,0.6650595189347559,5.37251560858175,4.707456089646994,10444239601,10431844921.6,63.37084206487884,62.63368303075477,NaN,NaN,21.77723909762399,16.604580302732234
2020-11-27T09:30:00-05:00,363.84,364.18,362.58,363.67,28514072,78622729.65,64.06395591756593,62.45788811215538,NaN,NaN,90.60958060937361,74.76292429203735,0.6402987460012373,5.5078295221485405,4.867530776147303,10472753673,10439528477,64.22944666862247,63.637308416855326,NaN,NaN,22.71869092328032,17.478024677096247
2020-11-30T09:30:00-05:00,362.83,363.12,359.17,362.06,83872709,76793930.85,61.6299405854664,62.32554810401855,NaN,NaN,73.73290654563424,78.19491214653458,0.4440908672107087,5.422644360160689,4.97855349294998,10388880964,10444519868.6,64.8065743696211,64.13911151629006,NaN,NaN,22.85148713776435,18.245662171477406
2020-12-01T09:30:00-05:00,365.57,367.68,364.93,366.02,74504969,76215764.35,65.13835896088204,62.48971947994242,NaN,NaN,131.64796998251174,92.95933131844781,0.5051610197234746,5.610004767604323,5.104843747880849,10463385933,10451766132.4,65.67247087353587,64.45176429150384,NaN,NaN,23.963331241525054,19.06247203862707
2020-12-02T09:30:00-05:00,364.82,366.96,364.2,366.79,45927000,73847404.75,65.79331198913155,62.56194873990898,NaN,NaN,130.32363688680613,102.12900136512008,0.5195569479191029,5.754289932779727,5.234732984860624,10509312933,10455714620.8,66.16103649680906,64.63815560025613,NaN,NaN,25.069234895596743,19.920581018194166
2020-12-03T09:30:00-05:00,366.68,368.19,365.5,366.69,62881998,70643519.65,65.62088772262555,62.94087875977353,NaN,NaN,129.82641896668662,111.22810259820244,0.44723817529738064,5.79378070398235,5.346542528684969,10446430935,10456152887.6,66.21850787072037,64.8261784746444,NaN,NaN,25.94288523294362,20.780910191729802
2020-12-04T09:30:00-05:00,367.32,369.85,367.22,369.85,50749859,69079025.15,68.43590905420739,63.251692520587696,NaN,NaN,147.16099024532303,122.53838452539233,0.5313856154852896,6.0107745480415815,5.479388932556292,10497180794,10461038311.8,66.89349615924507,64.91027688446194,NaN,NaN,27.491385107956802,21.739549465476518
2020-12-07T09:30:00-05:00,369.02,369.62,367.72,369.09,48944269,67777589.95,67.01466687468147,63.24166197110651,NaN,NaN,132.52092162115494,134.29598754049647,0.4578155212751298,6.051658334150204,5.593842812875074,10448236525,10472909424,68.53851343147932,65.06602710620044,NaN,NaN,28.427061543469033,22.694908333761163
2020-12-08T09:30:00-05:00,367.72,370.78,367.67,370.17,42458859,61285322.75,68.03070941855914,63.48943055028134,NaN,NaN,127.56967649963994,133.4803288439221,0.4056288451529042,6.100878869316205,5.6952500241633,10490695384,10478371314.2,69.29449231284077,65.20716595578686,NaN,NaN,29.495906258665304,23.666479465890326
2020-12-09T09:30:00-05:00,370.88,371.05,365.95,366.85,74098312,60712637.25,61.73530508091512,63.67818294685322,NaN,NaN,94.12549967423423,126.24070140140773,0.08785836203317121,5.805072976704764,5.717214614671593,10416597072,10459828142,63.69840204621961,65.1041298372481,NaN,NaN,28.753647688898443,24.393217783462916
2020-12-10T09:30:00-05:00,365.37,367.86,364.43,366.73,57735353,60666952.5,61.51373120969553,63.76179422641839,NaN,NaN,61.45953049771375,112.56732370761317,-0.17570057504575765,5.497588895864396,5.673289470910154,10358861719,10442314298.8,58.863227317959094,64.5798476393176,NaN,NaN,28.075937377698807,24.91932058263947
2020-12-11T09:30:00-05:00,364.9,366.7402,363.26,366.3,57698614,60145955.05,60.67339107039253,64.00530129389146,NaN,NaN,40.21084144820616,91.17729394818979,-0.4108475889586698,5.1597299847118165,5.570577573670486,10301163105,10403110761,49.75827922045358,63.58377723925611,NaN,NaN,27.283999355747135,25.257131835940566
2020-12-14T09:30:00-05:00,368.64,369.8,364.47,364.66,69216174,60458792.3,57.44985839975271,63.87938156967165,NaN,NaN,49.8018566361606,74.63348095119093,-0.6921427332884225,4.705399157059958,5.39754189034838,10231946931,10359852842.2,42.03247930130504,62.24011880550906,NaN,NaN,25.747953498361582,25.327249216286425
2020-12-15T09:30:00-05:00,367.4,369.59,365.92,369.59,64071099,59935290.35,63.69433396525401,63.85800721841009,NaN,NaN,78.84333610834584,64.88821287293212,-0.5667570908643729,4.689095526767915,5.2558526176322875,10296018030,10320917371.4,36.5340305203823,60.43369990386231,NaN,NaN,26.02127323850563,25.426395505174884
2020-12-16T09:30:00-05:00,369.82,371.16,368.8676,370.17,58420517,59550765.75,64.35706030886062,63.93938718271357,NaN,NaN,99.5342962028068,65.96997217864661,-0.46935981613851396,4.669152847459145,5.138512663597659,10354438547,10308485666.4,34.961444214749505,58.40445720028164,NaN,NaN,26.43075927271453,25.569876043394835
2020-12-17T09:30:00-05:00,371.94,372.46,371.05,372.24,64119472,59227174.4,66.69380810166221,64.12723376729187,NaN,NaN,124.88713450635325,78.65549298037452,-0.2984527490925588,4.765446727231961,5.0638994763245195,10418558019,10320424926.4,37.73350481779996,56.511889925222896,NaN,NaN,27.437924231214744,25.836740070226252
2020-12-18T09:30:00-05:00,370.97,371.15,367.02,369.18,136542328,63057243.45,60.390839330218576,64.03872653477417,NaN,NaN,70.73840479076242,84.76100564888577,-0.41713478040545393,4.542481000817702,4.959615781223156,10282015691,10316595443.6,37.18603634074951,54.53899435173207,NaN,NaN,26.523199453939387,25.934805696470985
2020-12-21T09:30:00-05:00,364.97,378.46,362.03,367.86,96386745,64355986.2,57.85099185285894,63.51820031277253,NaN,NaN,75.3211902307308,89.8648723677998,-0.5991106705174101,4.210727443076394,4.809838113593804,10185628946,10307331846.6,35.831708813884234,52.40751134747124,NaN,NaN,25.02281668018167,25.804521551286797
2020-12-22T09:30:00-05:00,368.21,368.3317,366.03,367.24,48388462,63613878.9,56.645934385583814,62.864816198233406,NaN,NaN,9.044105279140549,75.90502620195875,-0.7651805891801402,3.8533623771186285,4.618542966298769,10137240484,10275576337.4,31.585031676834703,49.93779671747307,NaN,NaN,23.4337171361966,25.465835206273912
2020-12-23T09:30:00-05:00,368.28,369.62,367.2172,367.57,46201402,62803155.15,57.1574736273412,62.2602866199988,NaN,NaN,30.72752964116244,62.143672889629876,-0.8502045115648738,3.555787326842676,4.40599183840755,10183441886,10241377005.2,27.768125262013143,47.19134081685113,NaN,NaN,22.23554400696441,25.004365034943984
2020-12-24T09:30:00-05:00,368.08,369.03,367.45,369,26457853,61859503.3,59.39337577119848,61.614391385498166,NaN,NaN,36.13948631795673,44.39414325195058,-0.8078360608376487,3.396196762360489,4.204032823198138,10209899739,10199645349.2,23.962734592846203,44.12485784782263,NaN,NaN,21.77810309853881,24.543470472600387
2020-12-28T09:30:00-05:00,371.74,372.59,371.07,372.17,39000402,62383819.8,63.89208606348716,61.391349898984295,NaN,NaN,151.62073844042138,60.570609981882384,-0.5749576060081418,3.485335815687961,4.060293421696103,10248900141,10193022239.2,23.41431226494275,40.90170062164145,NaN,NaN,22.627429377973943,24.26975031622518
2020-12-29T09:30:00-05:00,373.81,374,370.83,371.46,53680451,60874206.9,62.22917525968748,60.97695460192204,NaN,NaN,153.1942815159249,76.1452282389212,-0.48118113574142907,3.458817002019316,3.939998137760745,10195219690,10194940388,23.95711539459643,37.66331655605257,NaN,NaN,22.884985066717597,24.07192670915267
2020-12-30T09:30:00-05:00,372.34,373.1,371.57,371.99,49455259,59621721.4,63.003258328283366,61.06752269101976,NaN,NaN,139.38849952454441,102.21410708800198,-0.39927639979990115,3.4409026380108685,3.8401790378107696,10244674949,10216427281,29.946733427027354,35.252483083253125,NaN,NaN,23.310019119626205,23.963082767791747
2020-12-31T09:30:00-05:00,371.78,374.66,371.232,373.88,78520702,61251406.5,65.7026291417521,61.36672968616666,NaN,NaN,157.36595622839675,127.54179240544886,-0.24140416406632914,3.538423832727858,3.7798279967941872,10323195651,10244378034,36.908449683293895,33.68428468077704,NaN,NaN,24.429538878976793,24.029719355103897
2021-01-04T09:30:00-05:00,375.31,375.45,364.82,368.79,110210810,63617847.1,54.227462197625634,60.90630619525474,NaN,NaN,16.731662324633227,123.66022760678416,-0.48908997919327657,3.1684655228025917,3.6575555019958683,10212984841,10244995054.4,37.057154485548004,32.77706148542664,NaN,NaN,21.979359684489076,23.736810830730352
2021-01-05T09:30:00-05:00,368.1,372.5,368.05,371.33,66426229,64401665.6,58.15500066151286,60.95667349966619,NaN,NaN,49.20847343752471,103.17777460620482,-0.48994411399997606,3.0451253594958985,3.5350694734958745,10279411070,10251097240.2,38.59851163236692,32.53177808050249,NaN,NaN,21.089697676123823,23.358651808643707
2021-01-06T09:30:00-05:00,369.71,376.98,369.12,373.55,107997675,67354335.9,61.2820301279191,60.78436608271369,NaN,NaN,128.58729775927094,98.25637785487402,-0.3553491290286339,3.0908830622100822,3.446232191238716,10387408745,10289535051.2,47.34535760530335,33.304015729425416,NaN,NaN,21.31343666117058,23.066478216147544
2021-01-07T09:30:00-05:00,376.1,379.9,375.91,379.1,68766812,68669733.55,67.76707291906337,61.02793841201388,NaN,NaN,234.49139920568672,117.27695779110248,0.0704097816718372,3.5342444183285124,3.4638346366566752,10456175557,10331835172.8,54.95084246658484,34.731829890270795,NaN,NaN,23.748617184927635,23.163926640258985
2021-01-08T09:30:00-05:00,380.59,381.49,377.1,381.26,71677208,68548678.35,69.88143788622348,61.255626253768256,NaN,NaN,221.89135771361606,130.18203808814636,0.4398432561278094,4.013638706816437,3.5737954506886274,10527852765,10372766595.6,60.844476705285594,36.382613596519775,NaN,NaN,26.44893589948017,23.633213677290584
2021-01-11T09:30:00-05:00,377.85,380.58,377.7189,378.69,51176719,68220746.65,64.46322237353164,61.54651075686205,NaN,NaN,168.1918549129465,160.474076605809,0.4517466835504429,4.138478805126681,3.686732121576238,10476676046,10425504836.6,66.86034092092359,38.50220678081793,NaN,NaN,26.88904128896249,24.098331907529428
2021-01-12T09:30:00-05:00,378.89,379.86,376.36,378.77,52547716,67963201.75,64.55534932289862,62.02539343329345,NaN,NaN,136.90279984254786,178.01294188681362,0.4070203937117327,4.195507613715904,3.7884872200041713,10529223762,10475467375,71.35107072953645,41.03930406050738,NaN,NaN,27.26157705998847,24.550224072166433
2021-01-13T09:30:00-05:00,378.69,380.86,377.85,379.79,45303619,66767574,65.77367604689519,62.67737498052998,NaN,NaN,137.41695335625633,179.77887300621072,0.3882052423931439,4.273743772995601,3.8855385306024575,10574527381,10512891102.2,74.1740777358577,44.081378779009015,NaN,NaN,27.932701981212155,25.03343520203011
2021-01-14T09:30:00-05:00,380.59,381.13,378.1,378.46,49989113,66063474.7,62.74516283038535,63.076495637890275,NaN,NaN,113.4816086830491,155.5769149016832,0.23576070379466696,4.180239410345791,3.9444787065511244,10524538268,10526563644.4,75.13796694323217,47.46493889909608,NaN,NaN,27.603972833763713,25.40065486370634
2021-01-15T09:30:00-05:00,376.72,377.58,373.7,375.7,107159962,68500446.95,56.891021358227185,62.897756036963756,NaN,NaN,42.00075931499836,119.59879522195965,-0.08424535689604307,3.8391720104310707,3.9234173673271138,10417378306,10504468752.6,70.55520174783939,50.792972267309885,NaN,NaN,25.538692728936134,25.420374558739166
2021-01-19T09:30:00-05:00,378.34,379.23,376.75,378.65,51229172,67855931.95,61.071693331155366,62.696299413225766,NaN,NaN,77.95504722770251,101.55143368491085,-0.12790961433340353,3.7635303494103596,3.891439963743763,10468607478,10502855039,70.2183505831179,54.13611786146525,NaN,NaN,25.022861568436667,25.363586988695953
2021-01-20T09:30:00-05:00,381.11,384.79,380.69,383.89,61836062,64120618.65,67.16329959316951,63.04873686561734,NaN,NaN,139.19181206089652,102.00923612858057,0.15035475143164456,4.079383403033319,3.929028651601674,10530443540,10503098994.6,70.24148131318722,57.44214399850745,NaN,NaN,26.59688617948554,25.53977258738018
2021-01-21T09:30:00-05:00,384.49,384.95,383.25,384.24,47955809,61699071.85,67.52879852383175,63.37198973672794,NaN,NaN,135.93865175361205,101.71357580805173,0.3033995986021374,4.308278149854345,4.004878551252208,10578399349,10503873388.2,70.32028308719532,60.32596897423373,NaN,NaN,27.945969396268794,25.88351498864998
2021-01-22T09:30:00-05:00,382.25,384.1256,381.835,382.88,52136931,61886495.3,64.52341770226028,63.28776034819282,NaN,NaN,107.44795740762406,100.50684555296672,0.26011669945459914,4.330024425570457,4.069907726115858,10526262418,10504218218.2,70.35792409743244,62.7152171466722,NaN,NaN,28.13815730647257,26.205606748338923
2021-01-25T09:30:00-05:00,383.67,384.77,378.46,384.39,70401971,63096523.75,66.31591286488685,64.15122111014004,NaN,NaN,92.9902631209581,110.70474631415865,0.27861217009279926,4.418172938731857,4.139560768639058,10596664389,10540075434.8,74.04423206504288,65.35715125949326,NaN,NaN,28.837610258423197,26.581607249779534
2021-01-26T09:30:00-05:00,385.41,385.85,383.54,383.79,42665281,63906895.15,64.91244278978164,64.63389554787354,NaN,NaN,114.40073287591404,117.99388344380097,0.19956927878524766,4.389022367120617,4.18945308833537,10553999108,10557153760.8,75.60061105023661,68.00015836076967,NaN,NaN,29.006050651956976,26.927956307233455
2021-01-27T09:30:00-05:00,380.22,380.32,372.01,374.41,123351078,68124428.95,47.85977508008842,63.67516304445706,NaN,NaN,-35.025326892268986,83.15045565316787,-0.4972391562574101,3.5679041430136067,4.065143299271017,10430648030,10537194658.8,70.29555790080371,69.63945838187684,NaN,NaN,23.13765131190571,26.386484165043775
2021-01-28T09:30:00-05:00,376.36,381.93,375.89,377.63,94198104,70150311.6,52.47530365391681,62.582893811232296,NaN,NaN,10.670888484815913,58.096902999408634,-0.7394873436987743,3.1407841196475488,3.880271463346323,10524846134,10526484015.8,67.55595691813011,70.53982369984436,NaN,NaN,19.93064632422488,25.464221616355363
2021-01-29T09:30:00-05:00,375.63,376.67,368.27,370.07,126765121,74015804.7,42.8782810550469,60.65409689471969,NaN,NaN,-116.6894551646386,13.2694204849561,-1.3703958986723972,2.1672765900058266,3.537672488678224,10398081013,10500847734.8,61.38895821231592,70.57871523606082,NaN,NaN,13.377747216893981,23.73758241643231
2021-02-01T09:30:00-05:00,373.72,377.34,370.376,376.23,75817597,73880649.45,50.7775732473064,59.676550528560746,NaN,NaN,-63.757766955617264,-18.08018553035898,-1.3331342164000701,1.871254718178136,3.204388934578206,10473898610,10476294579,56.10622992056431,69.81056445032087,NaN,NaN,11.00847040046841,21.91913784272318
2021-02-02T09:30:00-05:00,379.65,383.22,376.3181,381.55,64450662,71592642.05,56.38699993145605,59.09309700060056,NaN,NaN,41.16860071068928,-32.726611963403926,-0.9295980480495372,2.042391374516285,2.971989422565822,10538349272,10473164611.8,55.45114786726551,68.67485567444437,NaN,NaN,11.290985619613613,20.400830382278958
2021-02-03T09:30:00-05:00,382.435,383.7,380.48,381.85,52427090,70892685.1,56.68675770571886,58.44403140480225,NaN,NaN,71.2569670529603,-11.470153174358076,-0.635888090872887,2.1771293089747132,2.8130173998476002,10590776362,10505190278.2,60.52926693060894,67.70022633121232,NaN,NaN,11.605544453607603,19.144360963897334
2021-02-04T09:30:00-05:00,382.96,386.24,381.9655,386.19,47142555,67849929.1,60.876134377367656,58.31052937244384,NaN,NaN,125.0719896885239,11.410067066383528,-0.16713915705114868,2.6040934535336646,2.7712326105848133,10637918917,10527804834.8,63.677832238522875,66.88164528087593,NaN,NaN,13.353493310437614,18.317094156260232
2021-02-05T09:30:00-05:00,388.2,388.47,386.1444,387.71,48669773,66845077.15,62.25317785271987,58.69354055062189,NaN,NaN,158.60860740547733,66.4696795804067,0.20716335456324142,3.0301868037888653,2.823023449225624,10686588690,10585506370.2,70.20796066076218,66.8568423460847,NaN,NaN,15.185307418829353,17.869696050912964
2021-02-08T09:30:00-05:00,389.27,390.56,388.35,390.51,38365185,65179476,64.71679409750868,58.953904891075695,NaN,NaN,171.26436968576,113.47410690868216,0.5838615648015937,3.552850405227616,2.9689888404260225,10724953875,10635717423.2,74.50358017764208,67.162930174265,NaN,NaN,17.499894632208644,17.816867276812346
2021-02-09T09:30:00-05:00,389.61,390.89,389.17,390.25,35551059,64398193,64.29714686234388,58.74917969601672,NaN,NaN,149.9179595021276,135.22397866696983,0.7457014199888583,3.9011156154120954,3.155414195423237,10689402816,10665928132,76.68209891057795,67.62297428836435,NaN,NaN,19.189641137022512,18.01297782827094
2021-02-10T09:30:00-05:00,392.12,392.28,387.5,390.08,59154370,64728525.7,64.00490603284952,58.49747308951799,NaN,NaN,129.8148236291889,146.93554998221555,0.7684322934590995,4.115954562247111,3.347522268788012,10630248446,10673822548.8,77.22961426815719,68.11649794414733,NaN,NaN,20.461327226860167,18.362742028069402
2021-02-11T09:30:00-05:00,391.24,391.69,388.1,390.71,42913288,64609009.15,64.64620645085131,58.50624371441735,NaN,NaN,118.34535229922015,145.5902225043548,0.7520834806490599,4.287626619599337,3.5355431389502767,10673161734,10680871112.2,77.73235761218183,68.64324319520087,NaN,NaN,21.6916523544381,18.83830064612207
2021-02-12T09:30:00-05:00,389.85,392.9,389.77,392.64,50593270,64639217,66.60889097417648,58.52717072222375,NaN,NaN,126.34478160787508,139.13745734483433,0.793346121940258,4.527225791375599,3.7338796694353413,10723755004,10688304375,78.27705856324164,68.9455879450722,NaN,NaN,23.302136394475035,19.475991467315353
2021-02-16T09:30:00-05:00,393.96,394.17,391.53,392.3,50972366,61829837.2,65.9146619021169,58.59875780167628,NaN,NaN,124.39187889700432,129.76295918708323,0.7218811575476121,4.636231116369856,3.9143499588222443,10672782638,10677870127.6,75.48570445777112,68.93738033132466,NaN,NaN,24.457262734470206,20.187601648337473
2021-02-17T09:30:00-05:00,390.42,392.66,389.33,392.39,52806681,61908712.65,66.01563322627351,59.895604812118066,NaN,NaN,96.92667514311911,119.16470231528152,0.6093033075946535,4.675979093315561,4.066675785720908,10725589319,10685107428.2,76.12174269979327,69.35353638839534,NaN,NaN,25.449735111914773,20.939335000277087
2021-02-18T09:30:00-05:00,389.59,391.515,387.74,390.72,59712773,61802548.2,62.326199318634664,60.599240216740775,NaN,NaN,68.97931653394609,106.99760089623294,0.36315040057553105,4.520613786440322,4.157463385864791,10665876546,10692233048.2,76.76105197580677,70.0110431782294,NaN,NaN,25.37396816226762,21.572854023418593
2021-02-19T09:30:00-05:00,392.07,392.38,389.55,390.03,83240971,63566806.3,60.813915821277114,61.88035698575721,NaN,NaN,69.81948621459613,97.29242767930813,0.10789259502120974,4.292329129641303,4.184436534620093,10582635575,10674127816.4,71.52130941560155,70.73478254989264,NaN,NaN,24.923579520502326,22.051529094430556
2021-02-22T09:30:00-05:00,387.06,389.62,386.74,387.03,67413570,64330638.25,54.609670366696314,62.15407820857079,NaN,NaN,31.015283948524154,78.22652814743796,-0.28735566105033516,3.825241958307174,4.112597619357509,10515222005,10632421216.6,61.16393189186378,71.09604697641404,NaN,NaN,22.83310160410937,22.163182310098957
2021-02-23T09:30:00-05:00,384.66,388.945,380.2,387.5,107284127,66174746.05,55.37773696874712,62.08198799694871,NaN,NaN,1.0700075969237413,53.56215388742184,-0.5275254176154993,3.453190847338135,3.9807162649536343,10622506132,10622365915.4,58.94749836254352,71.34578629750533,NaN,NaN,21.26414265396968,22.03474807350906
2021-02-24T09:30:00-05:00,386.33,392.23,385.27,391.77,72433946,67663179.3,61.71596612194621,62.44121716953638,NaN,NaN,50.83187510396979,44.34319387959198,-0.4141954199176374,3.4629719900565874,3.877167409974225,10694940078,10616236067.2,57.5777113860492,71.13496090146535,NaN,NaN,21.572970258535882,21.96877981422718
2021-02-25T09:30:00-05:00,390.41,391.88,380.7789,382.33,146670499,68829150.35,46.11940522518459,61.38716508723759,NaN,NaN,-17.091404272276414,27.129049718347478,-0.9592357062193555,2.6781227772000307,3.637358483419386,10548269579,10592714673.8,52.53319562851849,70.33891542932217,NaN,NaN,16.47345085405907,21.18373281991745
2021-02-26T09:30:00-05:00,384.35,385.58,378.23,380.36,152701639,71754327.1,43.64082391929846,60.057711234850345,NaN,NaN,-72.872560487654,-1.4093596221025428,-1.4094535784099058,1.875541510407004,3.2849950888169097,10395567940,10555301146.8,45.67796430208528,68.58677283227384,NaN,NaN,11.544491055375175,19.806698282125694
2021-03-01T09:30:00-05:00,385.59,390.92,380.572,389.58,105348798,70683510.95,55.65324825056865,59.41031510292606,NaN,NaN,-1.7192045929398472,-7.956257330395343,-1.0593053457130255,1.960863406675628,3.0201687523886536,10500916738,10552440093.4,45.19230160174543,66.49311007685264,NaN,NaN,11.446422537176321,18.612373175704356
2021-03-02T09:30:00-05:00,389.82,390.07,386,386.54,79595332,70872397.7,51.73763367132256,58.51320701785311,NaN,NaN,-5.217534516759267,-9.213765753131947,-1.0058486803375652,1.7628579019666972,2.7687065823042625,10421321406,10512203148.2,38.92425720054671,63.79612138327899,NaN,NaN,9.939858597646872,17.373442521696145
2021-03-03T09:30:00-05:00,385.79,386.83,381.31,381.42,119940211,73646875.15,45.88249116267937,57.21874881284096,NaN,NaN,-115.16979325906661,-42.414099425739224,-1.2716030363562716,1.179202786858923,2.4508058232151946,10301381195,10433491371.6,30.122678329643563,60.431340244813725,NaN,NaN,6.534350219303192,15.825000764211438
2021-03-04T09:30:00-05:00,381.22,384,371.88,376.7,183433020,80197171.65,41.24811064237488,55.54745625509264,NaN,NaN,-228.19010182528243,-84.63383893634042,-1.695076087893122,0.33196071334879207,2.027036801241914,10117948175,10347427090.8,23.788673508661205,56.578219951705115,NaN,NaN,2.0534674801504798,13.857638866488445
2021-03-05T09:30:00-05:00,380.46,384.76,372.64,383.63,152039624,85442025.1,49.33896972796967,54.313890451792155,NaN,NaN,-147.30152819598086,-99.51963247800579,-1.4478658003855638,0.21720455075995915,1.665070351145523,10269987799,10322311062.6,22.314066703119437,52.580863390267815,NaN,NaN,1.337414709484487,12.06903541548788
2021-03-08T09:30:00-05:00,384.66,387.68,381.42,381.72,123149245,89165998.7,47.40143667155473,52.99151722103772,NaN,NaN,-70.69406305672102,-113.31460417076202,-1.3540915301431649,-0.02754406153343325,1.3265474686097316,10146838554,10251495425.8,18.77938535572875,48.53041202583621,NaN,NaN,0.10328137585474438,10.359641981254574
2021-03-09T09:30:00-05:00,385.85,389.91,381.7299,387.17,113633556,92929417.25,53.06516202875816,52.066483564072335,NaN,NaN,-16.07709325965304,-115.48651591934079,-0.8886195309738691,0.21577305489239507,1.1043925858662642,10260472110,10219325566.6,17.42873745604051,44.338054508425294,NaN,NaN,1.1133561174870044,9.03874400071635
2021-03-10T09:30:00-05:00,389.69,391.4,388.1702,389.58,109899410,96646834.8,55.354506552416105,51.56850550934244,NaN,NaN,52.36654107435147,-81.97924905265717,-0.4065557619926945,0.596197883375396,1.0027536453680905,10370371520,10233123631.6,20.08364943377478,40.289668612565876,NaN,NaN,2.697032093502591,8.132785156828671
2021-03-11T09:30:00-05:00,392.23,395.65,391.74,393.53,86245040,98001368.3,58.89358485888103,51.43133901202843,NaN,NaN,120.36539343013386,-12.268150001573915,0.1598426526264669,1.2025569611511742,1.0427143085247073,10456616560,10300857308.6,31.694134166518154,37.44487038048849,NaN,NaN,5.205471635924289,7.714597510985188
2021-03-12T09:30:00-05:00,392.07,394.21,391.2,394.06,64653565,99088382.15,59.359105836822856,51.77058440275175,NaN,NaN,104.46763903631803,38.085683444885866,0.5307881244800576,1.7061994641247793,1.1754113396447217,10521270125,10351113773.8,38.79884339135589,35.84736405902364,NaN,NaN,7.309423373027174,7.6567154912769
2021-03-15T09:30:00-04:00,394.33,396.685,392.03,396.41,73592302,100238333.75,61.44406506802056,52.20389355269986,NaN,NaN,130.38744115365895,78.30198428696187,0.8747202784131247,2.2688116876611275,1.3940914092480028,10594862427,10440718548.4,48.98695025035394,35.13589633672438,NaN,NaN,9.695364207520015,7.947951022168774
2021-03-16T09:30:00-04:00,397.07,397.83,395.08,395.91,73722506,101375840.75,60.73018421050064,52.13348055902518,NaN,NaN,142.02290779810878,109.9219844985142,0.9998175098458455,2.6438632965553097,1.6440457867094642,10521139921,10492852110.6,53.80528617618645,34.866437393162755,NaN,NaN,11.408313177988743,8.442288473000199
2021-03-17T09:30:00-04:00,394.53,398.12,393.3,397.26,97959265,103633469.95,62.01347137778898,53.26877099849691,NaN,NaN,128.9921582896103,125.24710794156599,1.0969793395226515,3.0152699611127787,1.9182906215901272,10619099186,10542597643.8,57.892236294332754,35.249226012149485,NaN,NaN,13.203622323571459,9.122479023081807
2021-03-18T09:30:00-04:00,394.475,396.72,390.75,391.48,115349101,106415286.35,53.89308351689683,54.00107525546822,NaN,NaN,73.07225069357516,115.78847939425425,0.7140182360827145,2.81081341669352,2.0967951806108056,10503750085,10552024348.8,58.639009110265334,36.17501492701949,NaN,NaN,12.388984329879268,9.589122638338587
2021-03-19T09:30:00-04:00,389.88,391.569,387.15,389.48,113624490,107934462.3,51.38570505592087,53.69625074156482,NaN,NaN,20.336651687134076,98.96228192441745,0.2898042107873997,2.4590504440950554,2.1692462333076556,10390125595,10525795442.8,55.680102274848764,36.92414354652687,NaN,NaN,10.96163376172665,9.785195655965452
2021-03-22T09:30:00-04:00,390.03,394.07,389.97,392.59,73778646,108252716.1,54.899551626413945,53.92210202407134,NaN,NaN,57.42653873078974,84.37010143984362,0.18741939315196232,2.4035204747476087,2.2161010815956463,10463904241,10499603805.6,52.814192803088005,37.91628180385125,NaN,NaN,10.78504786976526,9.928031686508282
2021-03-23T09:30:00-04:00,391.91,393.46,388.66,389.5,90686552,107422837.35,50.95844871609062,54.284670420743566,NaN,NaN,29.617045489482262,61.888928978118315,-0.10397861304432521,2.08612781529024,2.1901064283345653,10373217689,10470019359.2,49.70230144577035,39.314826312146025,NaN,NaN,9.448905301993832,9.859585060149074
2021-03-24T09:30:00-04:00,391,392.75,387.47,387.52,97588644,108680572.25,48.553209293568074,54.80646318154309,NaN,NaN,10.886095399228669,38.26771640004199,-0.4274962639099664,1.6557360984471075,2.083232362357074,10275629045,10401325331,43.31967803880272,40.709898064299,NaN,NaN,7.618461216264892,9.539424511022762
2021-03-25T09:30:00-04:00,385.98,390.55,383.9,389.7,116128622,107153478.4,51.27984288991476,54.94509697882488,NaN,NaN,-9.569901454087733,21.739285970509414,-0.4877307240069464,1.473568957348391,1.9612996813553374,10391757667,10378926847.4,41.450557070278634,42.07679023338179,NaN,NaN,6.861477044821912,9.156860587279784
2021-03-26T09:30:00-04:00,390.93,396.41,390.29,395.98,114409114,105238852.15,58.159314979508174,55.713516857964414,NaN,NaN,79.93796258744997,33.65954815057258,-0.11702273221189508,1.8150212660904685,1.9320439983023636,10506166781,10402135084.6,44.13999414246087,43.888262289576936,NaN,NaN,8.326082364146103,9.038177983974972
2021-03-29T09:30:00-04:00,394.4,396.75,392.81,395.78,108107626,105376793.55,57.8790152994534,56.057363520156926,NaN,NaN,85.15210175184218,39.20466075478307,0.09108677113006114,2.04590246221494,1.9548156910848788,10398059155,10388966067.4,42.934835237559525,45.710126416828295,NaN,NaN,9.411046402721142,9.091444900938711
2021-03-30T09:30:00-04:00,394.42,395.45,393.02,394.73,76262249,105210139.4,56.34371689206297,56.128021401560275,NaN,NaN,67.04688119715584,46.69062789631778,0.1319206284946257,2.119716476703161,1.9877958482085352,10321796906,10378681910.8,41.971089900894995,47.27351502162259,NaN,NaN,9.8727112817285,9.20305438390868
2021-03-31T09:30:00-04:00,395.34,398,395.31,396.33,112734214,104849839.55,58.1647964484309,56.07596508652813,NaN,NaN,92.7610141318815,63.06561164284835,0.23458490867027404,2.2810269840463775,2.0464420753761035,10434531120,10410462325.8,46.004614426904745,48.29569218307878,NaN,NaN,10.776378489734192,9.427814970455183
2021-04-01T09:30:00-04:00,398.4,400.67,398.18,400.61,99682876,100662332.35,62.652758365867335,56.31122598145987,NaN,NaN,141.66196349772542,93.31198463321098,0.5411181413708528,2.722839752089669,2.1817216107188164,10534213996,10438953591.6,49.40028259390154,49.05293784040348,NaN,NaN,12.917046098283654,9.926276560144965
2021-04-05T09:30:00-04:00,403.46,406.94,403.38,406.36,91684764,97644589.35,67.6705672917962,56.755976140300994,NaN,NaN,231.4246039244378,123.60931290060853,1.0519421534466185,3.4966493025270893,2.444707149080471,10625898760,10462899987.4,52.125409693629265,49.27711351492314,NaN,NaN,16.456938757511036,10.859228302625832
2021-04-06T09:30:00-04:00,405.76,407.24,405.4,406.12,62020953,94588174.75,67.26434050548778,57.222701589942936,NaN,NaN,215.80303442910645,149.7394994360614,1.2793680342335172,4.043917191872367,2.76454915763885,10563877807,10496063717.8,55.68497960842584,49.411377331511666,NaN,NaN,19.162550356602885,12.045417167479696
2021-04-07T09:30:00-04:00,405.94,406.96,405.45,406.59,55836280,91698310.95,67.67359871434148,57.62699639969669,NaN,NaN,183.31354644689108,172.99283248600847,1.3596380189594042,4.4640966813381056,3.1044586623787014,10619714087,10555647154,61.25834458344726,49.65181363787699,NaN,NaN,21.493194881218596,13.395099698013825
2021-04-08T09:30:00-04:00,407.93,408.58,406.93,408.52,57863114,89096496.15,69.36718506976727,58.73228936775886,NaN,NaN,172.57114528063263,188.9548587157587,1.4335405527805527,4.896384353354392,3.4628438005738396,10677577201,10604256370.2,65.11317864726028,50.11425431909091,NaN,NaN,23.972559359028054,14.906165363873
2021-04-09T09:30:00-04:00,408.39,411.67,408.26,411.49,61104559,87839472.1,71.81434286825781,60.19147778292579,NaN,NaN,164.9226349743458,193.60699301108275,1.5626810402667362,5.4161951009072595,3.8535140606405234,10738681760,10645149923,67.99804033372187,50.99410703758185,NaN,NaN,26.862004631427617,16.614142402095087
2021-04-12T09:30:00-04:00,410.85,411.93,410.2,411.64,56704899,87442038.8,71.93628106904538,61.40838702882803,NaN,NaN,142.67478598496885,175.85702942318898,1.5361463710701608,5.773697024478224,4.237550653408063,10795386659,10679047502.8,70.1979661209781,52.23580513171686,NaN,NaN,29.267310777659162,18.421737884318528
2021-04-13T09:30:00-04:00,411.53,413.529,411.12,412.86,56550988,86589973.1,72.96088801917013,62.97998983619085,NaN,NaN,130.70477608274672,158.837377753917,1.47821223277432,6.085315944375964,4.607103711601644,10851937647,10736659470.8,73.52866930942862,53.93768855054959,NaN,NaN,31.602223819275448,20.30466444645523
2021-04-14T09:30:00-04:00,412.83,413.96,410.87,411.45,61658197,85986757.65,69.78952272608072,64.49686936708461,NaN,NaN,109.57201215364806,144.08907089526843,1.2324249182863882,6.147634859459629,4.915209941173241,10790279450,10770772543.4,75.28967703602092,56.221259907493746,NaN,NaN,32.77137639143853,22.08562329573856
2021-04-15T09:30:00-04:00,413.74,416.16,413.69,415.87,60229842,84100286.5,73.65530331196427,66.09511654008814,NaN,NaN,118.1381221666961,133.2024662724811,1.2510274838261157,6.478994295955886,5.22796681212977,10850509292,10805358961.6,76.96300385225076,58.757863249063185,NaN,NaN,34.97157885372765,23.926474089737003
2021-04-16T09:30:00-04:00,417.25,417.91,415.73,417.26,82037278,82434695.35,74.74957586435526,67.28013517472007,NaN,NaN,116.13432049891053,123.44480337739405,1.2381504607991092,6.775654888128656,5.537504427329547,10932546570,10844131923.6,78.70403947399997,61.22672362988741,NaN,NaN,37.14254383502788,25.814484053349986
2021-04-19T09:30:00-04:00,416.26,416.74,413.79,415.21,78498496,80678395.65,70.1234312381899,68.15473631320125,NaN,NaN,93.93181937487934,113.69621005537616,0.9838629174597973,6.767333074154294,5.783470156694497,10854048074,10855864206.6,79.2158995697838,63.81822822504629,NaN,NaN,37.70139814458262,27.51261463781179
2021-04-20T09:30:00-04:00,413.91,415.0859,410.59,412.17,81851828,81082054.75,63.81610661547592,68.68847843630218,NaN,NaN,67.97291565353295,101.1498379695334,0.5261722003163714,6.441185407089961,5.915013206773589,10772196246,10839915926.4,76.52334809789744,66.28624666768931,NaN,NaN,36.33703453612957,28.77324605185719
2021-04-21T09:30:00-04:00,411.51,416.29,411.36,416.07,66792024,79887328.35,67.81558497943462,69.37782047423102,NaN,NaN,78.69607482812823,94.97465050442943,0.40668055211396315,6.423363896916044,6.016683344802081,10838988270,10849657690.4,77.03679159007376,68.50283075077282,NaN,NaN,36.32520677803164,29.852097584167826
2021-04-22T09:30:00-04:00,415.89,416.78,411.13,412.27,97582788,79887035.55,60.76761680923305,69.24316750589999,NaN,NaN,64.80024169324133,84.30707440973848,0.013106559331056644,6.0330665439659015,6.019959984634845,10741405482,10827836928.4,73.17628885076252,70.20111691197717,NaN,NaN,34.07416988534128,30.455250770049748
2021-04-23T09:30:00-04:00,412.87,418.25,412.79,416.74,73276195,77744414.2,65.33190454924662,69.07612016714646,NaN,NaN,83.88402686332002,77.85701568262039,-0.003882930853427169,6.01510632106806,6.018989251921488,10814681677,10804263949.8,69.1450721476817,71.41680708726663,NaN,NaN,33.58202635435011,30.90193299637837
2021-04-26T09:30:00-04:00,417.44,418.22,416.8111,417.61,52182392,74633078.1,66.15716581901182,68.99703626096961,NaN,NaN,95.17753035370902,78.10615787838631,-0.013680673072899552,6.001888410580364,6.015569083653263,10866864069,10806827148.8,69.34283752688201,72.39236836715637,NaN,NaN,33.44459137232222,31.26516990722749
2021-04-27T09:30:00-04:00,417.93,418.14,416.3,417.52,51302156,71792804.6,65.98218272214342,68.87622083295545,NaN,NaN,89.4114420642077,82.39386316052126,-0.07969092940176203,5.91595542190106,5.995646351302822,10815561913,10815500282.2,70.04253322230689,73.01981041278918,NaN,NaN,33.28335108953837,31.553481504700475
2021-04-28T09:30:00-04:00,417.81,419.01,416.9,417.4,51238854,70541634.85,65.7325376340711,68.61660315897714,NaN,NaN,94.31909017184961,85.51846622926554,-0.17920663201012843,5.771638061290162,5.95084469330029,10764323059,10800567240,67.198756891174,73.16878028735445,NaN,NaN,33.08216921274984,31.77186546299324
2021-04-29T09:30:00-04:00,420.32,420.72,416.44,420.06,78544329,68832140.6,68.57117290674253,68.38494816172606,NaN,NaN,112.9651192966524,95.15144174994775,-0.11668456808817496,5.804988983190071,5.921673551278246,10842867388,10820859621.2,69.03837125669,73.24308963899503,NaN,NaN,33.70909654053257,32.048612759784575
2021-04-30T09:30:00-04:00,417.63,418.54,416.34,417.3,85527030,68124348.3,62.76172758125731,67.72962291259834,NaN,NaN,79.76875027859484,94.32838643300272,-0.30150367136009226,5.544793962078131,5.8462976334382235,10757340358,10809391357.4,66.75960594709868,72.99749248371793,NaN,NaN,32.56058645539868,32.12175185915802
2021-05-03T09:30:00-04:00,419.43,419.84,417.665,418.2,68128289,66946524.55,63.83761845945698,67.07796080119026,NaN,NaN,95.42718668380725,94.37831769902236,-0.39740306621421073,5.34954380067046,5.746946866884671,10825468647,10801112273,65.08933016681087,72.39468254495952,NaN,NaN,31.90589120378296,32.09091462267587
2021-05-04T09:30:00-04:00,416.07,416.6,411.67,415.62,101591166,68925035.2,58.60990695660885,66.27941681765655,NaN,NaN,6.722785453404289,77.84058637686168,-0.6537218138598186,4.929794599559898,5.583516413419717,10723877481,10782775386.6,61.4237819224414,71.40426146541814,NaN,NaN,29.807151142084592,31.764662696877114
2021-05-05T09:30:00-04:00,417.38,417.63,415.15,415.75,39960661,68131254.25,58.79301780529075,65.21782499575131,NaN,NaN,37.15948385310497,66.40866511311275,-0.8227158185035481,4.555121640290281,5.377837458793829,10763838142,10782678403.2,61.40408570178352,70.2929101689562,NaN,NaN,28.13819808737252,31.246596324090742
2021-05-06T09:30:00-04:00,415.83,419.21,413.675,419.07,74321368,68954166.95,63.26295396085845,64.3973520026444,NaN,NaN,63.88477859665896,56.592596973114055,-0.7226639376753337,4.474507536699662,5.197171474374995,10838159510,10781736827.6,61.198906901083596,69.04254355660503,NaN,NaN,27.909593417536488,30.76988162315442
2021-05-07T09:30:00-04:00,419.89,422.815,419.16,422.12,67733790,69285628.5,66.82343270692579,64.16163782183982,NaN,NaN,174.38497851465007,75.51584262032512,-0.47480786497606964,4.603661643154908,5.078469508130977,10905893300,10811447416,65.15540841984796,68.03822276018103,NaN,NaN,28.774936851970917,30.484889512985347
2021-05-10T09:30:00-04:00,422.5,422.74,417.81,417.94,81852446,70543005.85,58.46101861781022,63.77913153629226,NaN,NaN,106.73873148761633,77.77815158108692,-0.6076235393824376,4.31894008390293,4.926563623285368,10824040854,10811161857.4,65.08671290392815,67.22132024632607,NaN,NaN,26.90374042192763,29.97329678569139
2021-05-11T09:30:00-04:00,413.1,415.27,410.06,414.21,116887975,73559855.2,52.18523753669467,62.66267814752513,NaN,NaN,-104.49366016328314,55.53486245774944,-0.941971627243646,3.7490990892308105,4.6910707164744565,10707152879,10807816937,64.23241877651131,66.30672218821448,NaN,NaN,23.221238852876187,29.008717081003503
2021-05-12T09:30:00-04:00,411.23,412.59,404,405.41,134811046,77217497.65,41.00205214075148,61.25085209977645,NaN,NaN,-259.9528173036363,-3.8875977735988188,-1.7065178599527142,2.5579233915335635,4.264441251486278,10572341833,10769517675.2,55.28475296959396,65.02875533955958,NaN,NaN,15.538781980058896,27.084440638011415
2021-05-13T09:30:00-04:00,407.07,412.35,407.02,410.28,106393963,79525703.7,47.68373097749905,59.99026827322306,NaN,NaN,-154.66212019430947,-47.596977531792504,-1.8243482148747168,1.9840059828928815,3.8083541977675983,10678735796,10737632932.4,49.1467451447234,63.60030341077684,NaN,NaN,11.70255137589099,24.887027886279924
2021-05-14T09:30:00-04:00,413.21,417.49,413.18,416.58,82201629,79533921.25,54.81319097299753,59.1799843556506,NaN,NaN,0.5865058270085068,-82.35667206932081,-1.4352354067892628,2.01430993928102,3.4495453460702827,10760937425,10708641757.4,44.32766146489974,61.81350512063525,NaN,NaN,11.226836461315044,22.935571968427798
2021-05-17T09:30:00-04:00,415.39,416.39,413.36,415.52,65129221,78865457.5,53.49231730233477,58.28785111137855,NaN,NaN,-16.763112640299788,-107.05704089490405,-1.2152051955177643,1.9305388516730773,3.1457440471908416,10695808204,10682995227.4,40.540560096503306,59.706221325935,NaN,NaN,10.401746890087631,21.145025528664917
2021-05-18T09:30:00-04:00,415.8,416.06,411.77,411.94,59810238,77763378,49.18168073353179,57.10564704705432,NaN,NaN,-67.41112110329331,-99.64053308290609,-1.270737841881711,1.5573217448387027,2.8280595867204137,10635997966,10668764244.8,38.571367889211345,57.661407825794804,NaN,NaN,8.22839119871354,19.299792052957578
2021-05-19T09:30:00-04:00,406.92,411.05,405.33,410.86,106467052,79747129.4,47.92693686526708,55.6310587583775,NaN,NaN,-152.46462487665752,-78.14289459751032,-1.333636407656547,1.16101407714973,2.494650484806277,10529530914,10660202061,37.39446657305149,55.40112891982063,NaN,NaN,6.1199483307836005,17.416957235504153
2021-05-20T09:30:00-04:00,411.8,416.625,411.67,415.28,78022218,78769100.9,53.190381016716564,54.94739114662458,NaN,NaN,-24.648704336207413,-52.140211425889916,-1.043817764126497,1.1898782796481555,2.2336960437746525,10607553132,10645965528.2,35.457223559647346,53.165244463574105,NaN,NaN,6.08523448374767,15.798139699538941
2021-05-21T09:30:00-04:00,416.87,418.2,414.45,414.94,76578662,78934224.25,52.74869873733682,54.155325452187434,NaN,NaN,8.124123573021079,-50.6326878766874,-0.8495085872135255,1.1718103097577455,2.021318896971271,10530974470,10599972937.2,30.0424485743697,50.66189577839974,NaN,NaN,5.920933488178586,14.387110240773175
2021-05-24T09:30:00-04:00,417.34,420.32,417.08,419.17,51376702,78893939.75,57.47936930062894,54.07457276247459,NaN,NaN,78.19927001754503,-31.640211345118427,-0.4316659762298667,1.4817364266839377,1.9134024029138044,10582351172,10577281530.8,27.787755752139233,48.25932248052101,NaN,NaN,7.296470610031007,13.374161722095723
2021-05-25T09:30:00-04:00,420.33,420.71,417.62,418.24,57451396,79201401.75,56.148383403792096,53.88567030522468,NaN,NaN,74.70421433460028,-3.2171442575397124,-0.22393623067511137,1.6334821145699152,1.8574183452450266,10524899776,10555061892.8,25.749837334577833,45.71259045429203,NaN,NaN,8.000535820544476,12.606500879016973
2021-05-26T09:30:00-04:00,418.87,419.61,417.76,419.07,43088618,78793889.95,57.103084351439975,53.445679618837644,NaN,NaN,71.41397905415862,41.55857652862352,-0.04596121084127014,1.799966831693439,1.845928042534709,10567988394,10562753388.8,27.72578406833547,43.32165310909573,NaN,NaN,8.85524686836157,12.070607448923344
2021-05-27T09:30:00-04:00,420.17,420.72,418.9851,419.29,56707677,77702057.35,57.36802371140921,52.770293262015024,NaN,NaN,89.67535391891411,64.42338817964783,0.06521035869380953,1.927440990901971,1.8622306322081614,10624696071,10566181976.6,28.63745331291331,40.71322774431468,NaN,NaN,9.627705263160301,11.721621422385766
2021-05-28T09:30:00-04:00,420.97,421.25,419.79,420.04,58520164,76351714.05,58.31326261601819,52.759739261887034,NaN,NaN,97.59555942684375,82.31767535041236,0.16235775662742524,2.065177827992443,1.9028200713650176,10683216235,10596630329.6,36.31976283655424,38.658445596645116,NaN,NaN,10.533172323384129,11.551842979671246
2021-06-01T09:30:00-04:00,422.57,422.72,419.2,419.67,54216625,75656130.85,57.634351874080416,53.148961714557444,NaN,NaN,96.07501710953221,85.89282476880979,0.17377661872168026,2.120040844767118,1.9462642260454377,10628999610,10605960017.2,38.50427450940477,36.820721006137504,NaN,NaN,11.119210371243833,11.490038321324473
2021-06-02T09:30:00-04:00,420.37,421.23,419.29,420.33,49097061,73031425.6,58.56113910801558,54.403182212219164,NaN,NaN,81.52406404848104,87.25679471158594,0.1962000214364863,2.1915142528410456,1.9953142314045593,10678096671,10636599396.2,45.157940467249745,36.09737725597006,NaN,NaN,11.858284446552497,11.542644910642762
2021-06-03T09:30:00-04:00,417.85,419.99,416.28,418.77,58138763,73940330.7,55.472216322683295,54.95950259401804,NaN,NaN,38.80174072488401,80.73434704573103,0.08222299198446636,2.0980929713851424,2.015869979400676,10619957908,10646993299,47.24328207971964,35.96141560846979,NaN,NaN,11.721771754516295,11.568234459767552
2021-06-04T09:30:00-04:00,420.75,422.92,418.8422,422.6,55938789,73021201.75,60.922104182979815,55.3958535375882,NaN,NaN,91.33769804411256,81.06681587077071,0.23251748353424118,2.3065168338184776,2.0739993502842364,10675896697,10657233424.2,49.28914117030222,36.315807015998544,NaN,NaN,13.104348730924261,11.787679355647082
2021-06-07T09:30:00-04:00,422.59,422.78,421.19,422.19,51555032,72212263.85,60.074455106073735,55.866006237855274,NaN,NaN,101.08151017658771,81.7640060207195,0.2694567100955192,2.4108202379036356,2.1413635278081165,10624341665,10645458510.2,47.03066144547553,36.77938568378228,NaN,NaN,14.03571524537766,12.108827339894308
2021-06-08T09:30:00-04:00,423.11,423.21,420.32,422.28,47134279,70476355.5,60.20534595006887,56.65341089617935,NaN,NaN,93.7500777549315,81.29901814979937,0.26470532288393045,2.4722451814130295,2.207539858529099,10671475944,10653953777,48.85162295239987,37.513689616867175,NaN,NaN,14.850137406496309,12.500443063694593
2021-06-09T09:30:00-04:00,423.18,423.26,421.41,421.65,48436342,67053773.85,58.7533226950523,57.42672416973544,NaN,NaN,88.76217499463756,82.74664033903068,0.18752010728586876,2.441939992636435,2.254419885350566,10623039602,10642942363.2,46.61470576286511,38.17227813042529,NaN,NaN,15.18726477273194,12.884274736414215
2021-06-10T09:30:00-04:00,422.96,424.63,421.55,423.61,51020147,62864228.9,61.83708083155901,58.044345585081324,NaN,NaN,107.85100276162612,96.55649274637908,0.23384130090766364,2.5467215114851456,2.312880210577482,10674059749,10653762731.4,49.08202677954625,39.14547836041806,NaN,NaN,16.296972475381104,13.371802984838055
2021-06-11T09:30:00-04:00,424.2,424.43,422.82,424.31,45570828,59823072.15,62.903793593142545,58.76970950335317,NaN,NaN,118.65947662446908,102.02084846245039,0.27420245756365524,2.655633282532051,2.3814308249683958,10719630577,10662509507.4,51.051430134860034,40.64611990045309,NaN,NaN,17.528930913187317,13.965678403173664
2021-06-14T09:30:00-04:00,424.43,425.37,423.1,425.26,42358478,57830914.6,64.3597774481758,59.261167228177946,NaN,NaN,122.6522813385501,106.33500269484287,0.3240416330771909,2.786482866314884,2.4624412332376933,10761989055,10690038985.4,56.7247561897542,42.71304850313987,NaN,NaN,18.980586676669816,14.68209387081597
2021-06-15T09:30:00-04:00,425.42,425.46,423.54,424.48,51508508,57149878.95,62.20113338013461,59.69350651220242,NaN,NaN,111.24952247509864,109.83489163887627,0.2660656804219039,2.795023333765073,2.528957653343169,10710480547,10697839906,58.203096467502995,45.03113844120595,NaN,NaN,19.698023557024626,15.398655254560063
2021-06-16T09:30:00-04:00,424.63,424.87,419.92,422.11,80386082,58178671.15,56.04967575870843,59.61826304129302,NaN,NaN,56.372236171108966,103.35690387417057,0.04147598642008532,2.5808026363682757,2.5393266499481904,10630094465,10699250878.6,58.479380709022,47.227823915540704,NaN,NaN,18.71055516029034,15.871783812521532
2021-06-17T09:30:00-04:00,421.67,423.02,419.32,421.97,90949659,57402801.5,55.69925205561185,59.49906506587893,NaN,NaN,24.426324294112693,86.67196818066789,-0.13355175178604384,2.3723869602156356,2.5059387120016794,10539144806,10672267890,51.47223447708815,48.85887971298176,NaN,NaN,17.78921916572759,16.145703148693826
2021-06-18T09:30:00-04:00,417.09,417.8281,414.7,414.92,118676302,59435505.7,41.59603791515723,58.304977587246,NaN,NaN,-163.90068385877277,30.159936084019513,-0.7090154385407343,1.6196694138257612,2.3286848523664956,10420468504,10612435475.4,40.02089323275014,49.1232461698529,NaN,NaN,12.273876619886043,15.592585073149857
2021-06-21T09:30:00-04:00,416.8,421.06,415.93,420.86,72822028,59247674,52.50735354705863,57.93876342103016,NaN,NaN,-59.31223425373206,-6.232967034436913,-0.6746904201488539,1.485321827180428,2.160012247329282,10493290532,10558695770.8,32.93379380917621,48.72535469126514,NaN,NaN,10.960959969737079,14.930924344090888
2021-06-22T09:30:00-04:00,420.85,424,420.08,423.11,57700303,59563854.05,55.87049130818149,57.746574292470584,NaN,NaN,48.708664975269514,-18.741138534402744,-0.49391045266878963,1.542624181493295,2.0365346341620847,10550990835,10526797828.4,29.584882301559063,47.612993393715804,NaN,NaN,11.067062860691154,14.37894413217664
2021-06-23T09:30:00-04:00,423.19,424.05,422.51,422.6,49445414,59163554.95,54.92113308474039,57.70721120404608,NaN,NaN,67.4809729055767,-16.519391187509193,-0.4058231753314918,1.52925566499772,1.9350788403292118,10501545421,10501088019.6,27.18539519240211,46.18028718747884,NaN,NaN,10.841670873327871,13.87361938091253
2021-06-24T09:30:00-04:00,424.89,425.55,424.62,425.1,45110288,59264638.45,58.631931685119625,57.543627454198926,NaN,NaN,133.45781440350825,5.286906834369921,-0.18743543985784794,1.700784540506902,1.88821998036475,10546655709,10502590200.2,27.555107859704393,44.627856236721854,NaN,NaN,11.861926544088476,13.586234689937665
2021-06-25T09:30:00-04:00,425.9,427.0943,425.55,426.61,58129525,59335730.85,60.73439445580067,57.59076597917942,NaN,NaN,164.23623683559185,70.91429097324286,0.03842156857639534,1.936246941085244,1.8978253725088488,10604785234,10539453546.2,36.12602097166971,43.84895334573572,NaN,NaN,13.367701179704733,13.555015617047246
2021-06-28T09:30:00-04:00,427.17,427.65,425.89,427.47,53159581,59067701.7,61.9213933336454,57.71334079229202,NaN,NaN,160.49079963266223,114.8748977505217,0.21555132299719082,2.1672645262553374,1.9517132032581466,10657944815,10572384402.8,42.65314528402364,43.40620494085171,NaN,NaN,14.955106692217127,13.755028627785801
2021-06-29T09:30:00-04:00,427.88,428.56,427.13,427.7,35970515,58155396.2,62.25006951556753,57.96310842232883,NaN,NaN,158.06256171692385,136.74567709885258,0.312157930914581,2.341910616901373,2.029752685986792,10693915330,10600969301.8,47.653532223749686,43.480406830914895,NaN,NaN,16.33534149046453,14.12364475102562
2021-06-30T09:30:00-04:00,427.21,428.78,427.18,428.06,64827858,58941936.05,62.79143363700476,58.031276479860665,NaN,NaN,142.80980896170962,151.81144431007914,0.36081473780301465,2.4807711082405604,2.1199563704375457,10758743188,10652408855.2,55.22044895205569,43.918865557522714,NaN,NaN,17.627464447849793,14.6241904220005
2021-07-01T09:30:00-04:00,428.87,430.6,428.8,430.43,53441027,58707049.25,66.22538578690137,58.26853306512913,NaN,NaN,171.14371816394595,159.3486250621667,0.5043180026305807,2.7503538737257713,2.2460358710951907,10812184215,10705514556.4,61.42076498570981,44.6595323325834,NaN,NaN,19.773607791522533,15.359821474789362
2021-07-02T09:30:00-04:00,431.67,434.1,430.5218,433.72,57697668,58794993.2,70.32028538723128,58.69428363220452,NaN,NaN,201.27963331121737,166.7573043572918,0.7573093195142269,3.1926725204879745,2.4353632009737476,10869881883,10758533886.2,66.41988977659966,45.352041874500934,NaN,NaN,22.978023124920767,16.448135996236704
2021-07-06T09:30:00-04:00,433.78,434.01,430.01,432.93,68710419,59652762.55,68.18260712362755,59.12153175673973,NaN,NaN,159.77914720280063,166.61497387131948,0.8035612739080245,3.439814793358778,2.6362535194507535,10801171464,10787179216,68.77417241557393,46.107118727934576,NaN,NaN,24.99408773526653,17.668986244669536
2021-07-07T09:30:00-04:00,433.66,434.76,431.51,434.46,63549456,60473521.4,70.07965107719976,60.12367285091768,NaN,NaN,155.28778913930728,166.06001935579616,0.8640338985931928,3.7162958926922443,2.8522619940990515,10864720920,10821340334,71.35352440985586,47.026700420851284,NaN,NaN,27.27383503948114,19.041107501071195
2021-07-08T09:30:00-04:00,428.78,431.73,427.52,430.92,97595232,62931465.9,61.01509374354915,60.50337582862749,NaN,NaN,79.32445441399206,153.36294844625266,0.6047248254179758,3.608168025871521,3.003443200453545,10767125688,10823016834,71.47804241391991,48.45568670205355,NaN,NaN,26.524101261304768,20.11010660967599
2021-07-09T09:30:00-04:00,432.53,435.84,430.714,435.52,76238584,64192387.75,66.99009728270698,62.3172372120239,NaN,NaN,130.840450115541,145.30229483657166,0.6766736826040423,3.849285303708598,3.1726116211045556,10843364272,10829252845.4,71.9661678592405,50.737492032517146,NaN,NaN,27.836248158975142,21.213841116718726
2021-07-12T09:30:00-04:00,435.43,437.35,434.97,437.08,52889585,64558325.6,68.73987862961931,63.47670328934966,NaN,NaN,147.3249365855987,134.51135549144792,0.7569289408190985,4.118772797128429,3.3618438563093305,10896253857,10834527240.2,72.39646380756417,53.55625417525914,NaN,NaN,29.47115666531206,22.39345762366063
2021-07-13T09:30:00-04:00,436.24,437.84,435.31,435.59,52911312,65085967.3,65.18570796343275,64.1420759075819,NaN,NaN,125.22634618219071,127.60079528732595,0.6418143082152405,4.164111741578381,3.5222974333631405,10843342545,10842961456.4,73.10731027193441,56.66499903028595,NaN,NaN,29.679887410454818,23.434376164631228
2021-07-14T09:30:00-04:00,437.4,437.92,434.91,436.24,64130352,65717059.5,66.01131920442154,64.93423205898769,NaN,NaN,112.06718101932917,118.95667366333032,0.5453870881845733,4.204031293593857,3.658644205409284,10907472897,10851511851.8,73.84272074015719,59.997665140839885,NaN,NaN,30.09747183888351,24.3862469752387
2021-07-15T09:30:00-04:00,434.81,435.53,432.72,434.75,55126358,64454073.3,62.360540605988305,65.20056126762117,NaN,NaN,76.32774599976514,118.35733198048493,0.3279148024676184,4.068537708493807,3.7406229060261884,10852346539,10868556022,75.2931207884791,63.40752320718093,NaN,NaN,29.352660433109634,25.095734612077404
2021-07-16T09:30:00-04:00,436.01,436.06,430.92,431.34,75874662,63700323.45,54.879984904220585,64.78238915679403,NaN,NaN,49.99956200210844,102.18915435779842,-0.07730322751079877,3.64399387163769,3.721297099148489,10776471877,10855177543,71.92201304373478,65.964379783757,NaN,NaN,26.319423076407595,25.27054724983886
2021-07-19T09:30:00-04:00,426.19,431.4089,421.97,424.97,147987000,65165858.35,44.210980922003564,63.51735969881961,NaN,NaN,-56.70842020180275,61.38248300031813,-0.7676785492382256,2.761698912600707,3.5293774618389326,10628484877,10801623747,60.28604925597466,67.22387292461065,NaN,NaN,19.65429208005885,24.46822508272743
2021-07-20T09:30:00-04:00,425.68,432.42,424.83,431.06,99608174,66505165.65,53.515262060947514,62.893444880632465,NaN,NaN,-13.931989218849203,33.55081592011016,-0.8036765359958844,2.5247817918440774,3.3284583278399618,10728093051,10778573848.2,56.08056192003956,67.82580361720278,NaN,NaN,17.26202202070358,23.438767502438306
2021-07-21T09:30:00-04:00,432.34,434.7,431.0111,434.55,64724389,66856369.95,57.85327416109027,62.54071920378143,NaN,NaN,51.11444139550671,21.360267995345662,-0.591730597173791,2.588795081372723,3.180525678546514,10792817440,10755642756.8,52.180695307993204,67.6086783569126,NaN,NaN,16.95214492575838,22.512107134341175
2021-07-22T09:30:00-04:00,434.74,435.72,433.69,435.46,47878539,66778026.2,58.92951834363548,62.01958581497673,NaN,NaN,74.23374641765686,20.941468078924,-0.39878966453128273,2.6820385978824106,3.0808282624136933,10840695979,10753312644.8,51.786608748703266,66.92052433998357,NaN,NaN,17.0888634495732,21.73735803651718
2021-07-23T09:30:00-04:00,437.52,440.3,436.79,439.94,63766637,67710843.65,63.82680126314199,61.555765520398914,NaN,NaN,146.61560475334045,40.2646766291704,0.0008629980584116126,3.0819070099867076,3.081044011928296,10904462616,10778910792.6,55.7411684356819,66.15775852991801,NaN,NaN,18.944828144056675,21.338425194737106
2021-07-26T09:30:00-04:00,439.31,441.03,439.26,441.02,43719187,66990326.75,64.9129824518198,61.32222090098408,NaN,NaN,163.41175338838136,84.28871134720723,0.29214609141252135,3.4462266261939476,3.1540805347814262,10948181803,10842850177.8,63.741151379101176,65.79825702731281,NaN,NaN,20.75518090796525,21.255104582341126
2021-07-27T09:30:00-04:00,439.91,439.94,435.99,439.01,67397137,67702204.55,61.22810406211804,60.68996754276396,NaN,NaN,108.68301237135256,108.81171166524757,0.3023732559271157,3.532047104690321,3.229673848763205,10880784666,10873388500.8,66.82544447129565,65.47482274598708,NaN,NaN,21.034112201586602,21.223534242233338
2021-07-28T09:30:00-04:00,439.68,440.3,437.31,438.83,52472360,68527296.8,60.89472951936787,60.68137009817958,NaN,NaN,108.90489789759572,120.36980296566537,0.252001039312046,3.5446751479032628,3.292674108591217,10828312306,10880487474,67.51716488936808,65.19190292280481,NaN,NaN,21.152485598256547,21.21338443595094
2021-07-29T09:30:00-04:00,439.815,441.8,439.81,440.65,47435342,67657671,63.08343093876197,60.4023225021835,NaN,NaN,135.23725627753635,132.57050493764126,0.2933478657332538,3.659358940757784,3.36601107502453,10875747648,10887497807.8,68.22182911337595,64.92445015524306,NaN,NaN,21.909087937401125,21.312770650443824
2021-07-30T09:30:00-04:00,437.91,440.06,437.77,438.51,68951202,68433179.75,58.90843749613235,59.70007670693443,NaN,NaN,83.34292218025101,119.91596842302337,0.13662839463098697,3.536796568313264,3.400168173682277,10806796446,10867964573.8,64.05233468296952,64.32844093205773,NaN,NaN,21.303156615617127,21.311397216897152
2021-08-02T09:30:00-04:00,440.34,440.93,437.21,437.59,58783297,68487461.2,57.15710168494139,59.126604829899335,NaN,NaN,70.94521125313784,101.42265999597468,-0.058473554826277585,3.32707623014943,3.3855497849757077,10748013149,10827930843,56.438984208537356,63.137846213243655,NaN,NaN,20.294416522408227,21.16611426054159
2021-08-03T09:30:00-04:00,438.44,441.28,436.1,441.15,58053896,67954635.05,61.87983623894434,58.83149890379382,NaN,NaN,82.3086220916818,96.14778194004053,0.018631075419524024,3.4088386292501127,3.3902075538305887,10806067045,10812987318.8,53.86526417744384,61.7108850301927,NaN,NaN,20.817975686519162,21.116380178538385
2021-08-04T09:30:00-04:00,439.78,441.1243,438.73,438.98,46732212,67113772.85,57.70425488158781,58.49890706633665,NaN,NaN,77.13837002110827,89.79447636474303,-0.10341011348615137,3.2609449119728993,3.3643550254590506,10759334833,10799191824.2,51.52909877203773,60.01345488616118,NaN,NaN,20.000709019196492,20.956998584346685
2021-08-05T09:30:00-04:00,440.22,441.85,439.88,441.76,38969659,64182494.2,61.30651740364804,58.957945102010044,NaN,NaN,103.15148529668369,83.3773221685725,-0.027741314490620006,3.329678382345776,3.357419696836396,10798304492,10783703193,48.961596640585554,58.37342514307909,NaN,NaN,20.39877629560528,20.877252543097914
2021-08-06T09:30:00-04:00,442.1,442.94,441.8,442.49,46930008,62717065.4,62.216521536960464,60.24405514593553,NaN,NaN,116.19445855278705,89.9476294430797,0.037118608403277964,3.403817957340493,3.3666993489372152,10845234500,10791390803.8,50.285642803448575,57.659110396470076,NaN,NaN,20.99160472133391,20.893588568560197
2021-08-09T09:30:00-04:00,442.46,442.795,441.31,442.13,41222585,62133715.4,61.44901026715138,60.81075144637867,NaN,NaN,97.69287161531649,95.29716151551546,0.02215781844726239,3.394396621996293,3.3722388035490307,10804011915,10802590557,52.229944008080565,57.38406625990159,NaN,NaN,21.261861480558508,20.946198984559956
2021-08-10T09:30:00-04:00,442.61,443.44,441.88,442.68,43339275,61655113.55,62.21590011306696,61.12236758580558,NaN,NaN,99.05034482847434,98.64550606287395,0.015974793315928437,3.3922072951939413,3.376232501878013,10847351190,10810847386,53.66856691656261,57.49034280337082,NaN,NaN,21.69647509489915,21.053381286036984
2021-08-11T09:30:00-04:00,443.82,443.882,442.62,443.78,44034340,60650312.95,63.7682905515762,61.46799417208705,NaN,NaN,103.84088156636912,103.98600837192612,0.05068093083181813,3.4395836654177856,3.3889027345859675,10891385530,10837257525.4,58.023118860451014,57.9358078113528,NaN,NaN,22.488640107389635,21.258418260515935
2021-08-12T09:30:00-04:00,443.62,445.2572,442.66,445.11,38942418,59841115.95,65.60817576948429,61.59523520825436,NaN,NaN,114.649431536582,106.28559761990577,0.12375880084753232,3.543601235645383,3.4198424347978507,10930327948,10863662216.6,61.88064088949423,58.37434155805369,NaN,NaN,23.67443534293544,21.603563558004435
2021-08-13T09:30:00-04:00,445.59,445.94,445.07,445.92,39470251,58020895.4,66.71670285439427,61.72407237986682,NaN,NaN,133.24140975675064,109.69498786069849,0.1835892101822818,3.649328947525703,3.465739737343421,10969798199,10888574956.4,65.13601123384535,58.473974404821135,NaN,NaN,24.98457162098435,22.08656470985871
2021-08-16T09:30:00-04:00,444.53,447.11,442.87,446.97,73930864,54318088.6,68.1498523962355,62.21848297516093,NaN,NaN,130.7125123068338,116.29891599900195,0.24687776125579575,3.774336938913166,3.52745917765737,11043729063,10936518386,70.37867066381412,58.72777627571531,NaN,NaN,26.501891632387682,22.71732569879142
2021-08-17T09:30:00-04:00,444.24,444.96,440.85,444.04,92673933,53971376.55,60.34174088381647,62.178983786907246,NaN,NaN,70.4414962756666,110.57714628844039,0.05445913179868844,3.5955330924057307,3.5410739606070423,10951055130,10957259174,72.31800546091424,59.07069345939717,NaN,NaN,25.7153372101953,23.145613057563402
2021-08-18T09:30:00-04:00,442.96,444.625,438.92,439.18,89351931,55202753.65,50.09023845318791,61.250898609366246,NaN,NaN,-3.358762264991885,89.1372175221682,-0.4114371165762396,3.0267775648867428,3.4382146814629824,10861703199,10951322707.8,70.8874489343043,59.26109487517777,NaN,NaN,21.734095068738394,22.9439676305884
2021-08-19T09:30:00-04:00,436.27,441.14,436.12,439.86,92812246,57449439,51.33599969904597,60.710010195288646,NaN,NaN,-73.67528788053338,51.47227363874513,-0.6698331811863811,2.600923204980006,3.2707563861663873,10954515445,10956160207.2,71.3842036829128,59.784799803745145,NaN,NaN,18.87094642365165,22.362107458168865
2021-08-20T09:30:00-04:00,440.23,443.71,439.71,443.36,72008712,57861542.75,57.25057319015257,60.716686731375155,NaN,NaN,30.26302824473239,30.87659733634148,-0.6031341045941567,2.5168387554236915,3.1199728600178482,11026524157,10967505398.8,72.5664797481316,60.936763770859024,NaN,NaN,18.16238444027013,21.762147027040474
2021-08-23T09:30:00-04:00,445.16,448.23,443.4355,447.26,54973038,58424235.3,62.691847447677226,60.774687531998936,NaN,NaN,144.96094430585705,33.72628373614616,-0.3092664372928384,2.7333898134018,3.0426562506946384,11081497195,10975059025.2,73.35578384936025,62.32894374742448,NaN,NaN,19.33933320103724,21.416030766182867
2021-08-24T09:30:00-04:00,447.97,448.54,447.42,447.97,38744714,56991614.15,63.60018633173264,61.19582549272356,NaN,NaN,173.3680873281041,54.311601946633665,-0.09129239384480226,2.9285407583886354,3.0198331522334376,11120241909,11008896381,76.6032455469848,64.11995423134927,NaN,NaN,20.56332066830013,21.294215037913904
2021-08-25T09:30:00-04:00,448.17,449.457,447.77,448.91,40529711,56394481.7,64.82135990394286,61.44688567131605,NaN,NaN,167.4564119576812,88.4746367911683,0.08257257344340108,3.1230488690376887,3.0404762955942877,11160771620,11068710065.2,81.00947310622108,66.40908826460894,NaN,NaN,21.935067105609676,21.385765333299016
2021-08-26T09:30:00-04:00,448.61,448.86,446.16,446.26,57829572,56914193.2,58.82931910051265,61.204942640141205,NaN,NaN,106.95473518025622,124.6006414033262,-0.0096170752570508,3.028454951522974,3.038072026780025,11102942048,11098395385.8,82.74616515344961,68.72769700389473,NaN,NaN,21.276446462656285,21.370148351778624
2021-08-27T09:30:00-04:00,447.12,450.65,447.06,450.25,77235113,57328388.75,64.1959366456212,61.40115166717476,NaN,NaN,143.44028496339962,147.23609274705964,0.16003933780542923,3.2381211990368115,3.0780818612313823,11180177161,11129125986.6,84.34249405669479,71.02145057879575,NaN,NaN,22.44015307312825,21.523006169114286
2021-08-30T09:30:00-04:00,450.97,453.07,450.71,452.23,48357355,56807091.65,66.52765310433733,61.70913402369407,NaN,NaN,176.91873334236595,153.62765055436142,0.3562838537660924,3.5234366784389977,3.1671528246729053,11228534516,11158533450.8,85.70544031608154,73.30979867876138,NaN,NaN,24.15672038794099,21.8992510575181
2021-08-31T09:30:00-04:00,452.13,452.49,450.92,451.56,59300213,56869407.5,64.98540742160176,61.796070942981615,NaN,NaN,146.21522581961565,148.19707825266374,0.38897696363244894,3.6533740292134667,3.2643970655810177,11169234303,11168331929.6,86.13840755512327,75.3180335855237,NaN,NaN,25.063454275306114,22.351280088630674
2021-09-01T09:30:00-04:00,452.56,453.11,451.545,451.8,48721378,56968865.8,65.29575976109128,61.773755513810684,NaN,NaN,138.5338988807619,142.41257563727987,0.37463291072622606,3.7326882039888005,3.3580552932625745,11217955681,11179768741.8,86.64680173160117,77.08704507424561,NaN,NaN,25.88534865198081,22.85614702625212
2021-09-02T09:30:00-04:00,453.32,454.05,451.91,453.19,42830867,57161926.2,67.11381741649443,61.80212083967498,NaN,NaN,137.12148037017005,148.44592467526263,0.40409526361744863,3.8631743727843855,3.459079109166937,11260786548,11211337641.8,87.9595168821366,78.71729547769499,NaN,NaN,27.10897665064391,23.46369411545095
2021-09-03T09:30:00-04:00,451.98,453.63,451.55,453.08,47234364,57177144,66.8155093737847,61.70681062378564,NaN,NaN,115.27422182384852,142.81271204735242,0.36282264719627566,3.912607418162281,3.5497847709660055,11213552184,11218012646.4,88.2231447638769,79.99190077055663,NaN,NaN,28.031197132128895,24.11619454640494
2021-09-07T09:30:00-04:00,452.71,452.81,450.7423,451.46,51671534,57699591.45,62.41551054818139,61.854937028383134,NaN,NaN,85.55187412749001,124.53934020437723,0.18218668255764836,3.777518124163066,3.595331441605418,11161880650,11204681873.2,84.25548813831966,80.844578104657,NaN,NaN,27.620673181939736,24.61683435148134
2021-09-08T09:30:00-04:00,450.89,451.67,448.86,450.91,56181907,58341723.05,60.94804664739794,62.63049475654099,NaN,NaN,57.430815277711005,106.7824580959963,-0.008460633091039504,3.5847556502416182,3.5932162833326577,11105698743,11191974761.2,80.53735358886769,81.53385700855439,NaN,NaN,26.877720889294633,24.939818142597524
2021-09-09T09:30:00-04:00,450.7,452.57,448.72,448.98,57970407,59038526.4,55.97472896763839,62.96183256144045,NaN,NaN,45.21566285974781,88.11881089179347,-0.2834379148588191,3.238918889759134,3.522356804617953,11047728336,11157929292.2,71.44092120812064,81.53790826035495,NaN,NaN,24.82801817608147,24.923846718809518
2021-09-10T09:30:00-04:00,451.04,451.49,445.31,445.44,89948174,61588814.2,48.20494970685237,62.315716598347585,NaN,NaN,-9.218809862564981,58.850752845246475,-0.6989572485633602,2.6486602439137528,3.347617492477113,10957780162,11097328015,58.72605709817408,80.54930664250085,NaN,NaN,20.56253300322254,24.300801902297092
2021-09-13T09:30:00-04:00,448.64,448.92,444.11,446.58,83738649,63802234.1,50.58382711402002,61.45085800308636,NaN,NaN,-28.101775500744317,30.17555338032791,-0.8805236759632749,2.2469628975230194,3.127486573486294,11041518811,11062921340.4,52.96264170262866,79.09265363202,NaN,NaN,17.682544126138414,23.355336505702994
2021-09-14T09:30:00-04:00,448.12,448.34,443.22,444.17,78197140,64015547.9,45.79530364605969,60.179080668395436,NaN,NaN,-53.6351440955265,2.3381497357246075,-1.130480756947327,1.7143856273021356,2.8448663842494626,10963321671,11023209544.6,47.204362415088475,76.99273340831314,NaN,NaN,13.686980155701855,21.97414274141712
2021-09-15T09:30:00-04:00,444.62,448.41,443.44,447.88,78792222,63321462.35,53.14819008713021,59.34528282433739,NaN,NaN,-31.6765266229523,-15.483318644408048,-1.0170599145492178,1.5735414910629402,2.590601405612158,11042113893,11010492574.6,45.49840546954429,74.45622857712193,NaN,NaN,12.436508227201927,20.61162352510066
2021-09-16T09:30:00-04:00,447.32,448.36,444.02,447.17,77786735,62743202.55,51.702738300496,58.8362413386219,NaN,NaN,-42.77120098441422,-33.08069141324046,-0.9615825263516706,1.3886232476725695,2.35020577402424,10964327158,10993812339,43.28855815385551,71.63782807715094,NaN,NaN,10.983741244653023,19.236211770750998
2021-09-17T09:30:00-04:00,444.92,445.37,441.02,441.4,118425037,64023842.1,41.76237111898994,57.233843801005385,NaN,NaN,-148.00435730936582,-60.83780090260062,-1.266056926888866,0.7676346154131579,2.033691542302024,10845902121,10971436730.8,40.45034094073029,68.50267428315348,NaN,NaN,6.160112817250419,17.368197634536628
2021-09-20T09:30:00-04:00,434.88,436.56,428.86,434.04,166445534,68745683.2,33.037122985888686,54.84166307825905,NaN,NaN,-318.25686644029565,-118.8688190905109,-1.8787655696204872,-0.3147654197235852,1.564000149896902,10679456587,10899024286,32.92647860709228,64.7327484467971,NaN,NaN,-1.6963372870724611,14.64469264573533
2021-09-21T09:30:00-04:00,436.53,437.91,433.07,433.63,92526112,70623336.9,32.628167491971155,52.53043165471401,NaN,NaN,-224.77789549473675,-153.09736937035294,-2.2047354140638076,-1.1919191176828576,1.01281629638095,10586930475,10823746046.8,27.251653976374058,60.526551762600725,NaN,NaN,-7.6709511648826805,11.456743529932757
2021-09-22T09:30:00-04:00,436.05,440.03,433.747,437.86,102350143,73803608.35,40.773867219699,50.77886790175741,NaN,NaN,-151.27984597522533,-177.01803324080754,-2.032756058813586,-1.5281287771360326,0.5046272816775534,10689280618,10753179391.8,23.212868924311195,55.99555656208002,NaN,NaN,-9.758655020382148,8.4259723084592
2021-09-23T09:30:00-04:00,439.85,444.89,439.6,443.18,76395981,75596921.85,49.10791900135796,49.492732300676245,NaN,NaN,-61.19559506649444,-180.70291205722359,-1.4834929182556351,-1.3497388661419905,0.13375405211364466,10765676599,10713449280,21.298960227373968,51.23408822959697,NaN,NaN,-8.390449710857883,6.023626305699617
2021-09-24T09:30:00-04:00,441.44,444.67,441.21,443.91,62094837,75810185.1,50.14461355449778,48.301954027870025,NaN,NaN,-45.97241407466036,-160.2965234102825,-1.0160907881932304,-1.1363594331278932,-0.12026864493466294,10827771436,10709823143,21.127740205076165,46.441559332539775,NaN,NaN,-6.993243353257079,4.164073497277232
2021-09-27T09:30:00-04:00,442.81,444.05,441.9,442.64,61371108,75016984.85,48.30119470424553,47.29378861044604,NaN,NaN,-46.07862729523702,-105.86087558127076,-0.7498189967964481,-1.057542390930223,-0.307723394133775,10766400328,10727211891.2,24.271603835104827,42.15699616802443,NaN,NaN,-6.4943297532303506,2.6414444614904347
2021-09-28T09:30:00-04:00,439.69,440.04,432.94,433.72,130436306,79120932.4,37.79245458518169,45.63981774885917,NaN,NaN,-128.70532925101048,-86.64636233252551,-1.1100663514700717,-1.6953063334713647,-0.585239982001293,10635964022,10737018600.6,26.061588064973435,38.26587005917484,NaN,NaN,-9.944958648474197,0.8433868743526303
2021-09-29T09:30:00-04:00,435.19,437.04,433.85,434.45,82329213,80272382.4,38.96284234104617,44.424682989816866,NaN,NaN,-117.51521974324218,-79.8934370861289,-1.2257484859963634,-2.1174255894967473,-0.8916771035003839,10718293235,10742821124,27.158688730912502,35.10285345365996,NaN,NaN,-12.140635190818486,-1.0114734206718148
2021-09-30T09:30:00-04:00,436.02,436.77,428.78,429.14,140505979,84861612.45,33.95805271396274,43.40704749032475,NaN,NaN,-142.104708090728,-96.0752596909756,-1.5647425906181645,-2.8476053417730895,-1.282862751154925,10577787256,10705243255.4,24.61174849173497,32.6661171246286,NaN,NaN,-15.805803508076737,-3.1249491474439464
2021-10-01T09:30:00-04:00,430.98,436.0329,427.23,434.24,129240106,89182074.4,41.70336639088584,42.772728867243735,NaN,NaN,-116.0754677000888,-110.09587041606127,-1.3580254354778032,-2.980394545502179,-1.6223691100243758,10707027362,10681094440.6,23.111748940157796,30.53391049873782,NaN,NaN,-16.047051788315038,-4.9709638104255305
2021-10-04T09:30:00-04:00,433,433.96,426.36,428.64,128569957,93248854.05,36.62422689285545,42.11765195630057,NaN,NaN,-127.93887113535808,-126.46791918408549,-1.4998572779400352,-3.4971907074494197,-1.9973334295093845,10578457405,10643505856,20.969447929025264,28.65998803544759,NaN,NaN,-18.117294187904395,-6.849011007208225
2021-10-05T09:30:00-04:00,430.24,435.49,429.39,433.1,90682520,95199403.35,42.618323959909,41.36551866149905,NaN,NaN,-84.28465285304999,-117.58378390449339,-1.20729364390347,-3.506450484388722,-2.299156840485252,10669139925,10650141036.6,22.33792687458778,27.00566813580784,NaN,NaN,-17.59123587413841,-8.383614559626823
2021-10-06T09:30:00-04:00,429.27,435.1199,427.54,434.9,113032245,98041920.25,44.88401358255505,40.87846689593185,NaN,NaN,-77.45240094668132,-109.57122014518123,-0.82479932930113,-3.3301560021116643,-2.5053566728105343,10782172170,10662916823.6,25.029780762070644,25.701469750680353,NaN,NaN,-16.397257768021024,-9.528420732254565
2021-10-07T09:30:00-04:00,438.39,441.68,438.2,438.66,72437499,98765274.85,49.380231615680074,41.422599788552574,NaN,NaN,7.619083978394594,-79.62646173135671,-0.27902668478645953,-2.8541400287936085,-2.575113344007149,10854609669,10718281306.2,35.46840303271759,25.345617042965156,NaN,NaN,-13.872032096458947,-10.14893664142662
2021-10-08T09:30:00-04:00,439.48,439.89,437.19,437.86,74557404,97995736.35,48.47415104893724,42.52524465019889,NaN,NaN,-1.694236852113959,-56.75021556176174,0.05010276106577205,-2.5124848926749337,-2.5625876537407057,10780052265,10732886286.8,37.92386652889313,25.702573323093787,NaN,NaN,-12.187922627103228,-10.440220353666135
2021-10-11T09:30:00-04:00,437.16,440.26,434.62,434.69,65233285,97070468.15,44.95419021806591,43.40567484491995,NaN,NaN,-20.520266565029786,-35.26649464769609,0.0748288800852599,-2.469051553634131,-2.5438804337193908,10714818980,10760158601.8,42.33621607906458,26.780042044714538,NaN,NaN,-11.89264441176116,-10.647709504822567
2021-10-12T09:30:00-04:00,435.67,436.1,432.78,433.62,71181163,96719669.3,43.79809906081648,43.62169140499977,NaN,NaN,-49.76181508695736,-28.361927094477572,0.04131125096451749,-2.492241370013744,-2.5335526209782615,10643637817,10755058180.2,41.738695484382305,28.1033153704339,NaN,NaN,-12.004709659588064,-10.841566669789067
2021-10-13T09:30:00-04:00,434.71,436.05,431.54,435.18,72973979,96428757.15,45.97935762126004,43.39822273499278,NaN,NaN,-43.30133367710447,-21.531713640562202,0.14079091752525308,-2.357563974071695,-2.4983548915969482,10716611796,10741946105.4,40.16911660678745,29.45118368324915,NaN,NaN,-11.452311959710084,-10.92881599692064
2021-10-14T09:30:00-04:00,439.08,442.66,438.58,442.5,70236825,96051261.65,54.836862744546195,43.73338339142481,NaN,NaN,88.9376504237515,-5.268000351490815,0.685684676539553,-1.6412490459225069,-2.32693372246206,10786848621,10728393895.8,38.555308717005715,30.696010005529825,NaN,NaN,-8.053948612726773,-10.518120656321516
2021-10-15T09:30:00-04:00,444.75,446.26,444.09,445.87,66260210,93443020.3,58.23230016268258,44.44274806702746,NaN,NaN,156.97143057142236,26.465133133216455,1.2275485421996573,-0.7924980447124881,-2.0200465869121453,10853108831,10743005209,41.29377580570877,31.911879432001538,NaN,NaN,-4.110854036756022,-9.602796853526446
2021-10-18T09:30:00-04:00,443.97,447.55,443.27,447.19,62213228,88231405,59.51617268806513,45.99444221723342,NaN,NaN,142.1966568569241,59.00851781760723,1.6054838879171718,-0.013191727015680499,-1.6186756149328523,10915322059,10783105824.8,48.126796050609826,33.48796571668986,NaN,NaN,-0.5327586225493802,-8.307077106244009
2021-10-19T09:30:00-04:00,448.92,450.71,448.27,450.64,46996827,85954940.75,62.73987889443974,47.69280197104724,NaN,NaN,168.9779252642616,102.75646588785102,1.9931324192219204,0.8727399090945482,-1.1203925101273722,10962318886,10846842038.6,56.744470668144025,35.601235855063535,NaN,NaN,3.5290403036711075,-6.6162031905418495
2021-10-20T09:30:00-04:00,451.13,452.732,451.01,452.41,49571569,83316012.05,64.31009053502686,49.86080467255183,NaN,NaN,164.58627696899322,144.33398801707057,2.2547913833409425,1.6980967190488059,-0.5566946642921365,11011890455,10905897770.4,62.895333347118175,38.33577763044805,NaN,NaN,7.356031455422782,-4.620169669689759
2021-10-21T09:30:00-04:00,451.77,453.829,451.31,453.59,41305438,81561484.9,65.35820272179635,51.55043583904544,NaN,NaN,152.64893812625488,157.07624555757124,2.3809743849889387,2.419523316944037,0.03854893195509823,11053195893,10959167224.8,67.3986351989045,41.49912664892998,NaN,NaN,10.814957033721706,-2.4151515692024073
2021-10-22T09:30:00-04:00,453.13,454.67,451.05,453.12,58845088,81398997.45,64.54513564396791,53.544786464124904,NaN,NaN,134.93376810283812,152.66871306385437,2.304903088967575,2.919677793164567,0.614774704196992,10994350805,10987415619.6,69.51180523151328,44.966437884821985,NaN,NaN,13.429985369065609,-0.15156057802126233
2021-10-25T09:30:00-04:00,454.28,455.9,452.39,455.55,45214507,80591167.4,66.84186325994256,55.27503927127015,NaN,NaN,131.71779947868552,150.57294158820667,2.2858683852207697,3.472110185722954,1.1862418005021844,11039565312,11012264270.2,71.27558200100324,48.461984679565944,NaN,NaN,16.35253063538319,2.2061667381793733
2021-10-26T09:30:00-04:00,457.2,458.49,455.56,455.96,56075116,76873107.9,67.22761156318361,56.87101055560077,NaN,NaN,128.5309879439561,142.48355412414557,2.169459305807757,3.898065932761881,1.7286066269541238,11095640428,11038928578.6,73.07557393958302,51.893827049388264,NaN,NaN,18.883519949467406,4.588645768363378
2021-10-27T09:30:00-04:00,456.45,457.16,453.86,453.94,72437997,76378547.1,63.319189556947144,57.866650408548416,NaN,NaN,100.1133584675446,129.58897042385587,1.8380986508106458,4.026229940467431,2.188131289656785,11023202431,11041190973.8,73.22886223028124,54.59100270635709,NaN,NaN,20.036250460160453,6.795446438620102
2021-10-28T09:30:00-04:00,455.46,458.4,455.45,458.32,51437944,71925145.35,67.70363647998823,59.24018508219492,NaN,NaN,106.35633625805066,120.33045005021499,1.7936246354226535,4.430162083935102,2.636537448512448,11074640375,11045479870.2,73.53645233521247,57.134758835379905,NaN,NaN,22.359751638373215,9.018918610013404
2021-10-29T09:30:00-04:00,455.87,459.56,455.56,459.25,70162424,68971261.25,68.56287210996405,60.926519503044794,NaN,NaN,101.71691840219016,113.68708011008542,1.7070380356723098,4.770334993102836,3.0632969574305258,11144802799,11075570269,75.65026654920474,59.514333868961344,NaN,NaN,24.537395708452014,11.235843909790349
2021-11-01T09:30:00-04:00,460.3,460.7021,458.2,460.04,48433642,64964445.5,69.3098143077206,62.74878487782365,NaN,NaN,104.04296901772426,108.15211401789315,1.58576993862042,5.045509380706051,3.4597394420856307,11193236441,11106304494.8,77.61687743777773,62.07706115134673,NaN,NaN,26.568931770749067,13.42628503278445
2021-11-02T09:30:00-04:00,460.22,462.23,460.08,461.9,48908417,62875740.35,71.053661044214,64.53980655089178,NaN,NaN,107.7096171199384,103.98783985308962,1.5137918348121535,5.3519792356008224,3.838187400788669,11242144858,11135605380.8,79.33079948284254,64.8743242139221,NaN,NaN,28.814062786463708,15.624538997595772
2021-11-03T09:30:00-04:00,461.3,465.15,460.83,464.72,52509825,59849619.35,73.51115607674248,65.87368464604867,NaN,NaN,116.77935514379506,107.32103918833973,1.5342956744677059,5.756056993873301,4.221761319405595,11294654683,11189895831.2,82.07029673658067,67.98253764389173,NaN,NaN,31.50654421225534,17.893396885404282
2021-11-04T09:30:00-04:00,465.36,467,464.99,466.91,52847087,58870098.75,75.26726269623383,67.09046768415946,NaN,NaN,127.77261628666066,111.60429519406173,1.5679884610543748,6.181746895723563,4.6137584346691884,11347501770,11244468110.2,84.32000607267727,71.05583980581807,NaN,NaN,34.3462605902138,20.243805986091356
2021-11-05T09:30:00-04:00,469.28,470.65,466.92,468.53,66390563,58461756.7,76.50795552766374,68.30416645841652,NaN,NaN,137.74064664179434,118.80904084198255,1.568231761267275,6.574048136253282,5.005816374986007,11413892333,11298286017,86.1637893388161,73.7727678978328,NaN,NaN,37.12512717548492,22.655423298861866
2021-11-08T09:30:00-05:00,469.7,470.23,468.2031,468.93,50405194,57720352.15,76.81718994571192,69.30968867636453,NaN,NaN,131.42176463590607,124.28479996561892,1.4660649499839602,6.838397562465957,5.372332612481997,11464297527,11352498234.2,87.72908370875714,75.98595454359088,NaN,NaN,39.51930550899624,25.06454932888106
2021-11-09T09:30:00-05:00,469.32,469.57,465.88,467.38,51149147,56718751.35,72.81721329952381,69.91734030240004,NaN,NaN,110.63866173099726,124.87060888783068,1.1772793148786267,6.843931756080281,5.666652441201654,11413148380,11386698938.6,88.60491225424923,77.82235303695737,NaN,NaN,40.51083343281498,27.271161343728764
2021-11-10T09:30:00-05:00,465.58,467.38,462.04,463.62,69429653,56541535.05,64.0978754694215,69.8273169272304,NaN,NaN,74.13970471018276,116.34267880110824,0.6429429418621293,6.470331118529316,5.827388176667187,11343718727,11396511747.4,88.85079550871154,79.3546502019436,NaN,NaN,38.88333115851311,28.93004274584081
2021-11-11T09:30:00-05:00,465.21,465.29,463.75,463.77,34848495,54772118.55,64.28162626360495,69.80849482863304,NaN,NaN,66.0452493434181,103.99720541245972,0.23077258756232943,6.115853911120098,5.885081323557769,11378567222,11402724837.8,89.01245857930711,80.74755401250029,NaN,NaN,37.598652663011656,30.168415591150932
2021-11-12T09:30:00-05:00,465.12,467.86,464.11,467.27,53466654,54132440.75,68.35185490071427,69.91635137440245,NaN,NaN,81.35138490492022,92.7193530650849,0.13004337447836356,6.047635541655723,5.917592167177359,11432033876,11406353146.4,89.11174876083098,82.02156592391657,NaN,NaN,37.5899230722368,31.22863094559177
2021-11-15T09:30:00-05:00,468.64,468.81,466.23,467.43,46980500,53370804.35,68.52841087702494,70.0092656111054,NaN,NaN,85.66974719469877,83.56894957684344,0.01635243458135971,5.938032710404059,5.921680275822699,11479014376,11409296516.2,89.19703404124286,83.17309878832084,NaN,NaN,37.63116558317639,32.143278750961
2021-11-16T09:30:00-05:00,467.15,470.485,467.07,469.28,48857502,53463838.1,70.57260620686459,70.52736680038522,NaN,NaN,95.14779926427998,80.4707770835,0.008311783708832898,5.9320700054587405,5.923758221749908,11527871878,11432241215.8,89.86356945260228,84.36129216134377,NaN,NaN,38.23315405246054,33.01326093688951
2021-11-17T09:30:00-05:00,469,469.19,467.48,468.14,47858289,53378174.1,67.65632158801745,70.52398716524445,NaN,NaN,79.55078389919754,81.55299292130294,-0.12392156763531936,5.768856262205759,5.892777829841078,11480013589,11459500188.2,90.60518723721549,85.58048751148684,NaN,NaN,37.93595316989445,33.716502684461645
2021-11-18T09:30:00-05:00,469.24,470.01,466.34,469.73,50625607,53844182.55,69.54652098959565,70.59424779950385,NaN,NaN,79.38024878137918,84.21999280889516,-0.1525599422983861,5.702077901968096,5.854637844266482,11530639196,11489914583,91.36436543184395,86.70292314596108,NaN,NaN,38.19630959287338,34.35647509994904
2021-11-19T09:30:00-05:00,469.61,470.94,468.5,468.89,57315573,53767706.8,67.30854581812486,70.45130005024701,NaN,NaN,85.50119222959012,85.04995427382914,-0.2694949297321081,5.517769182101347,5.787264111833455,11473323623,11498172532.4,91.56370121683467,87.69912484446515,NaN,NaN,37.80431673662491,34.849023905188446
2021-11-22T09:30:00-05:00,470.89,473.54,467.35,467.57,72761954,55145079.15,63.83238200638398,69.93549440468772,NaN,NaN,81.38255322298193,84.19251547948576,-0.46566084336800806,5.205188057623445,5.670848900991453,11400561669,11482481991,87.4339716218294,88.2779228543928,NaN,NaN,36.509526427610645,35.08623855124876
2021-11-23T09:30:00-05:00,467.22,469.095,464.45,468.19,73206538,56001650.25,64.75315529687623,69.30992292041155,NaN,NaN,39.305477227936706,73.02405107221712,-0.5763362221859847,4.950428623258972,5.526764845444957,11473768207,11471661256.8,84.60014757965683,88.45862648604108,NaN,NaN,35.651404510941795,35.16697654549063
2021-11-24T09:30:00-05:00,466.06,469.57,465.19,469.44,61858813,55472691.05,66.59940329902493,68.69079010632521,NaN,NaN,49.780346412565656,67.06996357489075,-0.5861072887305783,4.794130734531734,5.380238023262312,11535627020,11482783943,85.1335293766625,88.5167352934686,NaN,NaN,35.38900684560372,35.1986951597925
2021-11-26T09:30:00-05:00,462.34,463.9,457.77,458.97,112669636,58534275.65,45.229153288877335,66.4565899464119,NaN,NaN,-127.76802629105258,25.6403085604044,-1.278728434604071,3.781827480007223,5.060555914611294,11422957384,11461247580.6,79.39916955674047,88.0335481661775,NaN,NaN,27.444302395290403,34.09092476486363
2021-11-29T09:30:00-05:00,464.07,466.56,461.73,464.6,86268818,59339595.35,53.811724391676826,64.81334240683796,NaN,NaN,-49.16140901836132,-1.2922116891858948,-1.3326595680006745,3.394731454610451,4.727391022611125,11509226202,11468428096.4,79.88564222804133,87.47330234612636,NaN,NaN,23.713215011821866,32.60839480014338
2021-11-30T09:30:00-05:00,462,464.03,455.3,455.56,148559598,64345893.15,42.339276231740115,62.63634690199626,NaN,NaN,-197.51120171180003,-57.07096267614229,-1.9166127434092655,2.331625093349544,4.248237836758809,11360666604,11460449083.4,77.69021887754027,86.69368139064716,NaN,NaN,15.567400915861128,30.173967102388772
2021-12-01T09:30:00-05:00,461.64,464.67,450.29,450.5,132485835,68524764.05,37.51776755311281,60.73776776511708,NaN,NaN,-233.15972040612664,-111.56400220295495,-2.5437990259983665,1.0684890542608514,3.612288080259218,11228180769,11411331595.8,65.717279592379,85.0412873966234,NaN,NaN,7.196689477988364,26.89149887033157
2021-12-02T09:30:00-05:00,450.73,459.07,450.31,457.4,127637758,72281160.7,46.4697999779269,59.46549445899721,NaN,NaN,-183.53039441339985,-158.22615036814804,-2.396147749497162,0.6171033933877652,3.0132511428849273,11355818527,11375369897.2,58.59697798805365,82.86875306867672,NaN,NaN,4.136549820663022,23.640791863236064
2021-12-03T09:30:00-05:00,459.17,460.3,448.92,453.42,137331647,76505388.7,42.67204268932657,57.6312221581838,NaN,NaN,-168.08241251204936,-166.2890276123474,-2.459458302876682,-0.06107173571092517,2.398386567165757,11218486880,11334475796.4,51.73278030894325,80.19882675068474,NaN,NaN,0.2991673947326416,20.30627408202129
2021-12-06T09:30:00-05:00,456.13,460.79,453.56,458.79,98977532,78134737.15,48.75711661665128,56.2189868538714,NaN,NaN,-98.32240727200646,-176.12122726307643,-2.0493760407271213,-0.16333348374314482,1.8860425569839765,11317464412,11296123438.4,46.25968145867443,77.131872994787,NaN,NaN,-0.35122740546903897,17.355202440951242
2021-12-07T09:30:00-05:00,464.41,468.88,458.6546,468.28,95484688,80388711.85,57.369055781681695,55.275876109215474,NaN,NaN,18.85874079837274,-132.84723876104187,-1.0964778052856754,0.5154453003768822,1.6119231056625576,11412949100,11306579937.6,47.878735471801754,74.13295628187268,NaN,NaN,2.654992714923639,15.255172480090156
2021-12-08T09:30:00-05:00,468.7,470,466.83,469.52,72238777,81443193.35,58.353931786281684,54.61141969480578,NaN,NaN,71.65426783950713,-71.88444111191514,-0.3773021657522142,1.14029539847229,1.517597564224504,11485187877,11357981359.2,55.04812842456539,71.59316636668338,NaN,NaN,5.216381984406526,13.821059552135353
2021-12-09T09:30:00-05:00,468.15,469.6291,466.14,466.35,61272568,81035339.1,54.8643823185925,53.56269550401985,NaN,NaN,46.733490985516326,-25.831664032131904,-0.12289564626021443,1.3639780063992362,1.4868736526594506,11423915309,11371600715.6,56.745830789790595,69.120413892251,NaN,NaN,5.972013609978696,12.699767274684401
2021-12-10T09:30:00-05:00,469.23,470.9,466.51,470.74,77159757,83150902.2,58.56017100649182,52.937811588903195,NaN,NaN,70.30836437282284,21.846491344842526,0.30960782522390984,1.873883434189338,1.5642756089654282,11501075066,11428118352.8,62.99209526084126,67.07958489539432,NaN,NaN,7.891392169627009,12.012856545390488
2021-12-13T09:30:00-05:00,470.19,470.56,466.27,466.57,87724680,84863803.5,54.03419117070931,52.23794081492644,NaN,NaN,45.946368161342704,50.700246431512355,0.28408160811191263,1.919377619105319,1.6352960109934063,11413350386,11447295547.6,64.84707685322876,65.4662352690657,NaN,NaN,7.889417718443352,11.423793855826611
2021-12-14T09:30:00-05:00,463.09,465.74,460.25,463.36,97264128,87377984.9,50.78060854430401,51.23990176117128,NaN,NaN,-17.99817337253041,43.32886359733173,0.03342685999485395,1.6770795859869736,1.6436527259921196,11316086258,11427922979.2,61.49384515232,63.81578509568451,NaN,NaN,6.797474418960999,10.762891079131524
2021-12-15T09:30:00-05:00,463.42,470.86,460.74,470.6,116899251,90780072.35,57.06070497634853,50.55856616669439,NaN,NaN,45.32470352715942,38.06295073486219,0.32162404651099297,2.045682784130861,1.724058737619868,11432985509,11417482505.6,59.70208314224099,61.99925322179725,NaN,NaN,8.041307383151771,10.374093408277274
2021-12-16T09:30:00-05:00,472.57,472.87,464.8,466.45,116568626,94215589.2,52.89455184905071,51.10609463527821,NaN,NaN,54.918207449372844,39.6998940276335,0.20483917647503835,1.9801077082136658,1.7752685317386274,11316416883,11395982820.4,56.078473219761136,60.333489197727296,NaN,NaN,7.633490270351914,9.982578674287936
2021-12-17T09:30:00-05:00,461.55,464.74,458.06,459.87,135636510,98466134.35,47.03119184396815,50.62177088187044,NaN,NaN,-43.537442519463816,16.930732649176168,-0.31520233793131247,1.3812656093244868,1.6964679472557993,11180780373,11331923881.8,46.9372922243763,57.98003562603693,NaN,NaN,5.252274266010468,9.306820901676868
2021-12-20T09:30:00-05:00,454.48,455.4,451.14,454.98,107134822,100957096.8,43.198759125001175,50.68316251710337,NaN,NaN,-126.21663057615358,-17.50186709832309,-0.9521656073976161,0.5062609380087792,1.4584265454063954,11073645551,11263982914.8,39.56998642234418,55.257161879237216,NaN,NaN,1.9843761720277395,8.26075736886985
2021-12-21T09:30:00-05:00,458.61,463.21,456.31,463.06,69806260,100809312.1,50.39204129290192,51.60275349851688,NaN,NaN,-25.603350258863053,-19.022902475589625,-0.7991372229297315,0.45950501674423094,1.2586422396739625,11143451811,11229456025.4,36.43975447037243,53.165910084808175,NaN,NaN,1.7309599199742915,7.327929161884771
2021-12-22T09:30:00-05:00,462.79,467.81,462.58,467.69,58890223,100093496.35,53.98784642122302,52.139756815895176,NaN,NaN,48.6022075625927,-18.367401668502964,-0.3773289200297669,0.786981089636754,1.1643100096665209,11202342034,11183327330.4,32.716090997381286,51.31727529976014,NaN,NaN,2.7741567350108025,6.677390243759918
2021-12-23T09:30:00-05:00,468.75,472.19,468.64,470.6,56439745,99822542.95,56.13970166766301,53.101732457204925,NaN,NaN,107.8084573574038,-7.789351686896792,0.08192716753609486,1.2667189690866394,1.1847918015505445,11258781779,11171800309.6,31.8404918261665,49.89639755099038,NaN,NaN,4.32126003861922,6.340800214454104
2021-12-27T09:30:00-05:00,472.06,477.31,472.01,477.26,56808619,97029492.1,60.67284027302852,53.95285557551758,NaN,NaN,154.60531077666735,31.839198972329438,0.779709348780717,2.1594284875264407,1.3797191387457237,11315590398,11198762314.6,36.145325917475795,49.1739435837619,NaN,NaN,7.170304472248653,6.4593008227104685
2021-12-28T09:30:00-05:00,477.72,478.81,476.06,476.87,47274585,95079780.45,60.279946328704334,54.16077632887634,NaN,NaN,151.38101608312724,87.3587283041856,1.1387245243142305,2.803124794138512,1.6644002698242812,11268315813,11237696367,41.856115047459014,48.743756410594564,NaN,NaN,9.261768570332075,6.859653358084984
2021-12-29T09:30:00-05:00,476.98,478.56,475.92,477.48,54502964,90376948.75,60.708523729828926,54.32896146770115,NaN,NaN,137.06171420289843,119.8917411965379,1.3278092152160776,3.3241617888443784,1.9963525736283008,11322818777,11273569760.2,46.59536801172478,48.13998780967738,NaN,NaN,11.062094313175422,7.460002065955046
2021-12-30T09:30:00-05:00,477.93,479,475.67,476.16,55329041,86519109.05,59.21946208220691,54.6400385936736,NaN,NaN,123.18094999644963,134.80748968330929,1.2742782015489067,3.589200325564434,2.3149221240155273,11267489736,11286599300.6,48.245413841096976,47.53281517048498,NaN,NaN,12.123128293357082,8.126162955583908
2021-12-31T09:30:00-05:00,475.64,476.86,474.67,474.96,65237431,83399092.7,57.83074495755744,54.58793673303543,NaN,NaN,99.72473895859966,133.19074600354847,1.0762403305741461,3.66022253723321,2.583982206659064,11202252305,11275293405.8,46.89155846556986,46.382776827965586,NaN,NaN,12.624965443826136,8.768849025332798
2022-01-03T09:30:00-05:00,476.3,477.85,473.85,477.71,72668233,80165922,60.13774361620168,55.02390476485631,NaN,NaN,102.86540550633956,122.8427649494829,1.0476366361060245,3.8935280017915943,2.8458913656855698,11274920538,11267159433.8,45.89373872230468,45.02896696147102,NaN,NaN,13.695441518100223,9.472647952871002
2022-01-04T09:30:00-05:00,479.22,479.98,475.58,477.55,71178678,78775979.3,59.93230392266821,55.67759729188232,NaN,NaN,105.96018210703149,113.75859815426375,0.9386332763979377,4.019182961182992,3.080549684785054,11203741860,11254244643.2,44.2825034158641,43.79958540886702,NaN,NaN,14.528111902212103,10.19485708849116
2022-01-05T09:30:00-05:00,477.16,477.98,468.2801,468.38,104538940,79228691.9,49.4961061614262,55.13726880510216,NaN,NaN,24.69708238894409,91.28567179147288,0.20781461425318692,3.340317952601538,3.132503338348351,11099202920,11209521471.8,39.155869456988235,42.33199871706325,NaN,NaN,12.23751679960126,10.486665618649745
2022-01-06T09:30:00-05:00,467.89,470.82,465.43,467.94,86858900,79959698.05,49.054708477221375,54.86299427854292,NaN,NaN,-19.194087365437248,62.81066431909551,-0.31778055741867295,2.73527764157501,3.053058198993683,11012344020,11158492328.6,34.27941753960033,40.77492331133749,NaN,NaN,10.248502712993028,10.452642346413072
2022-01-07T09:30:00-05:00,467.95,469.2,464.65,466.09,85111593,81151649.3,47.15077577390195,54.87153598782391,NaN,NaN,-36.48048986845293,35.569618553685,-0.7764516735100875,2.0824936071060733,2.858945280616161,10927232427,11103488353,29.949695873971905,39.56152357202289,NaN,NaN,8.030529848337169,10.106626275259371
2022-01-10T09:30:00-05:00,462.7,465.74,456.5973,465.51,119361989,83261760.9,46.54089273912781,55.110259817404376,NaN,NaN,-78.51755315340657,-0.7069731782642321,-1.0863136668020892,1.5010531971135492,2.5873668639156384,10807870438,11010078333,24.329580478326662,38.4729231474502,NaN,NaN,6.0169425640106375,9.52238574508098
2022-01-11T09:30:00-05:00,465.23,469.85,462.05,469.75,74303062,82590680,51.48157526752785,55.18808367273481,NaN,NaN,-23.206875605561585,-26.54038472078284,-0.9765844389377474,1.3666363152434542,2.3432207541812016,10882173500,10945764661,21.35787730409676,37.39564620700194,NaN,NaN,5.568300811894873,8.957516468911535
2022-01-12T09:30:00-05:00,471.59,473.2,468.94,471.02,67605444,81107745.8,52.88612342419107,55.10938917294681,NaN,NaN,18.292370301534426,-27.821327138264774,-0.796928377988364,1.3470602816957467,2.1439886596841107,10949778944,10915879865.8,20.12762282661869,36.49646990909032,NaN,NaN,5.571371802365106,8.47378151654776
2022-01-13T09:30:00-05:00,472.19,472.88,463.44,464.53,91173121,79821439.3,45.61843957226584,54.35787045184702,NaN,NaN,-31.869911315071263,-30.35649192819158,-1.0762701106013073,0.7986510214324767,1.874921132033784,10858605823,10885132226.4,18.92007092628299,35.57358270195579,NaN,NaN,3.4339434042337205,7.75380464336004
2022-01-14T09:30:00-05:00,461.19,465.09,459.9,464.72,95890948,78787555.4,45.853036320842705,53.29931302669089,NaN,NaN,-71.34365795233097,-37.32912554496719,-1.1999041811491398,0.37504090559735914,1.574945086746499,10954496771,10890585095.2,19.838565830764296,34.408814124333546,NaN,NaN,1.7596855887576937,6.8975019212739905
2022-01-18T09:30:00-05:00,459.74,459.96,455.31,456.49,109872376,77499348.7,38.17161220927292,51.72014630387436,NaN,NaN,-135.1995371598879,-48.66552234626346,-1.7540725083997724,-0.6176455487532166,1.1364269596465557,10844624395,10897935886.6,21.13556095466457,32.9287745462768,NaN,NaN,-2.2387972451157574,5.592316326075455
2022-01-19T09:30:00-05:00,458.13,459.6124,451.46,451.75,109357569,77610486.05,34.57870831107074,49.853730916820204,NaN,NaN,-170.00662626890644,-78.02547247893243,-2.3223194147001887,-1.7664723087286802,0.5558471059715085,10735266826,10868554551.8,19.759401502078305,31.011919795587765,NaN,NaN,-6.8394164946431495,3.8163544945442256
2022-01-20T09:30:00-05:00,453.75,458.74,444.5,446.75,122379696,80239157.85,31.23851345506091,47.85509172916692,NaN,NaN,-194.5724525834229,-120.59843705592388,-2.880901616679466,-3.045279914877824,-0.16437829819835803,10612887130,10801176189,17.02221350123257,28.781691199883163,NaN,NaN,-11.881391426170108,1.5738193630136066
2022-01-21T09:30:00-05:00,445.56,448.06,437.95,437.98,202271241,87408208.75,26.418150698327906,45.61133499636481,NaN,NaN,-226.04168036654667,-159.43279086621897,-3.638170802247259,-4.712091801007432,-1.073920998760173,10410615889,10711578202.2,14.204378503707773,26.446892631178724,NaN,NaN,-18.101565714422136,-1.236949933762928
2022-01-24T09:30:00-05:00,432.03,440.38,420.76,439.84,252496719,97211057.45,28.923194355203222,43.38172433486493,NaN,NaN,-220.5533046900638,-189.27472021376553,-3.7936019443199704,-5.8159234291601365,-2.022321484840166,10663112608,10653301369.6,12.728474065466571,24.077945155690287,NaN,NaN,-22.186691424135006,-4.229770146673225
2022-01-25T09:30:00-05:00,433.06,439.72,427.15,434.47,167997325,102770492.75,26.154718873835023,40.96903968851969,NaN,NaN,-177.53973856389763,-197.74276049456748,-4.016420026169053,-7.042846517551482,-3.0264264913824293,10495115283,10583399547.2,11.222238986678292,21.71649769646273,NaN,NaN,-26.569561190975676,-7.421168867287861
2022-01-26T09:30:00-05:00,440.72,444.04,428.86,433.38,186391088,109726317.9,25.618689932660587,39.263509957893575,NaN,NaN,-139.6799017779878,-191.67741559638375,-3.987500609510569,-8.01080225327064,-4.023301643760071,10308724195,10498091021,9.711795235107346,19.613349537756957,NaN,NaN,-30.20758716313012,-10.676371480979611
2022-01-27T09:30:00-05:00,438.26,441.59,429.45,431.24,149878307,114495085.05,24.55468296423986,37.513508135537755,NaN,NaN,-125.13913769833245,-177.7907526193657,-3.8602332358926166,-8.848593188625841,-4.988359952733225,10158845888,10407282772.6,8.413640302227378,17.765794020801746,NaN,NaN,-33.52011790136953,-13.9397638267496
2022-01-28T09:30:00-05:00,432.68,442,427.82,441.95,164457370,119951501.5,38.353876551862335,36.885158191106356,NaN,NaN,-96.49399736140019,-151.88121601833637,-2.8491396017469883,-8.54978445491696,-5.700644853169972,10323303258,10389820246.4,8.187009589097869,16.211316429025032,NaN,NaN,-31.944111340405378,-16.511813471557566
2022-01-31T09:30:00-05:00,441.24,450.28,439.81,449.91,152251425,124302201.2,46.22616043595303,36.86267731230816,NaN,NaN,-44.79117592170784,-116.7287902646652,-1.5060887991420406,-7.583255852097523,-6.077167052955482,10475554683,10352308661.4,7.706778024225571,15.023973396589238,NaN,NaN,-27.786585069928506,-18.1224951284677
2022-02-01T09:30:00-05:00,450.68,453.63,446.9384,452.95,123155382,126826558.65,48.909527551603006,36.67895961831352,NaN,NaN,-17.40748779552627,-84.70234011099092,-0.33592884174390125,-6.497078105135358,-6.161149263391457,10598710065,10373027617.8,10.818406768299951,14.27115407260375,NaN,NaN,-23.565806096927176,-18.90011098110477
2022-02-02T09:30:00-05:00,455.5,458.12,453.05,457.35,117360953,129135672.4,52.5966050696113,36.65827973584354,NaN,NaN,15.63105035888964,-53.64014968361543,0.7520824373402828,-5.221046216716104,-5.973128654056387,10716071018,10454496982.4,21.959979012251168,14.402036657291783,NaN,NaN,-18.853492242847057,-18.893451161353667
2022-02-03T09:30:00-05:00,450.95,452.97,445.71,446.6,118024442,129809947.5,44.20322682788615,36.55719311124499,NaN,NaN,-23.084784402142304,-33.22927902437741,0.7630174123956337,-5.019356888561845,-5.782374300957478,10598046576,10542337120,31.846485818864238,15.325352006761872,NaN,NaN,-17.60280038581332,-18.709072479133617
2022-02-04T09:30:00-05:00,446.35,452.78,443.83,448.7,118454352,131389720.1,46.01558082047132,36.56880343264703,NaN,NaN,-18.270465838359232,-17.58457271976922,0.9166065060912789,-4.63661616834338,-5.553222674434659,10716500928,10620976654,39.26469866311894,16.71293292335863,NaN,NaN,-16.016920155808293,-18.324479290087144
2022-02-07T09:30:00-05:00,449.51,450.99,445.85,447.26,84472859,131357783.4,44.9376953407114,37.052095084892635,NaN,NaN,-15.977721085332009,-11.821881752494068,0.9235533820432877,-4.398780946880549,-5.322334328923837,10632028069,10652271331.2,41.97156089697337,18.201218633523546,NaN,NaN,-15.105335504920218,-17.864601606491867
2022-02-08T09:30:00-05:00,446.73,451.92,445.22,450.94,81012036,129440285.75,48.27241930297317,38.03021729859995,NaN,NaN,-2.440100903399807,-8.828404374068777,1.1628650639019327,-3.8687529990464213,-5.031618062948354,10713040105,10675137339.2,43.937639602766616,19.92823564071557,NaN,NaN,-13.300977012710923,-17.212655235951733
2022-02-09T09:30:00-05:00,455.22,457.88,455.005,457.54,92589929,130354629.1,53.689505250460265,39.63385956969991,NaN,NaN,60.20741700554824,0.08686895526297675,1.7189705642852688,-2.882904857591768,-4.601875421877037,10805630034,10693049142.4,45.49549119351402,21.962041190164246,NaN,NaN,-9.983336539978744,-16.179895422241305
2022-02-10T09:30:00-05:00,451.34,457.71,447.2,449.32,140103712,133979542.5,47.07701502985733,41.10949273623772,NaN,NaN,28.550830537080508,10.413991943107542,1.494788664147027,-2.7333895916932534,-4.22817825584028,10665526322,10706545091.6,46.69734692394102,24.28296750589519,NaN,NaN,-9.282137974183911,-15.194501501090249
2022-02-11T09:30:00-05:00,449.41,451.605,438.94,440.46,153214597,137081616.3,41.18858995800751,41.98559242215231,NaN,NaN,-31.81286492035066,7.705512126709257,0.7490394931156317,-3.2918788894457407,-4.040918382561372,10512311725,10665707251,43.56680423218734,26.485705374946672,NaN,NaN,-10.718086776594667,-14.555013683305166
2022-02-14T09:30:00-05:00,439.92,441.6,435.34,439.02,123006262,138437382,40.306170201235524,42.99641037410949,NaN,NaN,-69.51213552679661,-3.001370761583669,0.18729531797022236,-3.8067992350985946,-3.994094553068817,10389305463,10617162729.8,40.12340527396732,28.550074395467316,NaN,NaN,-12.12570999066619,-14.207970298642454
2022-02-15T09:30:00-05:00,443.73,446.28,443.18,446.1,88659503,137376738.35,46.38776725308552,44.479915896996985,NaN,NaN,-0.04202809431301477,-2.5217561997663105,0.3136290791872489,-3.6020582040847557,-3.9156872832720047,10477964966,10570147702,37.067719669787785,30.504068997944493,NaN,NaN,-11.31700253355449,-13.794974903629887
2022-02-16T09:30:00-05:00,443.93,448.055,441.94,446.6,84863585,136152039.15,46.79998000652949,46.06886568573196,NaN,NaN,8.622655672897626,-12.83870846629643,0.4439790840794542,-3.360713428172687,-3.8046925122521413,10562828551,10521587405.4,34.172896796721375,32.34401589040835,NaN,NaN,-10.55545868436595,-13.332186872306467
2022-02-17T09:30:00-05:00,443.22,446.5652,436.42,437.06,102259108,135146009.75,40.41495397444692,46.21608550163086,NaN,NaN,-46.787267699647224,-27.906328113641973,-0.07172803281954776,-3.894352553276576,-3.8226245204570284,10460569443,10480596029.6,31.90764382607516,34.038346907335296,NaN,NaN,-11.966466467049838,-13.137083957269805
2022-02-18T09:30:00-05:00,437.33,438.66,431.82,434.23,132642896,131664592.5,38.72702605557078,45.680433045889274,NaN,NaN,-94.1464932534452,-40.37305378026089,-0.5369570113051605,-4.493820784588479,-3.9568637732833185,10327926547,10443718994,29.98213439033171,35.62944379062859,NaN,NaN,-13.643319537925663,-13.209403325934927
2022-02-22T09:30:00-05:00,431.89,435.5,425.86,429.57,124391830,125259348.05,36.056598924872326,44.762366715408504,NaN,NaN,-136.36174695553635,-53.74297606600883,-1.0617216898929644,-5.284015885649524,-4.222294195756559,10203534717,10406564844.8,28.13964286687164,36.86667494052657,NaN,NaN,-15.891291040515194,-13.592530142303536
2022-02-23T09:30:00-05:00,432.66,433.26,421.35,421.95,132578005,123488382.05,32.15238572605773,43.302065333726105,NaN,NaN,-168.28944866746318,-87.39246018063886,-1.782773566727327,-6.450761154165718,-4.667987587438391,10070956712,10325163194,24.576211039152625,37.05354865673382,NaN,NaN,-19.11777448312358,-14.381850762420685
2022-02-24T09:30:00-05:00,411.02,428.76,410.64,428.3,213942946,124865974.95,38.161508664989086,42.87051403637631,NaN,NaN,-171.37399055443603,-123.39178942610559,-1.6934596607329793,-6.784812163354616,-5.091352502621636,10284899658,10269577415.4,22.482531326110617,36.38469476439427,NaN,NaN,-19.895310584484886,-15.169487879858428
2022-02-25T09:30:00-05:00,429.61,437.84,427.86,437.75,121804459,123462282.55,45.84808731763525,42.858550214745165,NaN,NaN,-70.36447350186374,-128.1072305865489,-0.8992116690388761,-6.215367088920232,-5.316155419881356,10406704117,10258804350.2,22.089753941617445,35.15791299857273,NaN,NaN,-17.96534950629212,-15.56889668363467
2022-02-28T09:30:00-05:00,432.03,438.2,430.7,436.63,145615029,122520165.5,45.132058940996586,42.87243332905125,NaN,NaN,-62.56116009144327,-121.79016395414851,-0.37726366269515577,-5.787734998250301,-5.410471335555145,10261089088,10245436858.4,21.585829605195116,33.701789334874285,NaN,NaN,-16.6813872008837,-15.72782390038453
2022-03-01T09:30:00-05:00,435.04,437.17,427.11,429.98,137785908,121796889.65,41.034317671168274,42.355426069636614,NaN,NaN,-83.15972240886117,-111.14975904481348,-0.40540120952423386,-5.917222847460437,-5.511821637936203,10123303180,10229390551,20.967484883867655,32.06106399781008,NaN,NaN,-16.897476174672203,-15.894917082425627
2022-03-02T09:30:00-05:00,432.37,439.72,431.57,437.89,117726525,121525446.8,47.17780989017019,41.89030497247303,NaN,NaN,-38.55499621894054,-85.20286855510895,0.15326246909182384,-5.320243551571423,-5.473506020663247,10241029705,10263405149.6,25.818498133559814,30.655564493527635,NaN,NaN,-15.06222057036592,-15.775960437845669
2022-03-03T09:30:00-05:00,440.47,441.11,433.8,435.71,105501715,120932484.9,45.76269320039584,41.79642484179721,NaN,NaN,-29.037167079522,-56.73550386012615,0.4061661703179613,-4.965798307765795,-5.371964478083756,10135527990,10233530816,24.40183465728103,29.063027903051925,NaN,NaN,-14.034828831967896,-15.527227351291701
2022-03-04T09:30:00-05:00,431.75,433.37,427.88,432.17,114083256,120735425.6,43.48185742430937,41.960229660818776,NaN,NaN,-72.67873302185833,-57.19835576412506,0.3664500536961679,-4.913901910963546,-5.2803519646597135,10021444734,10156478939.4,21.17466403478251,27.463589317523006,NaN,NaN,-13.881626019348154,-15.292141446728337
2022-03-07T09:30:00-05:00,431.55,432.3018,419.36,419.43,137896560,121707536,36.442385402155296,41.68424503231305,NaN,NaN,-125.72088264459335,-69.83030027475507,-0.44255023222371115,-5.833539754939352,-5.390989522715641,9883548174,10080970756.6,18.581260487766897,25.924864689937262,NaN,NaN,-16.08992602117652,-15.406110671649506
2022-03-08T09:30:00-05:00,419.62,427.21,415.12,416.25,164772744,125722530.25,34.92260444069406,40.86530483142794,NaN,NaN,-146.54508216149372,-82.50737222528159,-1.0802082725563666,-6.741249863411099,-5.661041590854732,9718775430,10000065206.6,16.280412363790404,24.44005702522316,NaN,NaN,-18.355444331585954,-15.827444051640427
2022-03-09T09:30:00-05:00,425.14,429.51,422.82,427.41,116990765,127521466.7,43.78318533856187,40.64981949800168,NaN,NaN,-79.12161268473875,-90.62069551844124,-0.6594379123495777,-6.485338981291704,-5.825901068942127,9835766195,9919012504.6,14.361767721898957,23.024976377021563,NaN,NaN,-17.373298657542286,-16.04828042391212
2022-03-10T09:30:00-05:00,422.52,426.43,420.44,425.48,93972655,127590603,42.7004014449343,40.813065745893645,NaN,NaN,-92.97934129114621,-103.40913036076608,-0.4311928404027672,-6.364892119445585,-5.933699279042818,9741793540,9840265614.6,12.785281963828965,21.65909338686112,NaN,NaN,-16.943375287739826,-16.176151118744652
2022-03-11T09:30:00-05:00,428.12,428.77,419.53,420.07,95636277,125367231.25,39.73405443436602,40.88499634437902,NaN,NaN,-96.4597490392077,-108.16533356423595,-0.5566865675120267,-6.629557488432852,-6.072870920920825,9646157263,9765208120.4,11.490580988521259,20.33826814387466,NaN,NaN,-17.522265303881387,-16.368453145192756
2022-03-14T09:30:00-04:00,420.89,424.55,415.79,417,95729188,122492960.8,38.11589284666288,41.03208876736405,NaN,NaN,-120.91720681505497,-107.20459839832827,-0.7467161976398495,-7.006266167970637,-6.259549970330787,9550428075,9698584100.6,10.47644848732017,19.076611402478125,NaN,NaN,-18.492414158370778,-16.67187614707533
2022-03-15T09:30:00-04:00,419.77,426.84,418.42,426.17,106219117,121653603.55,45.283773817614794,41.97004505961813,NaN,NaN,-66.59714124280012,-91.21501021458955,-0.18440389190337303,-6.490054835210003,-6.30565094330663,9656647192,9686158453,10.293971311760487,18.056451421950115,NaN,NaN,-17.060669681714636,-16.727418080595232
2022-03-16T09:30:00-04:00,429.89,435.68,424.8,435.62,144954805,124468368.65,51.51617862841325,42.92395005700557,NaN,NaN,24.617626520415364,-70.46716237355872,0.8382736633434655,-5.257808864127298,-6.096082527470764,9801601997,9679325613.4,10.188874975105875,17.17833311116406,NaN,NaN,-13.750912181567918,-16.30220295216276
2022-03-17T09:30:00-04:00,433.59,441.07,433.19,441.07,102676870,125359032.9,54.71949722881043,43.55762219351808,NaN,NaN,104.70384033810208,-30.930526047709066,1.8387075403710416,-3.7976981020069616,-5.636405642378003,9904278867,9711822678.8,14.651868376820403,16.647055570821415,NaN,NaN,-9.976563611637243,-15.398540189230543
2022-03-18T09:30:00-04:00,438,444.86,437.22,444.52,106345544,125563354.7,56.67108626876596,44.3818384312159,NaN,NaN,144.66505101938307,17.294433964009094,2.6409289997980023,-2.3352443926305,-4.976173392428502,10010624411,9784716108.4,23.79901454341173,16.80514020926546,NaN,NaN,-6.29188420167915,-14.097589333866058
2022-03-21T09:30:00-04:00,444.34,446.46,440.68,444.39,88349763,123348698.05,56.57214244343274,45.49168305780621,NaN,NaN,148.12542515321087,71.10296035766225,3.042374533511426,-1.1732052255392205,-4.215579759050646,9922274648,9859085423,31.826793409271403,17.580805103937156,NaN,NaN,-3.3920087731765554,-12.568220682338985
2022-03-22T09:30:00-04:00,445.86,450.58,445.86,449.59,74650394,120861626.25,59.60985870969113,46.379686544914854,NaN,NaN,167.76431947864202,117.97525250195068,3.5047910042501984,0.16540899626210148,-3.339382007988097,9996925042,9927140993,38.23894925576367,18.46798018409458,NaN,NaN,0.002870211621949154,-10.77235055463028
2022-03-23T09:30:00-04:00,446.91,448.49,443.71,443.8,79426098,118204030.9,54.99692598266245,47.03927460079104,NaN,NaN,120.35709530088587,137.12314625804478,3.271837988608835,0.7504154777729468,-2.521422510835888,9917498944,9950320382.4,40.29861961528039,19.603464823951672,NaN,NaN,1.5631906990140172,-9.010130375538239
2022-03-24T09:30:00-04:00,445.94,450.5,444.76,450.49,64736892,110743728.2,58.949746619004436,48.144123828983545,NaN,NaN,131.56755999545402,142.49589018951517,3.404239896310194,1.7338773595518546,-1.6703625367583395,9982235836,9965911776.2,41.70683255271062,21.070048289517967,NaN,NaN,4.121878648930492,-7.134129086328421
2022-03-25T09:30:00-04:00,451.16,452.98,448.43,452.69,77101324,108508571.45,60.18814005702978,49.840249161474574,NaN,NaN,133.67720217050186,140.29832041973893,3.4643982032042624,2.6601352172469888,-0.8042629859572736,10059337160,9975654326,42.61765686007372,22.786933744682738,NaN,NaN,6.5897124339478905,-5.173580297717519
2022-03-28T09:30:00-04:00,452.06,455.91,450.06,455.91,68529767,104654308.35,61.99530552673954,51.77401352476354,NaN,NaN,132.08224701056045,137.08968479120887,3.533319975662375,3.612386983620695,0.07906700795832011,10127866927,10016772781.8,46.42259400196292,24.93994671883792,NaN,NaN,9.190972330708384,-3.1215013507995333
2022-03-29T09:30:00-04:00,460.02,462.07,457.18,461.55,86581542,102094090.05,64.99275138082233,53.288982527782146,NaN,NaN,151.0482461019537,133.7464701158712,3.7505071208564873,4.767200909028929,1.016693788172442,10214448469,10060277467.2,50.18618911108034,27.4988339609223,NaN,NaN,12.339304550513244,-0.9128147934691366
2022-03-30T09:30:00-04:00,460.34,461.195,456.465,458.7,79666942,100191110.9,62.31803172876505,54.69024183377006,NaN,NaN,122.12553066503072,134.10015718870017,3.4988786900780875,5.390292150770051,1.891413460691964,10134781527,10103733983.8,53.68594371561176,30.42030980033536,NaN,NaN,14.21469805506732,1.2482584706075
2022-03-31T09:30:00-04:00,457.89,458.76,451.16,451.64,121699948,101001022.55,56.153057330520134,55.86302775492393,NaN,NaN,83.82949476007278,124.55254414162394,2.6899494999274456,5.253850335601271,2.5639008356738255,10013081579,10109903132.4,54.17811444994886,33.469419333294475,NaN,NaN,14.040273231660622,3.0756891507579462
2022-04-01T09:30:00-04:00,453.31,453.46,449.14,452.92,89048773,99749298.4,56.98393705332982,57.21074519825728,NaN,NaN,66.2026914110176,111.05764198972709,2.1002287725599857,5.189186801373808,3.088958028813822,10102130352,10118461770.8,54.89425612247806,36.6421198786629,NaN,NaN,14.132440411214303,4.655225045108854
2022-04-04T09:30:00-04:00,453.13,456.91,452.26,456.8,59601000,95834520.4,59.489867141492255,58.22546614996281,NaN,NaN,78.29814725592462,100.30082203879994,1.8399568776080164,5.388904125823842,3.5489472482158257,10161731352,10125234655.8,55.487134012223905,39.870202928696,NaN,NaN,14.92125133366779,6.121800229188702
2022-04-05T09:30:00-04:00,455.22,457.83,449.82,451.03,74214501,91306608.25,54.41327868617292,58.43240186837422,NaN,NaN,60.49322692470396,82.18981820334997,1.1797869213923144,5.023680899956219,3.843893978563904,10087516851,10099848332.2,52.69147282855016,42.90610277537059,NaN,NaN,14.125370651315903,7.265167432349731
2022-04-06T09:30:00-04:00,446.89,448.93,443.47,446.52,106897781,90801959.05,50.76663955814067,58.15005489189781,NaN,NaN,16.982190119160418,61.16115009417592,0.38129709104334264,4.320515342368083,3.93921825132474,9980619070,10069015840.8,49.43378406462492,45.390525324499485,NaN,NaN,12.361970807059215,7.993282200165371
2022-04-07T09:30:00-04:00,445.59,450.69,443.53,448.77,78097214,90008187,52.47774051186071,57.850530194976,NaN,NaN,20.411203272769168,48.477491796715185,-0.03149244615378333,3.8998526936325106,3.931345139786294,10058716284,10078142781.8,50.41114425701429,47.29139173261395,NaN,NaN,11.372233766120594,8.475989566730403
2022-04-08T09:30:00-04:00,447.97,450.63,445.94,447.57,79272711,89190008.7,51.45069239974674,57.48471233471272,NaN,NaN,16.482260961301627,38.533405706772,-0.400992564733456,3.4301044338694737,3.8310969986029297,9979443573,10053605426,47.73961284641298,48.428021692409786,NaN,NaN,10.263069750799836,8.73128673588318
2022-04-11T09:30:00-04:00,444.11,445,439.39,439.92,89770538,88892076.2,45.35645167695112,56.46661183237415,NaN,NaN,-59.95104629916867,10.883566995753341,-1.1346998960496189,2.4127221285409064,3.5474220245905252,9889673035,9999193762.6,42.37660080075026,48.72356823133739,NaN,NaN,7.44523534662037,8.547565108845635
2022-04-12T09:30:00-04:00,443.08,445.75,436.6501,438.29,84363635,87799302.1,44.15631137243383,55.69228221735782,NaN,NaN,-94.82855456769438,-20.18078930272633,-1.6714545549696318,1.4581038308784855,3.1295583858481173,9805309400,9942752272.4,37.651575042477944,48.53449361899436,NaN,NaN,4.759882356362737,8.00646757277665
2022-04-13T09:30:00-04:00,438.03,444.11,437.84,443.31,74070394,84255081.55,48.661728330795746,54.95742376820005,NaN,NaN,-90.22871473523527,-41.622970273605475,-1.6284284808547596,1.0940227847796677,2.7224512656344273,9879379794,9922504417.2,36.09664745454169,48.1337661119823,NaN,NaN,3.6943613115759084,7.390452392605115
2022-04-14T09:30:00-04:00,443.55,444.7301,437.68,437.79,97869451,84014710.6,44.41806812417945,53.830990058710746,NaN,NaN,-115.5122523554905,-68.8076613992574,-1.8931892321283454,0.3559647254739957,2.249153957602341,9781510343,9867063229,32.178096030574665,47.38808319558951,NaN,NaN,1.4936360683516672,6.548050060568908
2022-04-18T09:30:00-04:00,436.81,439.75,435.61,437.97,66002498,81997558.3,44.58776617010149,52.58759439037946,NaN,NaN,-137.39882139085645,-99.58387786968902,-1.9689099616820804,-0.21198349450025944,1.756926467181821,9847512841,9840677082.6,30.48207463565943,46.24947466942497,NaN,NaN,-0.24587622595854627,5.577489162493557
2022-04-19T09:30:00-04:00,437.86,445.8,437.68,445.04,77821013,81471120.8,50.925457137061215,51.58278765868224,NaN,NaN,-70.57764935005906,-101.70919847986711,-1.4779834143938904,-0.09055280081054207,1.3874306135833483,9925333854,9847809246.4,31.532548306134373,44.91707175478597,NaN,NaN,0.04682431121807263,4.7873941837399165
2022-04-20T09:30:00-04:00,446.92,447.57,443.48,444.71,65224449,80999823.55,50.63435200203733,50.74823910677311,NaN,NaN,-36.61964550162427,-90.06741666665309,-1.1265106016737039,-0.020707638508781656,1.1058029631649222,9860109405,9858769247.4,33.202945114912794,43.45400042616462,NaN,NaN,0.20326547024557073,4.132518653240725
2022-04-21T09:30:00-04:00,448.54,450.01,437.1,438.06,85417327,81299385,45.04623126264441,49.954894387639136,NaN,NaN,-76.15271147884437,-87.25221601537493,-1.2816295635337975,-0.4962339912523248,0.7853955722814727,9774692078,9837831704.2,31.616068495524203,41.84242571513429,NaN,NaN,-1.3074677334402118,3.355377740857734
2022-04-22T09:30:00-04:00,436.91,438.0825,425.44,426.04,132471772,84686129,37.080379796164245,48.53321172641303,NaN,NaN,-181.00347649815726,-100.35046084390828,-2.0859186047631395,-1.8220026836724514,0.26391592109068784,9642220306,9809973696.8,29.589710028409655,40.03495813698654,NaN,NaN,-5.3755890810657485,2.108096766297237
2022-04-25T09:30:00-04:00,423.67,428.69,418.84,428.51,119647748,86813450.2,39.44992814130115,47.10178751211367,NaN,NaN,-190.79870201838497,-111.030436969414,-2.325460535504762,-2.642909748290265,-0.31744921278550275,9761868054,9792844739.4,28.385052293445383,38.0990951570738,NaN,NaN,-7.9103517397123415,0.6768898368672973
2022-04-26T09:30:00-04:00,425.83,426.04,416.07,416.1,103996312,88586777.45,32.77199747379592,45.5559817112296,NaN,NaN,-205.50273918092745,-138.01545493558766,-3.1427793771826615,-4.24592343426383,-1.1031440570811681,9657871742,9739352317,24.966607867485962,36.11874765985492,NaN,NaN,-12.560164271427881,-1.2141178928891567
2022-04-27T09:30:00-04:00,417.24,422.92,415.01,417.27,122029990,90359199.85,33.90790755660403,44.351786568262696,NaN,NaN,-188.15070704414342,-168.3216672440915,-3.405585484437153,-5.360125912627609,-1.9545404281904561,9779901732,9723310782.4,24.031922030612947,34.30432894313978,NaN,NaN,-15.815529305193435,-3.300033808932625
2022-04-28T09:30:00-04:00,422.29,429.64,417.6,427.81,105449088,91648307.15,43.2159718905807,43.69023166674269,NaN,NaN,-118.21291333627929,-176.73370761557845,-2.701323493873405,-5.3311947955322125,-2.6298713016588073,9885350820,9745442530.8,28.03489432844536,32.70602537681343,NaN,NaN,-15.518015000836218,-5.045459693490281
2022-04-29T09:30:00-04:00,423.59,425.87,411.21,412,145491009,92837860.2,35.20642806213357,42.52992707119889,NaN,NaN,-152.13398252375515,-170.95980882069804,-3.1032791110341256,-6.508970190451464,-3.4056910794173385,9739859811,9764970431.8,31.466360827703596,31.543650232619903,NaN,NaN,-18.234597666108527,-6.929622261007173
2022-05-02T09:30:00-04:00,412.07,415.92,405.02,414.48,158312526,96301047.85,37.173458785515805,41.94542757895351,NaN,NaN,-151.04434637389886,-163.00893769180084,-3.003221244020425,-7.15971763444287,-4.156496390422445,9898172337,9792231288.4,36.05055684986791,31.091789950414018,NaN,NaN,-19.617310054601102,-8.74214908866345
2022-05-03T09:30:00-04:00,415.01,418.93,413.36,416.38,100028190,98322407.35,38.708658742880736,41.556309533985434,NaN,NaN,-107.40320450312407,-143.38903075624017,-2.6239255457801294,-7.436403322647607,-4.812477776867477,9998200527,9860297045.4,45.79910057024993,31.673756059540587,NaN,NaN,-20.188830463267536,-10.377389285035461
2022-05-04T09:30:00-04:00,417.08,429.66,413.7099,429.06,144247895,101824077.05,47.86463311735705,41.499374161596954,NaN,NaN,-53.43091233405705,-116.44507181422289,-1.3955574188821096,-6.556924550470114,-5.161367131588005,10142448422,9932806383.4,53.86706550364274,32.943071634476375,NaN,NaN,-17.48107735171854,-11.392201865990186
2022-05-05T09:30:00-04:00,424.55,425,409.44,413.81,172929106,105125643.3,40.10502919956757,41.191299952696106,NaN,NaN,-91.53313908074752,-111.10911696311655,-1.4786468227394867,-7.009675660012363,-5.531028837272876,9969519316,9949640082.6,55.5223389756169,34.61051755912225,NaN,NaN,-17.96846066277282,-12.331667408387705
2022-05-06T09:30:00-04:00,411.1,414.8,405.73,411.34,151770811,108809323.15,39.00215687919455,40.79232786048846,NaN,NaN,-112.28256729835834,-103.13883391803718,-1.5604168370726557,-7.481549883613695,-5.92113304654104,9817748505,9965217821.4,57.05784678540568,36.508786998389844,NaN,NaN,-18.721908229527664,-13.244558954264843
2022-05-09T09:30:00-04:00,405.1,406.41,396.5,398.17,155586067,112624990.95,33.68333983065443,39.56074805288798,NaN,NaN,-154.69585984372338,-103.86913661200211,-2.316365861580395,-8.816590373516533,-6.500224511936138,9662162438,9918015841.6,51.2808062575129,37.919376852059735,NaN,NaN,-21.28744051494603,-14.393542034362156
2022-05-10T09:30:00-04:00,404.49,406.08,394.82,399.09,132497200,114761324.05,34.356786173133656,38.39806477939486,NaN,NaN,-141.73029092523632,-110.73455389642454,-2.5507787820944605,-9.688697989554214,-7.1379192074597535,9794659638,9877307663.8,46.87303320678829,38.895811715765134,NaN,NaN,-23.01413620613707,-15.625055487472858
2022-05-11T09:30:00-04:00,398.07,404.04,391.96,392.75,142360992,117661191.9,31.948969997091055,37.46254611756962,NaN,NaN,-143.46912995950805,-128.74219742151473,-2.903517162318649,-10.767315660358065,-7.863798498039416,9652298646,9779277708.6,38.32914854102978,39.37531743330124,NaN,NaN,-25.226754457413758,-16.996726768892987
2022-05-12T09:30:00-04:00,389.37,395.8,385.15,392.34,125090753,120212209.85,31.793791194748493,37.084932646039924,NaN,NaN,-152.61719580272316,-140.95900876590986,-2.926872070207331,-11.52238858579858,-8.59551651559125,9527207893,9690815424,32.56125219187015,39.58757044497698,NaN,NaN,-27.00926288281365,-18.427089070881653
2022-05-13T09:30:00-04:00,396.71,403.18,395.61,401.72,104174421,120527458.35,39.08355938912538,37.058763449455945,NaN,NaN,-97.08659703674185,-137.91981471358656,-2.111105633722463,-11.234398557744328,-9.123292924021865,9631382314,9653542185.8,30.479990189083523,39.737208866094,NaN,NaN,-26.26083460976549,-19.546195576436485
2022-05-16T09:30:00-04:00,399.98,403.97,397.6,400.09,78622444,121158455.65,38.31716446326002,37.45484680584623,NaN,NaN,-86.97806347979471,-124.37625544080083,-1.5099788615171885,-11.01076650091835,-9.500787639401162,9552759870,9631661672.2,29.296180917625094,40.046464083961084,NaN,NaN,-25.88806826623593,-20.45217738926498
2022-05-17T09:30:00-04:00,406.53,408.57,402.5824,408.32,83029710,121418890.5,44.26035463995626,38.19430731179996,NaN,NaN,-47.728329695518674,-105.5758631948573,-0.44221241883014173,-10.05355316293884,-9.611340744108698,9635789580,9599887660.6,27.61865710601333,40.30265944648968,NaN,NaN,-23.720076426819325,-20.9190201089156
2022-05-18T09:30:00-04:00,403.5,403.8,390.55,391.86,117674545,124041395.3,36.65378559350404,37.72557971915163,NaN,NaN,-102.28485059876732,-97.33900732270916,-0.7125895804290874,-10.502077719645058,-9.78948813921597,9518115035,9573050938.4,26.25139380858657,40.175266552214055,NaN,NaN,-24.265634519219503,-21.397107881816158
2022-05-19T09:30:00-04:00,388.62,394.14,387.11,389.46,98510715,124696064.7,35.69063479508395,37.76016591436237,NaN,NaN,-121.59578263286654,-91.13472468873783,-0.908615122384564,-10.925257042196677,-10.016641919812113,9419604320,9551530223.8,25.175095577466053,39.72589046291137,NaN,NaN,-25.00454838117825,-21.912456524582172
2022-05-20T09:30:00-04:00,393.25,397.03,380.54,389.63,131432197,124644085.95,35.819282601124385,37.663439044048694,NaN,NaN,-115.9114000860177,-94.899685298593,-0.8816802130823849,-11.118742186165093,-10.237061973082708,9551036517,9535461064.4,24.371596481451903,38.89167900802452,NaN,NaN,-25.548915682931213,-22.431950690060606
2022-05-23T09:30:00-04:00,392.83,397.73,390.38,396.92,76414878,122482442.45,41.24704886873084,37.84475262446655,NaN,NaN,-71.86243131101749,-91.87655886483756,-0.26001869091413354,-10.562085336725374,-10.30206664581124,9627451395,9550399369.4,26.713301929545622,37.52840767654563,NaN,NaN,-24.365658115478926,-22.70819460797751
2022-05-24T09:30:00-04:00,392.56,395.15,386.96,393.89,91448831,121855068.4,39.74261602938895,37.26460854675455,NaN,NaN,-83.21087425430952,-98.97306777659574,0.043811770785126214,-10.247301932329833,-10.29111370311496,9536002564,9530441966.2,25.57401367711718,35.50747540322239,NaN,NaN,-23.82946342576404,-22.8683758676613
2022-05-25T09:30:00-04:00,392.31,399.45,391.89,397.37,91472866,120327212.2,42.34366342969164,37.424510991763405,NaN,NaN,-50.73486770699177,-88.66307119824062,0.5478577219000833,-9.606291550739854,-10.154149272639938,9627475430,9552314045.2,29.140768069370424,33.623077481347636,NaN,NaN,-22.6243030748965,-22.833508325837755
2022-05-26T09:30:00-04:00,398.67,407.04,398.45,405.31,82168339,119163174.75,47.87246638774338,38.05810452808833,NaN,NaN,7.989793994665903,-62.745955872734136,1.434350043366667,-8.361211718431605,-9.795561761798272,9709643769,9610321935,37.672029943786654,32.23837627837485,NaN,NaN,-19.899846414258818,-22.414413767040763
2022-05-27T09:30:00-04:00,407.91,415.3801,407.7,415.26,84768710,116127059.8,53.84538336031608,39.49825049449272,NaN,NaN,83.82775321705492,-22.79812521211959,2.6390852785873697,-6.496705163564059,-9.135790442151428,9794412479,9658997127.4,43.7878198171436,31.70316296120561,NaN,NaN,-15.59515702966916,-21.440234233130536
2022-05-31T09:30:00-04:00,413.55,416.46,410.03,412.93,95936980,113008282.5,52.33316730612791,40.782277718278024,NaN,NaN,85.37005183714686,8.64837141751328,3.1904388741356087,-5.147741849481918,-8.338180723617526,9698475499,9673201948.2,45.46941890939939,31.6029047971064,NaN,NaN,-12.540588628447544,-20.168856289604395
2022-06-01T09:30:00-04:00,415.17,416.24,406.93,409.59,86585813,112336163.65,50.15853688125522,42.08296106714689,NaN,NaN,72.4941152348839,39.78936931535196,3.2316351534863204,-4.298636781759626,-7.530271935245946,9611889686,9688379372.6,47.28402062179896,32.24253851716135,NaN,NaN,-10.624952899883928,-18.80544151964433
2022-06-02T09:30:00-04:00,409.42,417.44,407.04,417.39,79609633,109104250.55,54.87443006173027,43.73157812907416,NaN,NaN,110.42534200247434,72.02141125724518,3.6544783581181584,-2.9621739875982485,-6.616652345716407,9691499319,9701184150.4,48.83107692329546,33.4046688551203,NaN,NaN,-7.514008761946722,-17.1923796971161
2022-06-03T09:30:00-04:00,412.4,414.04,409.51,410.54,71874281,104051509.3,50.3672770552068,44.53755796236569,NaN,NaN,92.73830013933164,88.97111248617833,3.3511062519527313,-2.4277695307754925,-5.778875782728224,9619625038,9683180404.2,46.75351660891243,34.567063599393784,NaN,NaN,-6.2004331822374095,-15.622101623562001
2022-06-06T09:30:00-04:00,414.78,416.609,410.5523,411.79,57508858,99338411.65,51.155683990918334,45.45459507148414,NaN,NaN,104.72729447981189,93.15102073872973,3.1177449531277057,-1.8816945913185918,-4.999439544446298,9677133896,9659724687.6,44.119843847137275,35.625896665787515,NaN,NaN,-4.904391321306342,-14.091000151811192
2022-06-07T09:30:00-04:00,408.1,416.22,407.61,415.74,59272373,94522726.95,53.660662042106964,46.12604560020919,NaN,NaN,93.23417898285962,94.72384616787227,3.1056999778090653,-1.1173145721849664,-4.223014549994032,9736406269,9667310841.6,45.195130633782966,36.881359060628206,NaN,NaN,-3.0824360064105116,-12.518348131039666
2022-06-08T09:30:00-04:00,413.93,415.82,410.38,411.22,64349966,91115365.25,50.470909128324614,47.11298299555352,NaN,NaN,77.85529123345827,95.79608136758715,2.685389072960639,-0.8662782087932328,-3.551667281753872,9672056303,9679344165,46.93929858488638,38.35906654464962,NaN,NaN,-2.435546576932926,-11.077947909024417
2022-06-09T09:30:00-04:00,409.34,411.74,401.44,401.44,86289796,88311805.45,44.330606293900104,47.73012381689754,NaN,NaN,13.347286867795736,76.38047034065143,1.6894169284947735,-1.4398961211354049,-3.1293130496301784,9585766507,9658197602.6,44.27277880421986,39.72318677513204,NaN,NaN,-3.724691381950023,-10.027482690870933
2022-06-10T09:30:00-04:00,394.88,395.7777,389.75,389.8,132893850,88701960.3,38.35038565486938,47.91091689216503,NaN,NaN,-96.91711321312349,38.449387670160405,0.2622905994121947,-2.801449800364935,-3.0637403997771298,9452872657,9624847126.4,40.37704159138418,40.86643285441291,NaN,NaN,-6.839993295331971,-9.572127062936795
2022-06-13T09:30:00-04:00,379.85,381.81,373.3,375,170004861,91993482.3,32.37092439667501,47.2769080013039,NaN,NaN,-183.79905874841847,-19.255882975485665,-1.5625241303543262,-5.016895562720038,-3.4543714323657113,9282867796,9545993906.4,32.9862925578489,41.314503613577436,NaN,NaN,-11.74959419847606,-9.883193796585262
2022-06-14T09:30:00-04:00,376.85,377.94,370.59,373.87,104011831,93262951.65,31.961176726603156,46.721090908247774,NaN,NaN,-166.58593653855047,-71.21990607976768,-2.6649936687206095,-6.785613518266473,-4.1206198495458635,9178855965,9434483845.6,25.7954941282741,41.33032364580293,NaN,NaN,-15.685771104870403,-10.712133412054568
2022-06-15T09:30:00-04:00,377.36,383.9,372.12,379.2,125666797,95394806,36.07161893568333,46.273087730104315,NaN,NaN,-121.61102593528099,-111.11316951351553,-2.838581792417367,-7.6688470900675725,-4.830265297650206,9304522762,9360977137.4,22.338523579870994,40.844449039410115,NaN,NaN,-17.63846333748605,-11.701609115687637
2022-06-16T09:30:00-04:00,370.51,370.94,364.0799,366.65,134473288,96234743.15,31.279833286157654,45.08789965141962,NaN,NaN,-158.77130563670502,-145.53688801441567,-3.5554553915066283,-9.27458453703349,-5.719129145526862,9170049474,9277833730.8,19.203643161340224,39.52527855494965,NaN,NaN,-20.981245819637167,-13.02727150196614
2022-06-17T09:30:00-04:00,365.51,369.38,362.17,365.86,111113904,96864902.6,31.00066198875311,43.456133839165126,NaN,NaN,-145.9942094608662,-155.3523072639642,-3.816670774213823,-10.48996761329414,-6.673296839080318,9058935570,9199046313.4,16.797967940928743,37.59743199236288,NaN,NaN,-23.684234738274387,-14.549694821438747
2022-06-21T09:30:00-04:00,371.89,376.525,371.81,375.07,76811861,94133885.8,37.95319386213932,42.42899287888023,NaN,NaN,-96.60756332937443,-137.9140081801554,-3.131719469555711,-10.587946176024957,-7.456226706469246,9135747431,9169622240.4,15.992231434038047,35.49191860126564,NaN,NaN,-23.801652723027146,-15.871403093094232
2022-06-22T09:30:00-04:00,370.62,378.72,370.18,374.39,90059424,94816113.1,37.65153594523251,41.53563566916432,NaN,NaN,-85.66342103756199,-121.7295050799577,-2.5136543677741816,-10.598294666186973,-8.084640298412792,9045688007,9142988648.8,15.277881418990617,33.20576580106504,NaN,NaN,-23.985316455438813,-17.03053357342917
2022-06-23T09:30:00-04:00,376.64,378.83,372.89,378.06,79292135,94208278.3,40.404628216724205,40.502078394521035,NaN,NaN,-69.77087824212578,-111.36147554132667,-1.6865762717231654,-10.192860638066747,-8.506284366343582,9124980142,9107080124.8,14.34735976880512,30.742643147172874,NaN,NaN,-23.325696190195433,-17.929842518681493
2022-06-24T09:30:00-04:00,381.4,390.09,381.365,390.08,98050333,94537151.65,48.43559941699403,40.364101420362985,NaN,NaN,-25.77220309525469,-84.76165503303659,-0.23512813923532327,-8.800194540387736,-8.565066401152412,9223030475,9117676325,15.973716409047341,28.544085990039655,NaN,NaN,-20.18641910138581,-18.25221060192497
2022-06-27T09:30:00-04:00,391.05,391.36,387.44,388.59,66009617,93729215.55,47.57965936720767,40.108671090097936,NaN,NaN,-15.660581812451225,-58.69492950335361,0.6699349929382983,-7.727647659979539,-8.397582652917837,9157020858,9137293382.6,19.038650683429864,26.75257219263198,NaN,NaN,-17.912448901595994,-18.203673216163686
2022-06-28T09:30:00-04:00,390.23,393.16,380.53,380.65,86689824,93825271.25,43.19870880413279,39.36138871595693,NaN,NaN,-28.808558090273095,-45.135128455533355,0.7719388382302466,-7.432659105130028,-8.204597943360275,9070331034,9124210103.2,18.552603636624582,24.849534549977808,NaN,NaN,-17.259747449125346,-18.068826678015352
2022-06-29T09:30:00-04:00,381.23,382.27,378.42,380.34,65675999,92312222.2,43.032112422507794,38.83004609411286,NaN,NaN,-42.72618008200358,-36.547680264421686,0.8504228403941783,-7.141569392867552,-7.991992233261731,9004655035,9116003508.8,18.23808070635205,22.799447558653924,NaN,NaN,-16.78318347699636,-17.885163363584066
2022-06-30T09:30:00-04:00,376.24,380.6582,372.56,377.25,112508273,93608345.2,41.32149726086942,38.61510973461067,NaN,NaN,-53.61945914295272,-33.317396444587075,0.7306994083692677,-7.078617972800146,-7.809317381169413,8892146762,9069436832.8,16.526043171000495,20.817537870566827,NaN,NaN,-16.864485094303564,-17.73935218225828
2022-07-01T09:30:00-04:00,376.56,381.7,373.8,381.24,74839729,93369850,44.395261498628464,39.046886580593466,NaN,NaN,-39.21316632240202,-36.005589090016535,0.9431831447232462,-6.630338450265356,-7.573521594988602,8966986491,9018228036,14.87264868495673,18.99579552010772,NaN,NaN,-16.068826611419805,-17.500705672138498
2022-07-05T09:30:00-04:00,375.88,381.98,372.9,381.96,81437965,93848034.2,44.95559807357759,39.94579184322936,NaN,NaN,-34.28709922929555,-39.7308925733854,1.1419156838655313,-6.146126990156688,-7.288042674022219,9048424456,8996508755.6,14.222705544376566,17.655539304859694,NaN,NaN,-15.257371442561363,-17.180229353627478
2022-07-06T09:30:00-04:00,382.11,385.87,379.6,383.25,70426244,94493903.5,46.00545223442301,40.948954379502204,NaN,NaN,-3.6827935503942837,-34.70573966540964,1.3553847624554214,-5.593811720952942,-6.949196483408364,9118850700,9006212688.8,15.989187795429586,16.955088852513658,NaN,NaN,-14.294762857177034,-16.768019854134558
2022-07-07T09:30:00-04:00,385.12,389.83,383.267,388.99,64525919,94756580.8,50.52703629983359,41.98148419122722,NaN,NaN,41.6718733597567,-17.82612897705757,1.8477994245850535,-4.639447202677047,-6.487246627262101,9183376619,9041957005.6,22.333905271666282,16.95475897335618,NaN,NaN,-12.194981276271827,-16.114728628725597
2022-07-08T09:30:00-04:00,387.27,390.64,385.66,388.67,72397765,95158970.75,50.27427574863789,43.33823008140438,NaN,NaN,71.5118088494782,7.200124621428611,2.098292032742852,-3.8643815863335362,-5.962673619076388,9110978854,9085723424,29.367839249026076,17.680772979619455,NaN,NaN,-10.507045796161139,-15.31363108121639
2022-07-11T09:30:00-04:00,385.85,386.87,383.5,384.23,58366945,93762828.2,46.77770698925594,44.46516186715458,NaN,NaN,57.37291730359024,26.517341346627063,1.916310140928866,-3.567285942915305,-5.483596083844171,9052611909,9102848507.6,31.964290156550504,18.764081709306726,NaN,NaN,-9.929863431957662,-14.54452141703657
2022-07-12T09:30:00-04:00,383.65,386.16,378.99,380.83,62219178,90229094.6,44.2402734106491,44.914238977762416,NaN,NaN,32.59301049882826,39.89336329225183,1.534804114365154,-3.5650909408877283,-5.099895055252882,8990392731,9091242162.6,31.129088238839657,19.845285766792554,NaN,NaN,-10.105822513402812,-13.910421573660319
2022-07-13T09:30:00-04:00,375.1,381.92,374.658,378.83,84224649,85940084,42.770547583452455,45.279882666206696,NaN,NaN,-14.21827814783137,37.78626637276441,1.1340860021955415,-3.6822875525084555,-4.816373554703997,8906168082,9048705639,28.218920540504584,20.769645704043548,NaN,NaN,-10.647088757401498,-13.44423117133763
2022-07-14T09:30:00-04:00,373.61,378.57,371.04,377.91,89704819,85224733.4,42.07805253836052,45.399412974895014,NaN,NaN,-50.542480249604914,19.34339565089208,0.808670698085459,-3.8055351820971737,-4.614205880182633,8816463263,8975322967.8,24.04296516472627,21.46218894660934,NaN,NaN,-11.286388488806187,-13.135967930975996
2022-07-15T09:30:00-04:00,382.55,385.25,380.54,385.13,79060383,82894412.7,49.04994345916896,45.44329469219322,NaN,NaN,48.38559124914061,14.718152130824564,1.06514520255151,-3.2827743769932454,-4.347919579544755,8895523646,8932231926.2,21.98551097091847,21.891602843885853,NaN,NaN,-9.963281096255606,-12.682726954587368
2022-07-18T09:30:00-04:00,388.38,389.09,380.66,381.95,63203626,79330929.6,46.400788313923194,45.35908961695862,NaN,NaN,45.14981468455382,12.27353160701728,1.0067607635489972,-3.089468625108509,-4.096229388657506,8832320020,8888173548.4,20.09230404984139,21.966863798629536,NaN,NaN,-9.549111786882433,-12.235067644915235
2022-07-19T09:30:00-04:00,386.08,392.87,385.39,392.27,78505972,77700533,54.91159976436102,46.195724685546345,NaN,NaN,128.1925638112588,31.39344226950339,1.6133332974916024,-2.0795627667930034,-3.692896064284606,8910825992,8872260200.6,19.441124668855437,22.030329586646026,NaN,NaN,-6.548743374707663,-11.422735606314154
2022-07-20T09:30:00-04:00,392.47,396.26,391.03,394.77,71843769,77452128.4,56.705071704719515,47.17236463427576,NaN,NaN,167.77686234486222,67.7924703680421,2.102159201193145,-1.0651970627931746,-3.1673562639863198,8982669761,8887560536.4,22.056738147801553,22.303090832463848,NaN,NaN,-3.5215768264605236,-10.293998637763636
2022-07-21T09:30:00-04:00,394.16,398.84,391.63,398.79,64903856,76194350,59.49509665926449,48.47047887701826,NaN,NaN,179.6416036398789,113.82928714593886,2.5837703395325997,0.06235666042942967,-2.52141367910317,9047573617,8933782607.2,29.503397365227272,23.230044703480047,NaN,NaN,-0.0991477644921768,-8.837591370153428
2022-07-22T09:30:00-04:00,398.92,400.18,392.75,395.09,72197332,75839609.85,55.92301023342569,49.29388950093236,NaN,NaN,150.9511717681907,134.34240324974888,2.5370512511007015,0.6499003847727067,-1.8871508663279948,8975376285,8949753135,31.923504799384517,24.447962997367743,NaN,NaN,1.7578450010296522,-7.323957602841559
2022-07-25T09:30:00-04:00,395.75,396.47,393.21,395.57,53631485,73618667.45,56.28965811798047,50.1034652183897,NaN,NaN,121.05090518839516,149.52262135051714,2.4226094855650406,1.141110990628306,-1.2814984949367347,9029007770,8989090685,37.6053156511821,26.11814943356814,NaN,NaN,3.3775553488250427,-5.7951700383177585
2022-07-26T09:30:00-04:00,393.84,394.06,389.95,390.89,52946393,72965506.25,51.76809364019176,50.51508246165889,NaN,NaN,74.27928851059747,138.73996629038487,1.9368989221221515,1.1396251577159546,-0.7972737644061969,8976061377,9002137762,39.411533560794204,27.791174131094184,NaN,NaN,3.4973210841578264,-4.467671306535532
2022-07-27T09:30:00-04:00,394.36,402.88,394.05,401.04,82342106,72748120.35,59.387552859829825,51.147976501658626,NaN,NaN,140.3450803734375,133.25360989609993,2.185947389135331,1.9351604720129671,-0.2507869171223641,9058403483,9017284506.4,41.527764243679556,29.162164057666562,NaN,NaN,6.009105000542438,-2.9709889769529654
2022-07-28T09:30:00-04:00,401.89,406.8,398.15,406.07,73966563,73162648.55,62.54533567319951,52.02448078198446,NaN,NaN,159.5833568920116,129.24196054652649,2.550744394598549,2.937643576125822,0.3868991815272732,9132370046,9034243792.2,43.89085104140807,30.1995220428367,NaN,NaN,9.13908243922107,-1.240978774642389
2022-07-29T09:30:00-04:00,407.58,413.03,406.77,411.99,87003672,71887418.5,65.90539655233908,53.39074432220468,NaN,NaN,191.06324831154535,137.26437585519741,3.019951138075518,4.161838104121671,1.1418869660461528,9219373718,9083043278.8,50.135573991563376,31.497470888194766,NaN,NaN,12.896632109801695,0.7786799231353374
2022-08-01T09:30:00-04:00,409.15,413.41,408.4,410.77,69997471,71645305.6,64.61885649531155,54.84635739968057,NaN,NaN,165.3008055078612,146.11435591909063,3.0674620905911683,4.976214579285113,1.9087524886939449,9149376247,9107116974.2,52.919349080092815,33.05391809114142,NaN,NaN,15.51821125184497,2.884327255808142
2022-08-02T09:30:00-04:00,409.12,413,406.82,408.06,63435418,70745178.25,61.73592426640037,56.201027162748275,NaN,NaN,133.43910144001438,157.94631850497402,2.7460920026218023,5.341367491971198,2.5952754893493957,9085940829,9129092864.6,55.36880825831561,34.99319578527078,NaN,NaN,16.840579008932423,4.878077506254468
2022-08-03T09:30:00-04:00,410.3,415.68,410,414.45,67820555,70614893.8,65.6297306363663,57.88328988403441,NaN,NaN,143.48354328622653,158.57401108753183,2.7848430175294494,6.076329261261208,3.2914862437317582,9153761384,9148164444.8,57.43833588811808,37.37857940837019,NaN,NaN,19.19977679460659,6.9240345474476275
2022-08-04T09:30:00-04:00,414.37,415.09,412.44,414.17,45656574,69671426.55,65.31608077650358,59.0451568352726,NaN,NaN,128.31219804705822,152.31977931854115,2.6152685325641833,6.560571909436987,3.945303376872804,9108104810,9143311397.6,56.71762136358195,39.85944443641758,NaN,NaN,21.003537641354427,8.935392132291456
2022-08-05T09:30:00-04:00,409.66,414.15,409.6,413.47,56814929,68892284.75,64.48635044354376,60.33698270167407,NaN,NaN,104.03062489501056,134.91325463523418,2.2912448901210585,6.809359489524127,4.518114599403068,9051289881,9109694630.2,51.86310410500091,42.12878729750041,NaN,NaN,22.25741410805369,10.838538128828919
2022-08-08T09:30:00-04:00,415.25,417.62,411.83,412.99,54025965,68675235.75,63.887032273375404,60.97808502374653,NaN,NaN,101.34930014956419,122.12295356357478,1.8962190381729283,6.888388397119229,4.992169358946301,8997263916,9079272164,47.86996616914265,44.159418833235215,NaN,NaN,23.14001850157776,12.595892467793039
2022-08-09T09:30:00-04:00,412.22,412.75,410.22,411.35,44931772,67810865.45,61.77458077378351,61.34019281439395,NaN,NaN,76.25903766590403,110.68694080875271,1.3990479279746397,6.7409792689146,5.3419313409399605,8952332144,9052550427,44.62026865622853,45.771099583837135,NaN,NaN,23.337451812677834,14.130400945633724
2022-08-10T09:30:00-04:00,418.78,420.14,416.72,419.99,68665712,67032918.6,67.81283432481717,61.934316933362005,NaN,NaN,111.10483955262774,104.21120006203296,1.5167735507399618,7.237898279364913,5.721124728624951,9020997856,9025997721.4,41.598337475696795,46.6350238774421,NaN,NaN,25.27789953490701,15.722900744101336
2022-08-11T09:30:00-04:00,422.99,424.95,419.21,419.99,59489704,65522162.85,67.81283432481716,62.783590082747104,NaN,NaN,117.50035475505945,102.04883140363322,1.4588915124013901,7.544739119126689,6.085847606725299,9020997856,9008576330.6,39.69863040565734,47.19038999217588,NaN,NaN,26.856557375284833,17.313423119984694
2022-08-12T09:30:00-04:00,422.03,427.21,421.03,427.1,61694542,64653870.8,72.02962972084805,63.907873768666214,NaN,NaN,130.14895000769152,107.2724964261694,1.744394747147302,8.266341040659427,6.521946293512125,9082692398,9014856834,40.749143839959146,47.414949148517096,NaN,NaN,29.56878435741749,19.064189011046523
2022-08-15T09:30:00-04:00,424.765,429.41,424.71,428.86,54048280,64196103.5,72.97351058415758,65.42254640752091,NaN,NaN,138.32105703667034,114.66684780359063,1.8847583373391599,8.877894215186075,6.993135877846915,9136740678,9042752186.4,45.306686574529955,47.83603150664108,NaN,NaN,32.09803390305558,20.9261668527621
2022-08-16T09:30:00-04:00,427.73,431.73,426.88,429.7,59289039,63235256.85,73.43428856558981,66.42588467221806,NaN,NaN,142.08389227862057,127.83181872613393,1.8637851225985589,9.322867281095114,7.459082158496555,9196029717,9091491701,52.22180871185869,48.599891825796725,NaN,NaN,34.31981126453579,22.839544625872627
2022-08-17T09:30:00-04:00,425.91,429.5,424.54,426.65,63563394,62821238.1,68.84465963303938,66.87583638363519,NaN,NaN,115.5416558074871,128.7191819771058,1.4902899191628665,9.321944557450138,7.831654638287271,9132466323,9113785394.4,55.02299299105972,49.39504482220042,NaN,NaN,34.95875292211156,24.5708600967639
2022-08-18T09:30:00-04:00,426.86,428.61,425.5,427.89,49023206,62027205.6,69.67449744315667,67.14505787583644,NaN,NaN,107.99540264347814,126.81819155478954,1.1858011040318992,9.313906018327145,8.128104914295246,9181489529,9145883729,58.77099637290015,50.011860706581615,NaN,NaN,35.72098892526894,26.163735643693194
2022-08-19T09:30:00-04:00,424.98,425.26,421.22,422.14,68016902,61818184.1,61.494921101080145,66.92191963339134,NaN,NaN,67.09450362075607,114.20730227740246,0.4917378123830556,8.742777179774066,8.25103936739101,9113472627,9152039774.8,59.468594193382,50.479663928959425,NaN,NaN,34.02205455508023,27.286352631034198
2022-08-22T09:30:00-04:00,417.05,417.23,412.4,413.35,77695640,63021391.85,51.534825848025385,66.19326974636456,NaN,NaN,-7.750908343046481,84.99290920145909,-0.605245737150387,7.494482195953026,8.099727933103413,9035776987,9131847036.6,56.11464447764845,50.53293794462605,NaN,NaN,29.19018425066141,27.558328576695228
2022-08-23T09:30:00-04:00,412.9,415.42,411.77,412.35,49105249,62829334.65,50.5320882542842,65.11486671907298,NaN,NaN,-30.148986199986343,50.5463335057377,-1.3987471295142457,6.351294021210606,7.750041150724852,8986671738,9089975440.8,49.83785967084364,49.99004678624931,NaN,NaN,24.99788196098899,27.192550488737194
2022-08-24T09:30:00-04:00,412.11,415.1101,411.39,413.67,49177804,61171119.55,51.863521553128926,64.15396963168908,NaN,NaN,-37.99306002987548,19.839390338265172,-1.8091901233014802,5.488553496598001,7.297743619899482,9035849542,9070652084.6,47.21320462262038,49.311159876180625,NaN,NaN,21.93592713906899,26.44160429592745
2022-08-25T09:30:00-04:00,415.24,419.56,414.09,419.51,50942252,60019904,57.33484918124066,63.64314811295314,NaN,NaN,0.06710104766449582,-1.7462699808975626,-1.6654440832676105,5.215938515814969,6.881382599082579,9086791794,9051712537.6,44.726905301724784,48.80143139023233,NaN,NaN,20.853377275852456,25.643286150202453
2022-08-26T09:30:00-04:00,419.39,419.96,405.25,405.31,103086976,60824069.2,44.18423755098037,62.23580563278207,NaN,NaN,-86.24019030716144,-32.41320876648105,-2.456988597163611,3.8101468526280655,6.2671354497916765,8983704818,9025758975.8,41.501627525340055,48.346550058532145,NaN,NaN,15.034625288546819,24.127763169965935
2022-08-29T09:30:00-04:00,402.2,405.84,401.1999,402.63,65370810,60592736.15,42.21618195051814,60.83877714540597,NaN,NaN,-152.54987632998512,-61.37300236386877,-3.05248157809992,2.4515334771667767,5.504015055266697,8918334008,9002270380,38.776354477807736,47.929127617216366,NaN,NaN,9.779403275983556,22.077997470825593
2022-08-30T09:30:00-04:00,403.85,404.1,396,398.21,85652443,61703587.4,39.12122506556881,58.78937648403109,NaN,NaN,-175.5679570381233,-90.45679653149617,-3.597962042332999,1.006562502350448,4.604524544683447,8832681565,8971472345.4,35.485931466283006,47.49252718797253,NaN,NaN,4.4160925168414,19.554868191684996
2022-08-31T09:30:00-04:00,399.93,401.24,395.04,395.18,76029671,62114043.2,37.11258597824572,56.59650160213313,NaN,NaN,-171.47136017656112,-117.1524565608333,-3.986593606707178,-0.37871746370052506,3.607876143006653,8756651894,8915632815.8,30.44207777920907,46.831344857511944,NaN,NaN,-0.5851677124806691,16.677720205375614
2022-09-01T09:30:00-04:00,392.89,396.78,390.04,396.42,78740084,63768218.7,38.50413690471747,54.20182354383809,NaN,NaN,-167.4928466554445,-150.6644461014551,-3.9749549327941196,-1.3608175229859967,2.614137409808123,8835391978,8865352852.6,26.754501464370136,45.831727544969866,NaN,NaN,-4.149861701943633,13.702351361472864
2022-09-02T09:30:00-04:00,400.28,401.555,390.33,392.24,99632149,65909079.7,35.64110731423321,51.535223310272066,NaN,NaN,-143.65506772464482,-162.1474215849518,-4.049876758113544,-2.448208537833807,1.601668220279737,8735759829,8815763854.8,23.704670857411344,44.28872642231854,NaN,NaN,-8.069689310282863,10.592059836936333
2022-09-06T09:30:00-04:00,393.13,394.12,388.42,390.76,76637400,67039651.45,34.65845966808595,48.76552124616465,NaN,NaN,-142.66589042504845,-160.17062440396444,-3.99358732086529,-3.3903159308018758,0.6032713900634145,8659122429,8763921539,21.008443680880347,42.05920034867723,NaN,NaN,-11.562596269444509,7.427108964596213
2022-09-07T09:30:00-04:00,390.43,398.59,390.2,397.78,70964232,68341274.45,42.724747618781315,46.89981324514621,NaN,NaN,-99.38296417759742,-144.93362583185927,-3.3064556557646503,-3.5297981796423983,-0.22334252387774822,8730086661,8743402558.2,20.03701344420415,39.56020180961612,NaN,NaN,-12.164521343459223,4.628304634874008
2022-09-08T09:30:00-04:00,395.39,400.86,394.12,400.38,80821681,68949072.9,45.41255439598434,45.166817313205335,NaN,NaN,-72.86801080531022,-125.2129559576091,-2.534482873814169,-3.3914461161454597,-0.8569632423312906,8810908342,8754253847.8,22.088780217652314,36.9400435128127,NaN,NaN,-11.831785564786385,2.2768631777796657
2022-09-09T09:30:00-04:00,402.74,407.51,402.46,406.6,76706918,69809933.6,51.30042097556241,44.438638732811214,NaN,NaN,-28.385163045140636,-97.39141923554833,-1.5130048701596017,-2.7482193300307927,-1.235214459871191,8887615260,8764698504.2,24.10731569519031,34.41423790579901,NaN,NaN,-9.65470427284116,0.5723535419766907
2022-09-12T09:30:00-04:00,408.78,411.73,408.46,410.97,69256262,70188019.6,54.9748987264867,44.68435822412987,NaN,NaN,4.605492898306128,-67.73930711095814,-0.5033036260384136,-1.864343992419208,-1.3610403663807944,8956871522,8808920842.8,32.12548717561418,32.70072666993942,NaN,NaN,-6.639172408478516,-0.45786445094548167
2022-09-13T09:30:00-04:00,401.83,403.1,391.92,393.1,122947081,73632959.65,41.26391431918616,44.02234580019431,NaN,NaN,-76.29506773100763,-54.465142572149965,-0.9720717468413089,-2.5761300499324307,-1.6040583030911217,8833924441,8843881245.2,37.72687315090177,31.835656204229284,NaN,NaN,-8.745477722323466,-1.6418092039994796
2022-09-14T09:30:00-04:00,394.47,396.2,391.12,394.6,85023747,74919695.05,42.55893899045532,43.35773276000334,NaN,NaN,-82.402964247861,-51.06914258620269,-1.1045785270830837,-2.9847814619449764,-1.8802029348618927,8918948188,8881653550.6,43.182591576388674,31.547755272355595,NaN,NaN,-9.88729599778286,-2.8197358888256767
2022-09-15T09:30:00-04:00,392.96,395.96,388.78,390.12,87633840,76123217.35,39.740686830933484,42.101006877838536,NaN,NaN,-91.3890952490783,-54.773359474956294,-1.398489060881666,-3.6283142609639754,-2.2298252000823093,8831314348,8885734751.8,43.75595112360172,31.478401402489656,NaN,NaN,-11.766061834418535,-4.097782452481799
2022-09-16T09:30:00-04:00,384.14,386.25,382.11,385.56,103084819,78826298,37.05123796513541,41.591506907421035,NaN,NaN,-132.59267903683877,-75.61486267329592,-1.7800750383039432,-4.454918997962238,-2.674843959658295,8728229529,8853857605.6,40.33240735358264,31.39488567593556,NaN,NaN,-14.196285484472984,-5.540425742766255
2022-09-19T09:30:00-04:00,382.26,388.55,382.1784,388.55,73278490,79089377.4,39.922234846491314,41.427653542847686,NaN,NaN,-113.12070838230576,-99.16010292941829,-1.7107304048486598,-4.81325696571912,-3.10252656087046,8801508019,8822784905,37.27117633250606,31.28737295127115,NaN,NaN,-15.235305738483303,-6.925408599297262
2022-09-20T09:30:00-04:00,385.06,386.12,381.195,384.09,77274882,79068339.5,37.19701249923672,41.290209788109685,NaN,NaN,-125.95316147175132,-109.09172167756704,-1.8339288555490714,-5.394937630306799,-3.561008774757728,8724233137,8800846644.2,35.2376191187645,31.269636355019827,NaN,NaN,-16.9656060800652,-8.359722525121253
2022-09-21T09:30:00-04:00,386.11,389.31,377.38,377.39,106746554,81950404.75,33.497656331619964,41.03200052763641,NaN,NaN,-136.36047306655982,-119.8832234413068,-2.2101229869813857,-6.32366250848446,-4.113539521503075,8617486583,8740554323.2,30.338462197929843,31.26223524207131,NaN,NaN,-19.651792264026373,-9.97287534496484
2022-09-22T09:30:00-04:00,376.58,378.3,373.44,374.22,89472641,83965146.6,31.882057362033763,40.55899484601615,NaN,NaN,-172.54656600557297,-136.1147175926057,-2.4948555211290993,-7.232108922914449,-4.73725340178535,8528013942,8679894242,26.366596665844597,31.234527756462338,NaN,NaN,-22.354952813496677,-11.741743554755104
2022-09-23T09:30:00-04:00,370.58,370.62,363.29,367.95,122346933,87535380.65,28.911842441697573,40.07833306940646,NaN,NaN,-207.58253608670705,-151.11268900257937,-2.899484025510926,-8.361608433674007,-5.462124408163081,8405667009,8615381738,22.92860925652262,31.179094784970285,NaN,NaN,-25.62435369435039,-13.724973574697287
2022-09-26T09:30:00-04:00,366.41,370.21,363.0299,364.31,92581244,87010094.05,27.320551728496568,39.55419678800721,NaN,NaN,-182.87311213103808,-165.06316975232585,-3.183600740007998,-9.441625333173079,-6.25802459316508,8313085765,8517697287.2,18.908227843272414,31.029079367998293,NaN,NaN,-28.822060546351562,-15.881700284933611
2022-09-27T09:30:00-04:00,368.02,370.4,360.87,363.38,108294074,89156257.25,26.912982084257052,38.42478496411262,NaN,NaN,-157.5690786521417,-171.38635318840392,-3.1970871926435462,-10.254383583969513,-7.057296391325967,8204791691,8413808998,15.746045653489901,30.722581668661558,NaN,NaN,-31.514308153350512,-18.11492998042174
2022-09-28T09:30:00-04:00,364.38,372.3,362.6,370.53,110802217,90413745.95,34.947900295776904,37.677309671240664,NaN,NaN,-116.3989623758466,-167.39405105026128,-2.5173073259282734,-10.20393054873631,-7.686623222808036,8315593908,8353430463,14.25402685744615,30.162956428646833,NaN,NaN,-31.41576150253987,-20.015048769295756
2022-09-29T09:30:00-04:00,366.81,367.11,359.7,362.79,112952315,92259878.15,30.977719669695745,36.22568814939304,NaN,NaN,-128.9906996980999,-158.6828777887667,-2.383144306590909,-10.665553606046672,-8.282409299455763,8202641593,8288355993.2,12.841691677938798,29.358268998843155,NaN,NaN,-32.590916789260035,-21.811601343576367
2022-09-30T09:30:00-04:00,361.8,365.91,357.04,357.18,153711243,96008436.1,28.454544514324226,34.33137713423857,NaN,NaN,-127.24144685996959,-142.61465994341918,-2.4566331121357514,-11.353200689625453,-8.896567577489702,8048930350,8217008661.4,11.4966845088545,27.884783094074606,NaN,NaN,-34.388670823373225,-23.608325554975917
2022-10-03T09:30:00-04:00,361.08,368.55,359.21,366.61,89756479,95514652.6,37.64805682324568,34.073101598814254,NaN,NaN,-89.99920690194195,-124.03987889759996,-1.6910048264052335,-11.010323610496243,-9.31931878409101,8138686829,8182128874.2,10.895863922062006,25.968282434871764,NaN,NaN,-32.86303036386492,-24.93042624196006
2022-10-04T09:30:00-04:00,372.4,378,366.5677,377.97,103602775,96862921.35,46.557270267857525,34.35869669005727,NaN,NaN,-37.85265089118867,-100.09659334540935,-0.31254747091903745,-9.710003122739806,-9.397455651820769,8242289604,8189628456.8,11.961218469980366,23.738184355842602,NaN,NaN,-28.34333865332528,-25.417985157869378
2022-10-05T09:30:00-04:00,373.39,379.46,370.95,377.09,88065669,97717993.2,46.00884216702136,34.8064220712064,NaN,NaN,-25.20727065105039,-81.85825500045011,0.5973424144305497,-8.650777633782582,-9.248120048213131,8154223935,8157354462.2,11.333231855788313,21.422275836713073,NaN,NaN,-25.053581805062734,-25.36592753603986
2022-10-06T09:30:00-04:00,375.62,378.72,372.68,373.2,82333543,97793586.3,43.565807811705845,35.271748488818574,NaN,NaN,-25.548571837720818,-61.16982942837431,0.9723927235634555,-8.032629143758811,-9.005021867322267,8071890392,8131204222,10.836773741274442,19.315444864405343,NaN,NaN,-23.142438257748868,-25.048286210569717
2022-10-07T09:30:00-04:00,368.97,373.2933,360.94,362.79,107789498,99347715.3,37.783787976185955,35.11900228379676,NaN,NaN,-72.0558757592705,-50.13271520823447,0.574247743139253,-8.2872121883982,-8.861459931537453,7964100894,8114238330.8,10.514947374804066,17.404285653140914,NaN,NaN,-23.385523947060722,-24.810748744354147
2022-10-10T09:30:00-04:00,363.96,364.21,357.67,360.02,76042765,99687040.45,36.39944933252501,35.06203348617449,NaN,NaN,-100.9524421197994,-52.32336225180596,0.19860847708181417,-8.613199335185186,-8.811807812267,7888058129,8064112590.8,9.60715750947243,15.573538395334339,NaN,NaN,-24.024000270437675,-24.698356105223223
2022-10-11T09:30:00-04:00,358.235,363.03,355.71,357.74,92482785,98163825.65,35.25448748944987,35.187521426019494,NaN,NaN,-104.24718150464878,-65.60226837449798,-0.11241502580049101,-8.952326594517615,-8.839911568717124,7795575344,7974769738.8,8.241428809095083,13.995178867560428,NaN,NaN,-24.892197540748874,-24.726047738869745
2022-10-12T09:30:00-04:00,358.17,359.8179,356.3,356.56,76991799,97762228.25,34.64706001411068,35.38502161545356,NaN,NaN,-105.40682255618432,-81.64217875552477,-0.29617860739445234,-9.21013482796019,-8.913956220565737,7718583545,7887641660.8,7.170840293082989,12.624053412363171,NaN,NaN,-25.773611938312413,-24.875699767361557
2022-10-13T09:30:00-04:00,349.205,367.51,348.11,365.97,147254518,100743262.15,43.07084146272785,36.39637868838429,NaN,NaN,-77.70145362396983,-92.07275511277456,0.28595916562893464,-8.556507263529568,-8.842466429158502,7865838063,7846431195,6.725801193869515,11.466709979316521,NaN,NaN,-23.947988892588544,-24.743169642393983
2022-10-14T09:30:00-04:00,368.55,370.26,356.96,357.63,123737013,101775871.85,38.352428574522406,37.18436989167185,NaN,NaN,-64.37595694137458,-90.53677134919538,0.18421715420687157,-8.612194986399913,-8.796412140606785,7742101050,7802031226.2,6.274014475784313,10.564266167353086,NaN,NaN,-23.86252791491441,-24.61736368132547
2022-10-17T09:30:00-04:00,364.01,367.9799,357.2808,366.82,93168231,102770358.9,45.44467585696266,38.508062304007964,NaN,NaN,-36.81276122240419,-77.70883516971634,0.7774698057729506,-7.824574883390596,-8.602044689163547,7835269281,7791473456.6,6.167917696194991,9.880114170403449,NaN,NaN,-21.42582366040797,-24.16142939262297
2022-10-18T09:30:00-04:00,375.13,375.45,367.52,371.13,97162850,103764757.3,48.44054381008597,39.47182255503004,NaN,NaN,56.01318481034414,-45.65676190671775,1.4620301531337514,-6.774506997746357,-8.236537150880109,7932432131,7818844814,10.398320061035378,9.604706542088394,NaN,NaN,-18.46763885960874,-23.34803074504951
2022-10-19T09:30:00-04:00,368.99,371.85,365.55,368.5,79746863,102414772.75,46.7533633117937,40.59865424375132,NaN,NaN,35.1576260455464,-17.5438721863716,1.7217077613517615,-6.0844024491904065,-7.806110210542168,7852685268,7845665158.6,14.467565246007482,9.720840368379015,NaN,NaN,-16.59722004883819,-22.383629217019323
2022-10-20T09:30:00-04:00,368.03,372.67,364.61,365.41,88283087,102355295.05,44.779926054253906,41.764752925174875,NaN,NaN,28.164856119878575,3.629389762398085,1.6681841250920195,-5.720880054177144,-7.389064179269163,7764402181,7825377982.2,13.951435904038235,9.896179753749283,NaN,NaN,-15.648331139748493,-21.421443777409205
2022-10-21T09:30:00-04:00,365.12,374.8,363.54,374.29,131038379,102789867.35,51.15999451196539,42.729891331512,NaN,NaN,74.2803730392293,31.360655758518863,2.1812531208037917,-4.662497778264424,-6.843750899068215,7895440560,7856045884.2,18.67463513299097,10.451806268815636,NaN,NaN,-12.792114583847352,-20.188682464043225
2022-10-24T09:30:00-04:00,375.89,380.06,373.11,378.87,85436907,102432650.5,54.105285591989094,43.269035283235674,NaN,NaN,143.35762726172453,67.39473345534459,2.743168005449993,-3.4147908922557235,-6.157958897705717,7980877467,7885167521.4,22.996955349839837,11.240073188805598,NaN,NaN,-9.491950331886615,-18.66057787373514
2022-10-25T09:30:00-04:00,378.79,385.25,378.671,384.92,78846348,100960264.2,57.73142660030648,44.10636274275605,NaN,NaN,179.3863299367866,92.06936248063309,3.393801771246392,-1.915706683647727,-5.309508454894119,8059723815,7910625858.2,26.666339698669148,12.335295177582802,NaN,NaN,-5.544506032365725,-16.78685332496808
2022-10-26T09:30:00-04:00,381.62,387.58,381.35,382.02,104087348,100624520.75,55.46907427028205,44.95659606122577,NaN,NaN,156.3903706437801,116.31591140027982,3.4870322639527824,-0.9507181249531413,-4.437750388905924,7955636467,7931216098,29.588764417833673,13.674723083051317,NaN,NaN,-2.984211894353744,-14.81504740630889
2022-10-27T09:30:00-04:00,383.07,385,379.33,379.98,81971756,99075492.8,53.869845713042395,46.105600185286946,NaN,NaN,116.59722814872576,134.00238580604926,3.2729414262979604,-0.3465736060334734,-3.619515032331434,7873664711,7953068604,32.65610991694656,15.25623469320435,NaN,NaN,-1.3439138897158829,-12.890599761081319
2022-10-28T09:30:00-04:00,379.87,389.52,379.68,389.02,100301958,96405028.55,59.449177995516926,47.75200937550066,NaN,NaN,140.3226177593962,147.21083475008263,3.5770905475957977,0.8518481521633134,-2.7252423954324843,7973966669,7968773825.8,34.85267868401395,17.0594862056716,NaN,NaN,1.8533390069703854,-10.78432279421679
2022-10-31T09:30:00-04:00,386.44,388.4,385.26,386.21,96631258,96748767.5,57.13589417096042,49.31496699560855,NaN,NaN,126.96920849356009,143.93315099644974,3.425726206499311,1.5569153626916545,-1.8688108438076565,7877335411,7948065414.6,33.30988746209822,18.850090395171826,NaN,NaN,3.8003189303987948,-8.700802547843136
2022-11-01T09:30:00-04:00,390.14,390.39,383.29,384.52,85407598,95839008.65,55.731311208524104,50.82098493806666,NaN,NaN,108.36680757505633,129.7292465241037,3.0604574813123393,1.9567610078327675,-1.1036964734795718,7791927813,7894506214.2,29.653749319385597,20.456012468479155,NaN,NaN,4.998040222111161,-6.743825009278236
2022-11-02T09:30:00-04:00,383.9,388.63,374.76,374.87,126990356,97785243,48.41278362392568,51.20255223529507,NaN,NaN,54.13203100389088,109.27757859612584,2.0653016166908165,1.4779305473839486,-0.5873710693068677,7664937457,7836366412.2,26.28147211928902,21.852846106009117,NaN,NaN,3.834169422670878,-5.23268294757122
2022-11-03T09:30:00-04:00,371.465,374.2,368.79,371.01,87100115,98023571.6,45.82080258776503,51.736007521955266,NaN,NaN,-5.97495938921172,84.76314108853833,1.0923094442063292,0.778015735951044,-0.3142937082552853,7577837342,7777200938.4,23.368991126750245,23.073915866792397,NaN,NaN,2.0694141427142996,-4.189526220387575
2022-11-04T09:30:00-04:00,377,378.87,370,376.35,103505182,97809355.8,49.82314156142166,52.04875507227376,NaN,NaN,19.45916593598972,60.590450723857046,0.7688478149939049,0.6467660604870957,-0.12208175450680908,7681342524,7718676109.4,20.901541889462564,24.12631759488294,NaN,NaN,1.7669352640533542,-3.3386031511817276
2022-11-07T09:30:00-05:00,377.71,380.57,375.53,379.95,68286947,97421564.9,52.377263207224054,52.32994931492648,NaN,NaN,42.02883559101273,43.60237614334758,0.7566606451699729,0.8237440519556571,0.0670834067856842,7749629471,7693134921.4,19.91335665804357,24.80596306609781,NaN,NaN,2.2736915948444736,-2.5368467588922705
2022-11-08T09:30:00-05:00,381.11,385.12,377.72,382,84641062,97029478.75,53.81884389455015,52.83462649940908,NaN,NaN,59.68484417600789,33.8659834635379,0.8395711860984195,1.1165473894087086,0.27697620331028905,7834270533,7701603465.4,21.242898761763783,25.289915460080405,NaN,NaN,3.1090537754350214,-1.7302895397026574
2022-11-09T09:30:00-05:00,379.93,381.14,373.61,374.13,78495470,97104662.3,47.83260316959077,53.05267486479029,NaN,NaN,7.097129827233312,24.45900322820639,0.34275604458686776,0.7054212590438738,0.362665214457006,7755775063,7719770986.6,24.151992985114205,26.018526680157258,NaN,NaN,2.04016803688096,-1.191652743047855
2022-11-10T09:30:00-05:00,388.05,395.04,385.642,394.69,141455847,96814728.75,60.266553144130235,53.70314333851635,NaN,NaN,145.28306865330606,54.710608836709945,1.3221789191190656,2.015388863355838,0.6932099442367725,7897230910,7783649700.2,33.458859305246435,27.07454269246122,NaN,NaN,5.403360669886244,-0.2495079697715551
2022-11-11T09:30:00-05:00,395.59,399.35,393.61,398.51,93839872,95319871.7,62.075217519081,54.27242419045149,NaN,NaN,179.55288479544146,86.7293526086003,2.104215011608378,3.3234787087472455,1.219263697138867,7991070782,7845595351.8,41.01716252557135,28.361700347870613,NaN,NaN,8.667724537758996,1.024382388447095
2022-11-14T09:30:00-05:00,396.66,400.1799,394.83,395.12,71893165,94256118.4,59.48731948020639,54.39784511044434,NaN,NaN,156.89422449081877,109.7024303885615,2.25661598113318,4.040033673555342,1.783417692422162,7919177617,7879504981,44.71891620408271,29.651170098257296,NaN,NaN,10.426968400438918,2.367608961588784
2022-11-15T09:30:00-05:00,401.15,402.31,394.49,398.49,93194452,94057698.5,61.21821781576414,54.808498220835915,NaN,NaN,152.18455049248524,128.20237165185696,2.432648866109969,4.824228775059623,2.3915799089496543,8012372069,7915125288.2,48.38353982162536,30.993654055670987,NaN,NaN,12.399577000661266,3.8007472528848525
2022-11-16T09:30:00-05:00,396.78,397.78,394.79,395.45,68508454,93495778.05,58.77856554166737,55.15912106573769,NaN,NaN,116.11441352942529,150.00582839229537,2.1996501192434246,5.141142558003935,2.9414924387605104,7943863615,7952742998.6,52.00224446894758,32.37552080938535,NaN,NaN,13.26911266602589,5.153370883333572
2022-11-17T09:30:00-05:00,390.46,394.95,390.14,394.24,74496255,92806436.45,57.79136212684065,55.040705646546535,NaN,NaN,80.34174813611322,137.0175642888568,1.8342653263409447,5.2343240966866915,3.4000587703457468,7869367360,7947170288.6,51.427049214230145,33.559404418686505,NaN,NaN,13.686973985509926,6.372457040787337
2022-11-18T09:30:00-05:00,397.74,397.81,393.04,396.03,92922451,90900640.05,58.891313806119044,55.16609276334358,NaN,NaN,94.01365965101635,119.90971925997178,1.592329928881342,5.390471181447424,3.798141252566082,7962289811,7941414094.4,50.80198083446244,34.808839659569664,NaN,NaN,14.342736329907476,7.5110683678045
2022-11-21T09:30:00-05:00,394.64,395.82,392.66,394.59,51243189,89190954.15,57.59107946188008,55.29893335286901,NaN,NaN,73.44056656476049,103.21898767476011,1.2306925780530156,5.336506975132352,4.105814397079336,7911046622,7939787895.4,50.614810732681754,36.30605833194796,NaN,NaN,14.535264054338704,8.514524894452244
2022-11-22T09:30:00-05:00,396.63,400.07,395.1527,399.9,60429025,88270088,61.009647761754906,56.19870936271395,NaN,NaN,97.57456134681192,92.29698984562545,1.240950222813563,5.65700217559629,4.416051952782727,7971475647,7931608611,49.62448481691402,37.973416381778314,NaN,NaN,15.658789472173188,9.53513411984095
2022-11-23T09:30:00-05:00,399.55,402.93,399.31,402.42,68261628,86478802,62.55241893539672,57.39382481611621,NaN,NaN,110.21312942381162,91.11673302450274,1.3028870646900348,6.04466078364527,4.741773718955235,8039737275,7950783343,51.99574358983804,40.018184414856016,NaN,NaN,17.039772857375524,10.607225368060176
2022-11-25T09:30:00-05:00,401.83,402.91,401.535,402.33,30545434,83907485.9,62.457368373106526,58.29626958837941,NaN,NaN,104.15077067422759,95.87853753212559,1.224434948797951,6.272317404952673,5.047882456154722,8009191841,7978748239.2,55.300438029466235,42.475248424856275,NaN,NaN,18.158788163811465,11.686020053167503
2022-11-28T09:30:00-05:00,399.09,400.81,395.11,395.91,68021749,82293475.45,55.92872827700333,58.54994566479222,NaN,NaN,58.64441712742941,88.80468902740822,0.6553457966217833,5.867064701931952,5.2117189053101685,7941170092,7974524295.4,54.68804036263455,44.95915440375563,NaN,NaN,17.365959334748617,12.497439950536235
2022-11-29T09:30:00-05:00,396.05,397.3,393.3,395.23,52310039,80077414.5,55.26972898262318,58.65358031394029,NaN,NaN,39.44735938243019,82.00604759094215,0.17338717373406443,5.428452872477749,5.255065698743684,7888860053,7970086981.6,54.011370479077094,47.29975952642087,NaN,NaN,16.526983913789163,13.073089088143796
2022-11-30T09:30:00-05:00,395.49,407.68,393.48,407.68,144566653,83035367.25,63.702524163656044,59.78714609923067,NaN,NaN,92.87873924313641,81.06688317020703,0.6088360875004648,6.016110808119265,5.4072747206188,8033426706,7982477193.4,55.66109972953598,49.55041000816528,NaN,NaN,18.259295544017846,13.813975724697231
2022-12-01T09:30:00-05:00,408.77,410,404.75,407.38,76398170,80505757.95,63.39239417477417,60.01042045856237,NaN,NaN,122.55416407387392,83.5350901002195,0.7814084462258739,6.384035278401143,5.602626832175269,7957028536,7965935445.6,52.93111272802333,50.941285252649344,NaN,NaN,19.56388682195983,14.635391595734745
2022-12-02T09:30:00-05:00,402.25,407.86,402.14,406.91,85342731,80417888.75,62.87593869389377,60.06761482819186,NaN,NaN,109.59011600160439,84.62295916569487,0.7675383540494574,6.5620497747370905,5.794511420687633,7871685805,7938434238.4,48.65823745006002,51.48707631868425,NaN,NaN,20.493436580145353,15.47225516493626
2022-12-05T09:30:00-05:00,403.95,404.93,398.17,399.59,77289815,79107120.4,55.31713109225175,59.76974422905224,NaN,NaN,61.39322422299118,85.17272058480721,0.1986364664724487,6.042807003778194,5.844170537305745,7794395990,7909079418,44.5264356862665,51.47332771026881,NaN,NaN,19.120021429118243,15.993364631247973
2022-12-06T09:30:00-05:00,399.42,399.99,391.64,393.83,77972217,79591383.9,50.202757302375716,58.982925620953075,NaN,NaN,-17.098311055953925,73.86358649713038,-0.5892229978278589,5.107641790020921,5.69686478784878,7716423773,7874592162,40.20680548659569,50.8892752577667,NaN,NaN,16.356022054491916,16.045172834568536
2022-12-07T09:30:00-05:00,392.94,395.64,391.97,393.16,65927896,78655725.6,49.62798417491513,58.32931266618505,NaN,NaN,-53.98920584172706,44.4899974801577,-1.1468450670790036,4.2633084540000254,5.410153521079029,7650495877,7798005996.2,32.635153178172686,49.50591159413991,NaN,NaN,13.940941906266332,15.74456841623965
2022-12-08T09:30:00-05:00,395.14,397.36,393.2684,396.24,60737912,77767847.7,52.329921959382276,57.939209797080885,NaN,NaN,-46.03117488264765,10.772929688853385,-1.288997196048948,3.7989070260178437,5.087904222066792,7711233789,7748847046.8,28.876191058557765,47.89513601159189,NaN,NaN,12.63898451839518,15.30091357369044
2022-12-09T09:30:00-05:00,394.94,397.62,393.15,393.28,81447733,74767442,49.57761227566565,57.27394540204849,NaN,NaN,-69.79403671769556,-25.103900855006607,-1.5458097700566515,3.1556420094959776,4.701451779552629,7629786056,7700467097,25.734615679911926,46.104609929124,NaN,NaN,10.737543953843968,14.649003627998088
2022-12-12T09:30:00-05:00,394.11,398.95,393.412,398.95,75405835,73845740.15,54.51288990207952,57.054074719205595,NaN,NaN,-20.30932549903828,-41.444410799412495,-1.3067570982823566,3.068005406699683,4.37476250498204,7705191891,7682626277.2,24.668782183372826,44.251322175601935,NaN,NaN,10.48702451694335,14.054435183561697
2022-12-13T09:30:00-05:00,410.22,410.49,399.07,401.97,123782534,76440208.6,56.930923377222165,56.76273726316754,NaN,NaN,101.68730310941658,-17.687287966338396,-0.9355756783883598,3.20529290699659,4.14086858538495,7828974425,7705136407.6,28.682227375022563,42.75544664403826,NaN,NaN,10.980361873531933,13.615281853557445
2022-12-14T09:30:00-05:00,401.61,405.5,396.31,399.4,108111349,77186053.45,54.286234753375986,56.172295535880345,NaN,NaN,33.78480710670607,-0.13248537665177054,-0.8556448368333682,3.0713125393432392,3.9269573761766075,7720863076,7719209847.4,31.151910167721084,41.26660139960133,NaN,NaN,10.636881502875845,13.18979608917436
2022-12-15T09:30:00-05:00,394.3,395.25,387.885,389.63,117705889,79645925.2,45.61165786070791,54.96903049928045,NaN,NaN,-127.49384345373056,-16.425019090868354,-1.4199913139385711,2.1519682337533936,3.5719595476919648,7603157187,7697594527,29.46425038067798,39.42115942468788,NaN,NaN,7.561529731548005,12.38575803808488
2022-12-16T09:30:00-05:00,385.18,386.575,381.04,383.27,119857952,81914010.05,41.01684272138224,53.90389581673609,NaN,NaN,-220.89144439235662,-46.64450062580056,-2.1377196767286053,0.8998099517812079,3.0375296285098132,7483299235,7668297162.8,27.305041686497844,37.46523094782098,NaN,NaN,3.404375518784157,11.102703392470492
2022-12-19T09:30:00-05:00,383.47,383.82,378.28,380.02,79878103,81261792.65,38.86241043768208,52.73194449209743,NaN,NaN,-219.26128268623074,-86.43489206323906,-2.710615097165121,-0.3507392429465881,2.359875854218533,7403421132,7607943011,23.48662649260052,35.28489209164408,NaN,NaN,-0.6996767992017171,9.416649079374462
2022-12-20T09:30:00-05:00,379.23,382.23,377.85,380.54,74427240,82420995.2,39.41077663082223,50.99681966832359,NaN,NaN,-187.21642524997867,-144.21563773511812,-2.9159292779107346,-1.2850357431698853,1.6308935347408493,7477848372,7537717800.4,19.984689736647724,32.73657709215206,NaN,NaN,-3.8174174963590555,7.52606813998396
2022-12-21T09:30:00-05:00,383.25,387.41,382.69,386.23,78167369,83307912.4,45.20260736467765,49.69754918188812,NaN,NaN,-110.51483038438094,-173.0755652333355,-2.54350443563618,-1.5484870098043757,0.9950174258318043,7556015741,7504748333.4,18.583734650374808,30.283192943748592,NaN,NaN,-4.780903894224164,5.767929277954228
2022-12-22T09:30:00-05:00,383.05,386.2134,374.77,380.72,100120855,84900873.75,41.10492447954449,48.14247673800603,NaN,NaN,-138.99007427661056,-175.37481139791151,-2.5374477656833734,-2.1767922812724123,0.36065548441096096,7455894886,7475295873.2,17.40962019802842,28.05114885431777,NaN,NaN,-6.8907341584546495,3.959548787038674
2022-12-23T09:30:00-05:00,379.65,383.06,378.03,382.91,59857329,86366468.5,43.304801186935904,47.284453173340616,NaN,NaN,-112.84853783857743,-153.76623008715566,-2.2641617009310537,-2.4695466417528564,-0.2053849408218026,7515752215,7481786469.2,18.629707753095317,26.201382573376975,NaN,NaN,-7.958573138604865,2.2569599405181684
2022-12-27T09:30:00-05:00,382.79,383.15,379.65,381.4,51638180,85547290.05,42.136132140232746,46.70826566175897,NaN,NaN,-97.14402507956102,-129.34277856582173,-2.068672409326222,-2.79122545247958,-0.722553043153358,7464114035,7493925049.8,20.980760598832305,24.828093652822446,NaN,NaN,-9.177073948429173,0.6235265278114053
2022-12-28T09:30:00-05:00,381.33,383.39,376.42,376.66,70911520,86477364.1,38.61340005691513,45.9215096533304,NaN,NaN,-103.3396448476348,-112.56742248535292,-2.1336086309138493,-3.3895638317956696,-1.2559552008818202,7393202515,7476995878.4,20.10814879277426,23.933307625293985,NaN,NaN,-11.286213082132281,-1.0778648450376926
2022-12-29T09:30:00-05:00,379.63,384.35,379.08,383.44,66970877,82597575.3,45.6170402016017,45.44201809920322,NaN,NaN,-68.57695537053375,-104.1798474825835,-1.6183280420182722,-3.2788652534046605,-1.6605372113863883,7460173392,7457827408.6,19.13758642634643,23.23769300870746,NaN,NaN,-10.98792708071546,-2.493588021563088
2022-12-30T09:30:00-05:00,380.64,382.58,378.43,382.43,84022205,82978777.05,44.79711051773368,45.100553687922364,NaN,NaN,-70.01786030897205,-90.38540468905579,-1.2598417610877695,-3.2353394127461,-1.9754976516583307,7376151187,7441878668.8,18.34421929857723,22.70980755289784,NaN,NaN,-10.98767038737482,-3.7070283595361926
2023-01-03T09:30:00-05:00,384.37,386.43,377.831,380.82,74850731,82454177.05,43.456228029567185,44.31079212560006,NaN,NaN,-59.49663123590927,-79.71502336852214,-1.0538427220734201,-3.2928010542501056,-2.2389583321766855,7301300456,7398988317,16.377863095085104,22.117599046591575,NaN,NaN,-11.370134393259477,-4.801757792925233
2023-01-04T09:30:00-05:00,383.18,385.88,380,383.76,85934098,82886391.2,46.599569844561934,43.57283830183861,NaN,NaN,-41.309542040204164,-68.54812676065077,-0.6614462510413155,-3.06576614597833,-2.4043198949370144,7387234554,7383612420.8,15.72702200056058,21.19222723413001,NaN,NaN,-10.794706244257373,-5.657893285972682
2023-01-05T09:30:00-05:00,381.72,381.84,378.76,379.38,76970456,82836303.15,42.783675119250574,42.75122689940108,NaN,NaN,-66.68704447010252,-61.217606685144325,-0.6384272814970844,-3.2023539968083696,-2.5639267153112852,7310264098,7367024737.4,15.032969246577949,20.040874311191214,NaN,NaN,-11.396330480217127,-6.477670028007602
2023-01-06T09:30:00-05:00,382.61,389.25,379.4127,388.08,104189603,84749388.5,51.31204179631955,43.1583971805162,NaN,NaN,-8.84828379650459,-49.27187237033849,-0.011943518624523364,-2.5788561135919394,-2.566912594967416,7414453701,7357880799.2,14.649181094714208,18.982655076479514,NaN,NaN,-9.240243667521723,-6.872323405081048
2023-01-09T09:30:00-05:00,390.37,393.7,387.67,387.86,73978071,85411396.45,51.104601072148704,43.87895134842808,NaN,NaN,40.15752997593411,-27.236794313357258,0.39071263202660855,-2.078521804934155,-2.4692344369607637,7340475630,7350745687.8,14.341505050136078,18.056688173882243,NaN,NaN,-7.5866644241578545,-6.974372122092021
2023-01-10T09:30:00-05:00,387.25,390.65,386.27,390.58,65358094,84606914.5,53.60209260145582,44.931785788697646,NaN,NaN,39.34565870119409,-7.468336325936582,0.8187034893264604,-1.4458550753026884,-2.264558564629149,7405833724,7371652341.4,19.66565227788203,17.783761444259493,NaN,NaN,-5.45093525534313,-6.756738283985037
2023-01-11T09:30:00-05:00,392.23,395.6,391.38,395.52,68881080,84280676.75,57.81636636905351,46.246470769999874,NaN,NaN,104.42961419801206,21.679494921706663,1.3799468847941463,-0.5396249586364661,-1.9195718434306124,7474714804,7389148391.4,23.927031198477707,18.065357262961637,NaN,NaN,-2.2955146472052568,-6.119420621587926
2023-01-12T09:30:00-05:00,396.67,398.485,392.42,396.96,90157699,82599435,58.985808490895664,47.23098513615831,NaN,NaN,145.21659314447803,64.06022244462278,1.7687820820068698,0.29140575907797484,-1.477376322928895,7564872503,7440070072.4,34.7720437047839,19.221665052562287,NaN,NaN,0.6505222976457341,-5.15228591884026
2023-01-13T09:30:00-05:00,393.62,399.1,393.34,398.5,63903932,80389064.15,60.254810274885926,48.59883412153984,NaN,NaN,168.6427708807567,99.55843338007503,2.0315221313266343,1.062026341229398,-0.9694957900972364,7628776435,7482934619.2,42.23703578819545,20.995051880431358,NaN,NaN,3.4766419186649493,-3.919581942053801
2023-01-17T09:30:00-05:00,398.48,400.23,397.06,397.77,62677281,77637633.75,59.317894337836655,49.74262648946132,NaN,NaN,166.75205958926077,124.87733930274037,2.051958570535347,1.5954524230719471,-0.4565061474633997,7566099154,7528059324,48.870872569025224,23.15513508156921,NaN,NaN,5.5758917440434965,-2.5630857011827586
2023-01-18T09:30:00-05:00,399.01,400.12,391.28,391.49,99632262,76626349.25,51.848782942135706,50.43638726102582,NaN,NaN,97.63214205408485,136.53463597331853,1.5605876263756606,1.494228385506176,-0.06635924086948453,7466466892,7540185957.6,50.51560091118604,25.26476653245162,NaN,NaN,5.344949687029894,-1.4333663600095226
2023-01-19T09:30:00-05:00,389.36,391.08,387.26,388.64,86958919,76980390.05,48.84301417589371,51.167073983810006,NaN,NaN,30.116157458894566,121.67194462549503,0.9895218985418608,1.1705431323078415,0.1810212337659807,7379507973,7521144591.4,47.90950717939009,27.250577845781322,NaN,NaN,4.268998197247545,-0.6187428518299414
2023-01-20T09:30:00-05:00,390.1,396.04,388.38,395.88,91806356,77849345.85,55.8457522199092,51.89769627083198,NaN,NaN,73.82902554445124,107.39443110548966,1.0401061406938492,1.4811539096332922,0.441047768939443,7471314329,7502432956.6,45.429240954379985,29.12855316921229,NaN,NaN,5.45963899652509,0.24959741222077725
2023-01-23T09:30:00-05:00,396.72,402.645,395.72,400.63,84178797,78149917.25,59.739614512465955,52.96501798474143,NaN,NaN,126.42796182853559,98.95146929504543,1.3164002359191145,2.086548063838336,0.7701478279192215,7555493126,7487776294.8,43.52835161824684,30.927419763474404,NaN,NaN,7.716447438017678,1.3162902730489057
2023-01-24T09:30:00-05:00,398.88,401.15,397.64,400.2,59524911,76120120.05,59.23038660701606,54.09174359741634,NaN,NaN,113.79157311325343,88.35937199984397,1.3861052603045745,2.5027794032999395,1.116674142995365,7495968215,7473750107,41.72887067682656,32.73820601931308,NaN,NaN,9.367144088586972,2.4664122466972005
2023-01-25T09:30:00-05:00,395.95,400.7,393.56,400.35,84800251,77367266.15,59.3605249746414,55.003240392422015,NaN,NaN,89.11104967111467,86.65515352324994,1.356525235568449,2.812330687455926,1.4558054518874772,7580768466,7496610421.8,45.67102635939248,34.877063473515356,NaN,NaN,10.742301203205434,3.6486820976269483
2023-01-26T09:30:00-05:00,403.13,404.92,400.03,404.75,72287425,78399728.4,63.08307374693336,56.4531974372565,NaN,NaN,125.06221926938144,105.64436588534731,1.5343991751056545,3.3738044207695452,1.8394052456638907,7653055891,7551320005.4,53.7373671710478,37.6416633252632,NaN,NaN,13.050960489924718,4.991864725098059
2023-01-27T09:30:00-05:00,403.655,408.16,403.44,405.68,68346180,78271461.4,63.83707286709216,57.34784251374026,NaN,NaN,136.4227515544984,118.16311108735674,1.60803229502049,3.849445614439503,2.241413319419013,7721402071,7601337553.8,59.63755939544282,40.85511891817239,NaN,NaN,15.17609761253476,6.446755137589015
2023-01-30T09:30:00-05:00,402.8,405.13,400.28,400.59,74202018,78633018.45,56.97790686934177,57.76736435639691,NaN,NaN,91.72018330343806,111.22155538233724,1.2246219518032238,3.772190759173043,2.547568807369819,7647200053,7619678939.2,61.57294428008233,44.22879314888284,NaN,NaN,15.074971225866813,7.679357435914415
2023-01-31T09:30:00-05:00,401.13,406.53,400.77,406.48,86811786,78772497.5,62.05830010077393,58.371379177776774,NaN,NaN,111.1623369944913,110.69570815858481,1.2727714116193125,4.13853307189396,2.8657616602746474,7734011839,7667287664,66.11485294426879,47.546593196481886,NaN,NaN,16.550017997184753,8.946594658953035
2023-02-01T09:30:00-05:00,405.211,413.67,402.35,410.8,101459155,80102918.7,65.29533092982825,58.90559093211783,NaN,NaN,143.98052591177515,121.6696034067169,1.4857954853311606,4.723006016938598,3.2372105316074373,7835470994,7718228169.6,70.1766572169359,50.85013791208605,NaN,NaN,18.83057100274738,10.358591279495084
2023-02-02T09:30:00-05:00,414.86,418.31,412.88,416.78,101654463,80888936.95,69.21117417499433,59.635974195267735,NaN,NaN,195.2179324669962,135.70074604623983,1.8935435924119766,5.604140022122408,3.7105964297104315,7937125457,7775042082.8,73.93006463078095,53.64713940680013,NaN,NaN,22.102128021481388,12.036239385493127
2023-02-03T09:30:00-05:00,411.59,416.97,411.09,412.35,94736781,81777253.2,63.49549879064632,59.86745194639348,NaN,NaN,153.76191387252175,139.1685785098445,1.7333084724186083,5.877232020233691,4.143923547815083,7842388676,7799239403.8,75.35283132536142,56.01255337374055,NaN,NaN,22.995162656550995,13.601799852787108
2023-02-06T09:30:00-05:00,409.79,411.29,408.1,409.83,60295325,79582539.3,60.43788858004965,59.94745153512298,NaN,NaN,102.17097392990773,141.25873663513843,1.3434134363956973,5.8231903433097045,4.479776906914007,7782093351,7826218063.4,76.86860161475539,58.01239116272127,NaN,NaN,22.753809260096304,14.909229768116994
2023-02-07T09:30:00-05:00,408.87,416.49,407.57,415.19,90990745,80433173,64.3681911310305,60.84169497718689,NaN,NaN,120.54987663024242,143.13624456228865,1.3298322362337478,6.142067202206192,4.812234965972444,7873084096,7854032514.8,78.34708847038641,60.000354559807015,NaN,NaN,23.80639044098139,16.180252721383336
2023-02-08T09:30:00-05:00,413.13,414.53,409.93,410.65,76227462,80976641.4,59.019835664579176,61.56861079780729,NaN,NaN,95.57949343022777,133.45603806597916,0.918003378474662,5.959739189065772,5.04173581059111,7796856634,7846309642.8,76.87779177659445,62.06951774532161,NaN,NaN,22.95537336648746,17.148127099255355
2023-02-09T09:30:00-05:00,414.41,414.57,405.81,407.09,78694859,81467330.35,55.150160016036516,61.518925640387806,NaN,NaN,62.39658671106697,106.89176891479333,0.33859834866032923,5.464983746416522,5.126385397756192,7718161775,7802516906.4,68.97817099571294,63.75158417684539,NaN,NaN,21.003144097738435,17.698843813324366
2023-02-10T09:30:00-05:00,405.86,408.44,405.01,408.04,70769715,80497931.15,55.97960726705518,61.25035369428703,NaN,NaN,36.782561074972975,83.49589835528357,-0.02842088053432512,5.090859297088286,5.119280177622612,7788931490,7791825469.2,67.1636649503882,65.43982084342693,NaN,NaN,19.687322479441153,17.982912194198192
2023-02-13T09:30:00-05:00,408.72,412.97,408.24,412.83,64913539,80548411.5,59.99677083901778,61.3050954251443,NaN,NaN,74.13628637015474,77.88896084333298,0.0020435559631568623,5.121834622576557,5.1197910666134,7853845029,7806175804.8,68.36649617898584,67.34250837929544,NaN,NaN,19.780184189578033,18.239665336395312
2023-02-14T09:30:00-05:00,411.24,415.05,408.511,412.64,88389313,81834013.1,59.76379732082623,61.333900592728924,NaN,NaN,74.59086984715722,68.69715948671593,-0.03777056601247608,5.072577859097805,5.110348425110281,7765455716,7784650128.8,64.54700478703833,68.69079255269871,NaN,NaN,19.786462431319666,18.460636349955934
2023-02-15T09:30:00-05:00,410.35,414.06,409.47,413.98,61685279,79936663.95,60.91647604578062,61.17914361407516,NaN,NaN,73.3647645184908,64.25421370436854,-0.021819692452226036,5.083073809544999,5.104893501997225,7827140995,7790707001,65.13720680101699,69.50506681198223,NaN,NaN,20.11660304342427,18.69720302045141
2023-02-16T09:30:00-05:00,408.79,412.91,408.14,408.28,76431469,79410291.45,53.84958505638862,60.46575162759633,NaN,NaN,35.995064011107516,58.97390916437665,-0.42097919297082154,4.578669510783698,4.999648703754519,7750709526,7797216551.2,65.79624233208314,69.94497273602796,NaN,NaN,18.301223343913126,18.640634495231655
2023-02-17T09:30:00-05:00,406.06,407.51,404.05,407.26,89257815,79282864.4,52.672023490060006,60.15818852907621,NaN,NaN,-22.4313145253882,47.131134044304424,-0.7597710699378606,4.049934866332194,4.8097059362700545,7661451711,7771720595.4,60.937371358859565,69.89957467022633,NaN,NaN,16.46757275808954,18.330197104211354
2023-02-21T09:30:00-05:00,403.06,404.16,398.82,399.09,82655924,79206720.75,44.31326820197998,58.890686250590925,NaN,NaN,-111.46927029626711,10.010022711020056,-1.497530284302404,2.9377930808920496,4.435323365194454,7578795787,7716710747,52.01260747362645,68.89227142232332,NaN,NaN,12.088505934349673,17.438526937088255
2023-02-22T09:30:00-05:00,399.52,401.13,397.02,398.54,83742293,80417589.85,43.80924251701608,57.355965649675774,NaN,NaN,-137.73678541396714,-32.45550834120481,-1.9569761666319243,1.989103156904548,3.9460793235364724,7495053494,7662630302.6,45.03025299886717,67.09609969246127,NaN,NaN,8.428283078037694,16.151349242938174
2023-02-23T09:30:00-05:00,401.56,402.2,396.25,400.66,96242399,80989697.25,46.342655086169685,55.72250000047401,NaN,NaN,-128.81312991781843,-72.89108722846666,-2.0430422249846223,1.3922765423056944,3.4353187672903167,7591295893,7615461282.2,39.98800406324647,64.67166679478024,NaN,NaN,6.09240459794528,14.714357150796332
2023-02-24T09:30:00-05:00,395.42,397.25,393.64,396.38,108194413,82785046.65,42.20549241668224,54.20178525947658,NaN,NaN,-169.04355162784785,-113.89881035625774,-2.2943458601788773,0.5673864420667201,2.8617323022455974,7483101480,7561939673,35.17505105489239,61.801825346889586,NaN,NaN,2.7979193624077663,13.01200889531225
2023-02-27T09:30:00-05:00,399.87,401.29,396.75,397.73,80444736,83389974.45,43.90651010207222,53.020972511049614,NaN,NaN,-112.92834268835105,-131.99821598885032,-2.2715207299300104,0.02233138983308436,2.2938521197630948,7563546216,7542358574,33.58252052555764,58.70996241194689,NaN,NaN,0.5647387291436996,11.233827443002458
2023-02-28T09:30:00-05:00,397.23,399.28,396.15,396.26,96438567,84501801.9,42.441693624229295,51.454794117706676,NaN,NaN,-120.9467929068393,-133.89372051096476,-2.252862088043338,-0.5222254902910777,1.7306365977522602,7467107649,7520020946.4,31.81305126637139,55.3861026116601,NaN,NaN,-1.7227114675311228,9.382893312926232
2023-03-01T09:30:00-05:00,395.41,396.69,393.38,394.74,99706823,85146553.75,40.92143967919791,50.16205154732229,NaN,NaN,-129.5664614341443,-132.25965571500018,-2.2358491919685046,-1.0641748922083707,1.171674299760134,7367400826,7494490412.8,29.875503175634464,52.02879628302011,NaN,NaN,-4.081977306932623,7.45934036723211
2023-03-02T09:30:00-05:00,392.68,398.69,392.33,397.81,85404726,84343832.3,45.19165333861578,49.450729641792236,NaN,NaN,-98.86688825544547,-126.27040738252558,-1.9227406321125327,-1.2317514903805318,0.6909891417320008,7452805552,7466792344.6,27.890856127464247,49.093988078145195,NaN,NaN,-4.9523116388844945,5.686247223501166
2023-03-03T09:30:00-05:00,399.71,404.45,399.03,404.19,90119952,83767106.75,52.823239386248524,49.22527479316319,NaN,NaN,-27.305616745674666,-97.92282040609095,-1.2248399325523085,-0.8400607739583847,0.38477915859392364,7542925504,7478757149.4,30.052485156058836,46.44318952140738,NaN,NaN,-3.425518670824835,4.3845663814545945
2023-03-06T09:30:00-05:00,405.05,407.45,404.01,404.47,72795946,82670065,53.131678566108505,48.734911059383954,NaN,NaN,7.84493647087999,-73.76816457424474,-0.708840173706956,-0.5012710585397713,0.20756911516718465,7615721450,7489192196.2,31.96796571596896,43.843294488334756,NaN,NaN,-2.1026714522923013,3.4578181194907525
2023-03-07T09:30:00-05:00,404.42,404.67,397.625,398.27,108310596,85070828.55,45.96544108128859,47.74931418513127,NaN,NaN,-46.63786119362628,-58.90637823160214,-0.7458248319016967,-0.7247119247099363,0.021112907191760455,7507410854,7497252837.2,33.483257585594814,41.624455402517356,NaN,NaN,-3.086828601613269,2.5228685879044637
2023-03-08T09:30:00-05:00,398.39,399.71,396.59,398.92,74746632,84258622.9,46.775939210418514,46.73927583974826,NaN,NaN,-61.4499608689931,-45.28307811857189,-0.6886197299041641,-0.8396617551884447,-0.15104202528428057,7582157486,7540204169.2,41.02147229767214,39.90190293799272,NaN,NaN,-3.6444097437958463,1.641828826232991
2023-03-09T09:30:00-05:00,399.74,401.48,390.53,391.56,111945322,86044515.9,39.54322038212185,45.71739264872921,NaN,NaN,-101.07856281536273,-45.725413030555345,-1.0849870804722537,-1.5072758758745977,-0.422288795402344,7470212164,7543685491.6,41.59918080325177,38.17354140021905,NaN,NaN,-6.476418369877606,0.48207922678862003
2023-03-10T09:30:00-05:00,390.99,393.16,384.32,385.91,189285696,91574057.75,35.06131592057332,44.45948496519445,NaN,NaN,-166.09555763231523,-73.48340120788346,-1.6332655155121594,-2.463870689792543,-0.8306051742803838,7280926468,7491285684.4,35.899241451577836,36.38510354969893,NaN,NaN,-10.427845378104564,-1.0764814310532633
2023-03-13T09:30:00-04:00,381.81,390.39,380.65,385.36,157789967,95925070.35,34.64960932279193,43.76922361668102,NaN,NaN,-174.20342787352718,-109.8930740767649,-1.9188245857846555,-3.2291359065112033,-1.3103113207265478,7123136501,7392768694.6,28.102733176863765,34.67725538564445,NaN,NaN,-13.67071267501533,-2.875657323047844
2023-03-14T09:30:00-04:00,390.5,393.45,387.05,391.73,149752357,100167011.25,42.99814034944639,43.7112877475689,NaN,NaN,-105.49593114795034,-121.66468806762971,-1.5787551466256504,-3.283755254008611,-1.7050001073829604,7272888858,7345864295.4,25.286954437208536,33.26701977409741,NaN,NaN,-13.827017466688845,-4.4401373435679865
2023-03-15T09:30:00-04:00,385.89,389.49,383.71,389.28,172996933,104397392.25,40.83726431104903,43.31804554934599,NaN,NaN,-133.66679254960988,-136.10805440375307,-1.4236543726754327,-3.4845680732272513,-2.0609137005518186,7099891925,7249411183.2,20.694955198770444,31.88894485520626,NaN,NaN,-14.637449993321127,-5.896896293532721
2023-03-16T09:30:00-04:00,386.82,396.47,386.29,396.11,143759805,108501118.55,48.593290849738466,43.774316865992866,NaN,NaN,-57.845667626327476,-127.46147536594601,-0.7971462969830356,-3.057346571780613,-2.2602002747975773,7243651730,7204099096.4,18.95362891091743,30.73027184492234,NaN,NaN,-12.750259931571636,-6.875948241823994
2023-03-17T09:30:00-04:00,393.22,394.4,388.55,389.99,140553411,111707215.65,43.1363434337292,43.71930496111122,NaN,NaN,-77.05904440923479,-109.65417272132993,-0.732633734600761,-3.1759924430485285,-2.4433587084477675,7103098319,7168533466.6,17.695082106291977,29.595454814974794,NaN,NaN,-12.990401843675878,-7.74944161351712
2023-03-20T09:30:00-04:00,390.8,394.17,390.07,393.74,93056894,111897169.6,47.05941913406813,44.04914249752828,NaN,NaN,-45.49643866117971,-83.91277487886045,-0.39220076506293866,-2.9336096647764407,-2.541408899713502,7196155213,7183137209,20.04283680665587,28.754725210709402,NaN,NaN,-11.863163061664672,-8.337116106109628
2023-03-21T09:30:00-04:00,397.24,399.41,395.58,398.91,91524248,112340585.8,51.978372842943976,44.83892343779586,NaN,NaN,41.1366635211678,-54.58625594503682,0.19484269891020123,-2.2978555260757503,-2.4926982249859515,7287679461,7186095329.6,20.53729171343663,28.087710106266695,NaN,NaN,-9.246078070262458,-8.466967815274318
2023-03-22T09:30:00-04:00,398.73,402.49,392.07,392.11,111748133,113740877.8,45.93313768513318,44.891886605404245,NaN,NaN,5.062377975510617,-26.84042184001271,0.14134153291044615,-2.316021308847894,-2.45736284175834,7175931328,7201303210.2,23.1678609664056,27.750353309048215,NaN,NaN,-9.090297015708543,-8.556014843907779
2023-03-23T09:30:00-04:00,395.09,399.29,390.35,393.17,119351319,114896323.8,46.96853206693893,44.473693225453566,NaN,NaN,-12.511237310061354,-17.773535776759488,0.19044871344647252,-2.2193019499502498,-2.4097506633967223,7295282647,7211629393.6,24.983783658400625,27.388303202072624,NaN,NaN,-8.63187871645305,-8.566852539985675
2023-03-24T09:30:00-04:00,391.841,395.84,389.4,395.75,107770124,114875109.35,49.5032886332913,44.214522515966614,NaN,NaN,-21.19052289718457,-6.599831474349445,0.39786331604868863,-1.9124215183358615,-2.31028483438455,7403052771,7271620284,34.647550801407746,27.579702136746825,NaN,NaN,-7.456364809788571,-8.408211435671802
2023-03-27T09:30:00-04:00,398.12,398.92,395.56,396.49,74010408,114553392.95,50.23796728049629,44.51970295876716,NaN,NaN,39.0287703050677,10.305210318900043,0.5752976152715208,-1.5911628152951494,-2.16646043056667,7477063179,7327801877.2,42.162012888385554,28.199613229803308,NaN,NaN,-6.292863174376118,-8.106018826915276
2023-03-28T09:30:00-04:00,395.77,396.49,393.69,395.6,62871680,112875048.6,49.30878358301992,44.70062041395298,NaN,NaN,10.24151938480949,4.126181491628379,0.6193054303309262,-1.3923286426530126,-2.011634072983939,7414191499,7353104284.8,45.21716616433198,28.499305648850434,NaN,NaN,-5.603943387183004,-7.748579478382094
2023-03-29T09:30:00-04:00,399.925,401.6,398.68,401.35,77497876,111764601.25,55.088300433699864,45.81098327477998,NaN,NaN,94.48490124059693,22.01068614464564,0.9997149130332565,-0.761990431692368,-1.7617053447256246,7491689375,7416255894.2,52.02820094347378,29.244235658866295,NaN,NaN,-3.238975097023834,-7.1043502810452
2023-03-30T09:30:00-04:00,404.09,404.35,401.76,403.7,69840049,110986367.4,57.23434459437775,47.39477103719458,NaN,NaN,123.62392656703193,49.237718920064296,1.3517741406623922,-0.0719876688976342,-1.4237618095600264,7561529424,7469505249.6,56.894672289153924,30.743909290121728,NaN,NaN,-0.6188321837934491,-6.177847695723521
2023-03-31T09:30:00-04:00,404.66,409.7,404.55,409.39,112062624,112083501,61.97246823773916,49.34640381683367,NaN,NaN,178.8613446907643,89.24809243765408,1.8776784816333643,0.9233362924816788,-0.9543421891516853,7673592048,7523613105,61.2016450564461,33.10811728152047,NaN,NaN,3.1862797127027007,-4.840115208805489
2023-04-03T09:30:00-04:00,408.85,411.37,408.44,410.95,67391097,111813258.55,63.17702466642183,50.78775269661763,NaN,NaN,197.0546473120785,120.85326783905623,2.217130236496209,1.817070606468576,-0.400059630027633,7740983145,7576397098.2,64.88743311725459,35.93672290152376,NaN,NaN,6.66913849290533,-3.195936108561087
2023-04-04T09:30:00-04:00,411.62,411.92,407.24,408.67,66601534,109727805.45,60.17680489270857,52.16914845245045,NaN,NaN,159.62946564009337,150.730857090113,2.1718093833177754,2.314702099119586,0.14289271580181073,7674381611,7628435120.6,68.10442999734988,39.323113958565145,NaN,NaN,8.724800970814451,-1.492973668650296
2023-04-05T09:30:00-04:00,407.91,408.7,405.88,407.6,65200243,109250486,58.76635941980351,52.8957962074551,NaN,NaN,119.09263112364033,155.6524030667217,1.9599656880389231,2.5928498258504646,0.6328841378115415,7609181368,7651933519.2,69.46490180711635,42.93106202257935,NaN,NaN,10.030531187153553,0.1532413107502537
2023-04-06T09:30:00-04:00,406.77,409.48,405.678,409.19,63743345,106840387.15,60.257042719766154,54.11870329931488,NaN,NaN,109.1543326995319,152.75848429322167,1.8201417254683996,2.908061294647041,1.0879195691786414,7672924713,7674212577,70.73924933299844,46.71993111020124,NaN,NaN,11.548581791456233,1.7811470937082505
2023-04-10T09:30:00-04:00,406.61,409.69,405.97,409.61,63681042,100560154.45,60.66160666239295,55.09028812276665,NaN,NaN,98.43495027480377,136.67320541002957,1.6539730014356535,3.1553858209732084,1.501412819537555,7736605755,7686815318.4,71.4647260737093,50.392923200705056,NaN,NaN,12.921625209507287,3.3726439673938273
2023-04-11T09:30:00-04:00,410.26,411.18,408.92,409.72,59297945,95635553.35,60.77422952296576,55.71856359991107,NaN,NaN,100.63007836986108,117.38829162158609,1.456449515577658,3.3219747140096274,1.8655251984319694,7795903700,7697799429.4,72.11367991751665,54.07695092956791,NaN,NaN,14.101305852584655,4.905309950992517
2023-04-12T09:30:00-04:00,411.87,412.17,407.44,408.05,86420379,92468954.45,58.05672103784396,56.58453383939042,NaN,NaN,84.05658372116362,102.27371523780013,1.1327129953202402,3.2814164425822696,2.1487034472620294,7709483321,7704819771.4,72.54346908684127,57.6037800810276,NaN,NaN,14.440059905392527,6.267417087335375
2023-04-13T09:30:00-04:00,409.18,413.84,407.9922,413.47,85814754,88109845.5,63.7258483508264,57.78148500252524,NaN,NaN,98.47612759381383,98.15041453183485,1.1967249480217732,3.644609632289246,2.4478846842674726,7795298075,7742043112.8,74.7643276850564,61.15953322578873,NaN,NaN,16.33883530737907,7.706191118770189
2023-04-14T09:30:00-04:00,412.81,415.09,410.06,412.46,78161500,84829930.25,62.04296827338761,58.67717640538926,NaN,NaN,96.47398923813573,95.61434583955561,1.0873393627256567,3.8070588876745433,2.7197195249488866,7717136575,7750885485.2,75.27593096579375,64.06156038038773,NaN,NaN,17.48119041905401,9.102619590239305
2023-04-17T09:30:00-04:00,412.37,413.96,411.085,413.94,66417168,81123118.1,63.56149727827617,59.6288571195164,NaN,NaN,93.4182088709049,94.61099755877584,1.0314334495657698,4.009011336906099,2.977577887340329,7783572974,7760278929,75.8363611284035,66.46687096896044,NaN,NaN,18.87132207088148,10.49814851604533
2023-04-18T09:30:00-04:00,415.58,415.72,412.7802,414.21,63550855,79647816.15,63.84566708614734,60.66720594116835,NaN,NaN,99.07230297165323,94.29944247913427,0.9324080204869363,4.1430879129489995,3.210679892462063,7847132971,7770524783.2,76.46306092016239,68.6987205943769,NaN,NaN,20.111950149565093,11.871548749405296
2023-04-19T09:30:00-04:00,412.22,415.08,412.16,414.14,55199304,77831568.95,63.70695215908529,61.282823921553025,NaN,NaN,87.93778994156196,95.07568372321393,0.7877240386345341,4.195334940755231,3.407610902120697,7791905641,7787009247.2,77.47526536347624,70.5163680529485,NaN,NaN,21.125023341436904,13.193473691124098
2023-04-20T09:30:00-04:00,411.21,413.7,410.27,411.88,75823667,76035345.65,59.232432509447264,61.425544486915136,NaN,NaN,64.35456115182437,88.25137043481604,0.4804506676796092,4.008174236720208,3.527723569040599,7716065282,7771162688.6,74.17302223527493,71.75053590624286,NaN,NaN,20.884044013646943,14.292126594341646
2023-04-21T09:30:00-04:00,412.19,412.68,410.17,412.2,73450887,73740324.05,59.66442290261647,61.26068410583495,NaN,NaN,59.10945210203801,80.7784630075965,0.25093172375843853,3.8413882237386474,3.590456499980209,7789522704,7785639914.4,75.21249670710093,72.75131102414677,NaN,NaN,20.785515780411227,15.219753620923015