time,open,high,low,close,Volume,Volume MA,RSI,RSI-based MA,Upper Bollinger Band,Lower Bollinger Band,CCI,Smoothing Line,Histogram,MACD,Signal,OnBalanceVolume,Smoothing Line,RSI,RSI-based MA,Upper Bollinger Band,Lower Bollinger Band,True Strength Index,Signal
1998-12-22T09:30:00-05:00,19.053574,19.053769,18.850801,18.927125,55920,NaN,NaN,NaN,NaN,NaN,NaN,NaN,NaN,NaN,NaN,NaN,NaN,NaN,NaN,NaN,NaN,NaN,NaN
1998-12-23T09:30:00-05:00,18.850607,19.2058,18.850607,19.2058,78830,NaN,NaN,NaN,NaN,NaN,NaN,NaN,NaN,NaN,NaN,78830,NaN,NaN,NaN,NaN,NaN,NaN,NaN
1998-12-24T09:30:00-05:00,19.2058,19.33306,19.142271,19.33306,43849,NaN,NaN,NaN,NaN,NaN,NaN,NaN,NaN,NaN,NaN,122679,NaN,NaN,NaN,NaN,NaN,NaN,NaN
1998-12-28T09:30:00-05:00,19.319965,19.319965,19.028203,19.078945,51978,NaN,NaN,NaN,NaN,NaN,NaN,NaN,NaN,NaN,NaN,70701,NaN,NaN,NaN,NaN,NaN,NaN,NaN
1998-12-29T09:30:00-05:00,19.104316,19.281912,18.875977,19.281912,100878,NaN,NaN,NaN,NaN,NaN,NaN,NaN,NaN,NaN,NaN,171579,NaN,NaN,NaN,NaN,NaN,NaN,NaN
1998-12-30T09:30:00-05:00,19.180429,19.307283,19.078945,19.2058,154704,NaN,NaN,NaN,NaN,NaN,NaN,NaN,NaN,NaN,NaN,16875,92132.8,NaN,NaN,NaN,NaN,NaN,NaN
1998-12-31T09:30:00-05:00,19.2058,19.231171,19.028203,19.028203,65404,NaN,NaN,NaN,NaN,NaN,NaN,NaN,NaN,NaN,NaN,-48529,66661,NaN,NaN,NaN,NaN,NaN,NaN
1999-01-04T09:30:00-05:00,18.799865,19.345238,18.79967,19.028609,250779,NaN,NaN,NaN,NaN,NaN,NaN,NaN,NaN,NaN,NaN,202250,82575.2,NaN,NaN,NaN,NaN,NaN,NaN
1999-01-05T09:30:00-05:00,18.95209,19.231171,18.95209,19.2058,47790,NaN,NaN,NaN,NaN,NaN,NaN,NaN,NaN,NaN,NaN,250040,118443,NaN,NaN,NaN,NaN,NaN,NaN
1999-01-06T09:30:00-05:00,19.560993,19.840073,19.434138,19.814702,129946,NaN,NaN,NaN,NaN,NaN,NaN,NaN,NaN,NaN,NaN,379986,160124.4,NaN,NaN,NaN,NaN,NaN,NaN
1999-01-07T09:30:00-05:00,19.611735,20.119153,19.560993,20.119153,90039,NaN,NaN,NaN,NaN,NaN,NaN,NaN,NaN,NaN,NaN,470025,250754.4,NaN,NaN,NaN,NaN,NaN,NaN
1999-01-08T09:30:00-05:00,20.347492,20.347492,20.030351,20.246008,173796,NaN,NaN,NaN,NaN,NaN,NaN,NaN,NaN,NaN,NaN,643821,389224.4,NaN,NaN,NaN,NaN,NaN,NaN
1999-01-11T09:30:00-05:00,20.271379,20.271379,19.751271,19.941557,62941,NaN,NaN,NaN,NaN,NaN,NaN,NaN,NaN,NaN,NaN,580880,464950.4,NaN,NaN,NaN,NaN,NaN,NaN
1999-01-12T09:30:00-05:00,19.840073,19.840073,19.383396,19.383396,117506,NaN,NaN,NaN,NaN,NaN,NaN,NaN,NaN,NaN,NaN,463374,507617.2,NaN,NaN,NaN,NaN,NaN,NaN
1999-01-13T09:30:00-05:00,18.444672,19.383396,18.444672,19.129687,359417,NaN,52.93495635280795,NaN,NaN,NaN,NaN,NaN,NaN,NaN,NaN,103957,452411.4,NaN,NaN,NaN,NaN,NaN,NaN
1999-01-14T09:30:00-05:00,19.078945,19.218481,18.470043,18.647639,59984,NaN,46.01299545194448,NaN,NaN,NaN,NaN,NaN,NaN,NaN,NaN,43973,367201,NaN,NaN,NaN,NaN,NaN,NaN
1999-01-15T09:30:00-05:00,18.901348,19.180429,18.812546,19.180429,96813,NaN,53.28411993989366,NaN,NaN,NaN,NaN,NaN,NaN,NaN,NaN,140786,266594,NaN,NaN,NaN,NaN,NaN,NaN
1999-01-19T09:30:00-05:00,19.48488,19.48488,18.825236,19.078945,54934,NaN,51.85159990333288,NaN,NaN,NaN,NaN,NaN,NaN,NaN,NaN,85852,167588.4,NaN,NaN,NaN,NaN,NaN,NaN
1999-01-20T09:30:00-05:00,19.281912,19.522932,19.104316,19.218481,76490,NaN,53.694936999920635,NaN,NaN,NaN,NaN,NaN,NaN,NaN,NaN,162342,107382,NaN,NaN,NaN,NaN,NaN,NaN
1999-01-21T09:30:00-05:00,19.053574,19.142368,18.825236,18.875977,438740,125536.9,48.760319369302415,NaN,NaN,NaN,-74.98423286671526,NaN,NaN,NaN,NaN,-276398,31311,46.77418088788971,NaN,NaN,NaN,NaN,NaN
1999-01-22T09:30:00-05:00,18.774494,18.875977,18.647639,18.749123,109992,128240.5,47.03616833702593,NaN,NaN,NaN,-113.61059856429183,NaN,NaN,NaN,NaN,-386390,-54761.6,42.58686246435049,NaN,NaN,NaN,NaN,NaN
1999-01-25T09:30:00-05:00,18.850607,18.926719,18.622268,18.901348,169731,132785.55,49.3506265412975,NaN,NaN,NaN,-94.61467843280518,NaN,NaN,NaN,NaN,-216659,-126250.6,39.4295968663603,NaN,NaN,NaN,NaN,NaN
1999-01-26T09:30:00-05:00,18.977461,19.015514,18.774494,18.91403,118122,136499.2,49.54842872959467,NaN,NaN,NaN,-70.28981821289297,NaN,NaN,NaN,NaN,-98537,-163128.4,37.869900355288486,NaN,NaN,NaN,NaN,NaN
1999-01-27T09:30:00-05:00,19.028203,19.028203,18.67301,18.67301,56905,136745.55,45.881170279681676,NaN,NaN,NaN,-86.65363310176947,-88.03059223569494,NaN,NaN,NaN,-155442,-226685.2,35.279750059177445,NaN,NaN,NaN,NaN,NaN
1999-01-28T09:30:00-05:00,18.622268,18.977461,18.622268,18.95209,47298,134066.55,50.45395676917996,NaN,NaN,NaN,-69.88366073494252,-87.0104778093404,NaN,NaN,NaN,-108144,-193034.4,37.70901054534973,NaN,NaN,NaN,NaN,NaN
1999-01-29T09:30:00-05:00,19.066255,19.383396,18.799865,19.358025,73041,129983.4,56.245186950648105,NaN,NaN,NaN,-5.0495177220745315,-65.29826164089692,NaN,-0.1642326992825751,NaN,-35103,-122777,42.55690437704826,NaN,NaN,NaN,NaN,NaN
1999-02-01T09:30:00-05:00,19.434138,19.434138,19.028203,19.028203,59861,129706.25,51.02645431997207,NaN,NaN,NaN,-9.076816437370507,-48.19068924181,NaN,-0.15352630197896389,NaN,-94964,-98438,44.177709727617504,NaN,NaN,NaN,NaN,NaN
1999-02-02T09:30:00-05:00,18.875977,18.977461,18.63495,18.825236,107283,122531.45,48.07055707399214,50.29653407275672,NaN,NaN,-74.16475437103928,-48.96567647343927,NaN,-0.15957961119147868,NaN,-202247,-119180,43.062579347543235,NaN,NaN,NaN,NaN,NaN
1999-02-03T09:30:00-05:00,18.723752,19.104316,18.584208,18.964772,69715,123627.7,50.206134413491895,50.10161821994843,NaN,NaN,-56.73961276016031,-42.98287240511743,NaN,-0.15137258437858492,NaN,-132532,-114598,43.40244654240176,NaN,NaN,NaN,NaN,NaN
1999-02-04T09:30:00-05:00,18.825236,18.926719,18.520784,18.520784,48653,119563.05,44.004972880105065,49.95818803624561,NaN,NaN,-94.662549129987,-47.93865008412632,NaN,-0.1786353800735725,NaN,-181185,-129206.2,42.53079822473831,NaN,NaN,NaN,NaN,NaN
1999-02-05T09:30:00-05:00,18.482724,18.571526,18.241704,18.368559,103095,120215.85,42.085642847067525,49.15829681532946,NaN,NaN,-142.5838297159117,-75.44551248289376,NaN,-0.21010269430669837,NaN,-284280,-179041.6,39.60839426622216,NaN,NaN,NaN,NaN,NaN
1999-02-08T09:30:00-05:00,18.495413,18.520784,18.190962,18.317817,137829,118417.5,41.43685755568739,48.41438664764049,NaN,NaN,-157.68217158550937,-105.16658351252154,NaN,-0.23641003515251668,NaN,-422109,-244470.6,36.10108556394255,NaN,NaN,NaN,NaN,NaN
1999-02-09T09:30:00-05:00,18.317817,18.368559,17.937253,18.064108,264204,128480.65,38.26089663814387,47.31195519322787,NaN,NaN,-209.74454288651927,-132.28254121561753,NaN,-0.2745659627650241,NaN,-686313,-341283.8,31.637013361838186,40.19473089926915,NaN,NaN,NaN,NaN
1999-02-10T09:30:00-05:00,18.114849,18.216333,17.911882,18.216333,31901,124200.4,41.17423363074792,46.770091926188265,NaN,NaN,-187.60889037324495,-158.45639673823445,-0.08723092241810726,-0.28918794636154743,-0.20195702394344017,-654412,-445659.8,27.66514651309768,38.82979987249829,NaN,NaN,NaN,NaN
1999-02-11T09:30:00-05:00,18.292446,18.977461,18.292446,18.95209,81047,110281.9,52.77390199419975,47.17993004455782,NaN,NaN,-12.779422854537613,-142.07977148314458,-0.029358749794536093,-0.2386554611866103,-0.2092967113920742,-573365,-524095.8,25.113577824630298,37.581708112518285,NaN,NaN,NaN,NaN
1999-02-12T09:30:00-05:00,18.850607,18.95209,18.470043,18.67301,107036,112634.5,48.839923771157025,47.14345127526207,NaN,NaN,-23.022351839978025,-118.16747590795785,-0.007448674438811115,-0.2186075544405881,-0.211158880001777,-680401,-603320,22.823819140977562,36.3955811321338,NaN,NaN,NaN,NaN
1999-02-16T09:30:00-05:00,18.863288,19.078945,18.825236,18.95209,463374,130962.55,52.64175657927537,47.36440326452498,NaN,NaN,48.86710666213866,-76.85762025842824,0.026409936968424252,-0.1781464587912467,-0.20455639575967094,-217027,-562303.6,26.557301568544275,35.58753836165207,NaN,NaN,NaN,NaN
1999-02-17T09:30:00-05:00,19.028203,19.408767,18.850607,19.028203,501434,153287.55,53.65332490829437,47.919557166568744,NaN,NaN,89.98133877121462,-16.912443926881462,0.05296966157185384,-0.13834431879485365,-0.1913139803667075,284407,-368159.6,41.08529547620605,36.002220177154115,NaN,NaN,-8.519175044626783,NaN
1999-02-18T09:30:00-05:00,19.129687,19.332654,18.977461,19.218481,69469,152936.5,56.17361048347854,48.32810386044721,NaN,NaN,116.08641089463487,43.82661632669449,0.08072729569437595,-0.09040486074873755,-0.1711321564431135,353876,-166502,51.7596732514379,37.0058389418747,NaN,NaN,-5.723251565393399,NaN
1999-02-19T09:30:00-05:00,19.358025,19.637106,19.243852,19.281912,76366,134817.8,57.01281505297476,48.38293443918484,NaN,NaN,158.2540030877121,78.03330151514444,0.09950158220946637,-0.04675517868128054,-0.1462567608907469,430242,34219.4,59.60498801730345,38.22355920189292,NaN,NaN,-3.1939597093622396,NaN
1999-02-22T09:30:00-05:00,19.434138,19.979609,19.434138,19.840073,89669,133801.65,63.615121623612936,49.28212496087347,NaN,NaN,207.22550286932736,124.08287245700554,0.14300682994597755,0.032501776541725036,-0.11050505340425251,519911,274281.8,66.60097603510202,39.82522108099896,NaN,NaN,1.3279822976210267,NaN
1999-02-23T09:30:00-05:00,19.979609,20.169895,19.814702,20.093783,121694,131399.8,66.15936125312987,50.57418240224045,NaN,NaN,213.1345862701433,156.93636837860646,0.17997705502267186,0.11446626537408733,-0.06551078964858453,641605,446008.2,70.53251027154906,41.78735900414223,NaN,NaN,5.953044836696977,NaN
1999-02-24T09:30:00-05:00,20.169895,20.195266,19.358025,19.434138,252133,138100.35,55.32682383952083,50.93994593267109,NaN,NaN,122.4110135569037,163.4223033357443,0.15221482776150883,0.1247577450533015,-0.02745708270820732,389472,467021.2,70.98262383966251,43.75737166823228,NaN,NaN,6.544580753681016,NaN
1999-02-25T09:30:00-05:00,19.155058,19.408767,18.901348,19.307283,173549,143932.55,53.51225218756579,51.61903731177542,NaN,NaN,40.79909997337221,148.36484115149173,0.11898938000196099,0.12127964229424393,0.0022902622922829317,215923,439430.6,69.48187417214982,45.68244852161882,NaN,NaN,6.429201831671979,NaN
1999-02-26T09:30:00-05:00,19.307283,19.713218,19.218481,19.662477,116890,147412.15,57.69597398534982,52.73406096450987,NaN,NaN,84.52429648022853,133.61889982999503,0.1145734645077379,0.1455070929269553,0.030933628419217405,332813,419944.8,68.38225724028291,47.73772444833744,NaN,NaN,7.720307624320977,NaN
1999-03-01T09:30:00-05:00,19.586364,19.878125,19.510251,19.738589,211610,154340.6,58.55667260121102,53.95690489633299,NaN,NaN,101.97543917908907,112.56888709194736,0.11037479793619324,0.16890212583945896,0.058527327903265716,544423,424847.2,68.51725224863281,50.053164925815324,NaN,NaN,9.01800626074524,NaN
1999-03-02T09:30:00-05:00,19.890815,20.068412,19.662477,19.789331,91517,155923.4,59.15333021744505,55.44922158056879,NaN,NaN,108.25328853633916,91.59262754518653,0.10466177919814001,0.18935455190094075,0.08469277270280073,635940,423714.2,68.44451926968624,52.6822724906616,NaN,NaN,10.242800356556907,NaN
1999-03-03T09:30:00-05:00,19.890815,19.916186,19.497561,19.599045,57398,153429.15,55.90298486015381,56.50127523981207,NaN,NaN,76.68766523773203,82.44795788135221,0.08267869050222396,0.18804113583058069,0.10536244532835673,578542,461528.2,69.60423592846475,55.6779217346164,NaN,NaN,10.344120979311693,NaN
1999-03-04T09:30:00-05:00,19.662477,20.093783,19.662477,20.043041,50377,152462.25,61.252894836688746,57.106917585704146,NaN,NaN,99.60593020749633,94.20932392817701,0.09194018097688578,0.22028767154946394,0.12834749057257816,628919,544127.4,72.02296223698289,59.02859204978444,NaN,NaN,12.100304194015973,NaN
1999-03-05T09:30:00-05:00,20.804169,20.804169,20.271379,20.550459,498725,174965.85,66.28683754793902,58.35312571261715,NaN,NaN,154.28154738020206,108.16077410817172,0.12413755933762166,0.28351943974460525,0.1593818804069836,1127644,703093.6,75.98383551471247,62.82573607647979,NaN,NaN,15.330825277824989,5.198060622543412
1999-03-08T09:30:00-05:00,20.550459,20.601201,20.309431,20.410915,133642,176493.2,63.83083117770258,59.152345326790524,NaN,NaN,128.4351749651767,113.45272126538926,0.12745233007906828,0.31869729300581895,0.19124496292675067,994002,793009.4,77.89053947266981,66.49239592677448,NaN,NaN,17.183032575479423,6.910199472962843
1999-03-09T09:30:00-05:00,20.448976,20.766108,20.29675,20.57583,105435,174873.5,65.45961353389507,59.99565165719058,NaN,NaN,129.1212065777401,117.62630487366945,0.1316296486212269,0.35578202370328427,0.22415237508205738,1099437,885708.8,79.68154108846974,69.24927061336473,NaN,NaN,19.213386000740552,8.667797548359658
1999-03-10T09:30:00-05:00,20.766108,20.969076,20.601201,20.956394,91270,166226.8,68.93604378468658,60.90725403584828,NaN,NaN,153.12827250450374,132.9144263270238,0.14959081826334192,0.41114089791123476,0.26155007964789284,1190707,1008141.8,81.78074530607319,71.39363290298154,NaN,NaN,22.089416929263216,10.585171745631595
1999-03-11T09:30:00-05:00,21.007136,21.286217,20.854911,21.057878,211117,175187.6,69.80869904715554,61.821245749718344,NaN,NaN,166.10373822893595,146.21398793131172,0.15709870319310293,0.45792345863927153,0.3008247554461686,1401824,1162722.8,84.02488652003399,73.1379113674623,NaN,NaN,24.694312429654058,12.600763271920517
1999-03-12T09:30:00-05:00,21.133991,21.260846,20.931023,21.09593,184019,180336.2,70.14733545006482,62.287832451607756,NaN,NaN,146.68864558248873,144.69540757176907,0.1532549542710709,0.4923934482850072,0.3391384940139363,1585843,1254362.6,85.18955018622992,74.46566666397142,NaN,NaN,26.91030642675188,14.64498372261071
1999-03-15T09:30:00-05:00,21.10862,21.260846,20.981765,21.159362,83018,179135.3,70.73657590534506,62.61477635533742,NaN,NaN,131.46365775165563,145.30110412906484,0.14376811010503254,0.518848631645227,0.37508052154019444,1668861,1389334.4,86.72468018344098,75.62225022910657,NaN,NaN,28.917862216938317,16.68396636465751
1999-03-16T09:30:00-05:00,21.362329,21.362329,20.854911,20.854911,188576,165395.4,64.18786157025737,63.2477076218186,NaN,NaN,104.11701740545145,140.3002662946071,0.10743648898996144,0.5093761327776463,0.4019396437876848,1480285,1465504,87.51138959439106,76.80287635444431,NaN,NaN,28.85198527435297,18.42225478032829
1999-03-17T09:30:00-05:00,20.753427,20.753427,20.474347,20.677314,161355,148391.45,60.65995557347881,63.75825786366953,NaN,NaN,53.768966486138545,120.42840509093408,0.06403430180235159,0.48198252104062433,0.41794821923827274,1318930,1491148.6,87.77408333340277,78.10946272310524,NaN,NaN,27.79092131752816,19.760635714213986
1999-03-18T09:30:00-05:00,20.525088,21.159362,20.525088,21.159362,199539,154894.95,66.10540673511373,64.3589316315098,NaN,NaN,80.57087398314253,103.32183224177538,0.06042669087357533,0.4934815828302419,0.4330548919566666,1518469,1514477.6,88.02093908745233,79.51222571218877,NaN,NaN,28.47289592196366,21.005244315321082
1999-03-19T09:30:00-05:00,21.159362,21.159362,20.677314,20.702685,244866,163319.95,57.925103921671614,64.31381958297128,NaN,NaN,62.675547648368216,86.51921265495127,0.021905705202162895,0.4604370234593702,0.4385313182572073,1273603,1452029.6,83.17938674024063,80.55952103301789,NaN,NaN,26.44569561990904,21.782451644547933
1999-03-22T09:30:00-05:00,20.651943,20.82954,20.57583,20.753427,427531,180213.05,58.539028468155884,64.26994088659347,NaN,NaN,43.13148744386132,68.8527785933924,-0.004146606028188282,0.43334806072197196,0.43749466675016024,1701134,1458484.2,83.28174550803436,81.61932290718562,NaN,NaN,25.015754274427977,22.24435202024508
1999-03-23T09:30:00-05:00,20.474347,20.550459,19.992299,20.043041,288962,188576.45,47.983193508713626,63.70424150434775,NaN,NaN,-23.21914281203964,43.38554654989418,-0.06958204834545134,0.3505171063183461,0.42009915466379744,1412172,1444861.6,82.14557696146309,82.51513298097122,NaN,NaN,20.08711721101338,21.936175618926267
1999-03-24T09:30:00-05:00,20.093783,20.195266,19.890815,19.992299,144481,183193.85,47.326728717914364,62.70951535300672,NaN,NaN,-48.85432286452639,22.860888679761178,-0.11401630964222037,0.27757876761102196,0.39159507725324233,1267691,1434613.8,81.24761306903619,83.17403661183218,NaN,NaN,16.01946645084805,21.09093145205795
1999-03-25T09:30:00-05:00,20.702685,20.702685,20.246008,20.448976,77229,178377.85,53.49355448554369,61.79570941997848,NaN,NaN,0.8123208339517652,6.909178049923026,-0.1103159587450191,0.25370012882196846,0.36401608756698756,1344920,1399904,78.13223270631428,83.32749355408943,NaN,NaN,14.477545099921649,20.146161973181336
1999-03-26T09:30:00-05:00,20.309431,20.448976,20.182577,20.271379,65158,175791.25,50.99323711022464,60.87873841515863,NaN,NaN,-33.778621468591474,-12.381655773468882,-0.11686619647129232,0.21793334197787217,0.3347995384491645,1279762,1401135.8,78.16423209697528,83.34704302725412,NaN,NaN,12.429075912693573,19.04372110739737
1999-03-29T09:30:00-05:00,20.57583,20.804169,20.525088,20.728056,75627,168992.1,56.6094897669465,60.24658671751944,NaN,NaN,26.121864687672,-15.783580324706744,-0.08875368367284564,0.2238574338581074,0.31261111753095305,1355389,1331986.8,71.81148508622775,82.78489616995111,NaN,NaN,12.493878715317983,18.108029337100316
1999-03-30T09:30:00-05:00,20.57583,20.626572,20.385544,20.487028,141648,171498.65,53.14756943291976,59.1188385495361,NaN,NaN,-16.976558071898147,-14.535063376678448,-0.08471255028498537,0.20672042967472137,0.29143297995970674,1213741,1292300.6,68.37669729275606,81.82746416899988,NaN,NaN,11.433190171419412,17.154480884860188
1999-03-31T09:30:00-05:00,20.499718,20.651943,20.169895,20.246008,112702,174263.85,49.863723287796304,57.694197423867585,NaN,NaN,-60.72298880988913,-16.908796565750997,-0.09577714648241492,0.1717115468566881,0.267488693339103,1101039,1258970.2,65.54134489499633,80.50721119578292,NaN,NaN,9.513451551611919,16.06290526582472
1999-04-01T09:30:00-05:00,20.195266,20.322121,20.093783,20.29675,52964,174393.2,50.55636551164055,56.29484242826585,NaN,NaN,-97.2262945350034,-36.51651963954203,-0.09689183219991784,0.14637390308920573,0.24326573528912357,1154003,1220786.8,62.351534808463484,78.87592438308532,NaN,NaN,8.18557038123826,14.937571710883798
1999-04-05T09:30:00-04:00,20.57583,20.778798,20.423605,20.702685,92995,154106.7,55.815350151662294,55.229040588717076,NaN,NaN,0.00017629767943251552,-29.76076008628785,-0.068823249573983,0.15723667332164482,0.22605992289562782,1246998,1214234,61.79570127713748,77.09528303263507,NaN,NaN,8.653123796867678,14.039793437452923
1999-04-06T09:30:00-04:00,20.651943,20.892963,20.474347,20.550459,142510,154550.1,53.516573206741306,54.46680570560879,NaN,NaN,-1.4881988041761884,-35.28277278465749,-0.05939823015346954,0.1518121352037909,0.21121036535726043,1104488,1164053.8,57.56378474660079,74.95616840065006,NaN,NaN,8.346800242635863,13.2265086953362
1999-04-07T09:30:00-04:00,20.740737,21.210104,20.728056,21.10862,324928,165524.75,60.018699897566655,54.42100172875792,NaN,NaN,85.92368078117109,-14.702725014043642,-0.01668209072841484,0.19035775194674187,0.2070398426751567,1429416,1207188.8,60.09368036378456,72.97899675996304,NaN,NaN,10.178402364296145,12.79106493375905
1999-04-08T09:30:00-04:00,21.311587,21.539926,21.260846,21.489184,194612,170691.85,63.74266861915911,54.25223472047545,NaN,NaN,162.73113831380658,29.988100410695502,0.03336522336376044,0.24874637187985726,0.21538114851609683,1624028,1311786.6,65.469516792397,71.36818088174479,NaN,NaN,12.965385327551926,12.815967847158031
1999-04-09T09:30:00-04:00,21.413071,21.565297,21.210104,21.438442,151255,167698.75,62.90140134593943,54.60768453649458,NaN,NaN,144.37733889122123,78.30882709594043,0.05778302540118235,0.28760993026757475,0.2298269048663924,1472773,1375540.6,68.27480947787753,70.30356822014743,NaN,NaN,14.914326068131972,13.115733307297166
1999-04-12T09:30:00-04:00,21.311587,21.844377,21.286217,21.819006,193873,168191.45,66.47508602784032,55.17454579075775,NaN,NaN,172.20343292000913,112.74947842040638,0.09224996638487837,0.34513936284749036,0.252889396462612,1666646,1459470.2,71.55144499322314,69.46568961194663,NaN,NaN,17.738815285632146,13.776173589916448
1999-04-13T09:30:00-04:00,22.072716,22.072716,21.742893,21.793635,209639,174522.5,66.01850383579617,56.46278224269222,NaN,NaN,183.8465134464538,149.81642087053237,0.10509261928018371,0.38425517056284164,0.27916255128265793,1457007,1529974,73.98238086582285,68.88260417654375,NaN,NaN,19.858097425401763,14.645019852128636
1999-04-14T09:30:00-04:00,21.92049,22.098087,21.514555,21.514555,160740,173130.7,61.05110107742224,57.44309455408563,NaN,NaN,136.76868585336229,159.9854218849706,0.08727771124060141,0.3882596903334097,0.30098197909280827,1296267,1503344.2,71.49728634441267,68.18615226764207,NaN,NaN,20.20624577684741,15.439480698517032
1999-04-15T09:30:00-04:00,21.64141,22.427909,21.184733,21.311587,124650,171295.45,57.653496088921585,57.7402332400412,NaN,NaN,108.95838903894756,149.2308720299988,0.055839491329966906,0.3707813432552669,0.3149418519253,1171617,1412862,63.67131331958521,67.15322945430428,NaN,NaN,19.495227386922913,16.018873082575016
1999-04-16T09:30:00-04:00,21.413071,21.413071,21.032507,21.210104,125143,167575.65,55.97611198646788,58.096152874058575,NaN,NaN,46.2358235101757,129.6025689537897,0.023859753019508823,0.344766543199686,0.3209067901801772,1046474,1327602.2,57.30606676100968,65.66336050173531,NaN,NaN,18.423850209117862,16.362441243509707
1999-04-19T09:30:00-04:00,21.603349,21.945861,21.210104,21.210104,149531,162808.9,55.97611198646786,58.050911604024385,NaN,NaN,69.87726268466102,109.13733490672007,-0.000360941033019202,0.3204556138889032,0.3208165549219224,1046474,1203567.8,49.54604499371719,64.07297192369883,NaN,NaN,17.547473467696513,16.53173156125068
1999-04-20T09:30:00-04:00,21.336958,23.772568,21.311587,21.489184,68607,144862.7,59.714311281798146,58.519964593229986,NaN,NaN,139.7313079620014,100.31429380982959,-0.0006376713814489898,0.3200194656951112,0.3206571370765602,1115081,1135182.6,45.85889677988128,62.464557601350634,NaN,NaN,17.80859233699761,16.714140243500243
1999-04-21T09:30:00-04:00,21.514555,21.819006,21.489184,21.819006,85235,134676.35,63.643408760612985,59.50422784128831,NaN,NaN,76.14812470450698,88.19018158005854,0.017347406789831432,0.34234139556384946,0.32499398877401803,1200316,1115992.4,44.85022858597429,60.98662072213477,NaN,NaN,19.187607341801634,17.067492686114726
1999-04-22T09:30:00-04:00,21.768264,22.047345,21.768264,22.047345,74519,131178.25,66.10789136978408,60.615051116870006,NaN,NaN,96.28386370915923,85.65527651410088,0.0393198790082695,0.3741438375343549,0.3348239585260854,1274835,1136636,46.22057847208202,59.83440955525038,NaN,NaN,21.10118094378402,17.64373386578177
1999-04-23T09:30:00-04:00,22.174199,22.174199,21.819006,21.971232,159138,135273.7,64.5374637554884,61.23805923142902,NaN,NaN,92.3266609157166,94.87344399520904,0.0431207059228611,0.38872484092966175,0.34560413500680065,1115697,1150480.6,47.16868863668771,58.7896229380754,NaN,NaN,22.245667998202865,18.30115302755621
1999-04-26T09:30:00-04:00,21.996603,21.996603,21.539926,21.64141,184512,141241.4,58.09691123487664,61.565226233438686,NaN,NaN,55.372016805986654,91.97239481947418,0.019043255496101696,0.3694082043769278,0.3503649488808261,931185,1127422.8,45.72292008563659,57.94384689086367,NaN,NaN,21.37965842736859,18.740939513243692
1999-04-27T09:30:00-04:00,21.831688,22.110768,21.64141,22.021974,73041,141112.1,62.71988322098622,61.75816789939722,NaN,NaN,75.87549862664153,79.2012329524022,0.0240461921586822,0.38042268907917887,0.35637649692049667,1004226,1105251.8,44.316351018395444,56.81689479476445,NaN,NaN,22.019714340323546,19.20933591711224
1999-04-28T09:30:00-04:00,22.047345,22.148828,21.768264,21.895119,189439,143501.65,60.33054810695451,61.51444500566832,NaN,NaN,73.8188146874352,78.73537094898784,0.014576788568658183,0.3745974826313194,0.36002069406266124,814787,1028146,39.7379010144819,54.978922239199086,NaN,NaN,21.836547212444444,19.58465181644541
1999-04-29T09:30:00-04:00,21.895119,22.224941,21.869748,21.971232,104573,143095.2,61.28357039725948,61.398885652191176,NaN,NaN,81.80634332043279,75.83986687124255,0.00945252440777783,0.37183634957238354,0.3623838251646057,919360,957051,36.04061251296144,52.67647959884793,NaN,NaN,21.958618625297248,19.923789931995675
1999-04-30T09:30:00-04:00,21.971232,22.072716,21.286217,21.666781,418047,161349.35,55.53623501409154,60.61753915120913,NaN,NaN,17.09846037588387,60.794226763276015,-0.016987917771776995,0.3411489279498845,0.3581368457216615,501313,834174.2,30.720485413851364,49.75998248603566,NaN,NaN,20.361998144799394,19.98639110525335
1999-05-03T09:30:00-04:00,21.590668,21.92049,21.489184,21.92049,258046,169601.9,58.98796600761019,60.11535787776727,NaN,NaN,31.775628752125172,56.07494915250372,-0.01974368956325767,0.3334572337675894,0.35320092333084707,759359,799809,29.412809798236026,46.57644169549375,NaN,NaN,20.010394897368712,19.98982021841269
1999-05-04T09:30:00-04:00,21.768264,21.869748,21.235475,21.235475,368901,180921.45,48.12496078907076,59.192062142885014,NaN,NaN,-71.28748158779838,26.642353109615726,-0.06737207948012658,0.2689858239806888,0.3363579034608154,390458,677055.4,25.27424149044772,43.27479563449624,NaN,NaN,16.024289574691217,19.423315840738194
1999-05-05T09:30:00-04:00,21.260846,21.413071,20.956394,21.362329,267530,178051.55,49.962640083667544,58.642715285366876,NaN,NaN,-142.84307319844072,-16.690024467559457,-0.08866386070619992,0.22552807757806548,0.3141919382842654,657988,645695.6,24.332307144115347,40.464866621962685,NaN,NaN,13.421944995693547,18.56597714858896
1999-05-06T09:30:00-04:00,21.133991,21.336958,20.905653,21.007136,211610,178901.45,45.14067312101351,57.86875536640584,NaN,NaN,-172.3791981241925,-67.5271327564845,-0.12289324599181406,0.16057538079449785,0.2834686267863119,446378,551099.2,21.70458199952688,37.9219034247139,NaN,NaN,9.61462636423037,17.287212750823446
1999-05-07T09:30:00-04:00,21.286217,21.539926,21.235475,21.413071,788426,210760,50.965192678642616,57.510832558704045,NaN,NaN,-81.91188698073461,-87.3292022278082,-0.11458380052828765,0.14023887612595232,0.25482267665423997,1234804,697797.4,33.66798415849152,36.78775622219779,NaN,NaN,8.281450763913854,16.000675324122078
1999-05-10T09:30:00-04:00,21.565297,21.64141,21.286217,21.336958,53949,203763.8,49.89550237682087,56.809489065491384,NaN,NaN,-67.50687433897718,-107.18570284602868,-0.1105494524758604,0.11663586105941448,0.22718531353527488,1180855,782096.6,39.398395881862236,36.32629187233929,NaN,NaN,6.889124884720872,14.699025261350478
1999-05-11T09:30:00-04:00,21.514555,21.869748,21.489184,21.590668,70577,196810.7,53.40606861912747,56.0782504839567,NaN,NaN,-2.4384975610588353,-93.41590604068077,-0.08810564195227805,0.11705326109492731,0.20515890304720535,1251432,954291.4,49.07597285621936,36.62813074878536,NaN,NaN,6.819143723735266,13.57332789883402
1999-05-12T09:30:00-04:00,21.539926,21.92049,21.286217,21.895119,51116,191329.5,57.27464064818173,55.44730400384225,NaN,NaN,11.973966285115907,-62.45249814396944,-0.05186069597689555,0.1403330330760859,0.19219372905298146,1302548,1083203.4,54.88450311982215,37.24698250933823,NaN,NaN,7.98667650817827,12.775234843026055
1999-05-13T09:30:00-04:00,21.92049,22.148828,21.9078,22.098087,61216,188157.8,59.6782064914255,55.100214199266325,NaN,NaN,98.79002981183211,-8.218652556764521,-0.015223692593449079,0.1731641133111701,0.18838780590461918,1363764,1266680.6,61.5982895918097,38.27766829184695,NaN,NaN,9.707774174100058,12.337026176036627
1999-05-14T09:30:00-04:00,21.565297,21.692152,21.159362,21.413071,197199,191760.6,49.547303630322766,54.4895279417982,NaN,NaN,-74.07406380809424,-6.651087922236442,-0.03689589399178961,0.14226793841488217,0.17916383240667177,1166565,1253032.8,60.872636382617344,39.359790884488426,NaN,NaN,7.87066459409371,11.698974521473353
1999-05-17T09:30:00-04:00,21.10862,21.235475,20.778798,21.007136,235752,196071.65,44.70422596064607,53.20269528034533,NaN,NaN,-165.1833222554842,-26.18637750553785,-0.0760846920598448,0.08405796733186577,0.16014265939171057,930813,1203024.4,58.1685908304809,40.34923658535167,NaN,NaN,4.666996745276248,10.69440626773091
1999-05-18T09:30:00-04:00,21.159362,21.336958,20.728056,21.057878,166159,200949.25,45.42237046963149,52.13782544910798,NaN,NaN,-134.75823403362978,-52.65032480005205,-0.09488074035364563,0.04154173394965355,0.13642247430329918,1096972,1172132.4,56.49896134434314,41.54645518034176,NaN,NaN,2.4028728486155324,9.50990149357157
1999-05-19T09:30:00-04:00,21.10862,21.210104,20.931023,21.210104,85974,200986.2,47.62017897940727,51.161868919261394,NaN,NaN,-101.52803347493014,-75.35072475206125,-0.09321696405706406,0.01990126923196911,0.11311823328903317,1182946,1148212,55.178253943499264,42.91342956823731,NaN,NaN,1.2356365874639106,8.327863649841905
1999-05-20T09:30:00-04:00,21.184733,21.336958,20.931023,20.931023,180570,206288.75,44.11292545927507,50.3459182367745,NaN,NaN,-100.63588050331074,-115.2359068150898,-0.10612912879389332,-0.01954317770333347,0.08658595109055985,1002376,1075934.4,51.27779710855472,44.381808975001846,NaN,NaN,-0.8398108086892531,7.01819587005174
1999-05-21T09:30:00-04:00,20.880282,21.007136,20.715366,20.880282,98907,203277.2,43.48582476329579,49.23862243360919,NaN,NaN,-129.16945435990664,-126.2549849254523,-0.11268631886735345,-0.054271947493631956,0.05841437137372149,903469,1023315.2,48.585168611079354,45.75126317591923,NaN,NaN,-2.699484605768641,5.6299558020774
1999-05-24T09:30:00-04:00,20.57583,20.677314,20.195266,20.423605,535184,220810.8,38.21967492080009,48.531102014447,NaN,NaN,-188.53368133936468,-130.92505674222838,-0.1405656474639297,-0.11729268795619063,0.023272959507739062,368285,910809.6,43.34440354189608,47.04198903673697,NaN,NaN,-6.006850652119909,3.967554880049213
1999-05-25T09:30:00-04:00,20.29675,20.423605,19.890815,19.890815,105558,222436.65,33.17242983455422,47.33180128236747,NaN,NaN,-210.65719601871217,-146.1048491392449,-0.18488477523696328,-0.20783300953846506,-0.022948234301501766,262727,743960.6,36.97456777953545,47.945007653552686,NaN,NaN,-10.62196046405448,1.8833384023201143
1999-05-26T09:30:00-04:00,19.992299,20.53777,19.789331,20.53777,236244,224776.9,43.01349523096808,47.179860004507084,NaN,NaN,-151.65651939740602,-156.13054632374005,-0.16147480912853812,-0.22479174571217442,-0.0633169365836363,498971,607165.6,32.72793154647793,48.73238976404919,NaN,NaN,-11.305457449159961,-0.0007752907484679383
1999-05-27T09:30:00-04:00,20.360173,20.360173,19.954238,20.043041,53580,222227.25,38.36130181497104,46.279582085673404,NaN,NaN,-157.13383828943702,-167.4301378809653,-0.1693323201573517,-0.2749823367803259,-0.10565001662297421,445391,495768.6,29.73311439629724,48.451327638178164,NaN,NaN,-13.510973397157732,-1.9308035916640771
1999-05-28T09:30:00-04:00,20.195266,20.423605,20.055722,20.360173,47421,203695.95,42.64374120382185,45.7615991447449,NaN,NaN,-117.75790171342165,-165.1478273516683,-0.14417876141732197,-0.2858734683946267,-0.1416947069773047,492812,413637.2,27.719148757496058,47.61709570072344,NaN,NaN,-13.813785841425986,-3.628372484487207
1999-06-01T09:30:00-04:00,20.246008,20.347492,19.840073,20.068412,256568,203622.05,39.897401626896595,44.79669435958555,NaN,NaN,-125.95710543578932,-152.63251217095325,-0.1381826110036142,-0.31442297073182246,-0.17624035972820826,236244,387229,27.083909589635596,46.0462340388246,NaN,NaN,-14.975914583628096,-5.24944992722162
1999-06-02T09:30:00-04:00,19.966928,20.093783,19.611735,19.941557,126251,191489.55,38.72950105082748,43.472041531203104,NaN,NaN,-130.23905705052982,-136.54888437731677,-0.13366941930956086,-0.34332713386515934,-0.20965771455559848,109993,356682.2,26.3321898393108,44.00678309021664,NaN,NaN,-16.269773608081916,-6.823781881630234
1999-06-03T09:30:00-04:00,20.195266,20.195266,19.865444,19.928867,87206,182473.35,38.60774951095274,41.96700888974077,NaN,NaN,-100.76999868344222,-126.371580234524,-0.12273190314270593,-0.3630725934839809,-0.24034069034127498,22787,261445.4,24.08748227557402,41.32743971048553,NaN,NaN,-17.330158812591552,-8.324692871767565
1999-06-04T09:30:00-04:00,20.169895,20.372863,20.043041,20.29675,91393,176462.5,44.094553684868266,41.57752675077973,NaN,NaN,-64.627559297679,-107.87032443617241,-0.08377409692154925,-0.34505831149321153,-0.2612842145716623,114180,195203.2,22.641720138060194,38.596659978731445,NaN,NaN,-16.576729470712497,-9.503555243045412
1999-06-07T09:30:00-04:00,20.423605,20.702685,20.347492,20.677314,60354,140058.9,49.15678067865407,41.89556637349459,NaN,NaN,-22.222137594939902,-88.76317161247607,-0.028295738406905913,-0.29665388758029465,-0.26835814917338874,174534,131547.6,21.317591649363607,35.964445751508784,NaN,NaN,-14.342886206335681,-10.194888237801164
1999-06-08T09:30:00-04:00,20.626572,20.626572,20.309431,20.309431,233904,149056.65,44.92215721679631,41.859836855434935,NaN,NaN,-36.456378432947645,-70.86302621190774,-0.013070532317836558,-0.28469631457068445,-0.2716257822528479,-59370,72424.8,20.139516967568383,33.36734258173915,NaN,NaN,-13.745517700830803,-10.702121018233969
1999-06-09T09:30:00-04:00,20.372863,20.563141,20.182577,20.25869,42001,147627.85,44.354607265510275,41.62658173301372,NaN,NaN,-41.306127080969816,-53.07644021799573,-0.0036043008721035052,-0.2761311583429773,-0.2725268574708738,-101371,30152,19.31750812024262,30.805860737220822,NaN,NaN,-13.43404488441093,-11.09239585625925
1999-06-10T09:30:00-04:00,20.01767,20.01767,19.738589,19.878125,121694,151156.75,40.24749264944995,41.35047938945478,NaN,NaN,-96.85088443905076,-52.292617369117444,-0.0192843008777559,-0.29663223356806867,-0.27734793269031277,-223065,-19018.4,18.377891819781098,28.455867502308422,NaN,NaN,-14.405942213708265,-11.565759621609109
1999-06-11T09:30:00-04:00,19.916186,20.195266,19.76396,19.916186,101001,153146,40.83753122574587,41.161315565344076,NaN,NaN,-84.18682478623388,-56.204470466828425,-0.02314381392756848,-0.3062777000997734,-0.2831338861722049,-122064,-66267.2,17.497169576694105,26.235296142709476,NaN,NaN,-15.02139545688068,-12.059421883790762
1999-06-14T09:30:00-04:00,19.992299,19.992299,19.738589,19.814702,35227,145047.4,39.71151967702222,41.26787590507423,NaN,NaN,-99.63961087425214,-71.68796512269088,-0.02824483916671483,-0.31843993513059843,-0.2901950959638836,-157291,-132632.2,16.314533982368204,24.304591174171772,NaN,NaN,-15.849582077525712,-12.600873340038612
1999-06-15T09:30:00-04:00,19.941557,20.068412,19.840073,19.916186,152980,140908.8,41.45009784709068,41.85913790596969,NaN,NaN,-77.3530957877345,-79.86730859364825,-0.02083929673041862,-0.31624421687690685,-0.2954049201464882,-4311,-121620.4,17.313206720049067,22.90020824135131,NaN,NaN,-16.072557376926397,-13.096828202451153
1999-06-16T09:30:00-04:00,20.398234,20.613883,20.372863,20.436286,229100,144055.85,49.48936840594449,42.32170027561086,NaN,NaN,41.090329905836555,-63.38801719628698,0.020779501390074895,-0.2694305434088946,-0.2902100447989695,224789,-56388.4,23.162876070773706,22.21698999308672,NaN,NaN,-13.894896853522628,-13.210838009747079
1999-06-17T09:30:00-04:00,20.525088,20.905653,20.398234,20.82954,193011,149407.7,54.568805701163505,43.47937912462461,NaN,NaN,107.58104578008387,-22.50163115246005,0.07351840311169261,-0.19831204090935373,-0.27183044402104634,417800,71784.6,33.16755302579037,22.462307038050515,NaN,NaN,-10.406359205685158,-12.810198180595375
1999-06-18T09:30:00-04:00,20.651943,20.854911,20.639254,20.804169,66389,143698.65,54.19018655618075,44.304125221221675,NaN,NaN,132.0695709446299,20.749647993712706,0.10357927713553267,-0.14235634760163052,-0.24593562473716318,351411,166479.6,39.44125675550926,23.299600466480033,NaN,NaN,-7.702972967557492,-12.08059457873282
1999-06-21T09:30:00-04:00,20.880282,20.956394,20.702685,20.931023,157660,146636.3,55.84001322795583,45.4428831927259,NaN,NaN,157.53627412344255,72.18482499325164,0.1273287278053648,-0.08677471498045719,-0.214103442785822,509071,299752,46.984184431662385,24.721048669481945,NaN,NaN,-4.960249201690709,-11.063402382012518
1999-06-22T09:30:00-04:00,20.905653,20.931023,20.702685,20.702685,89053,124329.75,52.19603305963538,46.404778336212175,NaN,NaN,122.72070434915054,112.19958502062863,0.12291958356792496,-0.060453963325915794,-0.18337354689384075,420018,384617.8,51.15623352473679,26.49419464701237,NaN,NaN,-3.610512424526095,-9.998703816657315
1999-06-23T09:30:00-04:00,20.702685,20.702685,20.29675,20.499718,49145,121509.1,49.12712575203971,47.15616235343267,NaN,NaN,49.23107829560113,113.82773469858157,0.10243127154562959,-0.055334457461803765,-0.15776572900743335,370873,413834.6,52.54090900142457,28.52658227028741,NaN,NaN,-3.3198359316988597,-9.044579833091822
1999-06-24T09:30:00-04:00,20.423605,20.423605,19.928867,20.169895,68483,113121.05,44.543866974643485,47.18825615984519,NaN,NaN,-27.838733975134904,86.74377874753782,0.06460976468374319,-0.07700352315275438,-0.14161328783649757,302390,390752.6,51.30350542429543,30.573852647875643,NaN,NaN,-4.41089380972569,-8.38262468689666
1999-06-25T09:30:00-04:00,20.29675,20.347492,20.169895,20.220637,95212,115202.65,45.38800294682489,46.91905775042882,NaN,NaN,-12.487307585241192,57.83240304156359,0.04204632349081289,-0.08905538347298148,-0.13110170696379436,397602,399990.8,51.792860117134836,32.75065753843073,NaN,NaN,-5.071282268771278,-7.909575770021606
1999-06-28T09:30:00-04:00,20.360173,20.753427,20.360173,20.689995,72055,116434.35,52.57850756920598,47.46593991845808,NaN,NaN,66.47093607908958,39.619335432693035,0.056848418213343924,-0.06004118419711446,-0.11688960241045838,469657,392108,51.318965492924775,34.977761004527615,NaN,NaN,-3.513040589785966,-7.281499315702229
1999-06-29T09:30:00-04:00,20.626572,20.854911,20.499718,20.753427,60354,106623.65,53.47015221711284,48.11705027214399,NaN,NaN,81.12016839781258,31.299228242425443,0.0682597386450954,-0.031564929104089146,-0.09982466774918454,530011,414106.6,52.62180119798411,37.35663908150915,NaN,NaN,-1.9801381255782815,-6.52416200282738
1999-06-30T09:30:00-04:00,20.854911,21.362329,20.499718,21.184733,187591,109690.65,59.101196815988274,49.46374342689672,NaN,NaN,136.89359959638614,48.83173250258244,0.10026886867561782,0.025511418095337746,-0.07475745058028008,717602,483452.4,56.56775448898547,40.08448641502374,NaN,NaN,1.1368544956884112,-5.429731074467981
1999-07-01T09:30:00-04:00,21.235475,21.413071,20.905653,21.413071,259770,118318.85,61.7409816778646,50.95684703061949,NaN,NaN,165.94752279106052,87.58898385582154,0.13032885860422241,0.08815362267499793,-0.042175235929224474,977372,618448.8,63.023999914352295,43.336402867713616,NaN,NaN,4.583937522543997,-3.999206989180556
1999-07-02T09:30:00-04:00,21.311587,21.616039,21.311587,21.413071,83757,117937.05,61.7409816778646,52.530380030679666,NaN,NaN,177.47957403142286,125.58236017915434,0.14272232738185517,0.1362276732980945,-0.006494654083760681,977372,734402.8,67.49374645632525,46.9920609015677,NaN,NaN,7.3531943970063125,-2.377435362582432
1999-07-06T09:30:00-04:00,21.3877,21.793635,21.3877,21.590668,176013,123720,63.84593224560173,54.130082487716166,NaN,NaN,170.42546024263115,146.37326501186266,0.15440160943405007,0.1865073577088019,0.032105748274751836,1153385,871148.4,71.82003711948119,50.88540593009856,NaN,NaN,10.330390674861247,-0.5620316429476206
1999-07-07T09:30:00-04:00,21.413071,21.616039,21.3877,21.514555,98045,116927.05,62.26483416009569,55.042615755869825,NaN,NaN,134.89423127270368,157.12807758684087,0.14847791383124911,0.21770314056381324,0.06922522673256412,1055340,976214.2,74.61547885614698,54.56059184333951,NaN,NaN,12.38510738198518,1.2875596463284933
1999-07-08T09:30:00-04:00,21.362329,21.64141,21.286217,21.438442,57891,117721.55,60.64741509264189,55.47680214097543,NaN,NaN,112.99801791833627,152.3489612512309,0.1314931315729741,0.23359164119878173,0.10209850962580765,997449,1032183.6,75.98231107315664,57.618788846722815,NaN,NaN,13.685448905387258,3.058686683336888
1999-07-09T09:30:00-04:00,21.425753,21.565297,21.336958,21.463813,84373,115855.5,61.01098291448017,55.96400188085396,NaN,NaN,102.83017184115747,139.72549106125027,0.11464261718959423,0.24540178111280042,0.1307591639232062,1081822,1053073.6,76.49111532195586,60.265207315754715,NaN,NaN,14.87201990642529,4.74630571520666
1999-07-12T09:30:00-04:00,21.463813,21.539926,21.286217,21.286217,91517,115381.3,57.03851274518901,56.04960898922775,NaN,NaN,80.56936732437818,120.34344971984135,0.0855454176306571,0.23769093596152757,0.15214551833087048,990305,1055660.2,76.55733727265604,62.37757537582569,NaN,NaN,14.871064502491082,6.192699827675863
1999-07-13T09:30:00-04:00,21.10862,21.184733,21.007136,21.057878,41755,115707.7,52.321526326123305,56.05857279397689,NaN,NaN,30.384296804864622,92.33521703228803,0.04686428131718556,0.21072586997735243,0.16386158866016687,948550,1014693.2,73.0476704787156,63.94124944396703,NaN,NaN,13.568245096066759,7.246349151731705
1999-07-14T09:30:00-04:00,21.286217,21.286217,20.981765,21.10862,567578,136437.6,53.246820344835186,56.35283669346229,NaN,NaN,30.3167853371415,71.41972784517559,0.021907332459885076,0.1912457542350232,0.16933842177513814,1516128,1106850.8,75.74180472383695,65.5984562812822,NaN,NaN,12.712192766171961,8.027183953794598
1999-07-15T09:30:00-04:00,21.311587,21.34964,21.184733,21.298898,172071,133586.15,56.64468036565151,57.21718050710571,NaN,NaN,51.964822184776416,59.213088698463615,0.015715653213310782,0.18898298829177662,0.17326733507846584,1688199,1245000.8,79.11246198440833,67.58481032129026,NaN,NaN,12.866446192293138,8.71850713072296
1999-07-16T09:30:00-04:00,21.286217,21.489184,21.10862,21.413071,24511,125161.15,58.58943581398236,58.16013999761696,NaN,NaN,57.46994007015433,50.141042344262985,0.016717597014955454,0.19416433134716016,0.1774467343322047,1712710,1371178.4,81.6239154906891,69.71559999082986,NaN,NaN,13.52365997237531,9.404957536673296
1999-07-19T09:30:00-04:00,21.514555,21.539926,21.235475,21.260846,152856,129484.5,55.0442284209317,58.336262915597366,NaN,NaN,54.106480113915985,44.848464902170534,0.005136840038954121,0.18386778438089735,0.17873094434194323,1559854,1485088.2,83.54719081805823,72.01761608548225,NaN,NaN,13.127296925814969,9.936720306550678
1999-07-20T09:30:00-04:00,21.184733,21.336958,20.931023,20.994447,56536,124428.3,49.409603753184555,58.046223739602496,NaN,NaN,3.9194237422029032,39.555490289638186,-0.02102145344632056,0.15245412753404253,0.1734755809803631,1503318,1596041.8,85.17481317880956,74.34283122696978,NaN,NaN,11.14104704674557,10.108766983721376
1999-07-21T09:30:00-04:00,20.981765,21.083249,20.651943,20.753427,59492,122950.25,44.928544107135906,57.03389140325589,NaN,NaN,-46.829822827880264,24.126168656633837,-0.05327786279812932,0.10687825248270144,0.16015611528083076,1443826,1581581.4,84.0083802007516,76.30287592066736,NaN,NaN,8.044536475799507,9.813876911161108
1999-07-22T09:30:00-04:00,20.677314,21.032507,20.626572,20.778798,79569,124471.45,45.488976049397856,55.87303385836541,NaN,NaN,-56.504510914631005,2.432302036752354,-0.07054363644716369,0.07197656972187616,0.14252020616903985,1523395,1548620.6,81.27617095789732,77.60660242377773,NaN,NaN,5.663982745863507,9.221034887547164
1999-07-23T09:30:00-04:00,20.880282,20.880282,20.347492,20.550459,99276,126011.1,41.40505890787343,54.420467946223184,NaN,NaN,-114.67540601532482,-31.996767180343475,-0.09353886593975853,0.025596623744341684,0.11913548968410022,1424119,1490902.4,76.57936290257425,78.25557502708122,NaN,NaN,2.3474976509169316,8.239100996599989
1999-07-26T09:30:00-04:00,20.347492,20.753427,20.347492,20.626572,140539,128277.45,43.234500928353825,52.948222852134045,NaN,NaN,-130.03580288190977,-68.82522377950863,-0.09927715004821411,-0.00496094787616741,0.0943162021720467,1564658,1491863.2,76.60360071948102,78.59725814136691,NaN,NaN,0.08301900357668035,7.073946426168088
1999-07-27T09:30:00-04:00,20.854911,20.981765,20.702685,20.905653,77229,128536.15,49.464796632598286,52.0339344573128,NaN,NaN,-68.03901839310986,-83.21691220657118,-0.08071908848104489,-0.006582658429259425,0.07413643005178547,1641887,1519577,77.3323027290168,78.79131698942903,NaN,NaN,-0.11876248583679741,6.046416581595961
1999-07-28T09:30:00-04:00,20.753427,20.905653,20.626572,20.651943,43233,127680.1,44.66539218922517,50.89236139278303,NaN,NaN,-102.62525620131734,-94.3759988812586,-0.08172289418856023,-0.028017187683914813,0.053705706504645415,1598654,1550542.6,78.15114041217004,78.94623337078714,NaN,NaN,-1.7659812045394983,4.930359755005181
1999-07-29T09:30:00-04:00,20.372863,20.474347,20.195266,20.347492,154458,126023.45,39.68888615332175,49.369354481271714,NaN,NaN,-168.82657258372848,-116.84041121507809,-0.09798698724667473,-0.068778027553698,0.02920895969297673,1444196,1534702.8,76.6263042801976,78.95588972494727,NaN,NaN,-4.80974114956783,3.538916768637608
1999-07-30T09:30:00-04:00,20.246008,20.347492,19.865444,19.890815,354120,130740.95,33.63515376271569,47.69768598252362,NaN,NaN,-188.43849182568954,-131.59302837715103,-0.13245471766964872,-0.13635943739408418,-0.003904719724435457,1090076,1467894.2,70.3881677508025,78.5152347591006,NaN,NaN,-9.64557331652265,1.6554181850432854
1999-08-02T09:30:00-04:00,19.992299,20.220637,19.738589,19.789331,236860,138396.1,32.450612149318374,46.27833496989469,NaN,NaN,-174.80520478259174,-140.54690875728744,-0.15355580138707095,-0.19584947145827414,-0.042293670071203195,853216,1325605.8,59.313034774547596,77.53418935166003,NaN,NaN,-13.87891568595239,-0.5637723679560966
1999-08-03T09:30:00-04:00,19.840073,19.916186,19.434138,19.535622,571150,158152.95,29.640253192574562,44.59215160187608,NaN,NaN,-189.46522873619676,-164.83215082590482,-0.17453743537021157,-0.26046546428396766,-0.08592802891375609,282066,1053641.6,44.80262502373349,75.32424794450978,NaN,NaN,-18.38084384941119,-3.109068293878252
1999-08-04T09:30:00-04:00,19.535622,19.789331,19.231171,19.281912,177860,162143.7,27.111647001476584,42.48264921872073,NaN,NaN,-182.21570296644398,-180.75024017893014,-0.19394656634729282,-0.3283612368478721,-0.1344146705005793,104206,754752,34.743021509984004,72.15500219633661,NaN,NaN,-23.006364591976258,-5.951539193606539
1999-08-05T09:30:00-04:00,19.180429,19.383396,18.888659,19.358025,176506,168074.45,29.066686225285764,40.37388139095669,NaN,NaN,-175.2197690431151,-182.02887947080745,-0.18986204739733792,-0.3717422297472517,-0.18188018234991377,280712,522055.2,29.238743091494968,68.41320416782276,NaN,NaN,-26.096166521720026,-8.82934309762275
1999-08-06T09:30:00-04:00,19.180429,19.269223,18.698381,18.850607,182911,173001.35,24.373145126548266,38.183089727072165,NaN,NaN,-171.10563843603376,-178.5623087928763,-0.20807313222747767,-0.44197159763426086,-0.2338984654067832,97801,323600.2,25.52467884307461,64.2687390267525,NaN,NaN,-30.518837679181736,-11.927842323559748
1999-08-09T09:30:00-04:00,18.812546,19.104316,18.812546,18.901348,240432,180447.1,25.665767885789464,36.487101450829655,NaN,NaN,-143.71613461007306,-172.34449475837255,-0.20320937023415275,-0.48791017819947413,-0.2847008079653214,338233,220603.6,23.832647043745297,59.88715573139076,NaN,NaN,-33.57372749047941,-15.0201116331197
1999-08-10T09:30:00-04:00,18.901348,18.901348,18.39393,18.571526,210624,188890.55,22.92309340887452,34.915283543810986,NaN,NaN,-146.92115349181557,-163.8356797094963,-0.20796119406227892,-0.54465230054317,-0.3366911064808911,127609,189712.2,23.33305081994098,55.55320363276144,NaN,NaN,-37.11106327733265,-18.175961868007263
1999-08-11T09:30:00-04:00,18.850607,19.028203,18.698381,18.926719,348085,177915.9,31.422195407585363,33.91051349796724,NaN,NaN,-108.20426984500864,-149.03339308520924,-0.17430073973379528,-0.5545670311481352,-0.38026629141433993,475694,264009.8,27.281388782645692,51.69643347738632,NaN,NaN,-37.28534102557951,-20.90587317623187
1999-08-12T09:30:00-04:00,19.078945,19.269223,18.95209,19.015514,162218,177423.25,33.39932966881588,33.33867569517741,NaN,NaN,-82.66539661789008,-130.52251860016423,-0.13493238162583665,-0.5489317684466357,-0.41399938682079906,637912,335449.8,30.96301181672395,48.438122685539874,NaN,NaN,-36.78746035040232,-23.174671343970505
1999-08-13T09:30:00-04:00,19.408767,19.687847,19.345336,19.637106,195351,185965.25,45.290327218761234,33.485520430206506,NaN,NaN,-36.81990232138149,-103.66537137723378,-0.059740776373720106,-0.4886753572879492,-0.4289345809142291,833263,482542.2,37.93092148420316,45.6757884544486,NaN,NaN,-32.11009664555864,-24.45116067276881
1999-08-16T09:30:00-04:00,19.611735,19.662477,19.459509,19.560993,94719,183058.4,44.248545350745324,33.112931052931295,NaN,NaN,-30.71152990205298,-81.06445043562977,-0.010427263839055123,-0.44196866071304797,-0.43154139687399284,738544,562604.4,41.397935221656745,43.109047918208596,NaN,NaN,-28.81157786657136,-25.074077414740604
1999-08-17T09:30:00-04:00,19.966928,20.271379,19.966928,20.271379,181679,189315.55,54.71786516604203,33.83096483698964,NaN,NaN,34.243629427830605,-44.83149385170053,0.0702975603269354,-0.3436694464653236,-0.413967006792259,920223,721127.2,47.63487187962547,40.929314451598266,NaN,NaN,-21.915511799386568,-24.622853755404314
1999-08-18T09:30:00-04:00,20.119153,20.182577,19.903496,20.055722,199785,196330.2,51.55289808817089,34.67839426090743,NaN,NaN,27.32579436187998,-17.725481010322795,0.1072205341965573,-0.2799413390465624,-0.3871618732431197,720438,770076,49.424781813272624,38.98634856110363,NaN,NaN,-17.568469482281646,-23.615084573529646
1999-08-19T09:30:00-04:00,19.789331,19.992299,19.751271,19.789331,42864,194494.95,47.86957121703521,35.6951383647874,NaN,NaN,11.36982352537786,1.0815630183307874,0.11127169093865935,-0.2480722595697955,-0.35934395050845486,677574,778008.4,49.7246918423701,37.5103859962156,NaN,NaN,-15.296753277804639,-22.426751531283216
1999-08-20T09:30:00-04:00,19.865444,20.093783,19.751271,20.068412,52471,192154.7,51.758279545905204,37.0742574645436,NaN,NaN,31.835617480295397,14.812666978666169,0.12906419923386764,-0.1980137014661203,-0.32707790069998793,730045,757364.8,48.91180070499707,36.767440705533424,NaN,NaN,-12.118120449072963,-20.954089948110322
1999-08-23T09:30:00-04:00,20.29675,20.601201,20.29675,20.601201,104942,190374.85,58.17303479672753,39.11231329341167,NaN,NaN,99.29254004733373,40.813480968543516,0.1704336962175812,-0.11403578042801144,-0.28446947664559263,834987,776653.4,49.73859012389383,37.120009641259166,NaN,NaN,-7.092694906494539,-18.973890656450926
1999-08-24T09:30:00-04:00,20.550459,20.943705,20.423605,20.651943,254843,199255.55,58.735800653327395,41.37118141140102,NaN,NaN,124.6328909906883,58.891333281115045,0.19326056929814878,-0.04289376502290665,-0.23615433432105543,1089830,810574.8,51.23329506880556,38.29788632403213,NaN,NaN,-3.034792841607375,-16.69687668290185
1999-08-25T09:30:00-04:00,20.119153,20.499718,19.992299,20.487028,301402,212164,56.09420323942239,43.3017183409822,NaN,NaN,85.95669978009934,70.61751436475893,0.18906545668409236,0.0001774865340600229,-0.18888797015003234,788428,824172.8,51.85143964486402,39.91307893498706,NaN,NaN,-0.57141114207197,-14.39323874849758
1999-08-26T09:30:00-04:00,20.563141,20.563141,20.01767,20.01767,313966,220139.4,49.298612954945085,45.08210890015341,NaN,NaN,70.91221345183438,82.52599235005023,0.1482936422293916,-0.0035209173632928525,-0.15181455959268444,474462,783550.4,49.81981269187338,41.64844563847269,NaN,NaN,-0.6445970120632428,-12.429147071864104
1999-08-27T09:30:00-04:00,19.992299,20.131835,19.687847,19.687847,281818,216524.3,45.15851818864148,46.474448207499975,NaN,NaN,23.393275582547226,80.8375239705006,0.09530039206882848,-0.03268906950664885,-0.12798946157547733,192644,676070.2,44.81638590823737,43.14728412879355,NaN,NaN,-2.0753086152056506,-10.950027292341469
1999-08-30T09:30:00-04:00,19.7259,19.76396,18.939401,19.040885,193011,214331.85,38.354380775679694,47.57668301941463,NaN,NaN,-52.81094535364513,50.41682689030482,0.01696869756071033,-0.10677858962458942,-0.12374728718529975,-367,508999.4,38.36621547868761,44.2210816044183,NaN,NaN,-5.749866820321771,-10.207147224910084
1999-08-31T09:30:00-04:00,19.078945,19.256542,18.825236,19.015514,336507,202599.7,38.11186661149803,48.05451667683696,NaN,NaN,-74.18387969280128,10.653472753606902,-0.0335085557381771,-0.1656329818580211,-0.132124426119844,-336874,223658.6,30.335802902701047,44.439254041565114,NaN,NaN,-8.647221869679253,-9.984300745591394
1999-09-01T09:30:00-04:00,19.104316,19.104316,18.863288,19.104316,161602,201786.8,39.55255458321889,48.49403274215147,NaN,NaN,-70.09873596515766,-20.557614395444496,-0.056518456982022125,-0.20277249734737168,-0.14625404036534956,-175272,30918.6,26.327254499911447,44.10812851893565,NaN,NaN,-10.523303395625657,-10.061301124167718
1999-09-02T09:30:00-04:00,18.736433,18.888659,18.647639,18.736433,510672,218495.1,35.83124267891277,47.81838384644801,NaN,NaN,-96.93736515672389,-54.127530117156155,-0.09012188984814284,-0.2589064026755281,-0.16878451282738527,-685944,-201162.6,22.475990666985652,43.00420488913441,NaN,NaN,-13.321470365530324,-10.52703958721952
1999-09-03T09:30:00-04:00,19.44682,19.687847,19.345336,19.687847,523605,235529.8,49.154697920322015,48.168823315703484,NaN,NaN,-2.3686852367882847,-59.279922281023254,-0.04420373718800849,-0.2240391843123959,-0.1798354471243874,-162339,-272159.2,21.44261615872847,41.5788249560681,NaN,NaN,-11.257815256849744,-10.631436111452409
1999-09-07T09:30:00-04:00,19.599045,19.599045,19.155058,19.155058,63187,226667.55,43.68463473955187,47.38073542809705,NaN,NaN,-40.39898351316325,-56.79752991292687,-0.045467719580351645,-0.23667009659982696,-0.19120237701947532,-225526,-317191,20.789705618255113,39.66131308025592,NaN,NaN,-11.507974111986979,-10.75665582581449
1999-09-08T09:30:00-04:00,18.964772,19.281912,18.901348,19.028203,630273,247650,42.47271364740722,46.73215082518535,NaN,NaN,-76.96745557792674,-57.35424508995196,-0.050228900433842566,-0.2539885025617785,-0.20375960212793595,-855799,-420976,19.328929448240714,37.5116093398965,NaN,NaN,-12.110990861698262,-10.950132259512172
1999-09-09T09:30:00-04:00,18.977461,18.977461,18.571526,18.799865,92625,234877,40.30519923483502,46.19183854074248,NaN,NaN,-114.55090732108259,-66.24467936113695,-0.06329439471582446,-0.2828775955227165,-0.21958320080689206,-948424,-575606.4,17.370562013416105,35.20060006639979,NaN,NaN,-13.30619448395993,-11.286712577290423
1999-09-10T09:30:00-04:00,18.95209,19.078945,18.787175,18.939401,162464,234889.3,42.24490149984744,45.51231153745264,NaN,NaN,-91.72979942113373,-65.20316621401892,-0.05725883698557582,-0.29115674703886185,-0.23389791005328603,-785960,-595609.6,17.128792021849463,32.93038516046067,NaN,NaN,-13.661273068623265,-11.625935504623687
1999-09-13T09:30:00-04:00,18.901348,18.91403,18.723752,18.761804,66020,228422.75,40.44361587827367,44.245924471848795,NaN,NaN,-98.06818252384653,-84.34306567143057,-0.05967568652016325,-0.3084925182034901,-0.24881683168332686,-851980,-733537.8,15.524295764872335,30.48650699195914,NaN,NaN,-14.50019912997773,-12.036544593959979
1999-09-14T09:30:00-04:00,18.533466,18.546155,18.317817,18.419301,357446,241559.1,37.15342861935484,42.704326469422185,NaN,NaN,-124.53535851824434,-101.17034067244678,-0.0776515486405383,-0.3458812674839997,-0.2682297188434614,-1209426,-930317.8,13.571124297482015,27.7963519368646,NaN,NaN,-16.231283573949842,-12.635793019672816
1999-09-15T09:30:00-04:00,18.698381,18.723752,18.267075,18.330498,422727,253611.5,36.328221962204445,41.292470663906606,NaN,NaN,-110.7595623494024,-107.92876202674192,-0.08806964912828019,-0.37831678025381166,-0.29024713112553147,-1632153,-1085588.6,12.260358364511703,24.968417559696576,NaN,NaN,-17.88376245068522,-13.385502938388873
1999-09-16T09:30:00-04:00,18.406611,18.419301,18.064108,18.267075,270363,257140.4,35.718045655623385,40.32243014252648,NaN,NaN,-119.67858675133829,-108.95429791279307,-0.09138413614748603,-0.404477301309889,-0.313093165162403,-1902516,-1276407,10.870773976784136,22.186343365761633,NaN,NaN,-19.414579786717677,-14.246799631007274
1999-09-17T09:30:00-04:00,18.431982,18.622268,18.330498,18.596897,501681,280081.25,41.24485662697811,40.04288288812196,NaN,NaN,-83.59841503080992,-107.3280210347283,-0.06476820483863166,-0.39405342121069253,-0.3292852163720609,-1400835,-1399382,10.078020317012587,19.705031537817003,NaN,NaN,-19.17446600037266,-14.950751969488044
1999-09-20T09:30:00-04:00,18.495413,18.495413,18.343188,18.38124,149900,284952.7,38.89036995949035,40.081167829822725,NaN,NaN,-88.46264907816149,-105.40691434559128,-0.055451293871768836,-0.3985993337117719,-0.3431480398400031,-1550735,-1539133,9.252269799783647,17.625463989323865,NaN,NaN,-19.643744625161155,-15.62117949172706
1999-09-21T09:30:00-04:00,18.152902,18.292446,18.000676,18.089478,413859,300398.55,35.90415543208648,39.92347417415046,NaN,NaN,-115.12110185050663,-103.52406301204374,-0.06219594017535962,-0.4208929650592026,-0.358697024883843,-1964594,-1690166.6,8.446766291316123,16.061961374224943,NaN,NaN,-20.922964289273292,-16.37857731994795
1999-09-22T09:30:00-04:00,18.064108,18.165591,17.797709,18.076789,179954,296654.1,35.77549413548931,39.65368414216979,NaN,NaN,-124.58166840110817,-106.28848422238491,-0.060702549884577794,-0.4345752122395652,-0.3738726623549874,-2144548,-1792645.6,7.941557586034563,14.748697308948016,NaN,NaN,-22.001647948211293,-17.18187312398557
1999-09-23T09:30:00-04:00,18.114849,18.292446,17.797709,17.937253,265929,294880.45,34.31908799352419,39.54567309321346,NaN,NaN,-117.95865119673331,-105.9444971114639,-0.062080729652711775,-0.4514735744208771,-0.3893928447681653,-2410477,-1894237.8,7.464891744615485,13.676475957350148,NaN,NaN,-23.321822217925124,-18.059008708834078
1999-09-24T09:30:00-04:00,17.835769,18.089478,17.772338,18.064108,197938,289079.05,36.836582237343194,38.66580768728641,NaN,NaN,-114.5556528319405,-112.13594467169003,-0.04804456161887055,-0.4494485467917535,-0.40140398517288295,-2212539,-2056578.6,6.7660256353258035,12.628148062821385,NaN,NaN,-23.77338848370608,-18.875348676672935
1999-09-27T09:30:00-04:00,18.14022,18.216333,17.696225,17.759656,713784,310677.35,33.516256149539615,37.93949493085696,NaN,NaN,-116.25900569041619,-117.69521599414097,-0.052498279984156015,-0.46702683515307797,-0.41452855516892195,-2926323,-2331696.2,5.778669753295048,11.555931215324238,NaN,NaN,-25.106324632818623,-19.76548809897946
1999-09-28T09:30:00-04:00,17.759656,17.86114,17.455205,17.734285,413489,321701.25,33.24731243994451,37.28053770175247,NaN,NaN,-133.86829719487895,-121.44465506301542,-0.05037767802436638,-0.4775006526993799,-0.42712297467501353,-3339812,-2606739.8,4.994047532532647,10.532011078487946,NaN,NaN,-26.284174740041617,-20.696729047702625
1999-09-29T09:30:00-04:00,17.746967,17.835769,17.594741,17.607431,140786,311915.2,31.870283459555296,36.67804371780392,NaN,NaN,-121.46479726816128,-120.82128083642604,-0.05060917196806386,-0.49038443963509337,-0.4397752676670295,-3480598,-2873949.8,4.372845700891332,9.603602770450461,NaN,NaN,-27.66817124319485,-21.692649361344372
1999-09-30T09:30:00-04:00,17.58206,18.076789,17.58206,17.962624,725362,340103.2,39.43438860107024,36.47729279646269,NaN,NaN,-84.6216185858197,-114.15387431424332,-0.021424316830931933,-0.46655566370569446,-0.4451313468747625,-2755236,-2942901.6,4.226741296745004,8.682027718657285,NaN,NaN,-26.8062569826255,-22.423164735813106
1999-10-01T09:30:00-04:00,17.82308,17.82308,17.404463,17.658173,98291,319484.15,35.768652134690484,36.143366814778176,NaN,NaN,-108.24837942340767,-112.89241963253676,-0.017379890990879054,-0.46685621061336136,-0.4494763196224823,-2853527,-3071099.2,3.9617079153164667,7.856128586546153,NaN,NaN,-27.100182510911598,-23.09131013225575
1999-10-04T09:30:00-04:00,17.873821,18.330498,17.86114,18.330498,497123,318160.05,47.397551822257206,36.87508990069977,NaN,NaN,-20.958406815833012,-93.83229985762013,0.033070160011500815,-0.40813861960810627,-0.4412087796196071,-2356404,-2957115.4,9.401281843484824,7.558282696974926,NaN,NaN,-23.565785551109546,-23.15909233494915
1999-10-05T09:30:00-04:00,18.39393,18.774494,18.013366,18.406611,589010,344451.2,48.53355621842301,37.74689949042966,NaN,NaN,27.500168994945557,-61.55860661965524,0.0718374522368403,-0.3514119643235567,-0.423249416560397,-1767394,-2642631.8,22.451902274661705,8.286250119128496,NaN,NaN,-20.389230837889105,-22.763397835369144
1999-10-06T09:30:00-04:00,18.596897,18.825236,18.596897,18.723752,392796,332577.35,53.08036714095532,38.987065310810515,NaN,NaN,96.48584051495145,-17.968479063032678,0.11646808386478963,-0.27766431172941,-0.3941323955941996,-1374598,-2221431.8,35.792363194099565,10.066363634651026,NaN,NaN,-16.213726781078552,-21.827730541899058
1999-10-07T09:30:00-04:00,18.825236,18.91403,18.546155,18.546155,86097,332250.95,50.39538489684161,39.640674472943616,NaN,NaN,89.81353979703057,16.91855261353738,0.13059565389595318,-0.23088782822425813,-0.3614834821202113,-1460695,-1962523.6,42.35669717672648,12.371983410344873,NaN,NaN,-13.574945271692362,-20.648761217583814
1999-10-08T09:30:00-04:00,18.343188,18.95209,18.330498,18.875977,404251,344340.3,54.95266080443543,40.787980961868264,NaN,NaN,105.94022191872871,59.75627288196465,0.15694854653969886,-0.16529779894558772,-0.3222463454852866,-1056444,-1603107,49.99893040493395,15.282459167855608,NaN,NaN,-9.85597714811743,-19.106934921945758
1999-10-11T09:30:00-04:00,18.812546,18.875977,18.622268,18.67301,191163,350597.45,51.798862220241,41.92331716102216,NaN,NaN,108.96311385011892,85.74057701515504,0.15522350560194142,-0.12821696348285982,-0.28344046908480125,-1247607,-1381347.6,54.047050706004455,18.53962234033335,NaN,NaN,-7.724387788909992,-17.480856760083505
1999-10-12T09:30:00-04:00,18.647639,18.647639,18.317817,18.317817,427408,354095.55,46.74310264397681,42.70671776877127,NaN,NaN,45.42794655632553,89.32613252743104,0.12592169589165347,-0.12603834922023438,-0.25196004511188785,-1675015,-1362871.8,54.37844884172231,21.856543144311043,NaN,NaN,-7.472231593008819,-16.05105316478712
1999-10-13T09:30:00-04:00,18.190962,18.419301,17.658173,17.772338,170840,341501.2,40.24641850526357,43.1300985196098,NaN,NaN,-51.9320322137706,59.642557981686636,0.06844074205600767,-0.16640911754187826,-0.23484985959788593,-1845855,-1457123.2,52.3061211641457,25.059488102848917,NaN,NaN,-9.435730741891778,-15.1060071043735
1999-10-14T09:30:00-04:00,17.632802,17.84845,17.341032,17.746967,459679,350967,39.968170080579156,43.35378336555522,NaN,NaN,-104.27399348617378,20.825051325045767,0.029346980383757493,-0.19816613411818906,-0.22751311450194656,-2305534,-1626091,48.721424491185246,28.056302306838877,NaN,NaN,-11.05721367329463,-14.527608042790805
1999-10-15T09:30:00-04:00,17.061951,17.417145,16.947786,16.947786,466700,349217.95,32.375221313165724,43.2722808772428,NaN,NaN,-185.534134573659,-37.469819973431775,-0.0456223200166698,-0.2845410145227838,-0.238918694506114,-2772234,-1969249,42.37048220983047,30.670003196591406,NaN,NaN,-15.260223970623473,-14.632267461052614
1999-10-18T09:30:00-04:00,17.074641,17.493257,17.04927,17.493257,208038,352124.85,40.661239369216524,43.80184708647652,NaN,NaN,-126.35050496374525,-84.53254373620462,-0.05323116667583527,-0.3054576528509081,-0.2522264861750728,-2564196,-2232566.8,38.25023675258864,33.04544528373827,NaN,NaN,-15.86958719325059,-14.809027422795182
1999-10-19T09:30:00-04:00,17.924563,18.203644,17.810398,17.86114,313966,347130.2,45.51050052590905,44.77614830550179,NaN,NaN,-13.033718255847772,-96.22487669863928,-0.029432844289569826,-0.28901754153703507,-0.25958469724746525,-2250230,-2347609.8,36.57672353764992,35.34572227207816,NaN,NaN,-14.652390862973602,-14.7866507713921
1999-10-20T09:30:00-04:00,18.14022,18.216333,17.899192,18.178273,326653,354465.15,49.35294581556533,45.484616677965725,NaN,NaN,11.753122335735751,-83.487845788738,0.009631672779084888,-0.24754510627360915,-0.25717677905269404,-1923577,-2363154.2,36.345334840317484,37.63990752519049,NaN,NaN,-12.34224187271267,-14.437449500152182
1999-10-21T09:30:00-04:00,17.886511,18.267075,17.886511,18.267075,255829,353960.15,50.40751895283677,46.530250022119034,NaN,NaN,18.030590436996576,-59.02692900410394,0.04162341485583049,-0.20514751048290591,-0.2467709253387364,-1667748,-2235597,39.715555248602314,40.19375376328234,NaN,NaN,-10.194649139227183,-13.831335162877181
1999-10-22T09:30:00-04:00,18.67301,19.180429,18.571526,19.028203,1054355,396781,58.402375562782744,47.31630886072799,NaN,NaN,135.90149799438313,5.260197509504485,0.1103164250684269,-0.10887539400320279,-0.21919181907162968,-613393,-1803828.8,49.46821484704504,43.055677549250916,NaN,NaN,-5.4513693998843555,-12.63419719673535
1999-10-25T09:30:00-04:00,18.875977,18.926719,18.622268,18.863288,1729956,447589.6,56.285109192080526,47.86999121598925,NaN,NaN,102.43732162262744,51.01776282677903,0.13906274371954136,-0.04536338942220297,-0.18442613314174433,-2343349,-1759659.4,50.353057078551835,45.04861717810021,NaN,NaN,-2.4156846982330777,-11.174409696949311
1999-10-26T09:30:00-04:00,18.787175,19.015514,18.571526,18.571526,578294,455829.85,52.64859705586719,47.83915049562581,NaN,NaN,80.28446131123867,69.68139874019631,0.13285228914648947,-0.018360771708632484,-0.15121306085512196,-2921643,-1893942,47.62282669021863,45.893650284965865,NaN,NaN,-1.1022982828548749,-9.735536637792963
1999-10-27T09:30:00-04:00,18.837917,19.560993,18.787175,19.48488,332196,465400.35,61.11771848483287,48.605031466196614,NaN,NaN,142.68677902411196,95.86813007787154,0.18166205914184405,0.07586451307218312,-0.10579754606966094,-2589447,-2027116,45.0159286066123,46.083595387100566,NaN,NaN,3.123293019464386,-7.898560972470484
1999-10-28T09:30:00-04:00,20.093783,20.867592,20.093783,20.867592,2519368,555100.65,69.8959607196853,49.6724100315716,NaN,NaN,264.01180260224277,145.0643725109208,0.2919380376552066,0.2591250009993473,-0.03281303665585927,-70079,-1707582.2,51.82946247237611,46.21434767763215,NaN,NaN,10.594485924731494,-5.256697130013059
1999-10-29T09:30:00-04:00,21.057878,21.235475,20.651943,20.753427,1160037,608187.95,68.52045627096021,50.86680960662299,NaN,NaN,241.17130767969064,166.1183344479823,0.3387664168500319,0.3906449844066806,0.051878567556648714,-1230116,-1830926.8,49.29033049865346,45.87458194853565,NaN,NaN,15.559607355497002,-2.282939346368765
1999-11-01T09:30:00-05:00,20.702685,20.842221,20.448976,20.499718,460788,606371.2,65.43847045073932,52.202193021391736,NaN,NaN,179.01191777709627,181.43325367887604,0.3336947596894592,0.46899701716847275,0.13530225747901353,-1690904,-1700437.8,51.97104259577743,45.702624359539584,NaN,NaN,18.339709750014556,0.6631533816859947
1999-11-02T09:30:00-05:00,20.448976,20.905653,20.410915,20.474347,527793,603310.35,65.12301988065141,53.979093119633724,NaN,NaN,147.83007452226764,194.94237632108187,0.31017046972494733,0.5230153446351977,0.2128448749102504,-2218697,-1559848.6,54.746739312028204,45.87695422724547,NaN,NaN,20.36991161551154,3.478404557946787
1999-11-03T09:30:00-05:00,20.499718,20.626572,20.347492,20.385544,64049,586873,63.960803943367495,55.692852681261456,NaN,NaN,114.26371300563096,189.25776311738565,0.27155858586499104,0.5522931072414892,0.2807345213764981,-2282746,-1498508.4,55.94309615241009,46.39278791733297,NaN,NaN,21.63349273638159,6.071988583437473
1999-11-04T09:30:00-05:00,20.753427,20.867592,20.563141,20.626572,676462,616391.25,65.74757207969824,58.076592021728075,NaN,NaN,111.0811428932357,158.67163117558422,0.24594429612849078,0.5881648915371116,0.3422205954086208,-1606284,-1805749.4,48.96108471046874,46.86354523880713,NaN,NaN,23.21854925831215,8.521497251276713
1999-11-05T09:30:00-05:00,21.184733,21.413071,21.032507,21.133991,409671,616662.25,69.20860966244265,60.115689899815656,NaN,NaN,121.59304768903317,134.75597917745273,0.24625928445868406,0.6500447009819759,0.4037854165232918,-1196613,-1799048.8,49.11025541303574,47.63926085741049,NaN,NaN,25.672211149969108,10.971599236804199
1999-11-08T09:30:00-05:00,21.083249,21.10862,20.905653,21.016651,718464,643027.3,67.50979582108438,61.68706813518532,NaN,NaN,96.86607585734905,118.3268107935033,0.22237779518725603,0.6817576605073619,0.45937986532010583,-1915077,-1843883.4,48.09730740808551,48.462159705298745,NaN,NaN,27.167103084224685,13.285242643578554
1999-11-09T09:30:00-05:00,21.10862,21.10862,20.499718,20.613883,137829,628548.35,61.893804797974056,62.58284377678594,NaN,NaN,73.48996388207375,103.45878866546452,0.16586013752291517,0.6667050372237497,0.5008448997008346,-2052906,-1810725.2,48.93616971275305,49.36150505332986,NaN,NaN,26.773139978958472,15.2120851200614
1999-11-10T09:30:00-05:00,20.360173,20.563141,20.25869,20.29675,110978,625555.25,57.8155405539491,63.1119881768654,NaN,NaN,48.56002227423502,90.31805051918533,0.09693650762086392,0.6220155342269145,0.5250790266060505,-2163884,-1786952.8,49.565523820264836,50.065074237020035,NaN,NaN,25.207484921879946,16.639999377464047
1999-11-11T09:30:00-05:00,20.119153,20.271379,20.00498,20.182577,214196,613281.1,56.37533663228225,62.967199681829655,NaN,NaN,31.976259700117822,74.49707388056177,0.03658164037352951,0.5708060770729624,0.5342244366994329,-2378080,-1941312,45.63272058858132,49.791110361415484,NaN,NaN,23.50080073374484,17.620113856932733
1999-11-12T09:30:00-05:00,20.626572,21.083249,20.068412,21.057878,641235,622007.85,63.81689548282388,63.505184416882756,NaN,NaN,59.69648289189194,62.117760921133524,0.04782395155665087,0.5940043761452465,0.5461804245885956,-1736845,-2049358.4,43.0573916907274,49.269991405142314,NaN,NaN,24.236900602230975,18.565369106261052
1999-11-15T09:30:00-05:00,21.007136,21.10862,20.892963,21.045189,180078,620609.85,63.64739648627329,64.29081294762605,NaN,NaN,73.22925857526678,57.39039746471707,0.046574198830040325,0.6043981731261461,0.5578239742961058,-1916923,-2049727.6,43.04845143488477,48.94325031547561,NaN,NaN,24.767661342290868,19.451410854265312
1999-11-16T09:30:00-05:00,21.197414,21.742893,21.172043,21.616039,632983,636560.7,67.79192826971726,64.76754221797493,NaN,NaN,104.98317548705269,63.68903978571285,0.07469412026572697,0.6511916246282645,0.5764975043625375,-1283940,-1895934.4,47.90122334869056,49.149342797052626,NaN,NaN,26.52920510545494,20.462524318720973
1999-11-17T09:30:00-05:00,21.463813,21.527236,21.057878,21.159362,423097,641382.9,61.72876376474113,64.18417100690749,NaN,NaN,83.7267375448155,70.72238283982895,0.05400367607484624,0.6440020994560953,0.5899984233812491,-1707037,-1804565,50.59465877522473,49.06114253297039,NaN,NaN,26.115847223173493,21.270141876499906
1999-11-18T09:30:00-05:00,21.273527,21.273527,20.82954,21.09593,197691,638476,60.91383202181124,63.640840703396854,NaN,NaN,67.07650801919007,77.74243250364341,0.02877735950336313,0.625970122760453,0.5971927632570899,-1904728,-1709894.6,53.289256536474696,49.34678010710048,NaN,NaN,25.53997988626638,21.880118735037975
1999-11-19T09:30:00-05:00,21.09593,21.10862,20.753427,20.778798,240186,597767.55,56.871389623604195,63.02890635860149,NaN,NaN,43.66505252462564,74.53614643019014,-0.014225679536553182,0.5794106638363985,0.5936363433729517,-2144914,-1791508.4,50.7209802017313,49.25748993609718,NaN,NaN,23.833561007128516,22.159181916765196
1999-11-22T09:30:00-05:00,20.702685,20.702685,20.525088,20.702685,216783,522108.9,55.91234441801231,62.37100096841298,NaN,NaN,3.8221899540643256,60.654732705949655,-0.05070284074482334,0.5302577924419225,0.5809606331867458,-2361697,-1880463.2,48.005281521574446,48.77595723677906,NaN,NaN,22.161858289346657,22.159564255705405
1999-11-23T09:30:00-05:00,20.550459,20.550459,20.144524,20.372863,212102,503799.3,51.833290182921125,61.50474998552396,NaN,NaN,-70.46173247390064,25.565751113758996,-0.09725306872861739,0.45939429727597414,0.5566473660045915,-2573799,-2138435,41.127969319288596,47.7177338915561,NaN,NaN,19.518425606222188,21.78225873435066
1999-11-24T09:30:00-05:00,20.144524,20.195266,20.00498,20.131835,127852,493582.1,49.01887799418785,60.30984326513036,NaN,NaN,-147.37499057520992,-20.654594510246092,-0.14178837489113338,0.3794118973906748,0.5212002722818082,-2701651,-2337357.8,36.75529938185073,46.8458920823691,NaN,NaN,16.447215144839365,21.02010965013476
1999-11-26T09:30:00-05:00,20.271379,20.271379,19.992299,19.992299,90901,372158.75,47.4138321580655,58.753073443389134,NaN,NaN,-135.20018502836473,-61.10993311975706,-0.17592600602805114,0.30129276474674427,0.4772187707747954,-2792552,-2514922.6,33.34710352727802,45.71995266195783,NaN,NaN,13.415038549410973,19.93367092145993
1999-11-29T09:30:00-05:00,19.713218,19.738589,19.510251,19.510251,957296,362021.7,42.26515946213185,56.94988513203538,NaN,NaN,-199.22907724206198,-109.68875907309457,-0.22321436957701174,0.19820080880353075,0.4214151783805425,-3749848,-2835909.4,28.247866383156634,44.30213544589147,NaN,NaN,9.145181645164028,18.392458167703374
1999-11-30T09:30:00-05:00,19.510251,20.093783,19.510251,19.840073,142017,346083.15,46.54249144770095,55.85336274987301,NaN,NaN,-133.45328031081536,-137.1438531260705,-0.22394602584872741,0.14148264606963323,0.36542867191836065,-3607831,-3085136.2,25.04551287011003,42.59565995713126,NaN,NaN,6.719669439632302,16.72491692083608
1999-12-01T09:30:00-05:00,19.637106,19.941557,19.637106,19.687847,635323,351459.65,44.88948880943584,54.93007333955063,NaN,NaN,-122.14117851461961,-147.47974233421434,-0.22571124423704564,0.08328961662205359,0.3090008608590992,-4243154,-3419007.2,21.525073247057193,40.592770630473574,NaN,NaN,4.219237432716817,14.938391279676186
1999-12-02T09:30:00-05:00,19.878125,19.941557,19.586364,19.776642,122310,354372.7,46.092196031307736,54.19556329662388,NaN,NaN,-106.12681861122228,-139.23010794141678,-0.21213590493851942,0.043830979685949956,0.25596688462446937,-4120844,-3702845.8,19.070848011218274,38.69549401780478,NaN,NaN,2.4771830866368743,13.15821868067057
1999-12-03T09:30:00-05:00,20.322121,20.626572,20.246008,20.246008,1472280,394163.6,52.04921520034744,53.35501470501841,NaN,NaN,-20.42917817364047,-116.27590657047192,-0.1648863902212943,0.0498588968478515,0.2147452870691458,-2648564,-3674048.2,20.06663715277456,37.05329726509387,NaN,NaN,2.647800233687445,11.656730331101553
1999-12-06T09:30:00-05:00,20.144524,20.144524,19.611735,19.700529,283912,387875.65,45.725313110122194,52.0748658924362,NaN,NaN,-88.31848144283383,-94.0937874106263,-0.16339667996705018,0.010499437110333076,0.17389611707738326,-2932476,-3510573.8,25.658683768533976,35.81117100321167,NaN,NaN,0.8485985077983553,10.112711499201096
1999-12-07T09:30:00-05:00,19.637106,19.662477,19.434138,19.662477,1271632,415534.05,45.31172722870404,50.469137246649545,NaN,NaN,-110.55218327437665,-89.51356800333856,-0.15791120192522773,-0.02349288532915139,0.13441831659607634,-4204108,-3629829.2,24.32192328791872,34.12693528458511,NaN,NaN,-0.719346929040828,8.565274580880821
1999-12-08T09:30:00-05:00,19.611735,19.611735,19.19311,19.19311,732752,445280.2,40.45143185683109,48.94932782465596,NaN,NaN,-127.9670311584145,-90.67873853209753,-0.1773744159664863,-0.08729970336203152,0.09007471260445477,-4936860,-3768570.4,22.831641363676013,32.14386261233163,NaN,NaN,-3.5997953855852445,6.82740744281424
1999-12-09T09:30:00-05:00,19.408767,19.510251,19.167739,19.47219,143742,446918.4,44.27857829613335,47.76109541567897,NaN,NaN,-106.82329347002317,-90.81803350385772,-0.1632862818229766,-0.11403313967426598,0.04925314214871061,-4793118,-3903025.2,21.45936098739699,29.870298644540366,NaN,NaN,-4.875955357472426,5.155498471344717
1999-12-10T09:30:00-05:00,19.76396,19.928867,19.599045,19.814702,739896,473203.4,48.64122620131188,47.17322659980095,NaN,NaN,-54.52387152575093,-97.6369721742798,-0.12448709138924684,-0.10635572208784794,0.0181313693013989,-4053222,-4183956.8,18.902879512254387,27.597577166720587,NaN,NaN,-4.630562053681422,3.757489824912411
1999-12-13T09:30:00-05:00,19.560993,19.713218,19.47219,19.586364,367792,459531.25,46.05260072645293,46.468959193261,NaN,NaN,-70.67132617295404,-94.10754112030384,-0.1083799894085688,-0.1173436174593121,-0.008963628050743303,-4421014,-4481664.4,16.640496380931125,25.357235370960357,NaN,NaN,-5.201335020281487,2.4776577041704257
1999-12-14T09:30:00-05:00,19.307283,19.48488,19.091626,19.116997,440834,472569.05,41.198936244097844,45.709362483345046,NaN,NaN,-106.40365658637955,-93.27783578270441,-0.12247509752643294,-0.1620574999587845,-0.039582402432351546,-4861848,-4613212.4,15.743836438426683,23.544083022327364,NaN,NaN,-7.214351992928389,1.0930848902991666
1999-12-15T09:30:00-05:00,19.091626,19.180429,18.977461,19.066255,447978,463318.8,40.69954053197432,45.11512409318694,NaN,NaN,-120.70920432000666,-91.82627041502285,-0.1277666619243264,-0.19929072983775953,-0.07152406791343313,-5309826,-4687805.6,15.24228973928102,22.00743947642953,NaN,NaN,-8.980909557736432,-0.3460571737059188
1999-12-16T09:30:00-05:00,18.850607,18.95209,18.520784,18.647639,489610,466644.45,36.7425827773967,44.35289199456775,NaN,NaN,-165.8516498294204,-103.63194168690231,-0.15044859631408664,-0.25958481330604144,-0.1091362169919548,-5799436,-4889069.2,13.950909843819346,20.62199707046819,NaN,NaN,-11.740401890318626,-1.9738207046505911
1999-12-17T09:30:00-05:00,18.622268,18.888659,18.622268,18.723752,1620210,537770.4,37.924320474068296,44.04283206684892,NaN,NaN,-151.37494897182216,-123.00215717611657,-0.15092610143999372,-0.29779384379194695,-0.14686774235195324,-4179226,-4914270,13.793327831942918,19.589530031095787,NaN,NaN,-13.645609466203481,-3.6412190991581466
1999-12-20T09:30:00-05:00,18.799865,18.863288,18.444672,18.571526,1198098,585666,36.45738884393766,43.32246759515154,NaN,NaN,-153.03318477961176,-139.47452889744812,-0.15168933929092626,-0.3364794164656111,-0.18479007717468482,-5377324,-5105532,12.627534121426422,18.702531549046956,NaN,NaN,-15.665053567904168,-5.3589097375504355
1999-12-21T09:30:00-05:00,18.571526,19.2058,18.520784,18.926719,1574389,653546.3,42.08640902397687,43.122247610475895,NaN,NaN,-101.11814057485506,-138.4174256951432,-0.11986363284447141,-0.3346196182302741,-0.21475598538580268,-3802935,-4893749.4,20.627179394630957,18.63839627387365,NaN,NaN,-15.796883654613088,-6.850048868559385
1999-12-22T09:30:00-05:00,19.002832,19.053574,18.799865,18.926719,1371648,711523.6,42.08640902397687,42.83611996709512,NaN,NaN,-84.09287924706241,-131.09416068055435,-0.09167455758579937,-0.3293491823680519,-0.2376746247822525,-3802935,-4592371.2,30.39391806706773,19.44718699214861,NaN,NaN,-15.90405776123529,-8.143478710370228
1999-12-23T09:30:00-05:00,18.926719,19.281912,18.926719,19.231171,564745,733368.25,46.77365944207935,42.459294555790265,NaN,NaN,-43.49321646701647,-106.62247400807357,-0.047604209962468,-0.2971798872353375,-0.2495756772728695,-3238190,-4080122,43.18951108115522,21.098820844175798,NaN,NaN,-14.658754206741259,-9.074232352708947
1999-12-27T09:30:00-05:00,19.408767,19.459509,19.078945,19.078945,3412245,899435.45,44.820364895334876,42.394655397591166,NaN,NaN,-28.348038213831817,-82.01709185647552,-0.02492565239062644,-0.28073274276115256,-0.2558070903705261,-6650435,-4574363.8,36.26292911299161,21.856266940208485,NaN,NaN,-14.141361982044995,-9.798108014042668
1999-12-28T09:30:00-05:00,19.078945,19.104316,18.95209,19.002832,136351,858388.2,43.834678190751376,42.28915189488026,NaN,NaN,-55.57998424307984,-62.52645174916912,-0.011929737407784524,-0.27071926213025677,-0.25878952472247224,-6786786,-4856256.2,33.011089438740896,22.476921665267216,NaN,NaN,-13.972467451578988,-10.394445076547857
1999-12-29T09:30:00-05:00,18.95209,19.319965,18.95209,19.19311,125882,857581.45,46.97421130955205,42.755064712931755,NaN,NaN,-27.5779778426634,-47.81841920273079,0.011343659012844731,-0.24460995095641636,-0.2559536099692611,-6660904,-5427850,27.605420579286147,22.817905894953658,NaN,NaN,-12.963559415453412,-10.761461410677223
1999-12-30T09:30:00-05:00,19.281912,19.48488,19.155058,19.281912,286129,840121.75,48.42321644528617,43.0511102950141,NaN,NaN,4.736594069543765,-30.052524539409546,0.03333693604590193,-0.21428243991188367,-0.2476193759577856,-6374775,-5942218,23.824598145418562,22.98685140624091,NaN,NaN,-11.715808014431328,-10.897796639784952
1999-12-31T09:30:00-05:00,19.48488,19.48488,19.2058,19.294594,687425,868377.5,48.639073042408405,43.05095649794957,NaN,NaN,14.226277433683213,-18.50862575926961,0.04844115293220702,-0.1870679347925268,-0.23550908772473383,-5687350,-6432050,20.890357789433082,23.1288141403251,NaN,NaN,-10.61249973256004,-10.857039938752822
2000-01-03T09:30:00-05:00,19.256542,19.256542,18.444672,18.571526,1186396,854083.3,38.695406335031585,42.525442612848046,NaN,NaN,-102.09272563773249,-33.25756324404975,0.01137139903407075,-0.2212948389321454,-0.23266623796621616,-6873746,-6476712.2,20.640741434419596,23.414545929859994,NaN,NaN,-12.45991729387382,-11.086022418055821
2000-01-04T09:30:00-05:00,18.165591,18.190962,17.594741,17.759656,886225,884198.95,31.02575440136205,41.79878676693834,NaN,NaN,-261.2750208329783,-74.39657056202944,-0.06214978512070207,-0.31035346936709374,-0.24820368424639166,-7759971,-6671349.2,19.544701986753623,23.686036326169063,NaN,NaN,-16.868484402176463,-11.912088415787341
2000-01-05T09:30:00-05:00,17.759656,17.949934,17.429834,17.620112,717602,856497.45,29.927760761340366,41.02937392617878,NaN,NaN,-236.09582522659426,-116.10014003881561,-0.1116159910416169,-0.3877236730484128,-0.2761076820067959,-8477573,-7034683,17.65955299404507,23.858697987223632,NaN,NaN,-20.734906658326917,-13.172491021864424
2000-01-06T09:30:00-05:00,17.670854,18.508095,17.670854,18.39393,416076,840663.65,42.153308884760825,41.415854362419076,NaN,NaN,-122.7795084619971,-141.6033605451238,-0.08486887789350678,-0.3821937793736794,-0.2973249014801726,-8061497,-7372027.4,16.106226279775157,24.01264916122048,NaN,NaN,-19.9244524360597,-14.137056938178034
2000-01-07T09:30:00-05:00,18.520784,18.723752,18.317817,18.698381,467808,856866.95,46.13521088946846,42.002346534947655,NaN,NaN,-51.55347305312271,-154.75931064248496,-0.041515332792193715,-0.34921906747041476,-0.30770373467822104,-7593689,-7753295.2,14.548657182071636,24.066601257658245,NaN,NaN,-17.88206015237001,-14.672057397348317
2000-01-10T09:30:00-05:00,18.850607,18.850607,18.317817,18.368559,460911,842917.7,42.705607867884794,42.448647893801024,NaN,NaN,-54.99791700100291,-145.34034891513903,-0.03040906157670764,-0.3457150616491056,-0.31530600007239795,-8054600,-7989466,13.666985265412094,24.140847767942937,NaN,NaN,-17.376649140473994,-15.05842764636627
2000-01-11T09:30:00-05:00,18.190962,18.431982,18.064108,18.064108,476430,848349.6,39.76690547036976,42.28296906854337,NaN,NaN,-101.51820739509637,-113.38898622756267,-0.03840853963753171,-0.3633166746193126,-0.3249081349817809,-8531030,-8143677.8,13.10837483842407,23.603790299642444,NaN,NaN,-17.943525356038535,-15.470584462033736
2000-01-12T09:30:00-05:00,18.203644,18.520784,18.203644,18.419301,143372,833476.5,44.56009755548609,42.459661106508314,NaN,NaN,-59.48112935912434,-78.06604705406868,-0.015779305483995754,-0.3446322668367756,-0.32885296135277986,-8387658,-8125694.8,13.55210602239346,22.400803725022854,NaN,NaN,-16.815505886174613,-15.662716094053861
2000-01-13T09:30:00-05:00,18.749123,19.066255,18.647639,18.977461,1105226,866338.9,51.14003552456922,42.77154511240045,NaN,NaN,35.46495327502564,-46.417154706664135,0.037849994262478426,-0.28154046852468184,-0.31939046278716027,-7282432,-7969881.8,17.484039990827938,20.564698647142333,NaN,NaN,-13.57426518376399,-15.364365964012451
2000-01-14T09:30:00-05:00,19.2058,19.548303,19.19311,19.421449,732013,878459.05,55.64921817900842,43.54503463266285,NaN,NaN,110.84612330638826,-13.937235434761948,0.10072573993402778,-0.19348328786962554,-0.2942090278036533,-6550419,-7761227.8,22.563364743431123,19.58615833503087,NaN,NaN,-9.31655626845302,-14.500393150361104
2000-01-18T09:30:00-05:00,19.358025,19.358025,18.774494,18.774494,466453,820771.2,48.60952709810376,43.88609526890231,NaN,NaN,36.69643722654314,4.401635410747263,0.09624992033837448,-0.17389662738068523,-0.2701465477190597,-7016872,-7553682.2,27.353566662348754,19.182049565288576,NaN,NaN,-8.150349666029904,-13.593244081170932
2000-01-19T09:30:00-05:00,18.787175,19.155058,18.67301,18.711062,339709,777851.75,47.968801002788176,43.95713738984774,NaN,NaN,14.574801666198669,27.620237223006274,0.08681377591510242,-0.1616293278251817,-0.2484431037402841,-7356581,-7318792.4,32.44674558865252,19.527858494529035,NaN,NaN,-7.465361696342638,-12.717832311909747
2000-01-20T09:30:00-05:00,18.850607,18.850607,18.267075,18.368559,588517,728558.15,44.553905242424385,43.68075801821476,NaN,NaN,-40.217713225780194,31.472920449675097,0.0567557288553063,-0.17749844267115122,-0.23425417152645753,-7945098,-7230280.4,34.31553340204174,20.277211012859258,NaN,NaN,-8.009942417242028,-12.045276612671502
2000-01-21T09:30:00-05:00,18.470043,18.470043,18.038737,18.14022,498601,684905.8,42.38741888730847,43.23421129285048,NaN,NaN,-76.34982440148062,9.109964914373853,0.022504287216536467,-0.20612381250578693,-0.2286280997223234,-8443699,-7462533.8,31.827475307021643,21.05843369268701,NaN,NaN,-9.140893967054712,-11.630364806154818
2000-01-24T09:30:00-05:00,18.317817,18.317817,17.658173,17.810398,346976,674017.35,39.40667805716524,43.28501641586002,NaN,NaN,-107.5503353160722,-34.56932681011824,-0.019107675536177704,-0.2525126941425455,-0.2334050186063678,-8790675,-7910585,27.660840955330002,21.559869372752043,NaN,NaN,-11.031186989603077,-11.544767975218855
2000-01-25T09:30:00-05:00,17.810398,18.14022,17.785027,18.000676,231810,514995.6,41.94317401297102,44.064832102403514,NaN,NaN,-91.470907649027,-60.20279578523226,-0.02991658526891397,-0.27080075019251026,-0.2408841649235963,-8558865,-8218983.6,25.214058320198973,21.964823396569567,NaN,NaN,-11.812630388895325,-11.583034034315494
2000-01-26T09:30:00-05:00,18.14022,18.698381,18.114849,18.67301,630889,539722.5,49.92039282365863,45.49287724971197,NaN,NaN,-9.615240683875443,-65.04080425524708,0.009979756484651381,-0.22840946931778205,-0.23838922580243344,-7927976,-8333262.6,24.354361204126974,22.44302398300399,NaN,NaN,-9.929293278103,-11.346785354856566
2000-01-27T09:30:00-05:00,18.761804,18.990143,18.571526,18.875977,262726,546564.7,52.06182703017423,46.20062854581293,NaN,NaN,45.18522485450119,-47.96021663919082,0.04958908408873772,-0.17640287069151128,-0.225991954780249,-7665250,-8277293,25.690699290728944,23.127629198072118,NaN,NaN,-7.723539342443177,-10.829178781654653
2000-01-28T09:30:00-05:00,18.368559,18.571526,18.064108,18.216333,171086,540812.55,45.28444809472879,46.1398597747601,NaN,NaN,-36.625669768447885,-40.01538571258427,0.03177928802310592,-0.1862678447513666,-0.21804713277447252,-7836336,-8155820.4,28.637255974662693,24.133957683257194,NaN,NaN,-7.99410746550268,-10.424168593632942
2000-01-31T09:30:00-05:00,18.013366,18.723752,18.013366,18.723752,542081,533545.35,50.61064823362807,46.70450551517033,NaN,NaN,8.199360924828317,-16.865446464404165,0.053320719335965716,-0.15139623360451537,-0.2047169529404811,-7294255,-7856536.4,35.4306654440676,25.688506267446872,NaN,NaN,-6.444441774751544,-9.855636190935599
2000-02-01T09:30:00-05:00,18.825236,18.863288,18.546155,18.825236,332196,490835.35,51.62489619223402,47.55150485244634,NaN,NaN,59.99016437382094,13.426767940165423,0.072370148117896,-0.1142542677931111,-0.1866244159110071,-6962059,-7537175.2,41.797733388662365,27.737746163892464,NaN,NaN,-4.899843422258174,-9.147665795410251
2000-02-02T09:30:00-05:00,18.774494,18.799865,18.470043,18.63495,400064,466527.3,49.56939206823093,47.90931160335669,NaN,NaN,32.889248551782735,21.92766578729705,0.07007400947849618,-0.09903190406288687,-0.16910591354138305,-7362123,-7424004.6,43.90852886424825,29.906062081167807,NaN,NaN,-4.260811664490817,-8.449543776707475
2000-02-03T09:30:00-05:00,18.622268,18.723752,18.178273,18.520784,350425,448168.45,48.32614918221522,47.70831972175997,NaN,NaN,-12.65835994796994,10.358948826802827,0.05921733782111574,-0.09508424126498838,-0.15430157908610412,-7712548,-7433464.2,43.76565147964456,31.783320044654708,NaN,NaN,-4.102520507210801,-7.828540452493665
2000-02-04T09:30:00-05:00,18.584208,18.67301,18.216333,18.330498,216660,438197.65,46.244272150938855,47.03653786261215,NaN,NaN,-33.30086022753407,11.023910734985595,0.038571445720099296,-0.10608727193598,-0.1446587176560793,-7929208,-7452038.6,43.46656510273753,33.27640578460517,NaN,NaN,-4.568928713694402,-7.362881632665199
2000-02-07T09:30:00-05:00,18.190962,18.292446,18.013366,18.14022,91640,419389.25,44.19404012320265,46.72114593583349,NaN,NaN,-90.49745832849328,-8.715453115678724,0.01278475008769614,-0.12867778004645913,-0.14146253013415527,-8020848,-7597357.2,41.100114926326576,34.25830208917501,NaN,NaN,-5.5468498460273015,-7.103448520288357
2000-02-08T09:30:00-05:00,18.368559,18.470043,18.241704,18.343188,608841,426785.75,46.8984703099979,46.644693743491324,NaN,NaN,-37.47835005593191,-28.209156001629292,0.010194581585380502,-0.12871930315242963,-0.13891388473781013,-7412007,-7687346.8,39.660149099974504,34.77354519712658,NaN,NaN,-5.625404871695835,-6.892299427632282
2000-02-09T09:30:00-05:00,18.343188,18.343188,17.785027,17.911882,223681,414148.3,42.216583721978466,46.47774220631662,NaN,NaN,-114.873368044658,-57.76167932091744,-0.018221792604135034,-0.16169112549297893,-0.1434693328888439,-7635688,-7742059.8,38.77075088835472,35.09177501757751,NaN,NaN,-7.06606002772594,-6.917122370502804
2000-02-10T09:30:00-05:00,17.937253,17.937253,17.252238,17.417145,641851,439072.25,37.5819530419478,46.134494645933714,NaN,NaN,-189.418928423187,-93.11379301596085,-0.06534238597317685,-0.22514731535531496,-0.1598049293821381,-8277539,-7855058,36.928821254519235,35.45615687097019,NaN,NaN,-9.77511554830346,-7.325407110188612
2000-02-11T09:30:00-05:00,17.658173,17.86114,17.302979,17.455205,589010,413261.45,38.14453936203122,46.04434188199557,NaN,NaN,-161.77399139687085,-118.80841924982819,-0.08756549385140786,-0.26926179669639794,-0.18169630284499008,-7688529,-7806922.2,38.274116143138706,36.21424795581367,NaN,NaN,-11.801697419588528,-7.9648771543886
2000-02-14T09:30:00-05:00,17.480576,17.607431,17.112693,17.607431,1015310,427426.3,40.45618051036692,45.938128060381,NaN,NaN,-160.22240102814396,-132.75340778975834,-0.08553298125095271,-0.288612529408681,-0.20307954815772827,-6673219,-7537396.4,45.3084590818043,37.649562295928334,NaN,NaN,-12.854962857604358,-8.663460826276566
2000-02-15T09:30:00-05:00,17.277608,17.696225,17.150754,17.632802,373705,422788.9,40.85292334193055,45.290451668828986,NaN,NaN,-131.94453466951785,-151.6466447124755,-0.07630470609077489,-0.2984604307711969,-0.222155724680422,-6299514,-7314897.8,50.33972174533127,39.505659477442926,NaN,NaN,-13.617513507888262,-9.37118263793538
2000-02-16T09:30:00-05:00,17.58206,17.658173,17.163435,17.264919,376538,424630.35,37.002887023396035,44.21481309691626,NaN,NaN,-135.1878869125205,-155.70954848604805,-0.08797266550306321,-0.332121556559251,-0.2441488910561878,-6676052,-7122970.6,54.249454195744,41.545570542086864,NaN,NaN,-15.390054616022306,-10.231021491947798
2000-02-17T09:30:00-05:00,17.556689,17.556689,16.871673,17.04927,612166,425812.8,34.92509671031246,43.47485942660081,NaN,NaN,-144.4548603692281,-146.71673487525624,-0.10221060047191499,-0.37191214164608155,-0.26970154117416656,-7288218,-6925106.4,57.926989559920486,43.63769436960528,NaN,NaN,-17.505622976260756,-11.270250275421077
2000-02-18T09:30:00-05:00,16.973157,16.973157,16.288142,16.440367,882284,444996.95,29.83148005469201,41.990633128105365,NaN,NaN,-192.70932760442557,-152.9038021167672,-0.1421765631861815,-0.44742224515689344,-0.30524568197071195,-8170502,-7021501,55.58291167873321,45.07714052922425,NaN,NaN,-21.050854760678128,-12.667479487600655
2000-02-22T09:30:00-05:00,16.617964,16.719448,16.2374,16.592593,564868,455891.55,32.482602218258705,40.62332641567856,NaN,NaN,-162.65462862217473,-153.39024763557336,-0.14727574965970275,-0.4893403690453404,-0.34206461938563765,-7605634,-7207984,51.261243300865104,45.75310552295302,NaN,NaN,-23.197022979263952,-14.171699986409697
2000-02-23T09:30:00-05:00,16.643335,16.732129,16.364255,16.529162,392673,463934.7,31.941057749736473,39.36415967864325,NaN,NaN,-134.28803010636898,-153.85894672294359,-0.14368086318791662,-0.5216656983705334,-0.37798483518261683,-7998307,-7547742.6,44.47618521681309,45.793652405279076,NaN,NaN,-25.112146539598694,-15.734620922579554
2000-02-24T09:30:00-05:00,16.364255,16.491109,16.009062,16.186658,436030,454191.75,29.118154880278297,37.99216008564775,NaN,NaN,-143.94663440539773,-155.61069622151905,-0.15230745925904265,-0.5683691592564202,-0.4160616999973775,-8434337,-7899399.6,38.757987768013756,45.435962140162594,NaN,NaN,-27.631797202108693,-17.43421753394086
2000-02-25T09:30:00-05:00,16.313513,16.617964,15.95832,16.085174,608471,471479,28.319518448754707,36.711820535491746,NaN,NaN,-130.68020434157006,-152.8557650159874,-0.1524135505561623,-0.6065786381925804,-0.4541650876364181,-9042808,-8250317.6,34.053004197006146,44.76356493261035,NaN,NaN,-29.95496134703812,-19.222895221526183
2000-02-28T09:30:00-05:00,16.491109,16.7575,16.2374,16.605275,1226058,524227.6,37.743694792168746,36.25108158327503,NaN,NaN,-92.18779294956019,-132.75145808501435,-0.10715810917353158,-0.5881127241033326,-0.480954614929801,-7816750,-8179567.2,35.74656645890393,44.381168613508734,NaN,NaN,-29.226981688427628,-20.652050431083534
2000-02-29T09:30:00-05:00,16.808242,16.833613,16.440367,16.719448,435414,518894.25,39.62038771786093,35.73121854097954,NaN,NaN,-72.12386075542028,-114.64530451166347,-0.061504444556020776,-0.557835170624827,-0.49633072606880624,-7381336,-8134707.6,36.85386344162009,44.180719637911984,NaN,NaN,-28.072228729096054,-21.71207590222818
2000-03-01T09:30:00-05:00,16.744819,17.100012,16.643335,16.947786,1579563,581262.6,43.301514666336075,35.808713608433656,NaN,NaN,-43.734739656393714,-96.5346464216684,-0.010568497208145622,-0.5095413475789883,-0.49897285037084266,-5801773,-7695400.8,46.565392467410824,44.73747975070171,NaN,NaN,-25.997647361694398,-22.32430039643764
2000-03-02T09:30:00-05:00,16.846303,16.973157,16.554533,16.846303,600711,591294.95,42.07378748305642,36.12955892565571,NaN,NaN,-47.76555252744376,-77.2984300460776,0.019983818137576992,-0.47399307769887145,-0.49397689583644844,-6402484,-7289030.2,53.66435775982248,45.932875215366224,NaN,NaN,-24.61529838130515,-22.651585822847284
2000-03-03T09:30:00-05:00,17.201496,17.201496,16.846303,16.998528,418663,594706.85,44.61068066271079,36.59142616141853,NaN,NaN,-18.089450803643043,-54.780279338492186,0.052303969673202666,-0.4285969337449451,-0.4809009034181478,-5983821,-6677232.8,61.87616957348044,47.61873617467635,NaN,NaN,-22.721535262516536,-22.661578599942892
2000-03-06T09:30:00-05:00,16.909726,17.087322,16.668706,16.833613,1879364,677842.05,42.442065838928585,36.73327511345865,NaN,NaN,-29.64132425428196,-42.270985599436536,0.06367954570393858,-0.4013014712882246,-0.46498101699216315,-7863185,-6686519.8,61.697420700728856,48.789376290313825,NaN,NaN,-21.694575225337804,-22.523435260713594
2000-03-07T09:30:00-05:00,16.643335,16.795561,16.135916,16.326194,1254018,735960.95,36.55403419283246,36.426211602808785,NaN,NaN,-81.03390789391578,-44.05299502713564,0.039328197385376795,-0.4158207702604422,-0.45514896764581897,-9117203,-7033693.2,55.269624677678586,49.14151221405291,NaN,NaN,-22.503388799143174,-22.52057148048925
2000-03-08T09:30:00-05:00,16.059803,16.2374,15.831465,16.135916,649611,737999.45,34.61475042791207,36.25563041741707,NaN,NaN,-124.62472228442097,-60.23099155274108,0.014010003751451505,-0.4376364629565046,-0.4516464667079561,-9766814,-7826701.4,43.99474735904652,48.40903315428881,NaN,NaN,-23.762694934351916,-22.698017688183917
2000-03-09T09:30:00-05:00,15.94563,16.313513,15.882207,16.22471,385406,746085.7,36.31275264314898,36.35474869833397,NaN,NaN,-107.0798180342395,-72.09384465410024,0.007190823195824758,-0.4426579377131752,-0.44984876090899995,-9381408,-8422486.2,37.76203450964512,46.96867922212628,NaN,NaN,-24.316134491806697,-22.9291772315586
2000-03-10T09:30:00-05:00,16.186658,16.440367,16.186658,16.275452,183526,723169.45,37.31458173417154,36.889255961153935,NaN,NaN,-74.4018192621829,-83.3563183458082,0.00987915928091987,-0.43749981180785014,-0.44737897108877,-9197882,-9065298.4,32.42462391700046,45.314515810573944,NaN,NaN,-24.497696024373543,-23.15325134481788
2000-03-13T09:30:00-05:00,15.806094,16.617964,15.806094,16.440367,411888,714313.35,40.58579395135965,37.46805537066115,NaN,NaN,-71.39504797307099,-91.707063089566,0.025649433114070863,-0.4153171796961814,-0.4409666128102523,-8785994,-9249860.2,31.066887810835453,43.872061847000396,NaN,NaN,-23.749714591305725,-23.23846038003043
2000-03-14T09:30:00-05:00,16.364255,16.681387,16.338884,16.376936,286375,677866.6,39.727067613121164,38.02419893233149,NaN,NaN,-33.23772049204578,-82.14782560919201,0.03416153976645442,-0.3982646881021843,-0.4324262278686387,-9072369,-9240893.4,31.2175825893479,42.925018802181455,NaN,NaN,-23.348229803988367,-23.254141726310134
2000-03-15T09:30:00-05:00,16.465738,17.455205,16.2374,17.379092,1207336,719548.15,55.68157802462631,39.92158629978491,NaN,NaN,95.04034352189936,-38.21481244792794,0.10560356102286877,-0.30042177659005276,-0.40602533761292153,-7865033,-8860537.2,37.462785473138034,42.832504352547474,NaN,NaN,-17.574780229728614,-22.442804369655633
2000-03-16T09:30:00-05:00,17.84845,18.875977,17.721596,18.863288,2142953,807868.9,68.8377720515955,42.8157472714164,NaN,NaN,336.0939098118539,50.41993312129071,0.24326569958113659,-0.10194321313650079,-0.3452089127176374,-5722080,-8128671.6,47.36570873221853,43.78341181934836,NaN,NaN,-6.130017186453416,-20.112406200626744
2000-03-17T09:30:00-05:00,18.825236,19.231171,18.698381,18.812546,1076403,831080.75,68.0935323177369,44.98359280895698,NaN,NaN,303.42865737779357,125.98602844928601,0.31670623898632716,0.05067388601527156,-0.2660323529710556,-6798483,-7648791.8,52.65924483820939,44.99146027501303,NaN,NaN,1.8482868040419747,-16.975164342816928
2000-03-20T09:30:00-05:00,18.863288,18.875977,18.254385,18.457353,422481,808090.6,62.96201098964168,46.650851614084175,NaN,NaN,193.15077883985134,178.89519381187046,0.3258928606424544,0.1413337228320124,-0.18455913781044198,-7220964,-7335785.8,55.782961463810466,46.343538705169486,NaN,NaN,6.327689512740823,-13.646185220594393
2000-03-21T09:30:00-05:00,18.254385,19.155058,18.241704,19.129687,932907,826492.55,67.8940958340156,48.40746455463269,NaN,NaN,178.03678039727257,221.15009398973416,0.3591563904701499,0.26438635027724544,-0.09477004019290448,-6288057,-6778923.4,60.74551948702073,47.356404920855915,NaN,NaN,11.95241671389683,-9.989242087095647
2000-03-22T09:30:00-05:00,19.091626,19.383396,18.977461,19.294594,831167,848417.25,68.98501704905334,50.32969523791819,NaN,NaN,166.24862844638153,235.39175097463058,0.3725657349318559,0.3709371284719154,-0.001628606459940507,-5456890,-6297294.8,64.46065315732238,48.127568877820195,NaN,NaN,16.644139155437873,-6.184473338162287
2000-03-23T09:30:00-05:00,19.256542,20.093783,19.091626,19.966928,724992,862865.35,73.01143571635448,52.35832059889274,NaN,NaN,161.73474282839595,200.519917577939,0.4043615736768759,0.5038233606361544,0.09946178695927847,-4731898,-6099258.4,65.89014765301891,48.41428159778723,NaN,NaN,22.10107996838724,-2.1436800086552124
2000-03-24T09:30:00-05:00,20.220637,20.448976,19.865444,20.195266,660573,865470.45,74.23480781774686,54.6292307402369,NaN,NaN,155.23259427837974,170.88070495805624,0.41675851114120477,0.6204099258857845,0.2036514147445797,-4071325,-5553826.8,69.52582219142985,48.9734531328373,NaN,NaN,26.794655130802674,1.9903678684101997
2000-03-27T09:30:00-05:00,20.182577,20.182577,19.383396,19.535622,316799,820007.5,65.0597781807572,56.66535531080295,NaN,NaN,110.01615126300692,154.25377944268735,0.358727911454512,0.6520613040627197,0.2933333926082077,-4388124,-4987258.8,72.77230071529084,50.22364427838103,NaN,NaN,27.550529240852107,5.641819493044758
2000-03-28T09:30:00-05:00,19.332654,19.916186,19.332654,19.687847,371734,816823.5,66.10101061479136,58.914373895580034,NaN,NaN,94.11970044950763,137.47036345313435,0.3105907252488692,0.6815717991692942,0.370981073920425,-4016390,-4532925.4,75.06620952451976,52.44303443305769,NaN,NaN,28.482372744822527,8.904755671870154
2000-03-29T09:30:00-05:00,19.890815,19.890815,19.345336,19.535622,237230,749706.85,64.0456118448241,60.89529240998541,NaN,NaN,81.68695865047454,120.55802949395294,0.2510407829515294,0.6847820526098367,0.43374126965830734,-4253620,-4292271.4,76.20953840900356,55.1892847115833,NaN,NaN,28.56898070453414,11.713930676536437
2000-03-30T09:30:00-05:00,19.713218,19.789331,19.408767,19.573674,512027,745272.65,64.3440785190153,62.82597075175996,NaN,NaN,74.12151587785813,103.0353841038454,0.19903011350813976,0.682528911543482,0.4834987980353423,-3741593,-4094210.4,77.13866527570556,58.383144808633666,NaN,NaN,28.725877583296146,14.14420880607354
2000-03-31T09:30:00-05:00,19.408767,19.840073,19.281912,19.700529,1534728,801075.9,65.37597534569308,64.59669799421235,NaN,NaN,68.68784352402047,85.72643395297354,0.15968496957706257,0.6831050100066705,0.5234200404296079,-2206865,-3721318.4,78.81610436846245,61.79380313417845,NaN,NaN,29.149446934470703,16.28781425298742
2000-04-03T09:30:00-04:00,20.119153,20.651943,20.01767,20.651943,540234,734119.4,71.93594299338667,66.8973319499456,NaN,NaN,100.60779280609978,83.8447622615921,0.18259834383794527,0.7516679702270395,0.5690696263890942,-1666631,-3177019.8,81.00680050344255,65.35017584232807,NaN,NaN,31.676252578989,18.48616258527336
2000-04-04T09:30:00-04:00,20.702685,20.804169,19.066255,19.827384,1568970,749867,61.12676975631626,67.28627421649487,NaN,NaN,70.37294493973643,79.09541115963785,0.12957836778760734,0.7310425861236034,0.6014642183359961,-3235601,-3020862,81.5948669798634,68.50246737852274,NaN,NaN,30.15915034344404,20.153732265012028
2000-04-05T09:30:00-04:00,19.738589,20.043041,19.599045,19.675158,345005,734636.7,59.35361954755512,66.60883475192057,NaN,NaN,59.69051913296729,74.6961232561364,0.07435561964788806,0.6944087428958561,0.620053123247968,-3580606,-2886259.2,82.10907193542016,70.98413617875141,NaN,NaN,28.383347512100315,21.32939158602464
2000-04-06T09:30:00-04:00,19.928867,19.941557,19.700529,19.890815,343281,732530.45,61.076234968631994,66.1075992269845,NaN,NaN,60.49495664197957,71.97081140896069,0.04395504646654069,0.6749969313311439,0.6310418848646032,-3237325,-2785405.6,82.50350236616569,73.11586885931972,NaN,NaN,27.485734146212614,22.208869094622923
2000-04-07T09:30:00-04:00,20.01767,20.01767,19.434138,19.48488,783869,762547.6,56.244284525503964,65.62776162240324,NaN,NaN,42.959971401473396,66.82523698445127,-0.009062551785446682,0.6197136951327948,0.6287762469182415,-4021194,-3148271.4,76.0104326606162,74.56068823052013,NaN,NaN,25.184485159686897,22.633957103917776
2000-04-10T09:30:00-04:00,19.535622,20.131835,19.345336,20.043041,179215,750913.95,60.83268852152799,65.12337538579699,NaN,NaN,54.5121152642774,57.60610147608679,-0.011929783274688743,0.6138640178248806,0.6257938010995694,-3841979,-3583341,68.99883742641411,75.1502109404768,NaN,NaN,24.67222153403258,22.92513773679132
2000-04-11T09:30:00-04:00,20.119153,20.207948,19.76396,20.169895,162464,744718.4,61.81279683470783,64.61107394191517,NaN,NaN,74.68148953763676,58.46781039566686,-0.01071124617753072,0.612404743377656,0.6231159895551868,-3679515,-3672123.8,67.62787931972747,75.37644138064859,NaN,NaN,24.563755573617257,23.159225999195026
2000-04-12T09:30:00-04:00,20.29675,20.943705,20.29675,20.385544,1093771,739040.15,63.48559117607465,63.93065647475231,NaN,NaN,154.94527382722882,77.51876133451917,-0.0013046036576882525,0.6214852349830764,0.6227898386407646,-2585744,-3473151.4,69.10923633903812,75.60637628679282,NaN,NaN,24.975737018242867,23.418727573344718
2000-04-13T09:30:00-04:00,20.068412,20.220637,19.802013,19.852755,790890,671437,56.85864163783217,62.68950174761555,NaN,NaN,53.86659743704615,76.19308949353248,-0.035019518250233084,0.5790154408279733,0.6140349590782064,-3376634,-3501013.2,68.63560647340425,75.542789449791,NaN,NaN,23.269683263525046,23.397435529084763
2000-04-14T09:30:00-04:00,18.926719,19.256542,17.962624,18.241704,1045857,669909.7,42.43434312198654,61.07339924341765,NaN,NaN,-208.47954160793407,25.905186891651,-0.16272714316079018,0.41062603012721866,0.5733531732880088,-4422491,-3581272.6,67.20675420417138,75.14525041328247,NaN,NaN,16.15131912144786,22.36227604227949
2000-04-17T09:30:00-04:00,18.67301,18.698381,18.064108,18.39393,498601,673715.7,43.882971921085634,59.486396479581515,NaN,NaN,-220.64482219132427,-29.126200599469332,-0.22975382635362673,0.28616089034597536,0.5159147166996021,-3923890,-3597654.8,66.90060797385176,74.56199315966332,NaN,NaN,11.232070052376056,20.77224661515043
2000-04-18T09:30:00-04:00,18.317817,19.281912,18.317817,19.129687,910121,672576.4,50.38219505963728,58.510438137782465,NaN,NaN,-130.82435377151904,-70.22736926130048,-0.21746998074381507,0.24407724076983328,0.46154722151364835,-3013769,-3464505.6,68.16974111993574,73.98772192472988,NaN,NaN,9.356407015279869,19.14141238659749
2000-04-19T09:30:00-04:00,19.002832,19.155058,18.622268,18.875977,218754,641955.75,48.30468146899009,57.36476691992352,NaN,NaN,-125.47557747485588,-126.31153952171744,-0.21876958595464135,0.1880852390703467,0.40685482502498804,-3232523,-3593861.4,65.54050854050038,73.15928215792952,NaN,NaN,7.1813728184504075,17.43283530543362
2000-04-20T09:30:00-04:00,18.888659,19.231171,18.774494,19.231171,175151,614463.7,51.33045745525921,56.361515642035386,NaN,NaN,-81.33597750307511,-153.35205450974166,-0.18915745662385897,0.17040800424516434,0.3595654608690233,-3057372,-3530009,66.23283036553093,72.26047687200585,NaN,NaN,6.40252386186198,15.85707652778053
2000-04-24T09:30:00-04:00,19.129687,19.687847,19.028203,19.687847,196583,591264.2,54.9790662851716,55.15031016287717,NaN,NaN,-15.751126743629365,-114.80637153688073,-0.13481529542764753,0.19104634158446387,0.3258616370121114,-2860789,-3217668.6,69.46458651482978,71.43603301567637,NaN,NaN,6.941512892665519,14.583424579906957
2000-04-25T09:30:00-04:00,19.687847,20.372863,19.687847,20.29675,252872,588067.85,59.35437276013667,55.02371037743577,NaN,NaN,82.11639070554514,-54.25412895750685,-0.05779949240600585,0.2536122715046041,0.31141176391060993,-2607917,-2954474,71.90470552541734,70.74387862607308,NaN,NaN,8.848058937090084,13.764086630933118
2000-04-26T09:30:00-04:00,20.28406,20.28406,19.802013,19.890815,939312,616446.75,55.48315003028199,54.74724826905912,NaN,NaN,58.03838549082784,-16.48158110503748,-0.03524243918515774,0.26735871492916274,0.3026011541143205,-3547229,-3061166,69.48082216598438,69.84186078539909,NaN,NaN,9.169490094208994,13.107715697115387
2000-04-27T09:30:00-04:00,19.281912,19.662477,19.142368,19.48488,170347,613102.6,51.84181749614424,54.08764702102428,NaN,NaN,-24.540888598571815,3.7053566702193357,-0.047921228654024595,0.24269961829678977,0.29062084695081436,-3717576,-3158176.6,67.26064589658972,68.75308532328653,NaN,NaN,8.274732264267666,12.417289492422855
2000-04-28T09:30:00-04:00,19.48488,19.890815,18.926719,19.890815,436399,609321.2,55.020851302446246,54.00025893366301,NaN,NaN,-3.8981431170809593,19.192923547418157,-0.030099649697213515,0.2529962848292975,0.283095934526511,-3281177,-3202937.6,66.20939256725387,68.05301103090349,NaN,NaN,8.532435896293952,11.862310407261583
2000-05-01T09:30:00-04:00,18.977461,19.713218,18.95209,19.44682,117136,538441.6,51.05132790795119,53.301590318407534,NaN,NaN,-30.453892286789056,16.252370438786222,-0.04826721113754806,0.2227619206045759,0.27102913174212395,-3398313,-3310442.4,63.63682031681833,67.67000980878952,NaN,NaN,7.503029520149089,11.239555994816941
2000-05-02T09:30:00-04:00,19.231171,19.434138,19.19311,19.256542,179585,520409.15,49.406243901835765,52.415407966059526,NaN,NaN,-34.937211984224305,-7.1583500991676745,-0.07173805801366673,0.18135655922504057,0.2530946172387073,-3577898,-3504438.6,59.1690329157029,67.06580649421633,NaN,NaN,6.166974419046327,10.514901483992567
2000-05-03T09:30:00-04:00,19.307283,19.47219,18.749123,18.91403,425560,463238.65,46.50142415677104,51.202253178966416,NaN,NaN,-65.22247919781238,-31.810523036895717,-0.10685423357052609,0.1195268252755497,0.2263810588460758,-4003458,-3595684.4,57.137112652842085,66.21065480234519,NaN,NaN,4.1684262624865305,9.608262166634562
2000-05-04T09:30:00-04:00,18.774494,18.825236,18.495413,18.622268,180940,455035.4,44.121696947323535,50.292471415358655,NaN,NaN,-109.56257191351298,-48.81485969988395,-0.14394633873610824,0.04644813542594051,0.19039447416204874,-4184398,-3689048.8,55.05380854970828,65.24052637922405,NaN,NaN,1.7836147400728797,8.490455391411464
2000-05-05T09:30:00-04:00,18.419301,18.799865,18.39393,18.749123,74519,441597.3,45.429323720507846,50.506398600967316,NaN,NaN,-97.3769315689363,-67.51061739025502,-0.15328924705805283,-0.001217084660517287,0.15207216239753554,-4109879,-3854789.2,51.46632983113809,64.1162103525788,NaN,NaN,0.1857552014016846,7.304069649981495
2000-05-08T09:30:00-04:00,18.546155,19.129687,18.546155,19.116997,49268,404867.25,49.14589765178281,50.88232186744568,NaN,NaN,-53.395318238960876,-72.09890258068938,-0.12901907898008294,-0.009201686327568126,0.11981739265251481,-4060611,-3987248.8,48.733162025785845,62.818535642002665,NaN,NaN,-0.1360996934078334,6.241188315211591
2000-05-09T09:30:00-04:00,19.231171,19.459509,18.850607,19.066255,701836,430998.3,48.6536854749421,50.75885689711031,NaN,NaN,-23.65316948464753,-69.84209408077403,-0.11137420270116857,-0.01940036072394591,0.09197384197722266,-4762447,-4224158.6,44.21089054097101,61.107189172076616,NaN,NaN,-0.5358646664123113,5.27303788926532
2000-05-10T09:30:00-04:00,19.015514,19.028203,18.546155,18.558837,348577,440303.95,43.91693924699718,50.445446738396534,NaN,NaN,-73.98041516795911,-71.59368127480337,-0.12769705564493933,-0.06764747757895151,0.060049578065987826,-5111024,-4445671.8,40.432841658534215,59.31378439479332,NaN,NaN,-2.2451151320619345,4.199016029075712
2000-05-11T09:30:00-04:00,18.799865,19.218481,18.799865,19.116997,294012,400316,49.71616830552815,50.3301403705586,NaN,NaN,-18.499069386221002,-53.38098076934498,-0.09616080628190288,-0.060151429786390764,0.036009376495512106,-4817012,-4572194.6,38.413649080373254,57.32670001728206,NaN,NaN,-2.0501990533576304,3.30627101729952
2000-05-12T09:30:00-04:00,19.078945,19.560993,19.028203,19.332654,611551,391349.05,51.79041992109182,50.10237991598147,NaN,NaN,34.46523016277608,-27.0125484230025,-0.0579191524623312,-0.036389564082401904,0.021529588379929302,-4205461,-4591311,38.10402386976335,55.086659828348736,NaN,NaN,-1.2811650482869352,2.6509230079300266
2000-05-15T09:30:00-04:00,19.434138,20.220637,19.434138,20.195266,493551,363733.75,59.06438215512918,50.08166630133808,NaN,NaN,134.44883545392076,10.556282315573842,0.02393979444022247,0.05145433143020739,0.02751453698998492,-3711910,-4521570.8,40.00394345077807,52.80803396587451,NaN,NaN,1.7483357185552975,2.5219819665907797
2000-05-16T09:30:00-04:00,20.207948,20.385544,19.916186,20.081093,217399,349673.65,57.82085631822568,50.248645321905485,NaN,NaN,148.16433836494392,44.91978388549213,0.06645533399148892,0.11058370447934607,0.04412837048785715,-3929309,-4354943.2,44.39561899206541,51.016233739166005,NaN,NaN,3.8187745481888746,2.7072380496762216
2000-05-17T09:30:00-04:00,19.700529,20.01767,19.687847,19.738589,118122,310073.7,54.13852798578305,50.4126960711654,NaN,NaN,83.41500803487294,76.39886852605855,0.06735943704070226,0.12832766678873497,0.06096822974803272,-4047431,-4142224.6,49.47974478191603,49.746169373832174,NaN,NaN,4.477973291484786,2.9602002270774452
2000-05-18T09:30:00-04:00,19.865444,20.372863,19.865444,19.992299,284158,313343.9,56.35581055718817,50.50805030364696,NaN,NaN,113.19459263622835,102.73760093054841,0.08003036209507162,0.16100618236687225,0.08097582027180063,-3763273,-3931476.8,53.97018362646813,48.87194016377605,NaN,NaN,5.687054740829222,3.3497508718991273
2000-05-19T09:30:00-04:00,20.01767,20.01767,19.48488,19.637106,182418,313707.25,52.52697314452616,50.613453534830896,NaN,NaN,48.163718908994426,105.47729867979209,0.06037110005672916,0.15643969534271207,0.09606859528598291,-3945691,-3879522.8,55.031326712360844,48.25726204917195,NaN,NaN,5.594850517829032,3.6704793927462567
2000-05-22T09:30:00-04:00,19.7259,19.890815,19.383396,19.890815,179954,312875.8,54.88477606008048,51.00477726041981,NaN,NaN,46.01186453311202,87.78990449563034,0.06019957927498332,0.17131806937971206,0.11111849010472874,-3765737,-3890288.2,54.749675180449564,47.941593639510984,NaN,NaN,6.205091635838576,4.032566856045159
2000-05-23T09:30:00-04:00,19.789331,20.093783,19.713218,20.01767,203850,310424.7,56.05988509442289,51.68752447025208,NaN,NaN,84.17451123555739,74.99193906975304,0.06401885563116486,0.1911420596436848,0.12712320401251995,-3561887,-3816803.8,56.39039328192167,47.8882565415881,NaN,NaN,7.044865541496975,4.462895239681133
2000-05-24T09:30:00-04:00,19.903496,20.448976,19.903496,20.271379,332811,280099.65,58.39400889419137,52.706975323599785,NaN,NaN,122.34512512227202,82.77796248723284,0.07808888754543084,0.2247343134443085,0.14664542589887766,-3229076,-3653132.8,59.87968935936966,48.23296231370677,NaN,NaN,8.424686394180538,5.028865404609619
2000-05-25T09:30:00-04:00,20.233319,20.322121,19.560993,19.76396,533090,298236.8,52.39885878092358,53.204799256486616,NaN,NaN,63.93657130342314,72.9263582206718,0.04909492893410794,0.2080140870665126,0.15891915813240465,-3762166,-3652911.4,59.88436520198847,48.834250554481805,NaN,NaN,7.9084148024799825,5.440229604305386
2000-05-26T09:30:00-04:00,19.586364,19.865444,19.48488,19.687847,645054,308669.55,51.5440148900527,53.37609334493446,NaN,NaN,32.235878104157116,69.74079005970434,0.02204225060675169,0.18647197139084426,0.16442972078409257,-4407220,-3745217.2,56.90657495605661,49.41806576378685,NaN,NaN,7.242050615608231,5.697632605920078
2000-05-30T09:30:00-04:00,20.055722,20.144524,19.840073,20.093783,315567,318591.1,55.69543663750218,53.87907557083161,NaN,NaN,75.38740425460317,75.61589800400256,0.028337477530706312,0.19985156769747547,0.17151409016676916,-4091653,-3810400.4,54.83302626347134,50.17678974396544,NaN,NaN,7.849762896116798,6.0050797902338955
2000-05-31T09:30:00-04:00,20.119153,20.372863,19.992299,20.334802,152117,317217.7,57.996423281397185,54.88475300186018,NaN,NaN,94.59757587148216,77.70051093118752,0.044615314704984976,0.2272832335480004,0.18266791884301542,-3939536,-3885930.2,52.448236904346224,51.03503226152345,NaN,NaN,9.028823007642057,6.43704310700649
2000-06-01T09:30:00-04:00,20.436286,21.045189,20.398234,21.007136,581373,325008.35,63.66539801698026,55.88112655267819,NaN,NaN,158.2894770189519,84.88938131052349,0.09372057580889429,0.29981863860413327,0.20609806279523898,-3358163,-3911747.6,51.621781076303485,51.97847026123275,NaN,NaN,11.865201416033898,7.212494294010405
2000-06-02T09:30:00-04:00,22.021974,22.047345,21.565297,21.869748,1363149,384118.8,69.37614825427163,57.13725000504818,NaN,NaN,260.18899465055665,124.1398659799502,0.17275674061524965,0.42204398856430103,0.24928724794905138,-1995014,-3558317.2,60.741791118746804,53.595453636160144,NaN,NaN,16.39104921396927,8.5237164254331
2000-06-05T09:30:00-04:00,21.819006,21.819006,21.159362,21.375011,214320,391108.85,63.237264449980856,57.435313026109,NaN,NaN,189.120946638767,155.5168796868722,0.17939321992191776,0.47352877285144857,0.2941355529295308,-2209334,-3118740,68.6561206259986,55.64203772010446,NaN,NaN,18.135842286971567,9.896877262795739
2000-06-06T09:30:00-04:00,21.210104,21.62872,20.702685,20.905653,292904,403290.65,57.99427626814584,57.447700165389016,NaN,NaN,125.74622107811494,165.5886430515745,0.14151383881516433,0.47102785144848625,0.3295140126333219,-2502238,-2800857,72.90935927077095,57.67873345429772,NaN,NaN,17.837381494647005,11.031235010203062
2000-06-07T09:30:00-04:00,20.842221,21.362329,20.842221,21.210104,116028,374000.25,60.293920610617555,57.88737106716291,NaN,NaN,115.19596196541538,169.70832027036118,0.12677862252425004,0.48798729078863445,0.3612086682643844,-2386210,-2490191.8,76.29483683859671,59.594097172632054,NaN,NaN,18.33791234734015,12.075046058365503
2000-06-08T09:30:00-04:00,21.235475,21.235475,20.728056,20.854911,305713,371857.05,56.4135993010548,57.89149883458195,NaN,NaN,79.94333043312287,154.03909095319537,0.08493627159292977,0.46737900775554664,0.38244273616261687,-2691923,-2356943.8,77.5885088780357,61.281120404886885,NaN,NaN,17.50822023290631,12.851213797585618
2000-06-09T09:30:00-04:00,21.057878,21.10862,20.398234,20.499718,279601,371136.5,52.75714513580131,57.90793969110161,NaN,NaN,40.25034323350576,110.05136066978517,0.028103552054693226,0.4175721762309834,0.3894686241762902,-2971524,-2552245.8,71.43499823502135,62.452811227934056,NaN,NaN,15.655640596841112,13.25184619747926
2000-06-12T09:30:00-04:00,20.550459,20.728056,20.525088,20.677314,104696,345793.75,54.35033446597262,57.86976529152248,NaN,NaN,30.498061748751624,78.3267836917821,-0.0012082794369959737,0.3879582748800452,0.38916655431704117,-2866828,-2683744.6,67.55033952842544,63.36714439564662,NaN,NaN,14.627532089292632,13.448372753452599
2000-06-13T09:30:00-04:00,20.499718,20.905653,20.398234,20.651943,687178,355475.1,54.0698071447905,57.72761686654873,NaN,NaN,27.513316360407252,58.68020274824056,-0.02468410268584309,0.3583114259597373,0.3829955286455804,-3554006,-2894098.2,61.76416842554908,63.75098547733429,NaN,NaN,13.71782816065496,13.486866383052936
2000-06-14T09:30:00-04:00,20.854911,21.235475,20.753427,21.007136,289208,359065.55,57.385978478407786,57.65561469399277,NaN,NaN,63.87819252938221,48.41664886103392,-0.018928422107476084,0.3593350010112353,0.37826342311871136,-3264798,-3069815.8,57.34529535396266,63.56995733409094,NaN,NaN,13.88758712537686,13.544112203384925
2000-06-15T09:30:00-04:00,20.702685,20.804169,20.169895,20.512399,1172971,411808,51.778322711408364,57.61129068902739,NaN,NaN,-1.845088434465738,32.0589650875162,-0.0493501288310122,0.3165757620799461,0.3659258909109583,-4437769,-3418985,49.731338294221636,62.84474112639331,NaN,NaN,12.351938276150117,13.373801642351381
2000-06-16T09:30:00-04:00,20.144524,20.220637,19.332654,19.48488,1356744,465437.3,42.49131370576328,56.964669175863854,NaN,NaN,-101.49474002524923,3.7099484357652246,-0.13474078854497984,0.19749990522973349,0.3322406937747133,-5794513,-3983582.8,40.39235251180973,61.665153808947096,NaN,NaN,7.77935174502582,12.574594514162015
2000-06-19T09:30:00-04:00,19.383396,20.093783,19.383396,19.992299,846317,498632.25,47.49920944942087,56.379224376715186,NaN,NaN,-85.14450391821657,-19.41856469762841,-0.15184534480687156,0.14243401276612389,0.29427935757299545,-4948196,-4399856.4,35.151123367045045,60.259303602059504,NaN,NaN,5.620434366120338,11.581143064441775
2000-06-20T09:30:00-04:00,20.081093,20.093783,19.687847,19.738589,785593,528914.2,45.37174244196648,55.47746145961299,NaN,NaN,-84.7080747376271,-41.862842917235284,-0.17348023363138254,0.07742906553376727,0.2509092991651498,-5733789,-4835813,30.663604607637083,58.70325843800885,NaN,NaN,3.191544329707135,10.382628959479684
2000-06-21T09:30:00-04:00,19.586364,19.76396,19.383396,19.586364,457339,541588.65,44.09558390265163,54.0796175943038,NaN,NaN,-111.79440541169512,-76.99736250545075,-0.1899485783604506,0.013473576214586558,0.20342215457503715,-6191128,-5421079,25.885846468560928,56.86497739459867,NaN,NaN,0.8405305807139415,9.019472048227435
2000-06-22T09:30:00-04:00,19.383396,19.573674,19.180429,19.573674,470765,548486.35,43.98451836168984,52.26592974483367,NaN,NaN,-114.82584173922486,-99.59351316640257,-0.1929776065462137,-0.03779985360772997,0.15517775293848374,-6661893,-5865903.8,22.957957624391256,54.16613214500184,NaN,NaN,-1.0750241757221293,7.577401159091783
2000-06-23T09:30:00-04:00,19.586364,19.840073,19.408767,19.434138,556616,549662.65,42.710635193887256,50.79974194082699,NaN,NaN,-96.4874744771464,-98.592060056782,-0.195079525206673,-0.08867165356985751,0.10640787163681548,-7218509,-6150703,21.297047722554353,50.78334122332725,NaN,NaN,-3.0332517363343943,6.061593602602329
2000-06-26T09:30:00-04:00,19.637106,19.865444,19.535622,19.738589,216167,528218.3,46.36092115836577,49.96878800441413,NaN,NaN,-79.9961813699614,-97.56239554713098,-0.1677113247244367,-0.1032312842687304,0.0644800404557063,-7002342,-6561532.2,19.145340662511657,46.94305417988016,NaN,NaN,-3.699868172317046,4.667099063328132
2000-06-27T09:30:00-04:00,19.941557,20.043041,19.76396,19.928867,270979,525988.9,48.566656954545884,49.131126314694725,NaN,NaN,-56.59615521090604,-91.94001164178677,-0.13021051688522814,-0.09828310565082887,0.03192741123439926,-6731363,-6761047,18.184474304601977,42.79231399888054,NaN,NaN,-3.6494018151647643,3.479027509257719
2000-06-28T09:30:00-04:00,20.01767,20.093783,19.738589,19.776642,389101,537838.1,46.90488160467841,48.451932193524975,NaN,NaN,-57.35720512434171,-81.05257158431608,-0.10988560657364721,-0.10542959698265975,0.004456009590987457,-7120464,-6946914.2,17.312751690412583,38.48690277119317,NaN,NaN,-4.059035693759857,2.4021613373980655
2000-06-29T09:30:00-04:00,19.548303,19.840073,19.48488,19.76396,92748,513406.85,46.761330212466866,48.02365969900109,NaN,NaN,-68.25497030936734,-71.73839729834458,-0.09223592167675079,-0.11083889250495105,-0.018602970828200248,-7213212,-7057178,16.798284852577083,34.58428038673287,NaN,NaN,-4.437264021723979,1.425100571809202
2000-06-30T09:30:00-04:00,19.560993,19.687847,19.002832,19.281912,776478,484073.3,41.55533917665938,47.10973146405014,NaN,NaN,-99.47947147406624,-72.33679669772854,-0.10693185916159485,-0.1522677947801938,-0.04533593561859896,-7989690,-7211414.2,16.07854416704903,30.907723575205985,NaN,NaN,-6.231693990795506,0.3312727771513866
2000-07-03T09:30:00-04:00,19.281912,19.637106,19.129687,19.637106,514860,499100.3,46.29945487899895,46.55470630220788,NaN,NaN,-78.26711193624541,-71.99098281098534,-0.08745647296248381,-0.15465652682170372,-0.06720005385921991,-7474830,-7305911.8,15.636495899977675,27.612889823379454,NaN,NaN,-6.46640732708671,-0.6398243805969129
2000-07-05T09:30:00-04:00,19.802013,20.093783,19.586364,19.852755,682005,518555.35,49.00588607388482,45.95612827331338,NaN,NaN,-28.853006910735925,-66.44235315095133,-0.056290199917857095,-0.13756280375654129,-0.08127260383868419,-6792825,-7318204.2,15.576503871681183,24.629404717502208,NaN,NaN,-5.897621728150181,-1.3909382873902367
2000-07-06T09:30:00-04:00,19.687847,20.093783,19.548303,20.00498,460911,535799.5,50.887512672205645,45.892498984798905,NaN,NaN,-18.115561903438167,-58.59402450677062,-0.023349367779425728,-0.11045931356296634,-0.08710994578354062,-6331914,-7160494.2,19.826533922247776,22.49334726236122,NaN,NaN,-4.88917736841038,-1.8906867275359713
2000-07-07T09:30:00-04:00,20.207948,20.474347,20.055722,20.347492,370256,539026.65,54.91828539864596,46.780139820004806,NaN,NaN,54.76153081123473,-33.990724282650206,0.021173800494374298,-0.060642695165572746,-0.08181649565994704,-5961658,-6910183.4,26.178613165213676,21.47808016617578,NaN,NaN,-2.8375031535127935,-2.0259462169612314
2000-07-10T09:30:00-04:00,20.448976,20.626572,20.347492,20.398234,463005,548196.85,55.500956567781195,47.351693185601974,NaN,NaN,87.78989811783626,3.463149635730292,0.051954235472297466,-0.01687370131957522,-0.06882793679187268,-5498653,-6411976,36.89533551064462,21.602666747861463,NaN,NaN,-0.9750443745743187,-1.8758173823345297
2000-07-11T09:30:00-04:00,20.525088,20.753427,20.410915,20.499718,219246,553924.35,56.70616953415113,48.16129512075802,NaN,NaN,107.45353831930359,40.607279686840094,0.07562725188308794,0.025706128061987243,-0.0499211238211007,-5279407,-5972891.4,44.537276593453065,22.59364331827689,NaN,NaN,0.9323413067501594,-1.4746518553224313
2000-07-12T09:30:00-04:00,20.931023,21.032507,20.702685,20.791479,230086,531069.75,60.05568824580186,49.30130257384018,NaN,NaN,151.78071737632305,76.73402454425188,0.10557516120488826,0.08204782768500962,-0.023527333519878634,-5049321,-5624190.6,49.742425627700655,24.29768468678687,NaN,NaN,3.5640482064978856,-0.7548375607766719
2000-07-13T09:30:00-04:00,20.892963,20.892963,20.499718,20.588512,554029,544310.8,56.765478558465325,50.21422830218129,NaN,NaN,131.34830854568608,106.62679863407675,0.10607312061198307,0.1090640672451002,0.002990946633117133,-5603350,-5478477.8,51.77898811716784,26.356329721985198,NaN,NaN,4.949343612462783,0.060045463971821644
2000-07-14T09:30:00-04:00,20.677314,21.057878,20.677314,20.931023,149038,493114.15,60.68031180654382,51.497776631656755,NaN,NaN,157.76926418349098,127.22834530852799,0.1226556876235905,0.15631055616260525,0.033654868539014754,-5454312,-5377008.6,53.20116137532243,28.6351949828972,NaN,NaN,7.311971620309906,1.0960349148772623
2000-07-17T09:30:00-04:00,20.905653,21.007136,20.525088,20.53777,169485,433751.2,54.570564327555694,52.08417971517032,NaN,NaN,105.14834998074498,130.70003568110974,0.10121619278300395,0.1601751095177697,0.05895891673476575,-5623797,-5402037.4,52.787601313492445,31.0382136008244,NaN,NaN,7.617934330577503,2.0277348314058683
2000-07-18T09:30:00-04:00,20.410915,20.57583,20.271379,20.57583,84988,395684.75,55.042366915320166,52.54673042665421,NaN,NaN,63.439548672070025,121.89723775166301,0.08436379578674377,0.16441366146819547,0.0800498656814517,-5538809,-5453917.8,51.887221264326975,33.445552669376184,NaN,NaN,8.001478511534602,2.881126785709973
2000-07-19T09:30:00-04:00,20.423605,20.626572,20.372863,20.499718,85974,360703.8,53.83821125267346,53.04196825865385,NaN,NaN,60.23431203269666,103.58795668293774,0.06379146088123447,0.15978919178299478,0.09599773090176031,-5624783,-5569010.2,49.85563080427606,35.770044034652145,NaN,NaN,7.992067692734317,3.6112612009991647
2000-07-20T09:30:00-04:00,20.525088,21.159362,20.525088,21.019818,119846,343829.15,60.23935214680258,54.00468411110639,NaN,NaN,105.10770764300632,98.33983650240178,0.07986944008832267,0.19583453101216364,0.11596509092384097,-5504937,-5549327.6,50.21463370836535,38.15692609577987,NaN,NaN,9.884642680355011,4.507458555192857
2000-07-21T09:30:00-04:00,21.057878,21.286217,20.880282,21.007136,201756,330378.7,60.02079647075577,55.323645346399,NaN,NaN,115.17785465528095,89.82155459675978,0.08389335073498433,0.22083177934257137,0.13693842860758704,-5706693,-5599803.8,49.24100896624734,40.52567358143689,NaN,NaN,11.361159351002884,5.486558668880003
2000-07-24T09:30:00-04:00,21.057878,21.311587,20.880282,21.083249,288716,316983.7,60.936816985997595,56.36917121118461,NaN,NaN,110.22136257850559,90.83615711631191,0.08562654423127075,0.24397160889667546,0.1583450646654047,-5417977,-5558639.8,50.09088728907889,42.98670153780127,NaN,NaN,12.851926018994506,6.538754004610647
2000-07-25T09:30:00-04:00,21.09593,21.210104,20.931023,21.121301,311872,321768.95,61.412828371560046,57.25538137530426,NaN,NaN,100.90386083960462,98.32901954981881,0.0832089794118954,0.26235628893027396,0.17914730951837857,-5106105,-5472099,51.913744904012944,45.5822187543964,NaN,NaN,14.229481452982592,7.637429354378067
2000-07-26T09:30:00-04:00,21.057878,21.235475,20.854911,21.019818,179092,317174.6,59.336148480720425,57.858855361626745,NaN,NaN,87.03574040709202,103.68930522469789,0.06922208462015564,0.2656749152935731,0.19645283067341748,-5285197,-5404181.8,53.35365079302611,47.97701281659486,NaN,NaN,14.876246340901597,8.671546066738571
2000-07-27T09:30:00-04:00,20.981765,21.3877,20.981765,21.10862,160616,305750.35,60.59191786613462,58.26411482359022,NaN,NaN,97.81942513325286,102.2316487227472,0.0607027471006443,0.27233126454922285,0.21162851744857855,-5124581,-5328110.6,54.97974708615481,50.03423666809065,NaN,NaN,15.758406239600026,9.683954662861636
2000-07-28T09:30:00-04:00,21.057878,21.210104,20.626572,20.626572,245975,313411.7,51.325953458785115,57.96590031580479,NaN,NaN,43.05231000480814,87.80653979265263,0.019488299075628934,0.23598889129311473,0.2165005922174858,-5370556,-5260883.2,56.425428047667346,51.42924327787798,NaN,NaN,13.947523863600008,10.293035977252831
2000-07-31T09:30:00-04:00,20.931023,21.184733,20.677314,21.09593,186359,283905.75,58.052346265966555,58.062055796648735,NaN,NaN,64.93852161354427,78.74997159966037,0.020613809150870438,0.24226785365607384,0.2216540445052034,-5184197,-5214127.2,57.44884268895723,52.35149799898543,NaN,NaN,14.333793283184072,10.870287020957294
2000-08-01T09:30:00-04:00,21.09593,21.248156,21.007136,21.121301,87698,262547.65,58.38710410568573,57.94287121521187,NaN,NaN,87.60770157921588,76.09073974758263,0.019836987457879235,0.24645027882755244,0.2266132913696732,-5096499,-5212206,57.49301993703157,52.90511187822335,NaN,NaN,14.742878306604473,11.423514347478319
2000-08-02T09:30:00-04:00,21.235475,21.3877,21.032507,21.09593,73657,232130.25,57.88958677342045,58.02316465913724,NaN,NaN,93.67006255997725,77.41760417815968,0.014625094939171773,0.2448946600436379,0.23026956510446614,-5170156,-5189197.8,58.0546697897217,53.353374854834335,NaN,NaN,14.939486636455335,11.925796103046464
2000-08-03T09:30:00-04:00,21.184733,21.717522,21.133991,21.654091,163080,217238.7,64.96294238825018,58.32906684354483,NaN,NaN,170.28485902161728,91.91069095583256,0.044112917419714404,0.28541071187910916,0.24129779445939475,-5007076,-5165696.8,58.655581500885354,53.74297629237454,NaN,NaN,17.322462764257775,12.696748483219508
2000-08-04T09:30:00-04:00,21.92049,22.45328,21.857059,22.44059,367546,217103.2,72.07966429492058,59.57971684121376,NaN,NaN,302.258519823813,143.75193291963356,0.10827550409471542,0.37664217457778904,0.2683666704830736,-4639530,-5019491.6,62.27635881678176,54.42074468546664,NaN,NaN,22.127191964852685,14.043954694881391
2000-08-07T09:30:00-04:00,22.377167,22.554763,22.047345,22.554763,691736,228539.75,72.93896792357832,60.858045484660764,NaN,NaN,268.0085564704307,184.36593989101084,0.14765499596825454,0.4529354154433918,0.30528041947513723,-3947794,-4772211,67.46596876045146,55.53351236376128,NaN,NaN,26.178311229178004,15.777434199780906
2000-08-08T09:30:00-04:00,22.554763,22.554763,22.275683,22.554763,153349,225244.9,72.93896792357832,62.22238524686826,NaN,NaN,217.6915195189461,210.38270347895687,0.16181379637863091,0.5075476649484258,0.34573386856979493,-3947794,-4542470,71.40225001038637,57.07255659276916,NaN,NaN,29.336660618775255,17.714466545351527
2000-08-09T09:30:00-04:00,22.351796,22.656247,21.971232,22.402538,437262,235603.7,69.62547448784626,62.8928225569428,NaN,NaN,154.85496377051186,222.6196837210638,0.1493390780239081,0.5324077160996801,0.38306863807577196,-4385056,-4385450,73.74072200075601,58.75299147079706,NaN,NaN,30.955308936857577,19.60601545842382
2000-08-10T09:30:00-04:00,22.554763,22.605505,22.148828,22.288365,188946,217349.55,67.16110158434158,63.40284435077035,NaN,NaN,127.45092658790273,214.05289723432088,0.12291294721045853,0.5367098220888451,0.41379687487838657,-4574002,-4298835.2,74.95720200561183,60.589862402180245,NaN,NaN,31.5712369228407,21.315332810483373
2000-08-11T09:30:00-04:00,22.377167,22.630876,22.174199,22.618187,168130,218304.15,70.41842203144519,64.0801018540166,NaN,NaN,119.89256367643765,177.57970600484583,0.11718222297330072,0.5602746535950125,0.4430924306217118,-4405872,-4252103.6,75.61360863764925,62.41291392707813,NaN,NaN,33.09606016282003,22.99829386081718
2000-08-14T09:30:00-04:00,22.542074,22.922638,22.326425,22.909957,145220,217090.9,72.97244265910673,64.90578858884138,NaN,NaN,125.1295960628126,149.00391392332216,0.12202792094232595,0.5956273317996192,0.4735994108572933,-4260652,-4314675.2,72.85982676161157,63.90906263119232,NaN,NaN,35.19867401762726,24.74120531179005
2000-08-15T09:30:00-04:00,22.783102,22.783102,22.402538,22.491332,66266,216154.8,64.383375222902,65.26630478471148,NaN,NaN,94.82036395114312,124.42968280976159,0.08763482035287484,0.5831429362983869,0.49550811594551203,-4326918,-4390500,69.55407056796273,65.06623547225921,NaN,NaN,34.28263221390182,26.104266297806017
2000-08-16T09:30:00-04:00,22.656247,22.706989,22.047345,22.224941,160986,219905.4,59.57774591530619,65.19386393108088,NaN,NaN,63.718108102057506,106.20231167607074,0.03996602492496204,0.5454656471017145,0.5054996221767525,-4487904,-4411069.6,68.64418723548094,66.0422669114968,NaN,NaN,31.958812084975758,26.940629981687408
2000-08-17T09:30:00-04:00,22.148828,22.529392,22.148828,22.516703,355598,231693,62.848492043763734,66.0169024014365,NaN,NaN,63.8106759029895,93.47426153908808,0.02200408804824916,0.5330047322370639,0.5110006441888147,-4132306,-4322730.4,70.43306926285388,67.04281271258155,NaN,NaN,31.03467916354382,27.52549415052404
2000-08-18T09:30:00-04:00,22.478651,22.478651,22.250312,22.262994,133518,228281.1,58.42166960888294,66.04328264021623,NaN,NaN,51.62678563683466,79.82110593116747,-0.011257407662202068,0.4969288846110622,0.5081862922732643,-4265824,-4294720.8,70.99804403454225,68.01061280869477,NaN,NaN,28.839220776659584,27.71316938282912
2000-08-21T09:30:00-04:00,22.262994,22.605505,22.237623,22.529392,94596,218575.1,61.489008167473706,66.26484721605823,NaN,NaN,59.40367245972299,66.67592121054955,-0.019147076296359478,0.4842524469028149,0.5033995231991744,-4171228,-4276836,71.37417807669073,69.0021241043847,NaN,NaN,27.959826971177286,27.748406181164572
2000-08-22T09:30:00-04:00,22.45328,22.909957,22.45328,22.770412,241294,215046.2,64.07150889216783,66.70641308168304,NaN,NaN,80.7981702216254,63.87148246464601,-0.012296510398635774,0.4880288852008796,0.5003253955995154,-3929934,-4197439.2,73.04546418757789,70.07289513280301,NaN,NaN,28.0335483888139,27.789140782257334
2000-08-23T09:30:00-04:00,22.656247,22.884586,22.427909,22.478651,432212,227702.2,58.92062311424161,66.27481884782529,NaN,NaN,64.67374840888777,64.06261052601205,-0.030538981558420164,0.46215166865149016,0.4926906502099103,-4362146,-4172287.6,73.57185324246517,71.13834311434444,NaN,NaN,26.459821775767306,27.599238067044475
2000-08-24T09:30:00-04:00,22.45328,22.630876,22.275683,22.44059,181925,228767.65,58.262595027612655,65.28788532873186,NaN,NaN,43.76755591984345,60.05398652938286,-0.04729283590357475,0.4335746053304419,0.48086744123401665,-4544071,-4254640.6,68.83201044303043,71.60660394479076,NaN,NaN,25.003432795187884,27.22840874249353
2000-08-25T09:30:00-04:00,22.516703,22.516703,22.136139,22.136139,105189,221728.35,53.14934627829112,63.87434092549706,NaN,NaN,11.702279159162867,52.0690852338485,-0.0791279868644198,0.38195745765349187,0.46108544451791167,-4649260,-4331327.8,64.6548469812917,71.40580953199363,NaN,NaN,22.169352179131796,26.505686376298996
2000-08-28T09:30:00-04:00,22.313735,22.706989,22.224941,22.554763,142510,219535.9,58.53765377645127,62.84567562927371,NaN,NaN,49.96523009141781,50.18139676018747,-0.0724216451992864,0.3705583880188037,0.4429800332180901,-4506750,-4398432.2,61.15738712662739,70.67403361172514,NaN,NaN,21.360896526544394,25.770716397762623
2000-08-29T09:30:00-04:00,22.605505,22.605505,22.123457,22.326425,101986,220250.3,54.833240898482444,61.78908751574771,NaN,NaN,6.864945449430697,35.39475180574853,-0.08303233998077397,0.33918960824212263,0.4222219482228966,-4608736,-4534192.6,54.709450007524566,69.31465704078003,NaN,NaN,19.520553575677482,24.877835994607604
2000-08-30T09:30:00-04:00,22.326425,22.770412,22.326425,22.529392,172071,225171,57.4130778032937,61.09280010281572,NaN,NaN,64.57711763465858,35.37542565090268,-0.07622666257505734,0.3269386200040749,0.40316528257913226,-4436665,-4549096.4,54.03591071725446,67.82027909161164,NaN,NaN,18.78189423938929,24.006987172433558
2000-08-31T09:30:00-04:00,22.504022,23.239779,22.504022,23.112924,538140,243924,63.81268866112964,60.62096200493604,NaN,NaN,249.83569682192,76.589053831318,-0.03440100013521402,0.36016403241011474,0.39456503254532876,-3898525,-4419987.2,58.77119632791048,66.61724964091601,NaN,NaN,20.238471466734424,23.46862778590511
2000-09-01T09:30:00-04:00,23.138295,23.138295,22.73236,22.73236,925271,271810.25,57.72073140629774,59.53155405830683,NaN,NaN,169.78101285321628,108.2048005701287,-0.03426600744259828,0.35173252324208093,0.3859985306846792,-4823796,-4454894.4,57.05960993494673,65.48866272472567,NaN,NaN,19.425909916888624,22.891096661759896
2000-09-05T09:30:00-04:00,22.859215,23.087553,22.71967,23.01144,566470,265546.95,60.684849109957504,59.26737362166794,NaN,NaN,165.3874723295965,131.2892490177644,-0.018093957211463896,0.3633810841703493,0.3814750413818132,-4257326,-4405009.6,58.901639903250945,64.7277748201034,NaN,NaN,19.73731569599025,22.440556523792804
2000-09-06T09:30:00-04:00,23.112924,23.392004,23.036811,23.189037,270240,271391.5,62.48719885273459,59.475191688627106,NaN,NaN,210.2627633995772,171.96881260779372,0.0008468762105269256,0.38253363664497186,0.38168676043444494,-3987086,-4280679.6,63.1450842500303,64.33498174971406,NaN,NaN,20.566762640249383,22.1728716832866
2000-09-07T09:30:00-04:00,23.036811,23.163666,22.884586,22.998751,177614,258409.1,59.34784705428705,59.225145617950204,NaN,NaN,125.29875047464158,184.1131391757903,-0.0029491443103442094,0.3780003300465147,0.3809494743568589,-4164700,-4226286.6,64.85475452548347,63.93653069704475,NaN,NaN,20.27225295866443,21.90135472262629
2000-09-08T09:30:00-04:00,22.935328,23.54423,22.935328,23.518859,2704373,384180.45,64.58512920112943,59.665392731682104,NaN,NaN,178.72162132086572,169.89032407557943,0.02454521643830815,0.4116309949047441,0.38708577846643594,-1460327,-3738647,75.7263392256379,64.2742660678373,NaN,NaN,21.728391441552812,21.876645682472937
2000-09-11T09:30:00-04:00,23.721827,24.000907,23.645714,23.988217,1599147,455731.3,68.52581886111865,60.168022066942456,NaN,NaN,244.86118566320195,184.90635863757657,0.06691579219655863,0.4707305187121342,0.4038147265155756,138820,-2746123.8,85.53448022048359,65.28571622096536,NaN,NaN,24.31353085944286,22.224772136325782
2000-09-12T09:30:00-04:00,24.051649,24.051649,23.797939,23.950165,1632773,530108.95,67.86649327608302,60.43909238007926,NaN,NaN,197.95975846852906,191.42081586536307,0.08385512030353492,0.5086336268949943,0.4247785065914593,-1493953,-2193449.2,88.35591654459733,66.37931996075245,NaN,NaN,26.126116280827706,22.782107014111773
2000-09-13T09:30:00-04:00,23.797939,24.038959,23.594972,23.797939,420757,547833.5,65.16528527949924,60.88513967759766,NaN,NaN,148.3171887288796,179.03170093122353,0.07648920676751558,0.5203900150508538,0.4439008082833382,-1914710,-1778974,89.94053535193183,67.54851154000008,NaN,NaN,26.791497841471575,23.35487713230603
2000-09-14T09:30:00-04:00,23.810621,23.899423,23.671085,23.721827,271102,553339.3,63.798001463299286,61.280525851575284,NaN,NaN,123.1095408025103,178.59385899679728,0.05895845528901589,0.5175988773946081,0.4586404221055922,-2185812,-1383196.4,91.17548109820389,69.14447372965532,NaN,NaN,26.93575589943128,23.866431241895352
2000-09-15T09:30:00-04:00,23.721827,23.721827,23.163666,23.25246,213334,546226.1,55.995409453830824,61.48381607839955,NaN,NaN,60.091665921152995,154.86786791685475,0.010744577644214826,0.4720711441608607,0.4613265665166459,-2399146,-1570960.2,85.79430961047616,70.65443534602564,NaN,NaN,24.657979803992323,23.979509607909204
2000-09-18T09:30:00-04:00,22.986069,23.024122,22.389848,22.478651,530010,566050.7,46.00576580185054,60.58868122307092,NaN,NaN,-51.68320556155149,95.55898967190406,-0.07362670418873107,0.36929318628073204,0.4429198904694631,-2929156,-2184555.4,71.03894226252005,71.36026071287512,NaN,NaN,19.09699301915488,23.282007238087157
2000-09-19T09:30:00-04:00,22.516703,22.97338,22.516703,22.960698,242156,573428.7,51.77727759850314,60.37039813021526,NaN,NaN,-27.60502645179956,50.446032687838326,-0.09592425830747242,0.3230145675851226,0.418938825892595,-2687000,-2423164.8,66.26613946106197,72.18573853098493,NaN,NaN,16.385361904904528,22.296772190489637
2000-09-20T09:30:00-04:00,22.859215,22.859215,22.19957,22.630876,221094,572418.7,47.99693930543085,59.69781680893934,NaN,NaN,-64.51595650999015,7.879403640064399,-0.1297392799488442,0.25676472595653976,0.386504005905384,-2908094,-2621841.6,62.50077762528252,72.79037188155837,NaN,NaN,12.885251650006893,20.952269256134958
2000-09-21T09:30:00-04:00,22.529392,22.529392,22.021974,22.377167,179585,559787.35,45.259514011018716,58.372590048217134,NaN,NaN,-98.1784426737755,-36.37819305519277,-0.16384753188314732,0.1816945910514498,0.34554212293459713,-3087679,-2802215,59.21128044973113,72.82180646168841,NaN,NaN,9.14485358134684,19.265495588308085
2000-09-22T09:30:00-04:00,22.301054,22.884586,22.275683,22.808473,112579,556320.05,50.434859888527896,57.85217065409072,NaN,NaN,-49.466078878413924,-58.28974201510615,-0.15226206530846687,0.15521454129901358,0.30747660660748044,-2975100,-2917405.8,57.14287271644768,72.82775380322421,NaN,NaN,7.705736255489404,17.614101397905415
2000-09-25T09:30:00-04:00,22.935328,23.328573,22.884586,23.176347,115905,556855.85,54.39525940574795,57.40291424664718,NaN,NaN,16.02599203742006,-44.747902495311834,-0.11634503651370409,0.16204531096535035,0.27839034747905445,-2859195,-2903413.6,57.3378246690193,72.7160527150648,NaN,NaN,7.82459302211774,16.215600201364317
2000-09-26T09:30:00-04:00,23.036811,23.315892,22.884586,23.024122,71193,553290,52.5250064629454,56.691329075947955,NaN,NaN,2.8618172968190856,-38.65453374558811,-0.09998661516109247,0.15340707852768887,0.25339369368878134,-2930388,-2952091.2,56.37702134779224,72.23261965061923,NaN,NaN,7.329149697777409,14.946107272280473
2000-09-27T09:30:00-04:00,23.036811,23.062182,22.745041,23.036811,411149,568748.15,52.67108685443963,56.21441763310171,NaN,NaN,-24.915180165796432,-30.734378476749367,-0.08599236958634954,0.1459032317058444,0.23189560129219394,-2519239,-2874320.2,57.599489566113164,71.71438643923564,NaN,NaN,6.979676533400725,13.808045738154796
2000-09-28T09:30:00-04:00,22.909957,23.734508,22.909957,23.620343,440587,582173.95,58.92968424442275,55.81045727905122,NaN,NaN,52.639584294741,-0.5707730830460633,-0.037587684393480064,0.18491099580034387,0.22249868019382393,-2078652,-2672514.8,60.67876931463445,70.63956001702111,NaN,NaN,8.646431807653295,13.070672319511724
2000-09-29T09:30:00-04:00,23.518859,23.874052,23.493488,23.54423,118491,561191.5,57.85502588391599,55.048257780679606,NaN,NaN,81.19432265489812,25.561307223616346,-0.012163988784789942,0.2072936942128365,0.21945768299762644,-2197143,-2516923.4,62.914986551069134,69.02388189777722,NaN,NaN,9.665902412018058,12.5842766184412
2000-10-02T09:30:00-04:00,23.518859,23.899423,23.138295,23.874052,381711,534013.5,61.160371232465245,54.56924906327834,NaN,NaN,72.9345380552994,36.94301642719222,0.02345646318660946,0.24877826198088826,0.2253217987942788,-1815432,-2308170.8,65.73090763027915,67.40780983246877,NaN,NaN,11.55082413631502,12.43664054956603
2000-10-03T09:30:00-04:00,23.797939,24.051649,23.759879,23.848681,155320,513456,60.76557652573781,54.254984152295386,NaN,NaN,101.65807469724624,56.702267907277644,0.040879712061059365,0.276421438870603,0.23554172680954363,-1970752,-2116243.6,68.12715775627214,65.84971143277879,NaN,NaN,12.9603270974695,12.51145291355224
2000-10-04T09:30:00-04:00,23.645714,23.797939,23.404686,23.54423,519294,525908.7,56.0868589537617,53.70418825875698,NaN,NaN,48.47578605917813,71.38046115227256,0.028080544325061407,0.2706424072158704,0.242561862890809,-2490046,-2110405,68.20000505904468,64.20860600141027,NaN,NaN,12.833978553196948,12.557528004930056
2000-10-05T09:30:00-04:00,23.594972,23.937475,23.594972,23.772568,306453,532350.65,58.65788997677634,53.89436543896738,NaN,NaN,70.78280053313756,75.00910439995187,0.030946852932607405,0.28124542905656824,0.25029857612396084,-2183593,-2131393.2,67.60186551092801,62.90914570858541,NaN,NaN,13.471972850621375,12.68816298288596
2000-10-06T09:30:00-04:00,23.594972,23.696456,22.529392,22.783102,2008203,497542.15,46.070331121426356,53.898977247508505,NaN,NaN,-42.83344271250116,50.20355132647202,-0.034306218417524514,0.2074158031020552,0.24172202151957972,-4191796,-2530323.8,57.31278704781617,61.928706050392286,NaN,NaN,9.871690600088897,12.285809785343522
2000-10-09T09:30:00-04:00,22.580134,22.71967,22.377167,22.427909,156305,425400.05,42.54116078960271,53.23925461830133,NaN,NaN,-103.82313385400911,14.85201694461033,-0.09827851171384733,0.11887388187727055,0.21715239359111788,-4348101,-3036857.6,47.43965239620329,60.58395697433095,NaN,NaN,5.712802097390806,11.346808687064563
2000-10-10T09:30:00-04:00,22.554763,22.554763,21.565297,21.780946,3847660,536144.4,36.98386725558334,52.45260661474079,NaN,NaN,-161.82037601870275,-37.84367319857946,-0.1764905879792255,-0.003460841382914026,0.17302974659631148,-8195761,-4281859.4,32.58253312673396,58.446939510148916,NaN,NaN,0.15049469642473237,9.747335259830301
2000-10-11T09:30:00-04:00,21.489184,21.819006,21.10862,21.819006,4429280,736570.55,37.50111699390031,51.898435399232326,NaN,NaN,-185.3250182143454,-84.60383405328416,-0.21540905279026243,-0.09623156939151656,0.11917748339874587,-3766481,-4537146.4,30.474973583523422,56.39434616256265,NaN,NaN,-3.9731390448682466,7.787267502016222
2000-10-12T09:30:00-04:00,21.64141,21.64141,20.461657,20.550459,1123332,779182.05,28.966758332619023,50.36499957381027,NaN,NaN,-224.06801433087037,-143.57399702608575,-0.310552518414089,-0.2690131646188654,0.04153935379522361,-4889813,-5078390.4,26.55336966431939,54.2093816588392,NaN,NaN,-11.151615990738453,5.081712717336982
2000-10-13T09:30:00-04:00,20.728056,21.717522,20.728056,21.616039,1250446,831037.65,41.093730668223195,49.41489037827279,NaN,NaN,-146.01132600827515,-164.20957368524054,-0.2862828034014605,-0.31631415045660205,-0.03003134705514153,-3639367,-4967904.6,28.573945269482564,52.15481884458658,NaN,NaN,-12.573104945467525,2.55959590836491
2000-10-16T09:30:00-04:00,21.577978,21.88243,21.425753,21.806317,167637,812919,42.96618141549173,48.732117160597525,NaN,NaN,-97.31944452342906,-162.90883581912453,-0.24364671110533154,-0.33458973593680597,-0.09094302483147441,-3471730,-4792630.4,31.780283634179938,50.39790900789999,NaN,NaN,-12.946747938257536,0.3444039302759889
2000-10-17T09:30:00-04:00,21.996603,21.996603,21.007136,21.210104,572998,829461.1,38.80398337251147,47.741609769031236,NaN,NaN,-109.59914352975177,-152.46458932133436,-0.2413706818490713,-0.39265637714281354,-0.15128569529374225,-4044728,-3962423.8,44.49097467452381,49.4615865156436,NaN,NaN,-14.754273586649305,-1.8125500007133386
2000-10-18T09:30:00-04:00,20.195266,21.476495,20.195266,20.969076,1687585,902785.65,37.23368305114375,46.191895398082735,NaN,NaN,-132.16715771149924,-141.83301722076513,-0.24129366188513898,-0.452902772650166,-0.211609110765027,-5732313,-4355590.2,40.630129734637386,48.0295408313581,NaN,NaN,-16.697699635512393,-3.938999948541775
2000-10-19T09:30:00-04:00,21.539926,22.123457,21.539926,21.958542,488994,918256.1,46.758837030221194,45.39931047996168,NaN,NaN,-51.15813128504894,-107.25104061160081,-0.16352176637175092,-0.41601131872971564,-0.2524895523579647,-5243319,-4426291.4,39.958614403255346,46.38979996365712,NaN,NaN,-14.931488968323864,-5.509355522796358
2000-10-20T09:30:00-04:00,22.021974,22.224941,21.92049,22.047345,466577,935956,47.52846453140076,44.425602858457076,NaN,NaN,-33.68827265675876,-84.78642994129756,-0.09823466870300002,-0.37528288823671474,-0.2770482195337147,-4776742,-4653766.4,37.79427524471338,44.39432622183099,NaN,NaN,-13.326952293532148,-6.6261550614728995
2000-10-23T09:30:00-04:00,21.971232,22.021974,21.590668,21.679462,321480,946234.75,44.649001165642524,43.274418904164555,NaN,NaN,-50.65037165246093,-75.45261536710395,-0.07311599493158083,-0.36844321319819073,-0.2953272182666099,-5098222,-4979064.8,34.884370801037775,42.01984143931425,NaN,NaN,-12.957933150218828,-7.530694788436604
2000-10-24T09:30:00-04:00,21.869748,22.504022,21.869748,22.224941,309285,958139.35,49.53138746781343,42.806170940882545,NaN,NaN,-15.526244959831669,-56.638035653119914,-0.016035598250934868,-0.3153717160802785,-0.2993361178293436,-4788937,-5127906.6,33.609284322161756,39.54907567239404,NaN,NaN,-11.033533946238869,-8.031100382408356
2000-10-25T09:30:00-04:00,22.427909,22.71967,22.123457,22.351796,533336,964248.7,50.62220621964736,42.23219352965905,NaN,NaN,1.7497322610584365,-29.854657658608375,0.03140648110693767,-0.2600780164456715,-0.2914844975526092,-4255601,-4832564.2,38.419222390990065,37.46460116382705,NaN,NaN,-9.163846128752775,-8.192921203314702
2000-10-26T09:30:00-04:00,22.148828,22.364477,21.273527,21.62872,869720,985705.35,44.692575437370245,42.13378240936932,NaN,NaN,-44.33186450734697,-28.48940430306798,0.016008265148340528,-0.27147416611718356,-0.2874824312655241,-5125321,-4808964.6,38.80076378490056,36.142313787904506,NaN,NaN,-9.429258386216837,-8.36954080087215
2000-10-27T09:30:00-04:00,22.021974,22.427909,21.831688,22.339106,1362040,1047882.8,50.79110741744007,42.7230643113577,NaN,NaN,-1.9670348314079191,-22.145156737997816,0.05347387936608683,-0.22064008205791552,-0.27411396142400235,-3763281,-4606272.4,42.117860591075825,35.762185801823975,NaN,NaN,-7.626239511779266,-8.26335490243031
2000-10-30T09:30:00-05:00,22.542074,23.366633,22.542074,23.150976,1245765,1091085.5,56.671332930054234,44.1293118595342,NaN,NaN,80.6989013561047,4.1246978637153155,0.12846410279664075,-0.1135338329282014,-0.24199793572484216,-2517516,-4090131.2,49.608000187807185,36.97829059190063,NaN,NaN,-4.0469479989314925,-7.661011059073336
2000-10-31T09:30:00-05:00,23.366633,23.493488,22.948009,23.341263,227376,1094688.3,57.9399413036674,45.58922788166042,NaN,NaN,112.84651136100086,29.79924912788182,0.18308214227693548,-0.013145257878672822,-0.1962274001556083,-2290140,-3590371.8,55.599193386491365,38.77287772068406,NaN,NaN,-0.8141593887867351,-6.682889391889535
2000-11-01T09:30:00-05:00,23.138295,23.341263,23.036811,23.239779,614137,1099430.45,56.981730593865876,47.59029732889234,NaN,NaN,112.72847287205032,51.9949972500802,0.203030698824706,0.057560973375274216,-0.1454697254494318,-2904277,-3320107,58.474472975772905,41.052956528645026,NaN,NaN,1.4628250976026238,-5.519215893390656
2000-11-02T09:30:00-05:00,23.468117,23.620343,23.25246,23.353944,71070,1087661.3,57.82669934764837,48.78550937742271,NaN,NaN,140.49772325593756,88.96091480273711,0.21350282618531177,0.12140880728220793,-0.09209401890310384,-2833207,-2861684.2,62.86696585041188,43.5024579987114,NaN,NaN,3.560915546844585,-4.222054259071336
2000-11-03T09:30:00-05:00,23.392004,23.493488,23.189037,23.290521,139061,994204.2,57.155052737022956,49.79900018610351,NaN,NaN,125.86800318203005,114.52792240542469,0.20566647768962373,0.16498907820892583,-0.0406773994806979,-2972268,-2703481.6,64.2715326227863,45.823261497897576,NaN,NaN,5.09276289048595,-2.8913660948488666
2000-11-06T09:30:00-05:00,23.518859,23.645714,23.290521,23.607653,137460,993261.95,59.67703949867841,51.289932766544,NaN,NaN,129.32554458206525,124.2532510506168,0.2105829011078512,0.2225512269041161,0.01196832579626491,-2834808,-2766940,63.23824331611758,47.16235211515426,NaN,NaN,7.124650929854774,-1.4605065198912037
2000-11-07T09:30:00-05:00,23.594972,23.721827,23.404686,23.53154,166898,809223.85,58.782712646789435,52.82914916623297,NaN,NaN,113.55219289084597,124.39438735658582,0.19765884962374342,0.2590418878259442,0.061383038202200764,-3001706,-2909253.2,60.87460938504341,48.60838637589756,NaN,NaN,8.57700707028262,-0.026576007009228908
2000-11-08T09:30:00-05:00,23.493488,23.493488,22.948009,23.112924,626454,619082.55,53.99037903128021,53.34568788059433,NaN,NaN,72.09127540161951,116.26694786249966,0.15192198842195304,0.2512855237296421,0.09936353530768903,-3628160,-3054029.8,58.4799418671368,49.93133833760338,NaN,NaN,8.545042424014168,1.1979409117083992
2000-11-09T09:30:00-05:00,23.036811,23.493488,22.833844,23.277831,601820,593006.95,55.52848855355192,53.91711816789085,NaN,NaN,65.59750076047925,101.28690336340802,0.12490910932126209,0.25549992195926663,0.13059081263800454,-3026340,-3092656.4,57.826348557667686,51.36220071710011,NaN,NaN,8.934321365825951,2.303138119439478
2000-11-10T09:30:00-05:00,23.138295,23.379315,22.909957,23.024122,519910,556480.15,52.61426045346274,54.486065259877996,NaN,NaN,50.761246076313995,86.26555194226479,0.08404833093349859,0.23565122630487778,0.1516028953713792,-3546250,-3207452.8,55.82929692124934,52.858266868543794,NaN,NaN,8.477880382834133,3.185244157067286
2000-11-13T09:30:00-05:00,22.859215,22.935328,22.136139,22.478651,4905834,793390,46.913579497851934,54.299078976309325,NaN,NaN,-7.293224446867133,58.94179813647831,0.017838814695116473,0.1739014137402748,0.15606259904515832,-8452084,-4330908,40.93121559726572,53.38126195962265,NaN,NaN,6.419669382078438,3.6473049034974503
2000-11-14T09:30:00-05:00,22.960698,23.138295,22.529392,22.605505,4580413,993760.75,48.31605757985758,54.13435407346719,NaN,NaN,10.432574194185804,38.317874397146284,-0.017922434535021764,0.13365955587638112,0.15158199041140288,-3871671,-4504901,39.187112525886214,53.436111254972374,NaN,NaN,5.086309464238082,3.8528769836032546
2000-11-15T09:30:00-05:00,22.427909,22.681618,22.174199,22.427909,1103009,964531.95,46.465277270971065,54.260975633010105,NaN,NaN,-37.91489952492121,16.31663941183814,-0.052113075003690335,0.08644064665678997,0.1385537216604803,-4974680,-4774205,36.588408973383636,53.27808591129259,NaN,NaN,3.439912496071315,3.7938820568129774
2000-11-16T09:30:00-05:00,22.326425,22.630876,22.19957,22.351796,153103,947737.4,45.658058661842375,53.89432929332456,NaN,NaN,-47.728384485011695,-6.348537637260056,-0.07693177424116131,0.04238900385902866,0.11932077810018997,-5127783,-5194493.6,32.919353612213925,52.62104969851674,NaN,NaN,1.839146351381506,3.514634098894196
2000-11-17T09:30:00-05:00,22.339106,22.681618,21.971232,22.174199,940051,971411.1,43.748271373460064,52.97125346785355,NaN,NaN,-65.77242744333675,-29.65527234119021,-0.10087641377428531,-0.006774739117666684,0.09410167465661863,-6067834,-5698810.4,29.14290107449419,51.15925690470867,NaN,NaN,-0.05571235071585968,3.0045846060927595
2000-11-20T09:30:00-05:00,21.768264,21.895119,21.362329,21.514555,373581,974016.15,37.477798380730775,51.50967183050094,NaN,NaN,-152.53392080762194,-58.703411613341174,-0.15355118768523102,-0.09783730994992013,0.05571387773531088,-6441415,-5296676.6,35.49713983780637,49.72339593694546,NaN,NaN,-3.684834518044877,2.048953302644526
2000-11-21T09:30:00-05:00,21.514555,21.692152,21.10862,21.565297,682375,992670.65,38.211450292707205,50.16893752327532,NaN,NaN,-153.26213652730408,-91.44235375763915,-0.17578700539392844,-0.1640198790070997,0.01176712638682876,-5759040,-5674150.4,32.54669203599421,47.87141158410412,NaN,NaN,-6.474657814522006,0.8312945716207358
2000-11-22T09:30:00-05:00,21.336958,21.489184,20.905653,21.045189,257060,978856.85,33.82954859770011,48.45485532685044,NaN,NaN,-162.67403877643687,-116.39418160794227,-0.21380829599536347,-0.2554932436073756,-0.04168494761201211,-6016100,-5882434.4,31.014836366879877,45.596259478137554,NaN,NaN,-10.3166644691139,-0.7612710056270691
2000-11-24T09:30:00-05:00,21.260846,21.362329,21.172043,21.197414,103957,940568.7,36.13783595077978,46.9536255564045,NaN,NaN,-143.04315674785133,-135.4571360605102,-0.21633644258693602,-0.3121055008456821,-0.0957690582587461,-5912143,-6039306.4,29.874366270738548,43.13931902441986,NaN,NaN,-12.87583300027756,-2.4919227191485676
2000-11-27T09:30:00-05:00,21.311587,21.552607,21.311587,21.489184,271225,886027.95,40.427386261862985,45.578650325203405,NaN,NaN,-110.94475084760364,-144.49160074136358,-0.18708713409724562,-0.3296279758803031,-0.1425408417830575,-5640918,-5953923.2,31.353956972702335,40.8618699998902,NaN,NaN,-13.86091175932482,-4.116064010602318
2000-11-28T09:30:00-05:00,21.413071,21.895119,21.413071,21.717522,1526475,900063.45,43.61908919709024,44.495534364510604,NaN,NaN,-79.91739028202224,-129.96829463624363,-0.14307530210628439,-0.321384969415913,-0.1783096673096286,-4114443,-5488528.8,38.91889057121717,39.29360437033119,NaN,NaN,-13.786533608857955,-5.49755966749598
2000-11-29T09:30:00-05:00,21.793635,22.250312,21.717522,22.250312,1482380,962813.65,50.30894261065267,44.23257462018007,NaN,NaN,-38.23288418532235,-106.9624441678473,-0.07236226640213053,-0.26876250031229176,-0.19640023391016123,-2632063,-4863133.4,47.320282783185654,38.49648586433467,NaN,NaN,-11.681572313005441,-6.380990045425903
2000-11-30T09:30:00-05:00,22.123457,22.491332,21.616039,22.148828,2074223,1035817.95,49.11354605201121,43.774364441498584,NaN,NaN,-32.72204704086987,-80.9720458207339,-0.02893328433596304,-0.23256683933011502,-0.20363355499415198,-4706286,-4601170.6,50.397896186999176,37.965882123572634,NaN,NaN,-10.297971956202852,-6.94055888982261
2000-12-01T09:30:00-05:00,22.301054,22.427909,21.933171,22.021974,503282,1057428.55,47.59129729527664,43.415581358771014,NaN,NaN,-23.596529330778356,-57.0827203373193,-0.006435146836474781,-0.21167748853974544,-0.20524234170327066,-5209568,-4460655.6,52.017184223198306,37.69358835942614,NaN,NaN,-9.56867171414181,-7.316003579011067
2000-12-04T09:30:00-05:00,21.92049,22.009284,21.692152,21.92049,1993422,1150146.6,46.35351267895809,43.37557658599288,NaN,NaN,-44.58594739230081,-43.81095964625874,0.0033982743747191235,-0.20099449873487174,-0.20439277310959086,-7202990,-4773070,48.245995058808916,38.21607260667922,NaN,NaN,-9.295129163495378,-7.598735805365968
2000-12-05T09:30:00-05:00,21.971232,23.036811,21.895119,22.833844,1343441,1210445.65,57.15421275063865,44.00687338390582,NaN,NaN,41.62929685603514,-19.501622218647256,0.06953505754257913,-0.11747395118136694,-0.18700900872394607,-5859549,-5122091.2,44.37538796474123,38.58666370945458,NaN,NaN,-5.5710803686239,-7.309070742974244
2000-12-06T09:30:00-05:00,23.239779,23.620343,22.326425,22.73236,1399977,1272099.6,55.80970452387261,44.674332473398785,NaN,NaN,86.57121167445207,5.459196953307628,0.10257162297295278,-0.05879448000775511,-0.1613661029807079,-7259526,-6047583.8,36.1039910791119,38.552062431292306,NaN,NaN,-2.9690000006916533,-6.689060636933874
2000-12-07T09:30:00-05:00,22.783102,23.036811,22.554763,22.783102,1007427,1291148.25,56.36245636852533,45.43893230959042,NaN,NaN,79.2338857527827,27.85038351203814,0.12261070804850382,-0.008102717920078106,-0.13071342596858193,-6252099,-6356746.4,33.83515288801175,38.61747666527787,NaN,NaN,-0.6932382244500135,-5.832514578007609
2000-12-08T09:30:00-05:00,23.290521,23.54423,23.087553,23.442746,3375170,1429815.75,62.86538438804804,46.80444038206099,NaN,NaN,149.78283736839438,62.5262568518727,0.17203199081667622,0.08432656255226334,-0.08770542826441288,-2876929,-5890218.6,39.96600468964954,39.390555494931824,NaN,NaN,3.4820934453199817,-4.50185628896081
2000-12-11T09:30:00-05:00,23.493488,23.82331,23.366633,23.633024,937095,1450675,64.50838620110781,48.735196654945064,NaN,NaN,170.32987273900545,105.50942087813397,0.20693278326231088,0.17096055081347572,-0.03597223244883516,-1939834,-4837587.4,50.998759636749206,40.49781405199917,NaN,NaN,7.434343631482683,-2.796684871754597
2000-12-12T09:30:00-05:00,23.417375,23.54423,23.163666,23.353944,348701,1222818.35,60.29469203513999,50.31257106511884,NaN,NaN,124.55810488557086,122.0951824840411,0.20047788374620887,0.21462512223392594,0.01414723848771706,-2288535,-4123384.6,56.79975982839325,42.23017603717052,NaN,NaN,9.505036407137748,-1.0392961176271192
2000-12-13T09:30:00-05:00,23.747198,23.747198,23.201718,23.366633,244866,1006041,60.4212798625525,52.21198044117972,NaN,NaN,122.81883428989886,129.34470700713047,0.18660350050508823,0.24740161411907735,0.06079811361398912,-2043669,-3080213.2,63.581441031972325,44.55636208467713,NaN,NaN,11.209573713620742,0.7105424296940037
2000-12-14T09:30:00-05:00,22.73236,22.884586,22.427909,22.6943,643329,983057,51.12120990498751,53.282221437908845,NaN,NaN,38.22896928255515,121.14372371308495,0.12466423587288089,0.21662840845509024,0.09196417258220935,-2686998,-2367193,67.35381307292906,47.233465427690746,NaN,NaN,9.879161925534115,2.0203452148140197
2000-12-15T09:30:00-05:00,22.377167,22.706989,22.186881,22.516703,597263,1005265,48.97673009442851,53.89288885452066,NaN,NaN,16.862112728859856,94.55957878517805,0.06713455407399316,0.1758823651747008,0.10874781110070764,-3284261,-2448659.4,66.50616603788293,49.74433750377507,NaN,NaN,8.124039462076805,2.8923015358515602
2000-12-18T09:30:00-05:00,22.859215,23.353944,22.757731,23.176347,1624644,1039494.65,56.30803221979638,54.799241927571096,NaN,NaN,73.49343648862862,75.19229153510267,0.06866226579411006,0.1945756433433452,0.12591337754923515,-1659617,-2392616,66.81556434226732,51.73695705885008,NaN,NaN,8.909805247442534,3.7519449232216995
2000-12-19T09:30:00-05:00,23.189037,23.594972,22.783102,22.922638,3553401,1198485.65,53.14511984220607,55.0018260155392,NaN,NaN,67.2689990760672,63.73447037320193,0.04868137257375907,0.18676509326643398,0.1380837206926749,-5213018,-2977512.6,60.53106498061473,52.68058435866645,NaN,NaN,8.541537963798605,4.436172500446972
2000-12-20T09:30:00-05:00,22.630876,22.922638,22.516703,22.706989,1652973,1247015.55,50.54615050926367,55.104154905342945,NaN,NaN,24.286586401961554,44.02802079561447,0.018584679496690903,0.16131457006353855,0.14272989056684765,-6865991,-3941977,51.86778182780562,52.78557619015263,NaN,NaN,7.425183577032132,4.863174082816281
2000-12-21T09:30:00-05:00,22.630876,23.239779,22.45328,23.239779,2455072,1356916.15,56.240027776671404,55.72192136829972,NaN,NaN,47.09399262863844,45.80102546483112,0.031446587674730825,0.1820381251602612,0.15059153748553036,-4410919,-4286761.2,49.15912387675102,52.581429022549244,NaN,NaN,8.279434656990023,5.351211307698244
2000-12-22T09:30:00-05:00,23.518859,23.569601,23.214408,23.430057,792491,1391342.85,58.095628473024924,56.56064392501877,NaN,NaN,92.40491832958719,60.9095865849766,0.04862988358926107,0.2113788919721067,0.16274900838284562,-3618428,-4353594.6,48.62899354330719,52.60878605715627,NaN,NaN,9.556310021897795,5.951939695441037
2000-12-26T09:30:00-05:00,23.594972,23.848681,23.455428,23.848681,1928264,1474194.8,61.92131722848003,56.901151387721725,NaN,NaN,123.7442464416758,70.95974857558603,0.08208263577253425,0.26535230309851343,0.18326966732597919,-1690164,-4359704,48.57742288443081,52.90893140856267,NaN,NaN,11.871442298733317,6.797582924482791
2000-12-27T09:30:00-05:00,23.620343,24.038959,23.620343,24.000907,372842,1416513.15,63.23571210383343,57.43158050057606,NaN,NaN,134.7057919877593,84.44710715792445,0.10679113846957858,0.3167585904129524,0.20996745194337382,-1317322,-3580564.8,55.114907781086316,54.266854030132265,NaN,NaN,14.159908670121466,7.849343745288316
2000-12-28T09:30:00-05:00,23.950165,24.305358,23.950165,24.241927,459309,1365359.6,65.27924676551814,58.068494100361264,NaN,NaN,154.26954464876093,110.44369880728432,0.1301468814874996,0.3726510538027483,0.24250417231524873,-858013,-2378969.2,62.940011434382384,56.345772497730174,NaN,NaN,16.6995140606986,9.113653790346927
2000-12-29T09:30:00-05:00,24.165814,24.406842,23.848681,23.950165,846564,1303976.65,60.86853168760578,57.92586176461539,NaN,NaN,128.01853380569995,126.62860704269663,0.11713286067030271,0.3889202481531271,0.2717873874828244,-1704577,-1837700.8,65.82985188399036,58.1931901544688,NaN,NaN,17.53176882609706,10.316241652596945
2001-01-02T09:30:00-05:00,24.026278,24.026278,23.049493,23.277831,1552342,1356429.65,52.12786020292966,57.04153847903124,NaN,NaN,38.7722162809991,115.902066632979,0.05745100751913118,0.3436011468817384,0.2861501393626072,-3256919,-1765399,66.2088980075928,59.27962860952906,NaN,NaN,15.448931758223011,11.049483096257811
2001-01-03T09:30:00-05:00,23.442746,24.863519,22.935328,24.533697,1574759,1335496.5,62.85713338394247,57.2245700039457,NaN,NaN,125.65212227948638,116.28364180054112,0.09456955943488532,0.4043620886562138,0.3097925292213285,-1682160,-1763798.2,66.21783322963617,59.952348138189265,NaN,NaN,17.41609786622251,11.958999491967054
2001-01-04T09:30:00-05:00,24.368781,24.88889,24.051649,24.102391,1037974,1320223.15,58.04559852140478,57.05487847957801,NaN,NaN,146.85962713362144,118.71440882971356,0.08252799543019862,0.41295252350907674,0.3304245280788781,-2720134,-2044360.6,63.070060853066245,59.915820982553115,NaN,NaN,17.23218398382686,12.71231156223274
2001-01-05T09:30:00-05:00,23.53154,24.000907,22.935328,23.594972,2139997,1357224.15,52.91386108887193,57.182924992712614,NaN,NaN,15.664681834296411,90.99343626682065,0.03525960999772415,0.37449904057603334,0.3392394305783092,-4860131,-2844784.2,55.0325254684737,59.035729010806314,NaN,NaN,15.237881128392711,13.073107214541308
2001-01-08T09:30:00-05:00,23.392004,23.594972,23.189037,23.353944,518679,1332786.75,50.62436362858345,57.30061310229511,NaN,NaN,-10.644084961818692,63.26091251331692,-0.014690290278496665,0.32087656773018836,0.335566858008685,-5378810,-3579630.8,48.87447504084227,57.77632251101769,NaN,NaN,12.888711721303675,13.046765001221646
2001-01-09T09:30:00-05:00,23.620343,23.620343,22.960698,22.960698,266052,1177330.85,47.047604234896426,56.63915396051654,NaN,NaN,-42.224402923989004,47.0615886723193,-0.07338317080633666,0.2438378945007642,0.31722106530710087,-5644862,-4057219.4,45.32470113393903,56.24126085327995,NaN,NaN,9.76205832989527,12.577521191032163
2001-01-10T09:30:00-05:00,23.01144,23.493488,22.859215,23.341263,495769,1155264.55,50.67929326764889,56.46302349090531,NaN,NaN,-30.614003960006837,15.808363424420666,-0.0849291388469956,0.21105964174835634,0.29598878059535194,-5149093,-4750606,40.70252859231203,54.82493682554405,NaN,NaN,8.381795010476647,11.97813173666709
2001-01-11T09:30:00-05:00,23.54423,23.848681,23.290521,23.392004,662174,1170938.2,51.16025584016893,56.50688815739854,NaN,NaN,14.830649226962974,-10.597432156911035,-0.08717410326883102,0.1870211515093132,0.2741952547781442,-4486919,-5103963,38.54525576145879,53.87332782080499,NaN,NaN,7.443574365210667,11.33033782645903
2001-01-12T09:30:00-05:00,23.442746,23.442746,22.783102,22.948009,549349,1186162.35,46.85461222815228,55.83650133250432,NaN,NaN,-55.38568380416935,-24.807505284604183,-0.11484590237979414,0.13063787680340155,0.2454837791831957,-5036268,-5139190.4,38.327162659915665,53.09961630531675,NaN,NaN,5.294408815068725,10.468062253403271
2001-01-16T09:30:00-05:00,23.036811,24.051649,22.859215,23.353944,867380,1197364.9,50.92147895780245,55.32406208141699,NaN,NaN,-3.257834186825899,-23.330255129605625,-0.10250184338836682,0.11735647494773715,0.21985831833610398,-4168888,-4897206,40.80486140345721,52.54074972389889,NaN,NaN,4.737509203898573,9.649411817759743
2001-01-17T09:30:00-05:00,23.671085,23.696456,23.239779,23.392004,544668,1194735.15,51.29778401276581,54.565238280294544,NaN,NaN,-9.017760348465593,-16.688926614500943,-0.08896701638613497,0.10864954785343528,0.19761656423957025,-3624220,-4493077.6,44.79381507908127,52.27049202351679,NaN,NaN,4.40281753538541,8.899898348849124
2001-01-18T09:30:00-05:00,23.315892,23.315892,22.884586,23.049493,480495,1137527.7,47.749580139213286,53.45908599710739,NaN,NaN,-79.09951846774618,-26.386029516048815,-0.09947973537066698,0.07326689502623651,0.1727466303969035,-4104715,-4284202,46.789638801777926,51.675829953566186,NaN,NaN,3.066537106496933,8.066561028513096
2001-01-19T09:30:00-05:00,23.138295,23.138295,22.73236,22.884586,667225,993218.9,46.096377796532394,52.08888107075126,NaN,NaN,-107.25529150072218,-50.80321766158584,-0.11295288939644113,0.03155551865135209,0.14450840804779322,-4771940,-4341206.2,46.29771500739136,50.4870944944954,NaN,NaN,1.4769094351319185,7.125182229458642
2001-01-22T09:30:00-05:00,22.935328,23.518859,22.935328,23.290521,291918,925166.15,50.62786208682647,51.3574046706956,NaN,NaN,-52.46815328152753,-50.21971155705747,-0.09088805642358741,0.03089833751830895,0.12178639394189636,-4480022,-4229957,47.45869233760597,49.174868812610804,NaN,NaN,1.4122379462356358,6.309047331855355
2001-01-23T09:30:00-05:00,23.303202,23.696456,23.214408,23.518859,418909,823358,53.02029198016614,51.42114979764107,NaN,NaN,-11.590899918761695,-51.88632470344463,-0.05883205006573193,0.04824633135973144,0.10707838142546337,-4061113,-4208402,47.694638542441155,47.85242170795711,NaN,NaN,2.052370485953582,5.700950639583674
2001-01-24T09:30:00-05:00,23.645714,23.937475,23.569601,23.658395,4038084,985637.65,54.47215985007175,50.82222311665031,NaN,NaN,36.59272024115161,-42.764228585521195,-0.02772724465440332,0.07241932560745923,0.10014657026186255,-23029,-3488163.8,54.97104275500606,47.049079531197826,NaN,NaN,2.9983961647337445,5.314871428890827
2001-01-25T09:30:00-05:00,23.937475,23.962846,23.54423,23.874052,1695345,973991.7,56.699427421827494,50.72606803810907,NaN,NaN,50.031356718978785,-16.938053548176203,0.00607186152022951,0.10773639716214944,0.10166453564191993,1672316,-2332757.6,63.6960810729852,47.093795261192035,NaN,NaN,4.434402873539053,5.189090206697716
2001-01-26T09:30:00-05:00,23.78525,24.000907,23.645714,23.962846,980206,1004359.9,57.618762278067564,51.0621324087659,NaN,NaN,66.07774520164664,17.728553792297564,0.03167795893445183,0.1412619843099847,0.10958402537553288,2652522,-847865.2,71.37312978400192,48.26098128372977,NaN,NaN,5.889341242455625,5.289126068948846
2001-01-29T09:30:00-05:00,24.234328,24.274905,23.933928,23.982632,273442,995066.55,57.83359760830047,51.5770776930314,NaN,NaN,109.3950931381295,50.10120307622897,0.04633039342315029,0.16749701715447074,0.12116662373132045,2925964,633332,76.67237378399673,50.24654547966937,NaN,NaN,7.160715650226611,5.556496009131384
2001-01-30T09:30:00-05:00,24.112539,24.226201,23.747198,24.193726,386391,972057.9,60.154283068241945,52.513269038270366,NaN,NaN,108.10702846233319,74.04078875244794,0.06545241266129198,0.20298213955793543,0.13752972689664344,3312355,2108025.6,80.53563358948794,52.761612083637154,NaN,NaN,8.893856750922955,6.033261829387323
2001-01-31T09:30:00-05:00,24.234328,24.274905,23.820266,23.893326,464236,917652.6,55.47523402091773,52.85583623493243,NaN,NaN,83.57372246148064,83.43698919651375,0.05358194175916653,0.2045071540956016,0.15092521233643508,2848119,2682255.2,81.7995924644462,55.69711664593245,NaN,NaN,9.188946952537218,6.484073989837308
2001-02-01T09:30:00-05:00,23.990759,24.112539,23.836503,23.925809,229962,850412.75,55.8749186518889,53.192597864341,NaN,NaN,79.77990944712664,89.38669974214332,0.04402993946197889,0.20596263666390868,0.1619326972019298,3078081,2963408.2,82.40214408605254,58.82975152626057,NaN,NaN,9.540702708303757,6.920735235332515
2001-02-02T09:30:00-05:00,24.128776,24.258676,23.917698,23.990759,223681,809698.1,56.711666070038234,53.89667313876142,NaN,NaN,108.15301699499052,97.80175410081209,0.038403455067310965,0.2099370160360685,0.17153356096875755,3301762,3093256.2,82.68721784188571,61.99832689640129,NaN,NaN,10.054506775534747,7.3684168839328334
2001-02-05T09:30:00-05:00,24.153132,24.193726,23.885215,24.153132,258415,715619,58.81435061538519,54.46044968573163,NaN,NaN,98.1357198258233,95.54987943835086,0.0416621378731096,0.22361123331014454,0.18194909543703494,3560177,3220098.8,82.977312781824,65.01064485199892,NaN,NaN,11.047078617508998,7.893939988729429
2001-02-06T09:30:00-05:00,24.128776,24.128776,23.641654,23.682248,622390,720804.55,51.067384298356885,54.44399256327385,NaN,NaN,42.60069937443275,82.44861362077077,0.009811107032688449,0.1942129792278955,0.18440187219520704,2937787,3145185.2,82.10231110165675,67.67553742504002,NaN,NaN,9.831245104410165,8.170697862398105
2001-02-07T09:30:00-05:00,23.836503,23.901453,23.471162,23.625425,313597,723181.8,50.20794401222631,54.61958998277478,NaN,NaN,8.839375329979681,67.50174419447058,-0.01597428426451661,0.16443401686456127,0.18040830112907788,2624190,3100399.4,81.5486669217648,70.15832514789622,NaN,NaN,8.579401415748283,8.229084084305274
2001-02-08T09:30:00-05:00,23.787791,23.852741,23.438687,23.560467,2849224,840854.55,49.18880934853453,54.84047795077493,NaN,NaN,-5.615164614310806,50.422729382183086,-0.03708888545691369,0.13404719430793577,0.17113607976484946,-225034,2439776.4,73.65833470302329,72.11265512615566,NaN,NaN,7.247689284066047,8.088884827128242
2001-02-09T09:30:00-05:00,23.381856,23.771554,23.349373,23.657892,357200,825605.85,50.801796231602886,54.852901818258964,NaN,NaN,-12.113232378372913,26.36947950751039,-0.04372162683915795,0.11648404621590203,0.16020567305505998,132166,1805857.2,66.96291685602075,73.50581402032813,NaN,NaN,6.514403074879553,7.863958862521286
2001-02-12T09:30:00-05:00,23.755308,24.047589,23.690358,23.990759,2499538,923115.3,55.94731172993994,55.06197465752853,NaN,NaN,53.646608420059366,17.471657226357607,-0.025804710953201415,0.1279497843635582,0.1537544953167596,2631704,1620162.6,65.09627090645992,74.74878776061519,NaN,NaN,7.247796497504742,7.775935667518922
2001-02-13T09:30:00-05:00,24.136895,24.136895,23.755308,23.852741,791998,919346.2,53.45107505527371,54.98904002932867,NaN,NaN,50.248165903475495,19.001150532166157,-0.02343174630523656,0.1244648124352139,0.14789655874045046,1839706,1400546.4,62.86433511133701,75.31259435749597,NaN,NaN,7.200166099340826,7.693682872064908
2001-02-14T09:30:00-05:00,23.86897,23.86897,23.454924,23.576697,138445,899035.05,48.764677203461176,54.422272156588214,NaN,NaN,-23.498153989219855,12.533644668326243,-0.0396809150613662,0.09829541491374272,0.13797632997510892,1701261,1215960.6,60.972098976317,75.11802420773395,NaN,NaN,5.833513449184456,7.427944383081987
2001-02-15T09:30:00-05:00,23.503637,23.649773,23.29255,23.576697,616601,905840.35,48.764677203461176,53.789837508402044,NaN,NaN,-68.46073385624742,-0.03546918006106523,-0.049043343964895514,0.07667215001898953,0.12571549398388504,1701261,1601219.6,63.445267996219975,74.55174836574953,NaN,NaN,4.7071170099138495,7.039254758343682
2001-02-16T09:30:00-05:00,23.300669,23.771554,23.29255,23.584824,842376,914597.9,48.91760108386185,53.152980613799286,NaN,NaN,-76.53637876554076,-12.920098457494637,-0.05296807789814481,0.05950539661120402,0.11247347450934883,2543637,2083513.8,66.32242367365761,73.81246621501097,NaN,NaN,3.802189257393444,6.576816829636505
2001-02-20T09:30:00-05:00,23.625425,23.625425,22.659292,22.716123,407208,920362.4,36.4083443040222,51.45684213064073,NaN,NaN,-241.22592104719902,-71.89460435094631,-0.10911521849763098,-0.023920548612689885,0.0851946698849411,2136429,1984458.8,65.18758610914244,72.71617710927201,NaN,NaN,-1.1822736764811759,5.4683753287625505
2001-02-21T09:30:00-05:00,22.529392,22.854132,22.042262,22.042262,570781,927956,29.999678304367663,49.637159579458576,NaN,NaN,-335.6378895814053,-149.07181544792246,-0.18236809671746476,-0.14276545101188987,0.039602645705574896,1565648,1929647.2,64.5296055146463,71.48260661285772,NaN,NaN,-8.069534344634402,3.5343882325629856
2001-02-22T09:30:00-05:00,21.92049,22.196526,21.254748,22.196526,661066,759105.1,32.91104355842789,47.99688278706851,NaN,NaN,-300.72977685515275,-204.51814002110905,-0.20923782633290686,-0.22194463721055868,-0.012706810877651825,2226714,2034737.8,65.2537613904328,70.25772213459918,NaN,NaN,-12.548993580671084,1.2367622592438328
2001-02-23T09:30:00-05:00,22.001685,22.269586,21.43336,22.090991,685454,708610.55,31.932574269121645,46.226947658431605,NaN,NaN,-213.2027604914955,-233.46654534815866,-0.22172981127895708,-0.2898690749763482,-0.0681392636973911,1541260,2002737.6,64.81980383190302,68.98147827674327,NaN,NaN,-16.43399385137832,-1.2876314708450463
2001-02-26T09:30:00-05:00,22.293958,22.578105,21.904253,22.578105,252133,672206.9,40.696604847356625,44.93282296071528,NaN,NaN,-126.67345302078236,-243.49396019920695,-0.1862284121814258,-0.30092477892417335,-0.11469636674274755,1793393,1852688.8,62.713752221618954,67.53408109387148,NaN,NaN,-16.92931529670641,-3.522157731682384
2001-02-27T09:30:00-05:00,22.594342,23.032752,22.423849,22.821666,434798,680274.7,44.54158275730943,44.466694279211886,NaN,NaN,-68.47741890509528,-208.94425977078623,-0.1376252630099949,-0.28672794550524117,-0.14910268249524627,2228191,1871041.2,62.8726436054349,66.16053341556992,NaN,NaN,-16.06332190383453,-5.313752613418405
2001-02-28T09:30:00-05:00,22.651165,22.846022,22.034152,22.285831,1071230,714516.65,38.610574038502634,43.63831070966019,NaN,NaN,-93.8782260084002,-160.5923270561852,-0.1327836042034881,-0.3150821877496064,-0.1822985835461183,1156961,1789303.8,61.61331554067646,64.73657974549218,NaN,NaN,-17.328492600334407,-7.030144040120691
2001-03-01T09:30:00-05:00,22.123457,22.318314,21.85554,22.310188,826363,732623,39.00814273071423,42.911120236958745,NaN,NaN,-101.58356349118046,-120.76308438339076,-0.11957182208917849,-0.3317633611575914,-0.21219153906841293,1983324,1740625.8,60.831858983722064,63.82040290839923,NaN,NaN,-18.179739690400737,-8.622943418732126
2001-03-02T09:30:00-05:00,22.066618,22.651165,22.066618,22.342662,661805,754215.15,39.57005366985655,42.10885291111972,NaN,NaN,-73.6720809893883,-92.85694848296933,-0.10101585594499687,-0.338461358999659,-0.23744550305466214,2645129,1961399.6,63.116717509858155,63.54567438367333,NaN,NaN,-18.687353491312468,-10.060716286243602
2001-03-05T09:30:00-05:00,22.529392,22.529392,21.928601,22.229001,924532,789257.7,38.242056241036956,40.8441918047695,NaN,NaN,-77.0408738236777,-82.93043264354837,-0.0891787519253881,-0.34891894296139725,-0.25974019103600915,1720597,1946840.4,62.856312152809544,63.385677329841165,NaN,NaN,-19.493309910115524,-11.408229661082448
2001-03-06T09:30:00-05:00,22.431968,22.716123,22.24523,22.293958,395629,796118.4,39.49186490926458,39.84710536576886,NaN,NaN,-52.816808095007396,-79.79831048153082,-0.07057118118163996,-0.3479541675130591,-0.2773829863314191,2116226,1924447.4,62.429677573061966,63.354630362821524,NaN,NaN,-19.80704826986244,-12.608060890908162
2001-03-07T09:30:00-05:00,22.488799,22.829784,22.131568,22.764827,628179,796407.85,47.74694375264775,39.77441011928219,NaN,NaN,-32.54509348580473,-67.5316839770117,-0.022630251114323374,-0.30567080022432336,-0.28304054911,2744405,2241936.2,65.95766707059099,63.710742369555376,NaN,NaN,-17.579379565682625,-13.318249273018798
2001-03-08T09:30:00-05:00,22.829784,23.089583,22.691766,22.854132,535307,807493.35,49.16353057626061,39.80289964591071,NaN,NaN,3.356058662723645,-46.54375954623088,0.016884173365635136,-0.2619353324029561,-0.2788195057685912,3279712,2501213.8,68.55460013064356,64.07569466487135,NaN,NaN,-15.32861604556974,-13.605444526240362
2001-03-09T09:30:00-05:00,22.448197,22.569986,22.196526,22.326425,447608,687412.55,41.929889123914975,39.303777363057364,NaN,NaN,-49.30333010624916,-41.670009369603065,0.009630869132367992,-0.2667809193531312,-0.2764117884854992,2832104,2538608.8,68.92282758083824,64.26143780109854,NaN,NaN,-15.513385112224165,-13.878007467095191
2001-03-12T09:30:00-05:00,21.806828,21.952957,20.710796,21.230392,973308,718217.95,31.547553584540196,38.95657802595151,NaN,NaN,-158.26054945222367,-57.913944495312265,-0.0628464995291732,-0.35496991289696567,-0.29212341336779246,1858796,2566248.6,69.2098245069044,64.54874054379583,NaN,NaN,-19.581399038318995,-14.692777691555735
2001-03-13T09:30:00-05:00,21.465843,21.806828,21.17357,21.798718,1515759,669029,39.86276642479771,39.66108432026794,NaN,NaN,-119.3154740381357,-71.21367768393793,-0.06604692172696869,-0.3746820655265033,-0.3086351437995346,3374555,2817914.4,71.76649377676796,65.06566113394737,NaN,NaN,-19.780492470253876,-15.419594088512612
2001-03-14T09:30:00-05:00,20.791991,21.29535,20.540311,20.791991,2522201,755539.15,32.36322001790322,39.621954067373316,NaN,NaN,-199.8438835115794,-104.67343568909287,-0.12602379313318018,-0.46616488521600985,-0.34014109208282967,852354,2439504.2,63.26061630913509,64.92329362814039,NaN,NaN,-23.00618129999912,-16.503392261582114
2001-03-15T09:30:00-05:00,21.311587,21.514555,21.092383,21.417131,635569,780395.35,39.9217152329345,40.192606993359945,NaN,NaN,-126.38991048989949,-130.62262951961748,-0.11401378293674447,-0.48265832075376025,-0.3686445378170158,1487923,2081146.4,56.43860584310574,64.32463662894058,NaN,NaN,-22.49985449217976,-17.360029723096062
2001-03-16T09:30:00-05:00,21.530792,21.530792,20.946246,21.068027,856664,792398.5,37.40765801439632,39.957682219577066,NaN,NaN,-129.1493797343976,-146.59183944524716,-0.11942749014396253,-0.5179289004969689,-0.3985014103530064,631259,1640977.4,49.39281118482255,63.373140840597976,NaN,NaN,-23.069967056591814,-18.1757350564526
2001-03-19T09:30:00-05:00,21.068027,21.417131,20.702685,21.311587,428393,771699.35,40.23543746426241,39.65010041293085,NaN,NaN,-117.14290882627947,-138.36831132005833,-0.09738361907219528,-0.5202309341932505,-0.4228473151210552,1059652,1481148.6,47.09381703506858,62.24608179985752,NaN,NaN,-22.4882779468767,-18.79181261222747
2001-03-20T09:30:00-05:00,21.473961,21.506444,20.653973,20.718922,1915454,847111.65,35.97623712772578,39.461933490732505,NaN,NaN,-123.55521447243862,-139.21625940691894,-0.11242941498357639,-0.5633840838505257,-0.45095466886694935,-855802,635077.2,37.21816574834924,60.50357110040558,NaN,NaN,-23.538379888628565,-19.469893651713342
2001-03-21T09:30:00-05:00,20.540311,20.881296,19.97201,20.118139,1576483,897396.75,32.24944919980106,38.979169667095846,NaN,NaN,-167.1999162934544,-132.68746596329393,-0.15019539254606074,-0.6386989095495252,-0.4885035170034645,-2432285,-21850.6,31.665695991860744,58.42027374384406,NaN,NaN,-25.74783582328929,-20.36674253336705
2001-03-22T09:30:00-05:00,19.769043,19.882704,18.981521,19.598542,2004261,964556.5,29.4117074869,38.25357351117038,NaN,NaN,-202.83465878898897,-147.97641562311182,-0.19469875831953032,-0.7318769649028773,-0.537178206583347,-4436546,-1206744.4,24.551120099724642,55.665588214548805,NaN,NaN,-28.55312530496806,-21.536225786452906
2001-03-23T09:30:00-05:00,19.744687,20.475361,19.728441,20.426649,624114,961489.5,38.67365190649659,38.28440177298893,NaN,NaN,-119.06134973941354,-145.95880962411502,-0.1546409698751331,-0.7304794189272634,-0.5758384490521303,-3812432,-2095482.6,20.779895180851653,52.66012985940896,NaN,NaN,-27.526074964319058,-22.39191852614807
2001-03-26T09:30:00-05:00,20.767635,20.954365,20.524074,20.751397,765516,987158.65,41.89352487013064,38.45594891305079,NaN,NaN,-67.76101629773365,-136.08243111840585,-0.09545252104198121,-0.6951541003546069,-0.5997015793126257,-3046916,-2916796.2,18.024443283500574,49.48832741015457,NaN,NaN,-25.590527128328734,-22.848862612173882
2001-03-27T09:30:00-05:00,20.678329,21.449605,20.475361,21.335944,464113,988624.4,47.26112471503821,38.421247553221534,NaN,NaN,-34.37886779492072,-118.24716178290228,-0.010578780346068739,-0.6129250547452116,-0.6023462743991429,-2582803,-3262196.4,17.00331271530574,45.99158781334848,NaN,NaN,-22.112548191167495,-22.743674837744397
2001-03-28T09:30:00-05:00,21.10862,21.335944,20.930009,21.222282,279970,949061.4,46.364275120832765,38.22130073497669,NaN,NaN,-23.70770093453772,-89.54871871111894,0.04141082589195588,-0.550582742034198,-0.5919935679261539,-2862773,-3348294,16.748599741850256,42.29115921414897,NaN,NaN,-19.70754712351411,-22.30994230714007
2001-03-29T09:30:00-05:00,21.10862,21.303477,20.970602,21.17357,141525,914819.5,45.96172750605734,38.509289190844,NaN,NaN,-21.43436025968171,-53.26865900525748,0.07411448627177697,-0.4993504600864327,-0.5734649463582097,-3004298,-3061844.4,20.98937149054592,38.867340921985225,NaN,NaN,-17.935844448955955,-21.685071184542338
2001-03-30T09:30:00-05:00,21.149214,21.547022,21.149214,21.547022,252749,894366.7,49.576261683824775,39.79705405507861,NaN,NaN,9.888494211107467,-27.47869021515328,0.11978830782307359,-0.4237295615793677,-0.5435178694024413,-2751549,-2849667.8,24.07451161665199,35.64339000125292,NaN,NaN,-15.333029473018762,-20.777636654324684
2001-04-02T09:30:00-04:00,21.319698,21.993558,21.319698,21.644454,3028933,999586.75,50.50640819635053,40.557314181618096,NaN,NaN,40.63327775898489,-5.79983140380958,0.15330930457358405,-0.3518812386854613,-0.5051905432590453,277384,-2184807.8,32.91420770109099,32.86822671013313,NaN,NaN,-12.945195579730434,-19.65871650081122
2001-04-03T09:30:00-04:00,21.441487,21.571394,20.832584,20.913763,920098,1025810.2,43.957536378105424,41.38547963591825,NaN,NaN,-15.289267794957693,-1.9819114038169627,0.1242576220077366,-0.3498685157493746,-0.4741261377571112,-642714,-1796790,37.48842025032624,31.027355563075357,NaN,NaN,-12.788971816674948,-18.677324403077467
2001-04-04T09:30:00-04:00,20.824457,20.824457,20.174978,20.402293,3387734,1163787.95,40.04351421545217,41.39417956324093,NaN,NaN,-90.23539356462176,-15.287449929833764,0.07121649731085189,-0.3851055161185464,-0.45632201342939827,-4030448,-2030325,35.90175091181919,29.56043735369775,NaN,NaN,-13.884683130363037,-17.992661364118263
2001-04-05T09:30:00-04:00,20.986848,21.222282,20.816347,21.149214,1273233,1200684.25,47.408094939677625,42.10849648647532,NaN,NaN,5.0420145415174655,-9.992174969593929,0.08606501542805783,-0.348740744144326,-0.4348057595723838,-2757215,-1980908.4,36.51406238157068,28.640526724894052,NaN,NaN,-12.442846585212601,-17.199830681417453
2001-04-06T09:30:00-04:00,20.808228,21.181688,20.451005,20.678329,6638132,1510210.45,43.75885300627887,42.36016902519077,NaN,NaN,-31.93462030957171,-18.356797873729764,0.06477336908202125,-0.35383904821985723,-0.4186124173018785,-9395347,-3309668,28.602126080534987,27.319691656713083,NaN,NaN,-12.4286572255344,-16.51823447343416
2001-04-09T09:30:00-04:00,20.702685,20.978721,20.589023,20.670218,803207,1501705.4,43.696459322239804,42.91161346765606,NaN,NaN,-31.48911785970089,-32.78127699746692,0.051331435031106765,-0.35444812351299504,-0.4057795585441018,-10198554,-5404855.6,20.908815794616146,26.15473808858929,NaN,NaN,-12.43649953491845,-15.93512948221763
2001-04-10T09:30:00-04:00,20.946246,21.400893,20.946246,21.270994,372227,1444528.8,49.44623690544261,44.13995544663046,NaN,NaN,55.638815905736976,-18.595660257327985,0.08225494811249329,-0.3029608734034852,-0.3852158215159785,-9826327,-7241578.2,16.674578953766357,25.083944014439687,NaN,NaN,-10.647335391441857,-15.17973032639252
2001-04-11T09:30:00-04:00,21.676929,21.709412,21.368427,21.449605,1360562,1386446.85,51.046814048867496,45.68532020105671,NaN,NaN,100.37314862851974,19.526048181300318,0.11223574258966457,-0.2449211432788978,-0.35715688586856237,-8465765,-8128641.6,15.08564658122549,24.40783876311832,NaN,NaN,-8.705847124150454,-14.254889868929368
2001-04-12T09:30:00-04:00,21.530792,21.676929,21.352181,21.611979,5781588,1643747.8,52.51858341823714,46.67424388046675,NaN,NaN,103.25491668228027,39.16862860945288,0.1387620011540719,-0.18370438442597248,-0.32246638558004437,-2684177,-8114034,15.228900741230703,24.011339160288255,NaN,NaN,-6.6756195908201255,-13.172136972056618
2001-04-16T09:30:00-04:00,21.798718,21.806828,21.311587,21.457716,361387,1618983.95,50.95131226826755,47.321228694619386,NaN,NaN,93.57912460683424,64.27137759273407,0.14120917293980256,-0.14595491940529115,-0.2871640923450937,-3045564,-6844077.4,26.79211769967435,24.637601618586384,NaN,NaN,-5.424105274264274,-12.065275300943426
2001-04-17T09:30:00-04:00,21.319698,21.66881,21.262875,21.636327,868981,1641013.35,52.71094832734884,47.71050180978443,NaN,NaN,86.68890452782313,87.90698207023888,0.14935715159015195,-0.10046765285740378,-0.24982480444755573,-2176583,-5239683.2,38.25156566618411,26.155333972220554,NaN,NaN,-3.8786871187369316,-10.895762703485357
2001-04-18T09:30:00-04:00,21.92049,23.536119,21.814947,22.54563,5582545,1824367.9,60.483431501359874,48.719012979822075,NaN,NaN,221.22247444419475,121.02371377793042,0.20694179628544856,0.008852440909254966,-0.1980893553761936,3405962,-2593225.4,51.68595246868742,28.65085916699464,NaN,NaN,-0.010803647620875649,-9.340768552647575
2001-04-19T09:30:00-04:00,22.537503,22.813555,22.488799,22.66741,1221131,1806600.3,61.39850368629101,49.821639849838775,NaN,NaN,195.7111012262698,140.09130429748043,0.24176416300487333,0.10411584837989807,-0.13764831462497526,4627093,25346.2,60.77874951630922,31.492957597406303,NaN,NaN,3.4126842824393515,-7.5188467190637285
2001-04-20T09:30:00-04:00,22.464443,22.537503,22.188407,22.277713,643822,1738578.35,56.86090896593108,50.34197179856066,NaN,NaN,138.24079050256321,147.08847906153704,0.22730183219513822,0.14647897561894752,-0.0808228565761907,3983271,1358835.8,64.44815788389914,34.37678947363825,NaN,NaN,5.0236490680639925,-5.727061606616911
2001-04-23T09:30:00-04:00,22.131568,22.253357,21.871778,22.001685,609580,1737851.65,53.826495340337274,50.57912088027399,NaN,NaN,89.26780960682501,146.22621606153518,0.1894429702307831,0.1559808562122882,-0.03346211401849492,3373691,2642686.8,67.59184023019874,36.85376322571737,NaN,NaN,5.49357892291155,-4.124112959541417
2001-04-24T09:30:00-04:00,22.123457,22.24523,21.831184,21.888023,118368,1705494.25,52.582135349804744,51.1951636639668,NaN,NaN,73.4621664839555,143.58086845276165,0.14883427986171163,0.15258073580864462,0.003746455946932986,3255323,3729068,70.00855934256546,39.176630303734456,NaN,NaN,5.528581156050181,-2.7451566573140465
2001-04-25T09:30:00-04:00,21.831184,22.147814,21.741879,22.123457,582359,1711406.55,54.90750893169353,52.256877572269765,NaN,NaN,68.60896451934501,113.05816646779172,0.1305700927116207,0.16695907183645886,0.03638897912483816,3837682,3815412,70.19877250416579,41.62641756033064,NaN,NaN,6.207555731475396,-1.4661977446298404
2001-04-26T09:30:00-04:00,22.139695,22.456324,22.139695,22.212763,900267,1742421.4,55.79310742634022,52.8558070356028,NaN,NaN,93.06143886110245,92.52823399475824,0.11764530293351819,0.1834456077917359,0.06580030485821772,4737949,3837583.2,70.25094698075672,44.03619503170108,NaN,NaN,7.015087400059415,-0.25458558110280394
2001-04-27T09:30:00-04:00,22.456324,22.724249,22.40762,22.691766,925763,1781633.3,60.29709520133403,54.037110049535315,NaN,NaN,119.86110374330411,88.85229664290642,0.13334609751840135,0.2324829267562194,0.09913682923781805,5663712,4173671.4,71.07756996342277,47.0701553090502,NaN,NaN,9.02523266890921,1.0711027403274835
2001-04-30T09:30:00-04:00,22.740471,22.894734,22.293958,22.326425,483328,1793162.25,55.640751149720614,54.89027375149822,NaN,NaN,93.72923343524543,89.7445814085905,0.11197780794795983,0.23910908917276785,0.12713128122480802,5180384,4535010,71.97906377142883,50.71803016453682,NaN,NaN,9.435943699369826,2.2660800201906754
2001-05-01T09:30:00-04:00,22.253357,22.578105,22.212763,22.513155,839173,1683674.25,57.449401880997904,55.461928392609316,NaN,NaN,76.3383638361685,90.31982087903309,0.10347215703155344,0.2564714775142498,0.15299932048269638,6019557,5087856.8,73.3478491503931,54.766120892867306,NaN,NaN,10.2940310384978,3.4129301656631217
2001-05-02T09:30:00-04:00,22.699893,22.813555,22.464443,22.691766,321480,1653743.35,59.16449325348907,56.04176262151085,NaN,NaN,91.4975293359651,94.89753384235712,0.10272046952005906,0.2813999073827702,0.17867943786271115,6341037,5588527.8,74.55985473956989,59.01427861846334,NaN,NaN,11.499931524632954,4.568216074087383
2001-05-03T09:30:00-04:00,22.488799,22.708004,22.367018,22.699893,383928,1503553.05,59.244988337130295,56.52222011571751,NaN,NaN,79.31491659689335,92.1482293895153,0.09575420942644336,0.29837219964576533,0.20261799021932198,6724965,5985931,75.51175960430757,63.32019710868311,NaN,NaN,12.517388955951933,5.7038122000680325
2001-05-04T09:30:00-04:00,22.48068,23.040871,22.456324,22.975921,170101,1448396.45,61.98583314496684,57.310400178338895,NaN,NaN,100.40278053270461,88.2565647473954,0.10213653124198863,0.33028865427180776,0.22815212302981913,6895066,6232201.8,76.1083635239894,66.84278609613419,NaN,NaN,14.158800415979272,6.911667659483924
2001-05-07T09:30:00-04:00,22.927217,22.927217,22.66741,22.829784,99892,1121484.45,59.6968298134316,57.809391713059085,NaN,NaN,91.7703770892728,87.86479347820087,0.08937653987695154,0.33987279787600855,0.250496257999057,6795174,6555159.8,76.90305909862886,69.60360705559454,NaN,NaN,14.953417727166334,8.060489097724268
2001-05-08T09:30:00-04:00,22.740471,22.837903,22.586232,22.594342,127852,1087716.7,56.10229228323962,57.49645319747906,NaN,NaN,69.21858776735628,86.44083826443843,0.059384473610168576,0.3247268500117677,0.26534237640159913,6667322,6684712.8,77.23024855266677,71.42819963302163,NaN,NaN,14.674770464522352,9.00538643583828
2001-05-09T09:30:00-04:00,22.561859,22.634936,22.40762,22.569986,708980,1104554.35,55.72846110908906,57.09145015625035,NaN,NaN,43.86966324239845,76.91526504572509,0.03349957646599583,0.3072168469840939,0.2737172705180981,5958342,6608173.8,76.54039717116905,72.55403160836876,NaN,NaN,14.343286709483671,9.767943617787623
2001-05-10T09:30:00-04:00,22.813555,22.813555,22.513155,22.578105,206806,1046866.55,55.83410956606904,57.01810734197449,NaN,NaN,56.46169547354264,72.34462082105496,0.013542028761293123,0.29064480646971447,0.27710277770842134,6165148,6496210.4,75.47829049449169,73.34189822341109,NaN,NaN,14.089704752647675,10.385338065624772
2001-05-11T09:30:00-04:00,22.748597,22.748597,22.261475,22.367018,200647,767819.5,52.337137708422674,56.91172465398059,NaN,NaN,16.29774335105567,55.523613384725174,-0.015674243355255135,0.25750997351435245,0.2731842168696076,5964501,6310097.4,73.64880715235856,73.77453871785107,NaN,NaN,12.959649834601938,10.753096889764368
2001-05-14T09:30:00-04:00,22.391375,22.578105,22.285831,22.553749,59369,752718.6,55.02089344669668,57.08592166090144,NaN,NaN,10.890933941978062,39.347724755266235,-0.023738599144108974,0.24351096793947136,0.26724956708358033,6023870,6155836.6,72.08911231378184,73.92314964436652,NaN,NaN,12.646290423887427,11.023553108924805
2001-05-15T09:30:00-04:00,22.634936,22.935328,22.537503,22.691766,267653,722652.2,56.95034290448178,57.23183837324347,NaN,NaN,78.76658624585409,41.25732445096579,-0.021177305309247663,0.24077793544702075,0.2619552407562684,6291523,6080676.8,71.29686807403816,74.00158504221454,NaN,NaN,12.869649326114024,11.287281139951837
2001-05-16T09:30:00-04:00,22.691766,23.373729,22.578105,23.300669,641728,475611.35,64.2387899351771,57.835101409589015,NaN,NaN,178.23959681375368,68.13131116523684,0.018008784408530876,0.284466221266932,0.2664574368584011,6933251,6275658.6,72.15189196605384,74.13736682687863,NaN,NaN,15.215748233785057,11.848490724785155
2001-05-17T09:30:00-04:00,23.284423,23.414331,23.113939,23.178889,402034,434656.5,61.97872718280412,57.95521797969402,NaN,NaN,192.46654557746174,95.33228118602065,0.03142485935681366,0.3057385110544182,0.2743136516976045,6531217,6348872.4,72.4833496453573,74.23777966130251,NaN,NaN,16.53801247210548,12.518422402973773
2001-05-18T09:30:00-04:00,23.268194,23.268194,22.91909,23.048989,194858,412208.3,59.57116717663261,58.235961981616306,NaN,NaN,131.54322051126502,118.38137661806255,0.02739567243665636,0.308558242243425,0.2811625698067686,6336359,6423244,72.83702804369271,74.29906282360707,NaN,NaN,16.98093815015177,13.15592465257063
2001-05-21T09:30:00-04:00,23.113939,23.414331,22.951565,23.373729,236983,393578.45,63.3988864931611,58.6609251681994,NaN,NaN,157.9221621604986,147.78762226176664,0.04159497238352006,0.3331562852861687,0.29156131290264864,6573342,6533138.4,73.38146824653768,74.3014641876174,NaN,NaN,18.487812546391986,13.917622923116538
2001-05-22T09:30:00-04:00,23.454924,23.812147,23.373729,23.60918,560311,415675.6,65.91840864761274,59.143347696351086,NaN,NaN,207.08397259965582,173.451099532527,0.0606821652472368,0.3674140194616946,0.3067318542144578,7133653,6701564.4,74.23386243251113,74.2781790228275,NaN,NaN,20.529413388808628,14.862164418215407
2001-05-23T09:30:00-04:00,23.690358,23.690358,23.389975,23.511763,1015679,437341.6,63.95672489580989,59.47990030768534,NaN,NaN,161.70620400493945,170.14442097076414,0.06045124745801089,0.38229591353697145,0.32184466607896056,6117974,6538509,71.83554583397596,74.01559232494665,NaN,NaN,21.673208647103927,15.835170736628053
2001-05-24T09:30:00-04:00,23.641654,23.739087,23.511763,23.601069,184881,401572.3,64.9854547442029,59.694158993345056,NaN,NaN,150.42227299450522,161.73556645417284,0.059902662277641294,0.3967229939260122,0.3368203316483709,6302855,6492836.6,71.14222345176955,73.66086803407381,NaN,NaN,22.919951864813967,16.847282326368898
2001-05-25T09:30:00-04:00,23.576697,23.649773,23.284423,23.284423,395013,375034.8,58.59919211286405,59.61575630044738,NaN,NaN,93.93801516993717,154.21452538590728,0.033140288525892125,0.378245692305736,0.3451054037798439,5907842,6407133.2,69.78120752877518,73.15216435051283,NaN,NaN,22.1876471421277,17.610191585763012
2001-05-29T09:30:00-04:00,23.495518,23.495518,23.195134,23.300669,809242,391330.5,58.822778202289435,59.81007672323665,NaN,NaN,70.90444879150162,136.8109827121079,0.012519404120317046,0.36075465893024017,0.3482352548099231,6717084,6435881.6,69.9886139207044,72.6349047339441,NaN,NaN,21.64718452994489,18.18690486350328
2001-05-30T09:30:00-04:00,23.316906,23.495518,23.089583,23.105828,586670,378705.35,54.98732125858539,59.75713816248639,NaN,NaN,46.50430354480781,104.69504890113826,-0.01667074636524568,0.32739682185336605,0.34406756821861173,6130414,6235233.8,66.55515289037072,71.92167299960136,NaN,NaN,20.095279007501695,18.459529741217338
2001-05-31T09:30:00-04:00,23.138295,23.308796,22.98404,23.308796,202125,372737.6,58.05548584900038,59.915807896981484,NaN,NaN,36.51687217782096,79.65718253571458,-0.02427651386382984,0.3137219258888244,0.33799843975265426,6332539,6278146.8,66.92882740699099,71.31099706477987,NaN,NaN,19.594407444717426,18.621655127431637
2001-06-01T09:30:00-04:00,23.178889,23.333152,23.016523,23.268194,177984,362440.4,57.215328313849355,60.26425008308338,NaN,NaN,33.28956094997042,56.230640126807636,-0.033443638655289265,0.2961938914335427,0.32963753008883195,6154555,6248486.8,66.3768165247717,70.79156916280938,NaN,NaN,18.946717138755382,18.668092557620742
2001-06-04T09:30:00-04:00,23.333152,23.454924,23.154532,23.454924,42371,356053.9,60.07682894582798,60.62538833302134,NaN,NaN,59.19309752170766,49.281656597161735,-0.028524814151436262,0.2939815123995366,0.3225063265509729,6196926,6306303.6,66.94906644641978,70.42442302942638,NaN,NaN,19.161975757450676,18.73864730045359
2001-06-05T09:30:00-04:00,23.536119,23.682248,23.422458,23.560467,563144,379216.5,61.638540367927384,60.96025958041031,NaN,NaN,92.76779259016908,53.65432535689523,-0.02015119327886994,0.29731733495238544,0.3174685282312554,6760070,6314900.8,67.03889952369724,70.12028241868775,NaN,NaN,19.77164610880788,18.886218558789917
2001-06-06T09:30:00-04:00,23.446806,23.471162,23.187007,23.381856,566593,401153.55,57.536652369527744,60.481535468578215,NaN,NaN,45.28389524968408,53.410243697870484,-0.02813924781460697,0.28229446846299666,0.31043371627760363,6193477,6327513.4,67.17983669784536,69.7651356138157,NaN,NaN,19.16963447190428,18.926706546377684
2001-06-07T09:30:00-04:00,23.187007,23.284423,22.98404,23.227601,1215342,426471.65,54.18305680834339,59.924701870402444,NaN,NaN,-2.152015917105041,45.676466078885284,-0.04434525844184767,0.255002143225294,0.2993474016671417,4978135,6056632.6,61.13389180340583,68.95446005367631,NaN,NaN,17.706979269077497,18.75245979247766
2001-06-08T09:30:00-04:00,23.016523,23.138295,22.927217,23.089583,726470,452454.85,51.30181323147211,59.334033731462405,NaN,NaN,-40.9008763894284,30.838378611005474,-0.06371529966121753,0.21970327709061976,0.2834185767518373,4251665,5676054.6,53.807083441963954,67.59517829640997,NaN,NaN,15.63340385358395,18.3068803726357
2001-06-11T09:30:00-04:00,23.024633,23.154532,22.837903,22.870378,186606,451752.8,47.024779735544634,58.164454677346946,NaN,NaN,-86.65674481596575,1.6684101434707912,-0.0890890290062335,0.1720572904940454,0.2611463195002789,4065059,5249681.2,47.009568652389795,65.71147118254227,NaN,NaN,12.557054725892261,17.48547670881521
2001-06-12T09:30:00-04:00,22.651165,22.959684,22.54563,22.943438,758372,486702.95,48.56396643713556,56.924851662312854,NaN,NaN,-150.8584477819769,-47.05683793095841,-0.09804089950363998,0.13859519512072893,0.2366360946243689,4823431,4862353.4,41.83871447156867,63.39753204247496,NaN,NaN,10.39492768085676,16.472541133392575
2001-06-13T09:30:00-04:00,22.813555,23.105828,22.683648,22.756716,966780,521659.3,44.96794648454153,55.568510347222265,NaN,NaN,-145.98170618840052,-85.30995821857533,-0.11258582047617788,0.09590381902914658,0.20848963950532445,3856651,4394988.2,36.606383202819636,60.88116328310665,NaN,NaN,7.462722883702622,15.185424240579724
2001-06-14T09:30:00-04:00,22.634936,22.634936,22.358892,22.358892,1375589,558352.35,38.43749520107743,53.67222752271329,NaN,NaN,-238.13040860934703,-132.50563675702375,-0.14308931894801238,0.02962799082030898,0.17271730976832136,2481062,3895573.6,32.000960847398616,58.08535881136588,NaN,NaN,2.6917302106368264,13.40061080773074
2001-06-15T09:30:00-04:00,22.269586,22.431968,22.034152,22.391375,2496951,663098.2,39.21373416608532,52.28755195508624,NaN,NaN,-220.05113841408712,-168.3356891619555,-0.15420898386658283,-0.020043920064907184,0.13416506380167564,4978013,4040843.2,34.579219899440076,55.57093112355623,NaN,NaN,-0.945670231008721,11.351142087910816
2001-06-18T09:30:00-04:00,22.448197,22.529392,22.155924,22.448197,388485,672779.55,40.624108411225606,50.98764697001025,NaN,NaN,-160.68068620565734,-183.1404774398938,-0.15069159464466203,-0.05419942950415191,0.09649216514051012,5366498,4301131,39.039250404270845,53.36026230095383,NaN,NaN,-3.5673898480155475,9.219923239921336
2001-06-19T09:30:00-04:00,22.79731,22.820846,22.594342,22.651165,1783413,750101.05,45.4893663914801,50.30922162235987,NaN,NaN,-82.43390648626385,-169.45556918075118,-0.12851421788729983,-0.06415060721861465,0.06436361066868516,7149911,4766427,46.11179965582561,51.9000227842006,NaN,NaN,-4.468742336954261,7.264399586081965
2001-06-20T09:30:00-04:00,22.651165,23.040871,22.651165,22.772954,683237,756247.35,48.23052800105321,49.60743891893508,NaN,NaN,-49.11572934285743,-150.08237381164255,-0.10069144141548601,-0.061500691100672356,0.03919075031481366,7833148,5561726.4,55.59479577357567,51.09044909609951,NaN,NaN,-4.444691058217438,5.5916723511820505
2001-06-21T09:30:00-04:00,22.935328,23.690358,22.935328,23.690358,745316,742729.2,63.23020402858425,50.037072898559,NaN,NaN,78.93987913166089,-86.66831626344097,-0.019784966928771464,0.014459541653849328,0.03424450858262079,8578464,6781206.8,65.59309899677982,51.034469272671515,NaN,NaN,1.084172774465837,4.947743840222591
2001-06-22T09:30:00-04:00,23.625425,23.625425,23.333152,23.381856,518555,759412.9,57.22564801466784,49.83341711776185,NaN,NaN,84.32177141936145,-25.79373429675124,0.01196272694901368,0.04919791726888789,0.03723519031987421,8059909,7397586,69.34962236841491,51.20593755281403,NaN,NaN,3.4512609186977232,4.7339605657190384
2001-06-25T09:30:00-04:00,23.422458,23.511763,23.081456,23.195134,246714,751997.95,53.889953171533925,49.279946603733755,NaN,NaN,47.71980921793365,15.886364787966965,0.018978832556497773,0.060958731015496426,0.04197989845899865,7813195,7886925.4,71.96639715916243,51.557901669632976,NaN,NaN,4.172580951937609,4.653763478035977
2001-06-26T09:30:00-04:00,22.73236,23.040871,22.73236,22.902861,965055,759788.6,49.06851704803396,48.67507979505562,NaN,NaN,-27.995145464787278,26.774116992262282,0.003346587085097927,0.04616313231537106,0.04281654523027313,6848140,7826571.2,71.15945000140569,51.84215976274442,NaN,NaN,3.097719085010574,4.431471421889491
2001-06-27T09:30:00-04:00,22.935328,23.276313,22.910971,22.910971,468178,753864,49.20432094172495,48.31945580458288,NaN,NaN,5.166405688017132,37.63054399843718,-0.006499624170774265,0.0346920150168053,0.041191639187579565,7316318,7723205.2,69.71762414366152,52.455283501334115,NaN,NaN,2.314341638201398,4.1290243099340485
2001-06-28T09:30:00-04:00,23.113939,23.389975,23.032752,23.211363,288469,758181.2,54.087564880014796,48.518438065193074,NaN,NaN,45.29919367364189,30.90240690683337,0.006464461763841592,0.04927221639238155,0.04280775462853996,7604787,7528469.8,66.96479869404979,53.39512030505453,NaN,NaN,3.238514282197836,4.001808591686018
2001-06-29T09:30:00-04:00,23.138295,23.170762,22.943438,23.0571,968627,797713.35,51.357078267528905,48.8278879603348,NaN,NaN,12.485212513753128,16.535095125711702,0.004016247502727985,0.047828064006949944,0.04381181650422196,6636160,7243720,63.04477748881913,54.54049236479948,NaN,NaN,3.130623722052091,3.8773536103097426
2001-07-02T09:30:00-04:00,23.178889,23.398102,23.081456,23.341263,184635,804826.55,55.78502553702493,49.343677896041186,NaN,NaN,64.16936918208452,19.82500711854188,0.02000641073831727,0.06881982992711855,0.04881341918880128,6820795,7045240,60.39107275076581,55.865660813313575,NaN,NaN,4.464996721727172,3.961302626226518
2001-07-03T09:30:00-04:00,23.300669,23.406212,23.251957,23.325025,129700,783154.35,55.47426630048051,50.094129311465394,NaN,NaN,82.42241406953327,41.908519025405994,0.027498672313358473,0.08318675958049937,0.0556880872671409,6691095,7013831,59.9609484112133,57.53384404248454,NaN,NaN,5.428537591278272,4.170907621233911
2001-07-05T09:30:00-04:00,23.333152,23.414331,23.162651,23.178889,134257,761537.55,52.63261540220889,51.108066468689074,NaN,NaN,66.2369157422195,54.12262103624646,0.02091939509594891,0.08183733113707703,0.06091793604112812,6556838,6861935,57.816336302847525,59.37779943215946,NaN,NaN,5.39657676264537,4.34600321286412
2001-07-06T09:30:00-04:00,23.016523,23.032752,22.683648,22.708004,870213,744281.1,44.688939318068506,51.49915255097359,NaN,NaN,-38.647046534603064,37.33337299459747,-0.014907155482190917,0.04228399168838948,0.057191147170580395,5686625,6478302.6,52.69048416589735,60.671461165477844,NaN,NaN,2.808744870241963,4.126394878203811
2001-07-09T09:30:00-04:00,22.772954,22.813555,22.553749,22.781072,1079483,761931.75,46.049625842037216,51.886689510317275,NaN,NaN,-55.738253850661685,23.688679721714507,-0.03243945729776049,0.016641825548379785,0.04908128284614027,6766108,6504292.2,52.994525721079924,61.66826654524992,NaN,NaN,1.1439045564061348,3.700324832232715
2001-07-10T09:30:00-04:00,22.79731,22.79731,22.229001,22.229001,1397637,822483.3,38.369259846698505,51.3781104714043,NaN,NaN,-111.37792662459346,-11.42077943962109,-0.07740718063181604,-0.04767769294362978,0.02972948768818626,5368471,6213827.4,49.18968011988839,61.88811514982583,NaN,NaN,-2.988769910838382,2.744739868936844
2001-07-11T09:30:00-04:00,22.164051,22.24523,21.85554,22.188407,9227588,1245944.1,37.86911867810541,50.638009805479456,NaN,NaN,-157.43666753950035,-59.39259576142781,-0.10439591843942242,-0.10076541036109177,0.0036305080783306555,-3859117,4103785,31.49794041422072,60.16691119558619,NaN,NaN,-6.389160030723616,1.439897026128207
2001-07-12T09:30:00-04:00,22.204653,22.659292,22.204653,22.578105,475322,1221371.2,45.247545715316775,49.353534211674635,NaN,NaN,-73.05838915625925,-87.25165674112357,-0.09100281258255327,-0.11012300764986094,-0.019120195067307662,-3383795,2115658.4,23.076249394651597,57.129993366862756,NaN,NaN,-6.9638796693880245,0.23935749819731678
2001-07-13T09:30:00-04:00,22.505036,22.854132,22.505036,22.846022,210994,1163141.45,49.67259009796533,48.81403007476731,NaN,NaN,-28.79656059054608,-85.28155955231217,-0.06056560328270671,-0.09482719917069105,-0.03426159588798434,-3172801,343773.2,18.363720304376287,53.48814321943143,NaN,NaN,-5.992500398876738,-0.6509079156704052
2001-07-16T09:30:00-04:00,22.878488,23.0571,22.521282,22.521282,610812,1068834.5,44.93241880231096,48.17420619125138,NaN,NaN,-42.272083406261,-82.58832546343203,-0.058724992874703334,-0.10766783698136351,-0.04894284410666017,-3783613,-1766171,14.552622065668999,49.38715928418189,NaN,NaN,-6.73014538821857,-1.5193704117487143
2001-07-17T09:30:00-04:00,22.537503,22.98404,22.48068,22.98404,347223,1066771.4,51.96673901683993,48.381222046166094,NaN,NaN,-23.994115458012498,-65.11156323011583,-0.024514535724286364,-0.07958601376201813,-0.05507147803773176,-3436390,-3527143.2,12.264827020911852,45.1804004998609,NaN,NaN,-4.941316766020662,-2.008219890930421
2001-07-18T09:30:00-04:00,22.73236,22.935328,22.66741,22.854132,758126,1015507.05,50.03449359653764,48.44052009293843,NaN,NaN,-25.33968080800583,-38.692165883816934,-0.009575340396253434,-0.06704065353304856,-0.05746531313679512,-4194516,-3594223,12.186236636351566,41.07101567791018,NaN,NaN,-4.155397932462233,-2.314959611149251
2001-07-19T09:30:00-04:00,23.040871,23.0571,22.610588,22.699893,255952,994142.8,47.76369945030616,47.98881541938781,NaN,NaN,-31.585005760845007,-30.39748920473408,-0.009029059377746874,-0.06875163735897871,-0.05972257798123184,-4450468,-3807557.6,11.92453663741344,37.139568388150444,NaN,NaN,-4.235838096206,-2.5893708233002153
2001-07-20T09:30:00-04:00,22.569986,22.66741,22.54563,22.594342,405237,977138.85,46.217837480056694,47.621726791711225,NaN,NaN,-68.35115849829747,-38.30840878628435,-0.01440488169637158,-0.07772868010169631,-0.06332379840532473,-4855705,-4144138.4,11.504754277364142,33.4581381587608,NaN,NaN,-4.771913015331021,-2.9011625650189017
2001-07-23T09:30:00-04:00,22.54563,22.724249,22.40762,22.472553,58630,954142.6,44.43098344136126,46.8107237848781,NaN,NaN,-79.22304775006154,-45.69860165504447,-0.024214193753314656,-0.09359154059696806,-0.0693773468436534,-4914335,-4370282.8,11.218983789698683,29.945846090113157,NaN,NaN,-5.745009137430024,-3.3074263610776335
2001-07-24T09:30:00-04:00,22.342662,22.496926,22.139695,22.180297,155689,949591.35,40.39501902290378,45.73363469362262,NaN,NaN,-134.63006812740352,-67.82579218892268,-0.047111727592535305,-0.12826700633432253,-0.08115527874178723,-5070024,-4697009.6,10.801529535734517,26.434459027578956,NaN,NaN,-7.820640791443961,-3.9521712797013944
2001-07-25T09:30:00-04:00,22.082864,22.367018,22.058508,22.350781,296106,916143.9,43.61273219512167,45.08935732168782,NaN,NaN,-119.96162479189513,-86.75018098570054,-0.04737401581177393,-0.14037279850650464,-0.0929987826947307,-4773918,-4812890,10.65016586484947,23.06544685343624,NaN,NaN,-8.603166971967854,-4.61659923573946
2001-07-26T09:30:00-04:00,22.204653,22.537503,22.204653,22.529392,261002,905785.1,46.84999068486646,45.24371813360195,NaN,NaN,-72.99778847651064,-95.03273752883366,-0.032808599893463436,-0.13400953256156,-0.10120093266809657,-4512916,-4825379.6,10.632871278546446,20.061331647196887,NaN,NaN,-8.304173609325757,-5.1433955748232165
2001-07-27T09:30:00-04:00,22.40762,22.724249,22.40762,22.659292,68607,894792,49.13708062138771,45.46425061784128,NaN,NaN,-26.06728850646874,-86.57596353046792,-0.012746854239315583,-0.11713450046724105,-0.10438764622792547,-4444309,-4743100.4,11.650719535915286,17.108202633970837,NaN,NaN,-7.386321673349699,-5.463813588898429
2001-07-30T09:30:00-04:00,22.569986,22.66741,22.529392,22.586232,243635,858542.4,47.88892094045486,46.14422641025244,NaN,NaN,-21.906470289510608,-75.11264803835773,-0.0032151658351963347,-0.10840660352192089,-0.10519143768672455,-4687944,-4697822.2,12.243058752680469,14.469158250598843,NaN,NaN,-6.972452151746903,-5.679333383591068
2001-07-31T09:30:00-04:00,22.691766,22.992167,22.634936,22.837903,129454,855783.35,52.376577309245356,47.18047345533387,NaN,NaN,49.85051222707403,-38.216531967462224,0.019947721631672882,-0.08025678564713346,-0.10020450727880634,-4558490,-4595515.4,13.65176667488835,13.194431554932246,NaN,NaN,-5.305178804827243,-5.62588272948195
2001-08-01T09:30:00-04:00,22.878488,23.081456,22.73236,22.935328,99892,854292.95,54.02707010863772,47.80758234057108,NaN,NaN,92.3983488493287,4.2554627607825495,0.04055105948916882,-0.049515682917345316,-0.09006674240651413,-4458598,-4532451.4,14.562206401775342,12.586285626869653,NaN,NaN,-3.43626356686166,-5.3130799919647655
2001-08-02T09:30:00-04:00,23.122058,23.122058,22.902861,22.902861,110608,853110.5,53.36333857461048,48.07120723176002,NaN,NaN,124.68875987912115,43.7927724319089,0.05008823216651655,-0.027456452198368453,-0.077544684364885,-4569206,-4543709.4,14.53274795130288,12.312644744507267,NaN,NaN,-2.063179297241673,-4.848808464147181
2001-08-03T09:30:00-04:00,22.943438,23.000277,22.764827,23.000277,123418,815770.75,55.143972564860235,48.800603929084964,NaN,NaN,100.80191135613919,69.1666124044305,0.06036406096172918,-0.002089608162723522,-0.0624536691244527,-4445788,-4544005.2,14.531916135420758,12.311165749489534,NaN,NaN,-0.4045871402095152,-4.213919703584658
2001-08-06T09:30:00-04:00,22.854132,22.967794,22.618698,22.66741,230455,773319.35,48.35075397653265,48.54231928334873,NaN,NaN,42.01799024759951,81.9515045118525,0.04296695143024846,-0.00874497983664213,-0.05171193126689059,-4676243,-4541665,14.573575360356216,12.476076345164136,NaN,NaN,-0.8067376023939334,-3.7271794034145542
2001-08-07T09:30:00-04:00,22.764827,22.910971,22.675521,22.910971,260263,716450.65,52.9208741504475,48.74848932291372,NaN,NaN,63.029218255618886,84.58724571756149,0.04582532344395552,0.005569723038053809,-0.04025560040590171,-4415980,-4513163,15.11624912265647,12.685362951328774,NaN,NaN,0.1842726727575387,-3.16840053538997
2001-08-08T09:30:00-04:00,22.73236,22.846022,22.448197,22.448197,1907817,350462.1,44.80815277919194,48.53737884640556,NaN,NaN,-35.53827638477012,58.99992067074172,0.01604850353781631,-0.020194970983631322,-0.03624347452144763,-6323797,-4886202.8,13.873989228442952,12.82460956497374,NaN,NaN,-1.4973106009487458,-2.9296734018983663
2001-08-09T09:30:00-04:00,22.488799,22.553749,22.334536,22.553749,699373,361664.65,46.81098112694203,48.57974624975452,NaN,NaN,-74.90282702881323,19.08160328915484,0.003610187509391169,-0.03173074013470867,-0.03534092764409984,-5624424,-5097246.4,13.212453077549938,12.946588050701298,NaN,NaN,-2.2476869181960337,-2.8322467613694617
2001-08-10T09:30:00-04:00,22.448197,22.634936,22.326425,22.569986,202002,361215.05,47.128823490713465,48.772449110422535,NaN,NaN,-57.15047256333084,-12.508873494739163,-0.0030167561030453385,-0.03911187277290651,-0.03609511666986117,-5422422,-5292573.2,12.613013489312337,13.046161600673702,NaN,NaN,-2.7577929531121392,-2.821610503046987
2001-08-13T09:30:00-04:00,22.651165,22.66741,22.40762,22.54563,80677,334708.3,46.67822575948064,49.22124959160659,NaN,NaN,-41.95168646641498,-29.302808837542056,-0.008237523365430141,-0.04639202087664884,-0.0381544975112187,-5503099,-5457944.4,12.111987667256855,13.1397657529253,NaN,NaN,-3.3020108821584424,-2.8902391286343376
2001-08-14T09:30:00-04:00,22.610588,22.764827,22.456324,22.553749,390333,336863.8,46.86061540629432,49.453241249547496,NaN,NaN,-19.24415147121957,-45.75748278290975,-0.010211991672451667,-0.05091948710178329,-0.04070749542933162,-5112766,-5597301.6,11.690552752998912,13.21407910207883,NaN,NaN,-3.7043199865372722,-3.0065363940490424
2001-08-15T09:30:00-04:00,22.513155,22.699893,22.456324,22.464443,113195,304617.25,45.03581084943755,49.323656975588285,NaN,NaN,-35.61415367882443,-45.772658241720606,-0.016242398496947162,-0.06101049355051558,-0.044768095053568414,-5225961,-5377734.4,16.61358981582994,13.641273283313366,NaN,NaN,-4.533927353433052,-3.224735102532472
2001-08-16T09:30:00-04:00,22.383264,22.464443,22.229001,22.399493,448347,314237,43.702897845304754,48.93550106301093,NaN,NaN,-101.40521800172336,-51.073136436302626,-0.022907502385477292,-0.07340247303541503,-0.050494970649937736,-5674308,-5387711.2,16.56839227629264,13.99253562191175,NaN,NaN,-5.594435773251362,-3.563263769778028
2001-08-17T09:30:00-04:00,22.24523,22.367018,21.977329,22.066618,384051,313177.7,37.56628439020402,48.198169880850166,NaN,NaN,-168.4973763929056,-73.34251720221759,-0.046667163084917765,-0.10882892450608495,-0.06216176142116718,-6058359,-5514898.6,15.971846276451373,14.258877587895384,NaN,NaN,-8.357601825309551,-4.248169206282531
2001-08-20T09:30:00-04:00,22.082864,22.302069,22.082864,22.285831,2267111,423601.75,43.22058928749221,47.54417073643923,NaN,NaN,-119.3978359111963,-88.83174709117387,-0.044556509855762594,-0.11785739874087042,-0.07330088888510783,-3791248,-5172528.4,23.913446683191324,14.991854731345597,NaN,NaN,-9.156783802187025,-4.949399862840316
2001-08-21T09:30:00-04:00,22.24523,22.594342,22.009796,22.009796,774631,454548.85,38.493149385645054,46.43460497051117,NaN,NaN,-122.64641404916979,-109.5121996067639,-0.05784550604894574,-0.14560777144629,-0.08776226539734426,-4565879,-5063151,26.309577789158467,15.830952687587251,NaN,NaN,-11.318775281491542,-5.8593106369333485
2001-08-22T09:30:00-04:00,22.123457,22.261475,21.961083,22.10722,2079150,543701.05,40.94817020723659,45.54780722998447,NaN,NaN,-146.88085742170284,-131.7655403553396,-0.05612495049888398,-0.15791845352094924,-0.10179350302206526,-2486729,-4515304.6,37.009773808063855,17.436454534498747,NaN,NaN,-12.380634316531218,-6.79092830544733
2001-08-23T09:30:00-04:00,22.123457,22.229001,22.050389,22.115347,220232,541662.55,41.15915907763303,44.54889198089681,NaN,NaN,-125.85144441055266,-136.65478563710545,-0.050657698875341134,-0.16511562661624168,-0.11445792774090055,-2266497,-3833742.4,47.268277401342395,19.77476605349315,NaN,NaN,-13.182946065194951,-7.704073699696989
2001-08-24T09:30:00-04:00,22.042262,22.237119,21.977329,22.17217,459679,561216.15,42.700696641460546,44.14531645696309,NaN,NaN,-109.42938173579084,-124.8411867056825,-0.0399055690028151,-0.16433988899441943,-0.12443431999160433,-1806818,-2983434.2,56.73506185147239,22.78630080285859,NaN,NaN,-13.433550277821002,-8.522570353714706
2001-08-27T09:30:00-04:00,22.204653,22.204653,21.888023,21.952957,1267074,612388.1,38.5092222351735,43.11591274872923,NaN,NaN,-121.25258057249621,-125.2121356379425,-0.043929644029651216,-0.17934637502866835,-0.13541673099901713,-3073892,-2839963,58.10184152672589,25.856700260292122,NaN,NaN,-14.856935521459224,-9.427479663392495
2001-08-28T09:30:00-04:00,21.879896,21.92049,21.603861,21.603861,963085,654069.65,32.96054467173738,42.26965502676819,NaN,NaN,-167.84359505433324,-134.25157183897517,-0.0651929144472049,-0.21690787405802325,-0.15171495961081835,-4036977,-2734182.6,59.127076205519394,29.08906361579758,NaN,NaN,-17.904152368987482,-10.638432907048921
2001-08-29T09:30:00-04:00,21.741879,21.766235,21.368427,21.409012,859497,692049.9,30.333400912790523,41.09268501147166,NaN,NaN,-182.84643365435673,-141.44468708550596,-0.08615445175569161,-0.25940802430543286,-0.17325357254974125,-4896474,-3216131.6,52.789066539096524,31.91596457733662,NaN,NaN,-21.33210204569632,-12.166099926855692
2001-08-30T09:30:00-04:00,21.392783,21.514555,21.181688,21.262875,705531,721796.05,28.498716190248615,39.76196306143845,NaN,NaN,-193.5139422454849,-154.9771866524924,-0.1025229807112556,-0.30140729843881076,-0.19888431772755516,-5602005,-3883233.2,45.516164560691706,34.26618965386372,NaN,NaN,-24.77430172094471,-13.96727161172555
2001-08-31T09:30:00-04:00,21.392783,21.59575,21.254748,21.327825,1233202,777285.25,30.5104183748783,38.607119676824006,NaN,NaN,-160.15548222003335,-165.12240674934088,-0.10144988586341896,-0.32569667505682887,-0.2242467891934099,-4368803,-4395630.2,40.85968168421961,36.31959636936106,NaN,NaN,-26.993974530258342,-15.828229171515948
2001-09-04T09:30:00-04:00,21.197926,21.636327,21.027425,21.238519,905440,811034.5,29.290143921527303,37.352085999340645,NaN,NaN,-155.54490689871113,-171.9808720145839,-0.0991140052599137,-0.34813929576830205,-0.24902529050838834,-5274243,-4835700.4,37.32766132617716,38.150818410302364,NaN,NaN,-29.205948299154798,-17.739331904035783
2001-09-05T09:30:00-04:00,21.011196,21.311587,20.800109,21.10862,1493835,872713.1,27.563309970058114,36.10405022224211,NaN,NaN,-162.54581663748186,-170.92131633121363,-0.09847373529073888,-0.372117459621812,-0.2736437243310731,-6768078,-5381920.6,33.46130741866463,39.35422681050484,NaN,NaN,-31.600393795354403,-19.719483602795584
2001-09-06T09:30:00-04:00,20.848813,21.003077,20.564667,20.62149,2383879,896516.2,22.262652581324843,34.572604131957824,NaN,NaN,-176.36441011596347,-169.62491162353496,-0.1215030115288358,-0.42552248874211784,-0.30401947721328204,-9151957,-6233017.2,28.50665818442684,40.20696008965729,NaN,NaN,-35.66097704396157,-21.99683980867644
2001-09-07T09:30:00-04:00,20.304861,20.629617,20.061316,20.215555,1966447,959869.9,18.986014474368787,33.24544199511245,NaN,NaN,-190.33257308919474,-168.98863779227693,-0.15270206290538402,-0.4948970558450121,-0.3421949929396281,-11118404,-7336297,23.623453862209573,40.753503488640014,NaN,NaN,-40.41538538016315,-24.628060604603114
2001-09-10T09:30:00-04:00,19.947654,20.459124,19.842103,20.256156,835848,991562.2,20.250301078943494,31.604707123073265,NaN,NaN,-171.005098429945,-171.15856103425926,-0.15854134201642323,-0.5403716704601571,-0.3818303284437339,-10282556,-8519047.6,19.72293542903327,40.45418125620015,NaN,NaN,-43.68773798390656,-27.35087165878932
2001-09-17T09:30:00-04:00,18.064108,19.444286,17.86114,19.363108,1865323,1080794.5,14.784857303478802,29.911257688632816,NaN,NaN,-246.3753115707035,-189.32464196865772,-0.20740145272954996,-0.6410821443556713,-0.4336806916261214,-12147879,-9893774.8,16.344867509354245,39.74241623621413,NaN,NaN,-49.11600640156804,-30.460176622043424
2001-09-18T09:30:00-04:00,19.241319,19.403685,19.078945,19.119538,3655388,1244047.25,13.698898682739838,27.96488115116876,NaN,NaN,-181.35927702793697,-193.08733404674874,-0.23874398097302474,-0.7321106678424023,-0.49336668686937757,-15803267,-11700812.6,13.155293041619927,38.03852475289671,NaN,NaN,-53.72899869664561,-33.784294061272305
2001-09-19T09:30:00-04:00,19.119538,19.363108,18.307669,18.981521,1040191,1290397.05,13.11122935395666,25.96145759947759,NaN,NaN,-169.54050114016715,-191.7225522515895,-0.2501835090803708,-0.806096073219841,-0.5559125641394702,-16843458,-13239112.8,11.158957621118745,35.45928762573788,NaN,NaN,-57.47757015165853,-37.16904778847034
2001-09-20T09:30:00-04:00,18.494399,18.689247,18.104701,18.145303,777833,1306871.35,10.24386526975266,23.64311250149845,NaN,NaN,-171.2729934953785,-187.91063633282624,-0.292535881192312,-0.9215824156298602,-0.6290465344375482,-17621291,-14539690.2,9.80430048588498,32.10709038533878,NaN,NaN,-62.05999721922558,-40.72489770714966
2001-09-21T09:30:00-04:00,17.171042,18.226482,17.171042,17.779945,1091430,1342240.3,9.28810228118742,21.5558896476423,NaN,NaN,-170.25669206500226,-187.7609550598377,-0.3213277100825941,-1.0307061720407908,-0.7093784619581968,-18712721,-16225723.2,8.383464798934895,28.555777761925132,NaN,NaN,-66.00664275887907,-44.33657557168243
2001-09-24T09:30:00-04:00,18.632416,18.908444,18.388847,18.705477,972692,1277519.35,27.692688773883972,21.179614226367057,NaN,NaN,-102.11057146820346,-158.9080070393377,-0.2569967830514701,-1.0306244407725345,-0.7736276577210643,-17740029,-17344153.2,7.596971279360574,24.875055981485218,NaN,NaN,-61.64835706319525,-46.809687213327116
2001-09-25T09:30:00-04:00,18.681121,19.16014,18.681121,19.005877,713784,1274477,32.480985745512896,21.33301314299008,NaN,NaN,-77.42899347407885,-138.12195032856607,-0.17697936635716494,-0.9948518656675205,-0.8178724993103555,-17026245,-17588748.8,7.432744001469402,21.635318657368995,NaN,NaN,-56.48403790952099,-48.19173731278338
2001-09-26T09:30:00-04:00,19.322506,19.322506,18.932817,19.192607,359047,1188471.85,35.34705088829449,21.822179907136213,NaN,NaN,-60.0307341392258,-116.21999692837781,-0.09817538911638812,-0.9405917357058406,-0.8424163465894525,-16667198,-17553496.8,7.742291485053983,18.937184866252014,NaN,NaN,-51.5383724355646,-48.66982804460927
2001-09-27T09:30:00-04:00,19.200717,19.582304,19.070834,19.509236,179339,1186427.2,39.998053455888524,22.499868127208373,NaN,NaN,-41.53245143072377,-90.27188851544686,-0.01574939463832814,-0.8621030898873627,-0.8463536952490346,-16487859,-17326810.4,9.830415761418863,16.720808728909102,NaN,NaN,-45.939310353707896,-48.27975408876622
2001-09-28T09:30:00-04:00,19.655381,20.142495,19.655381,20.036943,433320,1185109.25,46.859430609430845,23.75481717634434,NaN,NaN,-5.21975411588946,-57.26450092562429,0.07813230414034722,-0.7486883150736006,-0.8268206192139478,-16054539,-16795174,14.706206262872143,15.104990510101603,NaN,NaN,-38.76560893228455,-46.920590494983124
2001-10-01T09:30:00-04:00,19.963883,20.118139,19.850221,19.980121,316429,1137577,46.246190907172384,25.089308671852503,NaN,NaN,3.3739032236382,-36.16760598725595,0.13679142811929557,-0.6558313340648283,-0.7926227621841239,-16370968,-16521361.8,17.189861168203592,13.942744349354385,NaN,NaN,-33.52027363141145,-45.00625951447289
2001-10-02T09:30:00-04:00,20.012587,20.369818,19.890815,20.256156,431965,1111021,49.69059990720324,27.048447766558102,NaN,NaN,22.263288884327594,-16.22914951557467,0.19122909717047232,-0.5535863907210334,-0.7448154878915058,-15939003,-16303913.4,19.20202076705833,13.27812739097092,NaN,NaN,-28.09727871942909,-42.59069082946663
2001-10-03T09:30:00-04:00,20.191207,20.78388,20.191207,20.580913,3206671,1228379.7,53.46834799450554,29.51147158942501,NaN,NaN,52.47241887499505,6.271481087269502,0.24284060191285017,-0.4412647355004431,-0.6841053374132933,-12732332,-15516940.2,26.191924629902772,13.461589588663289,NaN,NaN,-22.351426924330852,-39.69936741444723
2001-10-04T09:30:00-04:00,20.662092,20.743279,20.312987,20.418522,2511978,1318702.05,51.3903112509712,31.735758030284135,NaN,NaN,55.81802382571761,25.741576138557775,0.2583330311090014,-0.3611890485270415,-0.6195220796360429,-15244310,-15268230.4,28.30293194574766,14.074446482714318,NaN,NaN,-18.355128514549385,-36.650190428747536
2001-10-05T09:30:00-04:00,20.540311,20.540311,19.647254,19.858348,4038084,1458946.15,44.906748193125345,33.88732166525889,NaN,NaN,26.489195739570206,32.08336610964972,0.2244002097573865,-0.3390218174393098,-0.5634220271966963,-19282394,-15913801.4,26.207617543833123,14.778928628034237,NaN,NaN,-16.942068808455243,-33.834744482991496
2001-10-08T09:30:00-04:00,19.631008,19.663491,19.322506,19.411812,1601857,1493767,40.51838256132194,35.802999085157616,NaN,NaN,-12.313135556460226,28.945958353630033,0.16800807166661313,-0.3534119376134299,-0.5214200092800431,-20884251,-16816458,23.579114443366393,15.523487299587556,NaN,NaN,-17.20611165963572,-31.459225508226385
2001-10-09T09:30:00-04:00,19.444286,19.712204,19.330625,19.574186,6147906,1726470.55,42.710729024457756,37.91724906162197,NaN,NaN,1.3344529877086844,24.76019117430625,0.1389713273106598,-0.3477058501417183,-0.4866771774523781,-14736345,-16575926.4,25.717096632063644,16.563354371797907,NaN,NaN,-16.72304760216808,-29.35405723593234
2001-10-10T09:30:00-04:00,19.460524,20.004477,19.460524,19.882704,2170298,1715791.5,46.72836983396183,40.52328510192263,NaN,NaN,32.96693947556738,20.85909529442072,0.13761239280074994,-0.31466168645144066,-0.4522740792521906,-12566047,-16542669.4,26.025252980445003,17.721993835695052,NaN,NaN,-15.053842504088449,-27.3111694170975
2001-10-11T09:30:00-04:00,20.012587,20.29675,19.97201,20.199326,974047,1666171.5,50.56031077561891,43.47129999438202,NaN,NaN,75.1263292937619,24.720756388029592,0.15387614275485856,-0.2599289008086174,-0.41380504356347597,-11592000,-15812207.4,32.63542919835854,19.454277007082453,NaN,NaN,-12.447526300442313,-25.187791829003903
2001-10-12T09:30:00-04:00,19.647254,19.931409,19.525474,19.882704,2234717,1736114.95,46.92523118290798,44.84505302359802,NaN,NaN,37.24484825009905,26.871886890135364,0.1395700097138825,-0.23934253142112283,-0.37891254113500533,-13826717,-14721072,41.10179977887731,21.84747904276222,NaN,NaN,-11.39025272531132,-23.216714814190677
2001-10-15T09:30:00-04:00,19.712204,20.093783,19.606652,19.97201,443297,1665013.65,48.05954742970337,45.95780742961163,NaN,NaN,45.09948284149878,38.354410569727165,0.13244048573633938,-0.21336193396458114,-0.3458024197009205,-13383420,-13220905.8,50.34234052786739,24.912450223219217,NaN,NaN,-10.198637134607756,-21.356989431393117
2001-10-16T09:30:00-04:00,20.053189,20.451005,20.053189,20.29675,1147967,1539642.6,52.07085152152595,47.15236461769958,NaN,NaN,80.46170431538374,54.17986083526216,0.14490585191991584,-0.16467010480102573,-0.30957595672094157,-12235453,-12720727.4,52.99054098356344,28.144468044541323,NaN,NaN,-7.967868655356551,-19.44425789195932
2001-10-17T09:30:00-04:00,20.702685,20.702685,20.093783,20.093783,734846,1524375.35,49.49784730283681,47.83092132105304,NaN,NaN,77.22199361895957,63.030871663940594,0.134992162878797,-0.14083575312244534,-0.27582791600124235,-12970299,-12801577.8,52.50313398471815,31.192519346205557,NaN,NaN,-6.859889434696248,-17.64649096949317
2001-10-18T09:30:00-04:00,20.174978,20.256156,19.850221,20.069426,1247367,1547852.05,49.18375984775326,47.99694483807607,NaN,NaN,45.29558361008741,57.064722527205696,0.12266220602747771,-0.12250015846689521,-0.24516236449437293,-14217666,-13326711,49.3293951580641,33.665604267290696,NaN,NaN,-6.0475826859500215,-15.989504071844149
2001-10-19T09:30:00-04:00,19.890815,19.907052,19.501117,19.744687,1556037,1571082.4,45.076867287189515,47.91342172236301,NaN,NaN,-16.21430677527014,46.372891522131866,0.0900148865636225,-0.13264375628984482,-0.22265864285346731,-15773703,-13716108.2,47.057826574937614,35.7990303677717,NaN,NaN,-6.515772946574211,-14.6361139110913
2001-10-22T09:30:00-04:00,19.728441,20.329217,19.728441,20.223682,683606,1556628.1,51.508725075279685,48.04328780579704,NaN,NaN,42.67963564429151,45.88892208269041,0.09743172833659339,-0.10086898243272557,-0.19830071076931896,-15090097,-14057443.6,45.097425191430155,37.64870211236968,NaN,NaN,-5.0009783332764455,-13.259665971403464
2001-10-23T09:30:00-04:00,20.337344,20.499718,20.174978,20.272394,549349,1548406.35,52.12276953480772,47.947175058675775,NaN,NaN,83.64838336328707,46.526257892271076,0.10188948464178108,-0.07093885496709262,-0.1728283396088737,-14540748,-14518502.6,42.52067038709629,38.815041095026366,NaN,NaN,-3.595111198923256,-11.879015289620577
2001-10-24T09:30:00-04:00,20.215555,20.3617,20.093783,20.199326,235998,1542253.9,51.077939787963025,47.92486281131805,NaN,NaN,55.78524799498079,42.23890876747532,0.09625491870583308,-0.05250969122658233,-0.14876460993241541,-14776746,-14879792,40.564739786590486,39.69088451222943,NaN,NaN,-2.71953592453574,-10.5705182374656
2001-10-25T09:30:00-04:00,19.97201,20.564667,19.850221,20.467251,158153,1541194.6,54.66640628307412,48.621981246314384,NaN,NaN,69.75041849873712,47.12987574520526,0.10613204617502973,-0.016099552213628243,-0.12223159838865798,-14618593,-14959977.4,40.123598226478464,40.684883132418385,NaN,NaN,-0.940586196175187,-9.194813660138399
2001-10-26T09:30:00-04:00,20.459124,20.743279,20.459124,20.702685,458570,1542457.1,57.60892486792801,49.84273426821482,NaN,NaN,145.11974416323358,79.39668593290601,0.12289843109937737,0.03139144048556375,-0.09150699061381362,-14160023,-14637241.4,42.81896628813952,42.059158264187886,NaN,NaN,1.4382888322939855,-7.675799018362344
2001-10-29T09:30:00-05:00,20.377945,20.442878,19.97201,19.97201,378878,1545579.55,47.33918207775361,50.173338057735954,NaN,NaN,9.945201375117014,72.8497990790711,0.08116901776915712,0.009954281597632786,-0.07121473617152434,-14538901,-14527002.2,43.75040673922607,43.34725184327092,NaN,NaN,0.448521067710371,-6.515181863209099
2001-10-30T09:30:00-05:00,19.80962,20.093783,19.525474,19.931409,786825,1563322.55,46.83951657553445,50.18127711070542,NaN,NaN,-58.237009923280425,44.47272042175761,0.04881700607726976,-0.010193478574937131,-0.059010484652206895,-15325726,-14683997.8,42.684044476064585,44.53716552152946,NaN,NaN,-0.49179019597329376,-5.65469733931827
2001-10-31T09:30:00-05:00,20.069426,20.069426,19.631008,19.752797,658972,1435937.6,44.60883253569828,49.75617152213967,NaN,NaN,-59.285887215997676,21.45849337956191,0.015119710541229264,-0.040110846475670314,-0.05523055701689958,-15984698,-14925588.2,41.02687110868552,45.13655422940996,NaN,NaN,-1.9437974944424217,-5.124568790050292
2001-11-01T09:30:00-05:00,19.801509,20.101893,19.403685,20.077545,614384,1341057.9,49.33345868786704,49.92818777249388,NaN,NaN,-41.53787785948748,-0.7991658920830048,0.014434483448827584,-0.0371874527058651,-0.05162193615469268,-15370314,-15075932.4,39.98645521938983,45.056886760875145,NaN,NaN,-1.7973034167661057,-4.649245165295408
2001-11-02T09:30:00-05:00,19.890815,20.248038,19.890815,20.183088,1045610,1191434.2,50.802183369459755,50.124090339619336,NaN,NaN,25.76274795516981,-24.670565133695757,0.020454451938593632,-0.026053871231450643,-0.046508323170044275,-14324704,-15108868.6,39.74864397115806,44.300194149681616,NaN,NaN,-1.2509156482703938,-4.16376952000612
2001-11-05T09:30:00-05:00,20.580913,20.629617,20.377945,20.62149,187837,1120733.2,56.449476025616335,50.436849232768644,NaN,NaN,137.0950056929808,0.759395729877005,0.05155719434948445,0.017938169766811285,-0.033619024582673164,-14136867,-15028461.8,40.676225796396764,43.42060020774114,NaN,NaN,0.9607296021252487,-3.431698216844496
2001-11-06T09:30:00-05:00,20.62149,20.889415,20.386056,20.873186,1102270,868451.4,59.33549030531612,51.139538018660026,NaN,NaN,170.5007867994665,46.506955074426386,0.08471822635241864,0.07227875835785014,-0.012439467994568503,-13034597,-14570236,45.7974799221352,42.941624917556645,NaN,NaN,3.7153066703917372,-2.4106975186678916
2001-11-07T09:30:00-05:00,20.718922,21.189815,20.718922,20.954365,522620,786067.5,60.250424075227535,51.93001403490819,NaN,NaN,199.2115759192318,98.20644770147229,0.10635591174655906,0.12050542168863032,0.014149509942071262,-12511977,-13875691.8,52.491998476072546,43.167525154557254,NaN,NaN,6.236033232981457,-1.1754502684322705
2001-11-08T09:30:00-05:00,21.189815,21.327825,20.905653,21.019314,261495,750439.9,61.00635379335893,53.06783449963458,NaN,NaN,188.07955378776413,144.12993403092258,0.11835853618746994,0.1620976801764087,0.043739143988938745,-12250482,-13251725.4,57.56296665106363,43.91789230285196,NaN,NaN,8.532003762009658,0.2113288787737191
2001-11-09T09:30:00-05:00,20.824457,21.019314,20.678329,20.881296,324682,654938.15,58.46203911635356,53.56449978828272,NaN,NaN,122.309689708501,163.43932238158885,0.1104702508609348,0.18182695756510725,0.07135670670417245,-12575164,-12901817.4,60.132868090713394,44.99185250994362,NaN,NaN,9.785042072995859,1.5790021922340247
2001-11-12T09:30:00-05:00,20.62149,20.946246,20.29675,20.78388,259647,645755.65,56.665672209332904,53.88899283646309,NaN,NaN,73.21480744012803,150.66328273101828,0.09286758633349151,0.18744118962103684,0.09457360328754533,-12834811,-12641406.2,61.978281467921775,46.38168187285972,NaN,NaN,10.359525724792231,2.833362696885197
2001-11-13T09:30:00-05:00,21.230392,21.344054,21.076153,21.344054,453028,611008.7,63.5932355916364,54.78294253672548,NaN,NaN,157.40267218712538,148.04365980855005,0.11185309141869584,0.23438996756091512,0.12253687614221928,-12381783,-12510843.4,62.90539704507675,47.97744310560875,NaN,NaN,12.982801700407256,4.283282554531205
2001-11-14T09:30:00-05:00,21.555148,21.555148,21.17357,21.303477,661435,607338.15,62.80995280659608,55.36462443126276,NaN,NaN,144.66617420869648,137.13457946644297,0.11418263966082318,0.26526517571824826,0.15108253605742508,-13043218,-12617091.6,61.58928131080345,49.51070618306053,NaN,NaN,14.894978576677396,5.799239129123517
2001-11-15T09:30:00-05:00,21.43336,21.514555,21.17357,21.17357,269624,558451,60.25129986177797,55.55336550225204,NaN,NaN,119.08060830863167,123.3347903706165,0.09998936082357213,0.27606923708689024,0.1760798762633181,-13312842,-12829563.6,58.93384576998768,50.661769003192546,NaN,NaN,15.792045889340406,7.226782952011644
2001-11-16T09:30:00-05:00,21.352181,21.352181,20.905653,21.068027,185251,489911.7,58.17771810834841,56.327546647294525,NaN,NaN,84.5633779181663,115.78552801254955,0.07751088678541676,0.27296848474508906,0.1954575979596723,-13498093,-13014149.4,56.648761036843645,51.58308002445094,NaN,NaN,15.976426192003606,8.47673198629621
2001-11-19T09:30:00-05:00,21.270994,21.498318,21.116731,21.498318,273935,469428.15,63.667636664209994,57.52955522505706,NaN,NaN,112.17348150202596,123.57726282492914,0.08503678274348794,0.3017535763890322,0.21671679364554428,-13224158,-13092018.8,55.66814830922929,52.51051601253413,NaN,NaN,17.7656204223108,9.803716048584008
2001-11-20T09:30:00-05:00,21.189815,21.425249,21.189815,21.376537,1038959,493908.65,61.218338418659,58.7159485024114,NaN,NaN,95.56375695451679,111.20947977840743,0.0755485553036902,0.311152487775157,0.23560393247146683,-14263117,-13468285.6,51.06802059093367,53.22774097555185,NaN,NaN,18.549088353920272,11.05305494934633
2001-11-21T09:30:00-05:00,21.149214,21.270994,21.003077,21.189815,71316,485674.55,57.56189653778755,59.30369406312001,NaN,NaN,63.69961804619625,95.01616854590736,0.0515770201519726,0.3000752076614326,0.24849818750945998,-14334433,-13726528.6,48.12845996930229,53.80931274340274,NaN,NaN,18.15660351975233,12.067847602261473
2001-11-23T09:30:00-05:00,21.068027,21.538911,21.068027,21.514555,66266,481080.2,61.83167389834345,60.09151481518314,NaN,NaN,86.6933372885795,88.53871434189693,0.05230701130808635,0.3138819516445679,0.26157494033648154,-14268167,-13917593.6,46.017901118822714,54.257116825378795,NaN,NaN,19.07920942566034,13.069470719889882
2001-11-26T09:30:00-05:00,21.457716,21.685056,21.3603,21.628217,444159,480359.65,63.22627832169523,60.57557212204592,NaN,NaN,101.50612408112475,91.92726357448862,0.05489145016050723,0.33018925303711555,0.2752978028766083,-13824008,-13982776.6,45.288243919956884,54.58654669134738,NaN,NaN,20.252403106442188,14.095603917968782
2001-11-27T09:30:00-05:00,21.555148,21.790591,21.3603,21.676929,860852,504458.35,63.83613545631031,60.89704677568836,NaN,NaN,101.29354431280049,89.75127613664353,0.05423267436385093,0.34308864583142196,0.288855971467571,-12963156,-13930576.2,46.02631519470426,54.60289206795945,NaN,NaN,21.39087469718316,15.13778545785655
2001-11-28T09:30:00-05:00,21.352181,21.571394,20.986848,21.027425,640989,497166.55,51.55834893451353,60.27618426563736,NaN,NaN,37.75753917104285,78.19003257994873,0.0068935273773676475,0.29747288068928057,0.2905793533119129,-13604145,-13798781.8,47.93600550181742,54.277463998369804,NaN,NaN,18.556334573179342,15.626149617188377
2001-11-29T09:30:00-05:00,21.149214,21.287231,20.946246,21.254748,718218,500128.85,54.83269023822536,59.83520829741354,NaN,NaN,25.926844920748994,70.63547795485928,-0.011281036643624065,0.27647805750738286,0.2877590941510069,-12885927,-13509080.6,51.95969664098879,53.8772304262216,NaN,NaN,17.215286294674048,15.853169142543473
2001-11-30T09:30:00-05:00,21.189815,21.230392,21.027425,21.035552,420141,490416.7,51.23637824174672,59.319089663513054,NaN,NaN,2.0812533543577265,53.71306116801493,-0.03869315206145568,0.2393926540741873,0.278085806135643,-13306068,-13316660.8,54.47626749356211,53.47318752642508,NaN,NaN,14.954052222941492,15.72472386831462
2001-12-03T09:30:00-05:00,20.824457,20.865059,20.629617,20.743279,424698,459371.1,46.82628039661197,58.61627596260441,NaN,NaN,-108.49076711267685,11.713682929254617,-0.07503361124557589,0.18429379207867314,0.25932740332424903,-13730766,-13298012.4,54.723810006414475,52.95501099346028,NaN,NaN,11.608185312300726,15.136646931741206
2001-12-04T09:30:00-05:00,20.78388,21.10862,20.678329,21.027425,1203887,510173.6,51.22201246509661,57.732617167851565,NaN,NaN,-64.76771163781487,-21.49856826086846,-0.07810842567356785,0.16169187123228923,0.23980029690585708,-12526879,-13210757,55.93128390459326,52.4568600548543,NaN,NaN,10.160882589756321,14.425823454314793
2001-12-05T09:30:00-05:00,21.027425,21.555148,21.027425,21.319698,937958,501958,55.31402749327046,57.197193931185446,NaN,NaN,45.25627534067124,-19.998821026942785,-0.05947512052218121,0.16545639625313058,0.22493151677531179,-11588921,-12807712.2,61.09286569774468,52.42140179677868,NaN,NaN,10.243749952849155,13.828384382676845
2001-12-06T09:30:00-05:00,21.327825,21.636327,21.311587,21.59575,376168,494635.4,58.82728312765504,57.095478450176664,NaN,NaN,107.52239856818593,-3.6797102974553924,-0.029112005715249467,0.18854150963124994,0.2176535153464994,-11212753,-12473077.4,64.78119351598086,52.83906949292105,NaN,NaN,11.442584346992797,13.487555806150553
2001-12-07T09:30:00-05:00,21.441487,21.628217,21.368427,21.449605,961607,529641,56.303501976526654,56.96160586933225,NaN,NaN,86.84123749642538,13.272286530958132,-0.019865832172295456,0.1928212251311301,0.21268705730342555,-12174360,-12246735.8,67.0560495052601,53.58244724066508,NaN,NaN,11.637705841874649,13.22329152553971
2001-12-10T09:30:00-05:00,21.514555,21.514555,21.068027,21.10862,192025,523008.15,50.824721436435816,56.04425478163411,NaN,NaN,-2.3272738238269866,34.5049851887281,-0.03672900337443724,0.16677580308537898,0.20350480645981622,-12366385,-11973859.6,69.60503239174103,54.5779389608445,NaN,NaN,10.062049805367826,12.771685565515154
2001-12-11T09:30:00-05:00,21.197926,21.473961,21.10862,21.230392,1121115,566081.55,52.59864971688718,55.428562731507554,NaN,NaN,1.969627728253935,47.852453061941866,-0.03945722725777706,0.15418327238759488,0.19364049964537194,-11245270,-11717537.8,71.81135969769349,56.05960603989877,NaN,NaN,9.319822726293125,12.278562302769151
2001-12-12T09:30:00-05:00,21.10862,21.29535,20.978721,21.149214,650104,575935.35,51.27084175638164,54.979201675692835,NaN,NaN,-50.75243041755113,28.650711910297396,-0.046044785866487414,0.13608451731226268,0.1821293031787501,-11895374,-11778828.4,70.49367524864296,57.657121416994535,NaN,NaN,8.321061381706304,11.713205028331602
2001-12-13T09:30:00-05:00,21.027425,21.027425,20.78388,20.816347,2517890,668758.1,46.128647575446266,53.857556938343045,NaN,NaN,-139.82184159752572,-20.818136122844937,-0.0706632286133404,0.09380026741207459,0.164463496025415,-14413264,-12418930.6,58.43426690769569,58.544004687628316,NaN,NaN,5.868210932482114,10.878205871781676
2001-12-14T09:30:00-05:00,20.865059,20.865059,20.629617,20.702685,1100299,710291.85,44.487873056636104,52.51909941941024,NaN,NaN,-163.6276892847344,-70.91192147907688,-0.09114233398400345,0.050535578545410687,0.14167791252941414,-15513563,-13086771.2,49.01325461646887,58.81007688023631,NaN,NaN,3.352903411314946,9.80316266314357
2001-12-17T09:30:00-05:00,20.702685,21.035552,20.702685,20.986848,149531,708505.85,49.3394711721375,51.48362339911218,NaN,NaN,-94.99126434818692,-89.44471958394888,-0.08235744041230704,0.038731112014030344,0.12108855242633738,-15364032,-13686300.6,42.4039122577327,58.551333813309775,NaN,NaN,2.615070853289498,8.776292404592988
2001-12-18T09:30:00-05:00,21.149214,21.181688,20.970602,21.181688,226637,706140.95,52.41062936762153,51.54450057290562,NaN,NaN,-25.141042722803817,-94.86685367416042,-0.061203633798073614,0.04458401017874536,0.10578764397681897,-15137395,-14464725.6,35.676892540375135,57.67568288749247,NaN,NaN,2.911103404350881,7.938408261701259
2001-12-19T09:30:00-05:00,21.027425,21.59575,21.027425,21.59575,492689,678827.45,58.20877955816099,51.78564981004387,NaN,NaN,70.654150189477,-70.5855375527548,-0.01927641825308879,0.08169212116045799,0.10096853941354678,-14644706,-15014592,31.834988120012056,56.2382037074227,NaN,NaN,5.011903701333309,7.520336181648695
2001-12-20T09:30:00-05:00,21.473961,21.59575,21.319698,21.506444,1055095,728016.4,56.606831997695885,52.16925364975453,NaN,NaN,82.73764396928169,-26.07364043939333,0.001393438697425517,0.10271033778532868,0.10131689908790316,-15699801,-15271899.4,30.19631166986335,54.503921148587075,NaN,NaN,6.235423865059981,7.336777279278879
2001-12-21T09:30:00-05:00,21.327825,21.352181,21.068027,21.262875,574845,753445.35,52.37336355595515,52.5654738754219,NaN,NaN,9.14017870454723,8.479933158462996,-0.002191833154428266,0.09857710764486782,0.10076894079929609,-16274646,-15424116,29.237521658773133,52.6834719808984,NaN,NaN,6.000790735096354,7.145922058681375
2001-12-24T09:30:00-05:00,21.270994,21.270994,21.141087,21.246638,218261,742150.45,52.093671004770194,52.6277351996843,NaN,NaN,12.924200207847882,30.063026069669952,-0.006279011182702271,0.09292017682091824,0.09919918800362051,-16492907,-15649891,27.82621232604329,50.67596686814484,NaN,NaN,5.73110346770581,6.943805117113437
2001-12-26T09:30:00-05:00,21.303477,21.43336,21.246638,21.344054,103218,704268.75,53.69153569132065,52.51184292811646,NaN,NaN,63.692465755570886,47.829727765344884,-0.0031991375703684932,0.0952002660406599,0.09839940361102839,-16389689,-15900349.8,26.30905032603762,48.191408627308626,NaN,NaN,5.952695664754661,6.802218052490755
2001-12-27T09:30:00-05:00,21.352181,21.43336,21.197926,21.327825,664145,705426.55,53.372155483432316,52.12219095352912,NaN,NaN,51.7958535690751,44.05806844126452,-0.0030338138254895064,0.09460713632916651,0.09764095015465601,-17053834,-16382175.4,23.63885761866537,45.25267034892895,NaN,NaN,6.050548695242116,6.69483671574095
2001-12-28T09:30:00-05:00,21.392783,21.652573,21.392783,21.555148,1564659,747748.6,57.211568574529466,52.18705285338647,NaN,NaN,113.43021587973331,50.19658282335488,0.010845894316301147,0.11119831805003244,0.1003524237337313,-15489175,-16340050.2,24.361654454838487,42.203070702470264,NaN,NaN,7.201209444193818,6.7671756769485025
2001-12-31T09:30:00-05:00,21.59575,21.636327,21.352181,21.352181,2225109,837997,53.01418796028211,52.34344331937549,NaN,NaN,77.67840084712657,63.90422725187075,0.0051090931192223354,0.10673879013275922,0.10162969701353688,-17714284,-16627977.8,22.77484335628111,38.85805719993741,NaN,NaN,7.036186536962276,6.805605799807613
2002-01-02T09:30:00-05:00,21.230392,21.43336,21.027425,21.327825,633229,848423.55,52.51627477671033,52.33755939507714,NaN,NaN,9.911576289418033,63.301702468184786,-0.0012353314026976314,0.10008553276016485,0.10132086416286248,-18347513,-16998899,20.88735237077269,35.22062810515736,NaN,NaN,6.764752349584457,6.7997695926328765
2002-01-03T09:30:00-05:00,21.43336,21.514555,21.279121,21.473961,194242,797941.3,55.2330573398587,52.62057479389693,NaN,NaN,65.5365297178951,63.67051526064962,0.00325519947384334,0.10538986350516666,0.10213466403132332,-18153271,-17351615.4,19.253309105575596,31.56060195208112,NaN,NaN,7.2652381967763375,6.866265107510514
2002-01-04T09:30:00-05:00,21.59575,21.839295,21.59575,21.758116,763422,789214.5,60.022731652279845,53.61300937081361,NaN,NaN,161.97425498334152,85.7061955435029,0.0231021003217637,0.13101228943352794,0.10791018911176424,-17389849,-17418818.4,18.94913844723942,28.740235633477102,NaN,NaN,9.096411235417841,7.1848574114972745
2002-01-07T09:30:00-05:00,21.839295,21.912379,21.59575,21.701285,495399,795176.05,58.670707188285434,54.626068951645706,NaN,NaN,150.85410859085394,93.19097408572704,0.029720084753286857,0.1450602950533728,0.11534021030008595,-17885248,-17898033,16.898933424985415,26.446355548371137,NaN,NaN,10.25184210771325,7.622998082385271
2002-01-08T09:30:00-05:00,21.717522,21.717522,21.279121,21.400893,338477,764019.55,52.002885416523384,54.8163128262447,NaN,NaN,59.167307973413386,89.4887555109844,0.012088282880109033,0.13045056390022225,0.11836228102011322,-18223725,-17999921.2,16.490409223687706,24.595391045939348,NaN,NaN,9.355067640818877,7.870436590732929
2002-01-09T09:30:00-05:00,21.514555,21.758116,21.400893,21.514555,494783,779157.45,54.127249991220864,54.938928585073214,NaN,NaN,81.49742930525352,103.8059261141515,0.006577880269402703,0.1265846313568666,0.12000675108746389,-17728942,-17876207,19.049343972568778,23.407709005381754,NaN,NaN,9.208483678138547,8.061586174648017
2002-01-10T09:30:00-05:00,21.43336,21.636327,21.392783,21.43336,479387,747071.05,52.344923881577635,54.520081751031555,NaN,NaN,53.593986109007666,101.417417392374,-0.003496510541971226,0.11563611290999987,0.11913262345197109,-18208329,-17887218.6,18.99355547249006,22.490463816273042,NaN,NaN,8.582950782188817,8.136066832868131
2002-01-11T09:30:00-05:00,21.758116,21.758116,21.311587,21.311587,3820808,905606.25,49.70161387400426,54.02685188505359,NaN,NaN,40.82242668669519,77.18705173304474,-0.018485028432502063,0.09602633791134352,0.11451136634384558,-22029137,-18815076.2,15.005721065005545,21.40542163021177,NaN,NaN,7.303187174072178,8.01708402446871
2002-01-14T09:30:00-05:00,21.189815,21.311587,21.149214,21.149214,3342530,946838.25,46.34123227164921,53.595985364746014,NaN,NaN,-53.868656082051146,36.242498798463714,-0.03831676913067478,0.06661540493050211,0.10493217406117689,-25371667,-20312360,10.994248168129843,20.102330666594394,NaN,NaN,5.229372617094107,7.61883953770091
2002-01-15T09:30:00-05:00,21.197926,21.611979,21.197926,21.611979,3055907,1044618.65,55.5626488900967,53.8437694994122,NaN,NaN,36.98399030080802,31.80583526394264,-0.020162357046886153,0.07972922775256919,0.09989158479945534,-22315760,-21130767,9.49941196230715,18.793273497756097,NaN,NaN,6.146049468120436,7.408440956332271
2002-01-16T09:30:00-05:00,21.43336,21.555148,21.311587,21.344054,2095902,1141937.2,50.18527006958374,53.593321955002416,NaN,NaN,-5.781989854581866,14.349951431975569,-0.02573561927839936,0.06772206070145614,0.0934576799798555,-24411662,-22467311,7.66621994973751,17.461642756591797,NaN,NaN,5.205199884120403,7.093692231730575
2002-01-17T09:30:00-05:00,21.676929,21.676929,21.449605,21.547022,269624,1144086.55,53.83063186291148,53.62607026782236,NaN,NaN,72.00063137721364,18.031280485616758,-0.01577882062354595,0.07373415420042306,0.08951297482396901,-24142038,-23654052.8,6.471946412929455,16.23543481332495,NaN,NaN,5.585372642547429,6.8782180047044115
2002-01-18T09:30:00-05:00,21.392783,21.620098,21.392783,21.465843,153719,1127138.05,52.18574675765052,53.26708299518815,NaN,NaN,30.74129815915972,16.015054780109665,-0.01470766710757862,0.07112839093949574,0.08583605804707437,-24295757,-24107376.8,6.0821677311116815,14.929757190201602,NaN,NaN,5.3878299870229895,6.665305430749923
2002-01-22T09:30:00-05:00,21.59575,21.59575,21.352181,21.392783,104203,1079593.45,50.68466843157238,53.10068874313746,NaN,NaN,4.368107674860496,27.662407531491993,-0.018710358097487112,0.062448110425215475,0.08115846852270259,-24399960,-23913035.4,8.622916708662672,13.91890528680029,NaN,NaN,4.780978198016455,6.396115826073713
2002-01-23T09:30:00-05:00,21.352181,21.59575,21.270994,21.490199,450687,1073385.55,52.64076996436197,53.10958125654115,NaN,NaN,1.0036051518413953,20.46633050169867,-0.01476138410335244,0.06270673839351204,0.07746812249686448,-23949273,-24239738,8.220316331999626,13.0141169983165,NaN,NaN,4.8391735484362135,6.173695500696928
2002-01-24T09:30:00-05:00,21.59575,21.717522,21.482088,21.514555,3765750,1250760,53.141220050667116,52.96016430731317,NaN,NaN,74.07521971309382,36.437772415233816,-0.010664346626939436,0.06413768921319019,0.07480203584012962,-20183523,-23394110.2,18.789544568735167,12.980990959970754,NaN,NaN,5.025959894638922,6.00973327126007
2002-01-25T09:30:00-05:00,21.392783,21.701285,21.392783,21.652573,112086,1251203.4,55.97993179400137,52.67139288886471,NaN,NaN,73.20992226221742,36.679630592234574,0.0005886702051352,0.07553787359654862,0.07494920339141342,-20071437,-22579990,27.45155656286741,13.588306539658467,NaN,NaN,5.981414336839579,6.0056877092
2002-01-28T09:30:00-05:00,21.676929,21.676929,21.279121,21.43336,731767,1254584.5,50.72389746934304,52.103763623225966,NaN,NaN,-18.937238050101858,26.743923350382254,-0.007061975035805718,0.06612173459665627,0.07318370963246199,-20803204,-21881479.4,33.960080734851076,14.806959918934584,NaN,NaN,5.321390566712127,5.907930974558876
2002-01-29T09:30:00-05:00,21.490199,21.547022,20.386056,20.499718,13953833,1874043.2,35.4551376988086,50.921781643389195,NaN,NaN,-367.0611672217155,-47.54193162893296,-0.07173710404769237,-0.01648767042715349,0.055249433620538885,-34757037,-23952894.8,26.397146972242766,15.514584043831373,NaN,NaN,-1.0575358872963851,4.912864280008124
2002-01-30T09:30:00-05:00,20.499718,21.43336,19.931409,20.759524,13399683,2432771.9,40.79582284394847,49.96953684715546,NaN,NaN,-279.6819150551073,-103.67903567032269,-0.09243713098707677,-0.060296980113307086,0.03214015087376969,-21357354,-23434511,30.56460646877204,16.337102793560177,NaN,NaN,-4.249780075209954,3.603915086405542
2002-01-31T09:30:00-05:00,20.905653,21.10862,20.678329,21.10862,13498837,3076052.3,47.126546468567454,49.59679560336902,NaN,NaN,-151.56221246910275,-148.806522106762,-0.07858032414747042,-0.06608525431056833,0.012495069836902083,-7858517,-20969509.8,46.172139265542924,18.278430207349665,NaN,NaN,-4.580446701737784,2.43472054524221
2002-02-01T09:30:00-05:00,21.068027,21.068027,20.735152,20.848813,5226822,3327681.3,43.406515246136024,49.14714570137842,NaN,NaN,-142.14984566306686,-191.87847569181886,-0.0824700265818053,-0.09059246339035454,-0.008122436808549242,-13085339,-19572290.2,52.66673384613555,20.968502548858954,NaN,NaN,-6.1704366651721205,1.2054123723258774
2002-02-04T09:30:00-05:00,20.662092,20.662092,20.093783,20.093783,5462697,3562645.05,34.80745036436109,48.323304136572126,NaN,NaN,-230.06689995279388,-234.10440807235727,-0.12869500164921654,-0.16899118887006992,-0.040296187220853374,-18548036,-19121256.6,54.572176006847215,24.08121168019591,NaN,NaN,-10.979333408212447,-0.5352655963224546
2002-02-05T09:30:00-05:00,20.053189,20.174978,19.769043,20.093783,5692904,3822520.3,34.80745036436109,46.84078995616244,NaN,NaN,-220.565084767477,-204.80519158150955,-0.15055414320299879,-0.22848886622460185,-0.07793472302160306,-18548036,-15879456.4,65.36445861971474,28.071572155725026,NaN,NaN,-14.491769742280717,-2.5290519028879204
2002-02-06T09:30:00-05:00,20.093783,20.134376,19.614779,19.80962,6314189,4121305.9,32.03717343855067,45.54449733966008,NaN,NaN,-193.25350485419904,-187.5195095413279,-0.1737868354913981,-0.29516826738585067,-0.12138143189445258,-24862225,-16580430.6,61.93797358142884,31.948125986560118,NaN,NaN,-18.312572638651723,-4.783840579425606
2002-02-07T09:30:00-05:00,19.769043,20.207444,19.728441,19.996358,8301205,4511627,35.661061079120714,44.2466708551036,NaN,NaN,-145.30839068737976,-186.2687451849833,-0.166214649589244,-0.3291497438810076,-0.1629350942917636,-16561020,-18320931.2,54.32331766044167,35.366081075668134,NaN,NaN,-20.149566209860392,-6.97894424091629
2002-02-08T09:30:00-05:00,20.166851,20.540311,20.134376,20.524074,8459853,4910650.3,44.64403180348964,43.7079769298064,NaN,NaN,-78.39181059267153,-173.51713817090427,-0.11759225314294869,-0.30992541072044943,-0.19233315757750075,-8101167,-17324096.8,57.542745679417166,39.04183664340424,NaN,NaN,-18.57997063831395,-8.636233726258812
2002-02-11T09:30:00-05:00,20.532184,20.702685,20.304861,20.702685,972323,4768226.05,47.3247156786663,43.46798030459882,NaN,NaN,-50.3791392744152,-137.57958603522852,-0.06780029536442114,-0.27708352678302717,-0.20928323141860602,-7128844,-15040258.4,63.83245081022213,42.98537479351563,NaN,NaN,-16.42459039282582,-9.748856107196955
2002-02-12T09:30:00-05:00,20.540311,20.694574,20.459124,20.467251,568810,4629540.05,44.280736685298834,42.87083507038002,NaN,NaN,-49.12945228970101,-103.29245953967333,-0.04615430993273731,-0.26697611883452765,-0.22082180890179035,-7697654,-12870182,68.5934008914632,47.29773797633446,NaN,NaN,-15.663127891452255,-10.593752076376283
2002-02-13T09:30:00-05:00,20.499718,20.938119,20.499718,20.881296,5391627,4746326.05,50.33134554600443,42.6701297486184,NaN,NaN,-15.40253241768683,-67.72226505237087,-0.00173096552755575,-0.22298551581123505,-0.2212545502836793,-2306027,-8358942.4,75.74217989329294,51.36578335666002,NaN,NaN,-12.95899516008013,-10.931643945476832
2002-02-14T09:30:00-05:00,20.78388,21.068027,20.580913,20.840703,1637946,4723428.25,49.760827229025345,42.22590799397726,NaN,NaN,-4.098610704804521,-39.48030905585584,0.02563005126946591,-0.1892169861968469,-0.2148470374663128,-3943973,-5835533,78.66723833657933,55.024046340496575,NaN,NaN,-11.026706033086597,-10.945224243706798
2002-02-15T09:30:00-05:00,20.743279,20.824457,20.475361,20.515955,2237673,4821830.7,45.33360495326397,41.84088709997161,NaN,NaN,-31.266863294776837,-30.055319596276895,0.02266989762809668,-0.18650966543119196,-0.20917956305928864,-6181646,-5451628.8,79.08052686375854,58.24693534970425,NaN,NaN,-10.781048137769188,-10.92177051428714
2002-02-19T09:30:00-05:00,20.256156,20.377945,19.955765,19.955765,5080001,5068144.8,38.903653751732556,42.08720967518046,NaN,NaN,-98.4398972725936,-39.66747119591256,-0.014216829766969946,-0.22695060026800107,-0.21273377050103112,-11261647,-6278189.4,75.68091630428013,61.76720458770693,NaN,NaN,-12.734781451653177,-11.180772076768003
2002-02-20T09:30:00-05:00,20.093783,20.337344,19.704085,20.329217,8057450,5465807.15,44.55006591422167,42.35536989448569,NaN,NaN,-85.72073575542045,-46.985727889056456,-0.01081915880856521,-0.22625771901173763,-0.21543856020317242,-3204197,-5379498,76.84638085941182,65.07304561560976,NaN,NaN,-12.451553383995325,-11.362312263514763
2002-02-21T09:30:00-05:00,20.174978,20.377945,19.931409,20.093783,5893429,5737944.25,41.91982303629405,41.98346107789474,NaN,NaN,-77.10610671234632,-59.32644274798836,-0.02118314192657858,-0.24191748761139564,-0.22073434568481706,-9097626,-6737817.8,71.2856710237618,66.8668693126254,NaN,NaN,-13.088869003611132,-11.608963226385672
2002-02-22T09:30:00-05:00,19.728441,20.012587,19.566075,19.97201,8530306,5976172.05,40.58513131886333,41.78193365451812,NaN,NaN,-112.77777878570701,-81.06227636416885,-0.03232750593889258,-0.2611437281084328,-0.2288162221695402,-17627932,-9474609.6,61.61189951712434,67.50580971769602,NaN,NaN,-14.01924265217485,-11.953288858641269
2002-02-25T09:30:00-05:00,19.931409,20.491607,19.931409,20.48348,4636087,6202372.1,48.0647219551428,42.72888162528824,NaN,NaN,-29.403903430932917,-80.68968439140006,-0.0028910217864460686,-0.2324299994025978,-0.22953897761615172,-12991845,-10836649.4,57.434561535511605,67.71026582688634,NaN,NaN,-12.372320686072342,-12.013150548274279
2002-02-26T09:30:00-05:00,20.377945,20.653973,20.29675,20.467251,2365033,6284035.4,47.85884809517715,43.661124320346524,NaN,NaN,13.722592653316655,-58.25718640621801,0.01676771451777226,-0.2085793344689364,-0.22534704898670865,-15356878,-11655695.6,55.01882476142219,66.97129197986546,NaN,NaN,-11.146508450861756,-11.889344534358203
2002-02-27T09:30:00-05:00,20.702685,20.994958,20.540311,20.678329,11514158,6162051.65,50.80997387380392,45.00203863715033,NaN,NaN,73.10391453974061,-26.492256347185805,0.0437353891518395,-0.17067781254690928,-0.21441320169874878,-3842720,-11783400.2,54.632978758593005,66.44950663537718,NaN,NaN,-9.22201847348585,-11.508297954233582
2002-02-28T09:30:00-05:00,20.662092,21.027425,20.662092,20.743279,1265104,5555322.7,51.715571063226086,46.14878935030071,NaN,NaN,86.5930578959049,6.247576574464444,0.06444524529012341,-0.13385664508609452,-0.19830189037621793,-2577616,-10479398.2,57.881126974122324,66.70363587206865,NaN,NaN,-7.390470364108799,-10.92003686993004
2002-03-01T09:30:00-05:00,20.905653,21.059908,20.743279,21.027425,5794521,5170106.9,55.569357802541546,46.92916977880442,NaN,NaN,115.95332016229092,51.99379636406403,0.09398887003738138,-0.08081580282949119,-0.17480467286687257,3216905,-6310430.8,66.21049925530463,67.32276112748919,NaN,NaN,-4.654960845064571,-10.025026009234974
2002-03-04T09:30:00-05:00,21.352181,21.758116,21.230392,21.741879,7846083,5301069.95,63.46529360871848,48.082068202379574,NaN,NaN,221.08595522099858,102.09176809445034,0.1547676358176767,0.018654871905223303,-0.1361127639124534,11062988,-1499464.2,72.87655457253852,67.96876853908321,NaN,NaN,0.5492920412434658,-8.514409144880911
2002-03-05T09:30:00-05:00,21.709412,22.001685,21.611979,21.758116,5309963,5293433.25,63.62351237118992,49.46369503708608,NaN,NaN,212.9260371336121,141.93245699050945,0.18702653501180702,0.09767040485230538,-0.08935613015950164,16372951,4846501.6,78.81385630971701,68.69880106895849,NaN,NaN,4.681483493750814,-6.629281625076379
2002-03-06T09:30:00-05:00,21.879896,22.204653,21.766235,22.123457,3083129,5162944.5,67.07823207359077,50.659901217627976,NaN,NaN,207.74101492555516,168.85987706767236,0.22157139995483155,0.1876081197840378,-0.03396328017079375,19456080,9506261.6,81.94002196423338,69.14150407402566,NaN,NaN,9.356185865586669,-4.345643412124515
2002-03-07T09:30:00-05:00,22.082864,22.229001,21.758116,21.928601,3825981,5038534.1,63.608414232011015,51.64901457498409,NaN,NaN,168.567305577105,185.2547266039124,0.21948269518230648,0.24039008880708934,0.020907393624782868,15630099,13147804.6,83.93503784722355,69.5177754676431,NaN,NaN,12.174650732838913,-1.9856013914154538
2002-03-08T09:30:00-05:00,22.285831,22.285831,21.961083,22.026033,796432,4663295.45,64.59461847006767,53.024801254755786,NaN,NaN,155.07758613859494,193.07957979917316,0.2126951638406829,0.2867763484256365,0.07408118458495358,16426531,15789729.8,85.21140552604614,69.95569537209222,NaN,NaN,14.771553019284733,0.40827781011314457
2002-03-11T09:30:00-05:00,22.042262,22.24523,21.961083,22.155924,835478,4282076.7,65.92054849973016,54.95457945104133,NaN,NaN,131.47414301625787,175.15721735822504,0.20490499489339523,0.3302124282016976,0.12530743330830238,17262009,17029534,85.78228340360212,70.67722159347237,NaN,NaN,17.323553084746738,2.824745706489372
2002-03-12T09:30:00-05:00,21.92049,22.269586,21.92049,22.164051,6110709,4538996,66.00632835039892,56.487169625053994,NaN,NaN,111.17355256587703,154.806720444678,0.1886570516995832,0.3611287479327814,0.1724716962331982,23372718,18429487.4,86.41976655225689,71.361034857247,NaN,NaN,19.43539890062528,5.197696162794502
2002-03-13T09:30:00-05:00,22.164051,22.180297,21.85554,21.961083,2469607,4634035.85,61.821169901929714,57.90869440117083,NaN,NaN,86.74118644547573,130.60675474866213,0.15405810616722762,0.3650443289422327,0.2109862227750051,20903111,18718893.6,86.55398474604678,72.45162869455308,NaN,NaN,20.127694677121575,7.3305530934126555
2002-03-14T09:30:00-05:00,21.92049,22.155924,21.92049,22.017914,1600256,4444467.3,62.53742279536131,59.47671522092069,NaN,NaN,79.49474223482554,112.79224208020621,0.1259994774393765,0.36848556957422574,0.24248609213484923,22503367,20093547.2,87.2010507707479,74.27942521266904,NaN,NaN,20.899165362890166,9.268926274766585
2002-03-15T09:30:00-05:00,22.042262,22.472553,22.042262,22.40762,3783733,4551756.65,67.0959966151805,60.836091982351945,NaN,NaN,92.03106796846114,100.18293844617945,0.12446719880734441,0.39807009064402976,0.27360289183668535,26287100,22065661,88.08679246140568,76.46887027880435,NaN,NaN,22.909008015807018,11.217509380629505
2002-03-18T09:30:00-05:00,22.529392,22.578105,22.17217,22.358892,1942059,4536975.95,66.01432433287225,62.13291171361588,NaN,NaN,87.73376290503802,91.43486242393548,0.1113779275509923,0.4128253012754257,0.3014473737244334,24345041,23482267.4,88.69215365836988,78.87410805715774,NaN,NaN,24.27814587979204,13.083314594795581
2002-03-19T09:30:00-05:00,22.488799,22.529392,22.326425,22.350781,409301,4303440.95,65.8241006763372,63.20534934236826,NaN,NaN,83.80167642907826,85.96048719657571,0.09406934766707786,0.4190340583082808,0.3249647106412029,23935740,23594871.8,88.74112833594486,81.31040445554002,NaN,NaN,25.364662857456555,14.837792918032862
2002-03-20T09:30:00-05:00,22.326425,22.326425,22.001685,22.001685,4918398,4146488.35,58.06839499346129,63.6591224802422,NaN,NaN,54.85256237567823,79.58276238261621,0.05304826206711466,0.39127503822509624,0.3382267761579816,19017342,23217718,87.37612944032213,83.41719034598286,NaN,NaN,24.18302009673076,16.17282537213256
2002-03-21T09:30:00-05:00,22.115347,22.115347,21.717522,22.009796,3585795,4031106.65,58.19165256284925,63.846429248835605,NaN,NaN,35.71904504324298,70.8276229442997,0.021990238882690583,0.36571457476134483,0.34372433587865425,22603137,23237672,87.38718334206425,84.92981063789425,NaN,NaN,23.24043372519412,17.182483708284213
2002-03-22T09:30:00-05:00,22.026033,22.237119,21.888023,22.001685,2649069,3737044.8,58.008022047210964,63.45662413729936,NaN,NaN,41.091947935041055,60.639798937615694,-0.002280387245019444,0.34087385182237995,0.3431542390673994,19954068,21971065.6,82.4518138224833,85.61375772717602,NaN,NaN,22.403671480694538,17.9283676757714
2002-03-25T09:30:00-05:00,22.001685,22.074745,21.652573,21.652573,2830502,3646765.55,50.6058385390757,62.52679029214835,NaN,NaN,1.5050957984562843,43.39406551629935,-0.04278118778007389,0.289677754342307,0.3324589421223809,17123566,20526770.6,77.1043284513773,85.49164859443748,NaN,NaN,19.530675789137867,18.157268834823753
2002-03-26T09:30:00-05:00,21.676929,22.164051,21.676929,21.92049,1871851,3622106.45,55.31804327897359,61.68677680681855,NaN,NaN,12.384108828285518,29.110551996140817,-0.051856772046026844,0.2676379770648474,0.3194947491108742,18995417,19538706,73.588146263709,84.89508604440002,NaN,NaN,18.302233927013237,18.177978133707967
2002-03-27T09:30:00-05:00,21.92049,22.277713,21.92049,22.204653,7766511,3434724.1,59.70853838910784,61.40821424661117,NaN,NaN,51.1755058226356,28.37514068553229,-0.03960490859878463,0.26998861336239344,0.30959352196117806,26761928,21087623.2,75.47617405066003,84.29088148750262,NaN,NaN,18.517544307255406,18.226487587071887
2002-03-28T09:30:00-05:00,22.115347,22.342662,22.013863,22.042262,1697685,3456353.15,56.303693662568904,60.81600533178983,NaN,NaN,47.11419908182967,30.654171493249635,-0.04303544248387131,0.25579921885633894,0.29883466134021025,25064243,21579844.4,76.061796673599,83.63733799804211,NaN,NaN,17.68501797860142,18.14913478586182
2002-04-01T09:30:00-05:00,21.839295,22.017914,21.717522,22.001685,1178636,3225558.9,55.452777376101146,60.06830739438776,NaN,NaN,-59.7114492354461,10.4934920591522,-0.048243593564508414,0.23853016938457472,0.28677376294908313,23885607,22366152.2,77.00640851139153,83.01048979145564,NaN,NaN,16.75904702392039,17.950550819870188
2002-04-02T09:30:00-05:00,21.798718,22.164051,21.798718,22.082864,468178,2856663.65,56.85754111718199,59.41482259201512,NaN,NaN,-25.463293897063053,5.099814120048331,-0.04641276039525155,0.2287578124550187,0.27517057285027025,24353785,23812196,78.67312810142724,82.45715847353924,NaN,NaN,16.366576358940435,17.72426875402308
2002-04-03T09:30:00-05:00,22.123457,22.123457,21.725633,21.758116,4904479,2836389.45,50.057117521644166,58.57453313628044,NaN,NaN,-110.13621178363496,-19.404250002335765,-0.06606553231722129,0.19258865745374365,0.25865418977096494,19449306,23902973.8,78.7771303488992,81.90166887374299,NaN,NaN,13.99158416066194,17.19102809782863
2002-04-04T09:30:00-05:00,21.758116,22.042262,21.758116,21.952957,1332109,2748838.45,53.6398261949046,57.938990521962104,NaN,NaN,-76.43918644758922,-44.92718845638073,-0.06484404808777228,0.17759912966124958,0.24244317774902185,20781415,22706871.2,73.67876047289863,80.93579099532518,NaN,NaN,13.00196651785198,16.59259072926054
2002-04-05T09:30:00-05:00,22.115347,22.269586,22.058508,22.058508,4188355,2766957.15,55.502102295603436,57.11085521342089,NaN,NaN,32.80195257169342,-47.78963775840798,-0.05615350322595805,0.1722512987165743,0.22840480194253235,24969770,22687976.6,73.59772978005253,79.9008579466571,NaN,NaN,12.713538932199183,16.038440472537488
2002-04-08T09:30:00-04:00,21.912379,22.212763,21.912379,22.123457,147930,2734532.05,56.655884818323294,56.44239524809596,NaN,NaN,8.183339576696468,-34.21067999597947,-0.045700208175413454,0.17127954172326554,0.216979749898679,25117700,22934395.2,73.99934667035714,78.85137173322762,NaN,NaN,12.798167942894652,15.575544396874225
2002-04-09T09:30:00-04:00,22.24523,22.40762,22.17217,22.261475,1243918,2754954.05,59.08376933481746,55.960943009415985,NaN,NaN,104.22177762696728,-8.2736656911734,-0.029922781560394573,0.1795762729481858,0.20949905450858036,26361618,23335961.8,74.67540169341108,77.84667697304664,NaN,NaN,13.555683303125129,15.286992812052926
2002-04-10T09:30:00-04:00,22.310188,22.448197,22.253357,22.342662,420264,2470431.8,60.48589045307975,56.13362125653158,NaN,NaN,121.71322422248973,38.096221510051535,-0.015193992780942578,0.19050656353240214,0.20570055631334472,26781882,24802477,77.02486920555094,77.10730124199154,NaN,NaN,14.586043974324065,15.186857263805946
2002-04-11T09:30:00-04:00,22.24523,22.326425,21.725633,21.790591,1543966,2424149.75,48.35205786248326,55.4307930636483,NaN,NaN,-62.97995656367776,40.788067486833825,-0.042272993298191425,0.15285931469060543,0.19513230798879685,25237916,25693777.2,78.34010992373244,76.46108171211071,NaN,NaN,11.744289072336526,14.695061807881743
2002-04-12T09:30:00-04:00,21.98544,22.147814,21.871778,22.066618,1348122,2411543.05,53.38697703698973,55.10071842006107,NaN,NaN,-25.61244311606042,29.105188349283054,-0.041193151767342756,0.14364086827961842,0.18483402004696117,26586038,26017030.8,78.81381075843099,76.20122435039268,NaN,NaN,10.928934613921411,14.157043637315981
2002-04-15T09:30:00-04:00,22.24523,22.24523,21.660683,21.782472,581497,2251431.25,48.18005108051175,54.927447887306506,NaN,NaN,-79.17513651967722,11.633493130008315,-0.05817554531390762,0.11211458840457666,0.17029013371848428,26004541,26194399,79.08410784672739,76.34263716434626,NaN,NaN,8.510152028201214,13.350344836013871
2002-04-16T09:30:00-04:00,21.92049,22.269586,21.92049,22.229001,447608,2176708.7,55.52160489132731,54.94198800247462,NaN,NaN,45.17666105443631,-0.175530184497876,-0.038826187406123897,0.12175739946082942,0.16058358686695332,26452149,26212505.2,79.11340277574664,76.73729834377752,NaN,NaN,8.92750153989005,12.718510079424753
2002-04-17T09:30:00-04:00,22.285831,22.399493,22.10722,22.285831,462142,2179350.75,56.36883328478736,54.703437637880306,NaN,NaN,120.34127502432415,-0.44992002413099214,-0.022500303901817037,0.13245820698968203,0.15495851089149906,26914291,26238987,79.15937881841248,77.00038439861699,NaN,NaN,9.529877130707511,12.262991086750862
2002-04-18T09:30:00-04:00,22.310188,22.40762,21.879896,22.204653,887334,1977797.55,54.76413639221282,54.5934692614263,NaN,NaN,62.20160331815477,24.586391952235513,-0.01768137077393031,0.13285679742408618,0.1505381681980165,26026957,26396795.2,79.44968028269804,77.2423760849812,NaN,NaN,9.514340900151065,11.870326774379462
2002-04-19T09:30:00-04:00,22.326425,22.326425,22.180297,22.24523,3159249,1956470.25,55.44688110944009,54.59304809952194,NaN,NaN,96.62970007766133,49.03482059097986,-0.012516968574097148,0.13489195748039506,0.1474089260544922,29186206,26916828.8,80.4177097387105,77.48604045836113,NaN,NaN,9.704140231594888,11.560871553981666
2002-04-22T09:30:00-04:00,22.131568,22.196526,21.879896,21.944846,1585229,1903278.25,49.491768479904444,54.06692148257355,NaN,NaN,-27.803243131048777,59.30919926870555,-0.029137565319530295,0.11098696940507935,0.14012453472460965,27600977,27236116,81.00920057865157,77.65290277816287,NaN,NaN,8.04074173180914,11.057995865099876
2002-04-23T09:30:00-04:00,21.839295,22.001685,21.774362,21.839295,1450355,1834270.9,47.558846136114624,53.88847352646429,NaN,NaN,-101.75580523245422,29.922706011327442,-0.04604110091279384,0.08257315858361736,0.1286142594964112,26150622,27175810.6,80.51452762432656,77.77700258355055,NaN,NaN,6.086051957584795,10.347718164026293
2002-04-24T09:30:00-04:00,21.92049,22.001685,21.660683,21.701285,4606032,1970979.95,45.07973673717551,53.27703856519793,NaN,NaN,-135.25650788227742,-21.19685056999287,-0.06420238639459117,0.048361276503172235,0.1125636628977634,21544590,26101870.4,72.07397511985596,77.6623750583332,NaN,NaN,3.7026196179488187,9.39841837172951
2002-04-25T09:30:00-04:00,21.571394,21.636327,21.319698,21.498318,5010654,1833187.1,41.64183249762853,52.28701929391401,NaN,NaN,-232.18890800730696,-80.07495283508521,-0.08619903430800402,0.0048148700127583766,0.0910139043207624,16533936,24203266.2,60.082246063990546,76.69698336432877,NaN,NaN,0.6106290793894972,8.143019901395224
2002-04-26T09:30:00-04:00,21.530792,21.676929,21.319698,21.417131,1545444,1825575.05,40.3173384720966,51.11998026918353,NaN,NaN,-195.32747803530864,-138.46638845767922,-0.1014783323237011,-0.03583401108386397,0.06564432123983713,14988492,21363723.4,47.38423109214573,74.79590368017082,NaN,NaN,-2.340479753764003,6.645377093515335
2002-04-29T09:30:00-04:00,21.400893,21.530792,21.189815,21.230392,1379284,1835607.45,37.37285158016466,49.56920042956547,NaN,NaN,-204.3471592090006,-173.77517167326957,-0.11825115191533933,-0.08216961865433703,0.036081533261002295,13609208,18565369.6,38.703132667275376,72.22645589258971,NaN,NaN,-5.767294660560869,4.872138271504449
2002-04-30T09:30:00-04:00,21.287231,21.652573,21.214163,21.482088,1884045,1906400.8,43.37556513369255,48.347034335323535,NaN,NaN,-137.6255048966827,-180.94911160611528,-0.1068314072468308,-0.0974577257975362,0.009373681449294593,15493253,16433895.8,33.64668836050615,69.12801440365793,NaN,NaN,-6.9843474905105145,3.178354591216597
2002-05-01T09:30:00-04:00,21.59575,21.676929,21.238519,21.628217,4523384,1887346.05,46.57709295845796,48.22025112789316,NaN,NaN,-105.45849541455901,-174.9895091125716,-0.08483330029590179,-0.09666794392058264,-0.011834643624680858,20016637,16128305.2,32.98139557521456,65.88810623590665,NaN,NaN,-7.052888547095646,1.7167484286005623
2002-05-02T09:30:00-04:00,21.717522,21.839295,21.59575,21.839295,996218,1870551.5,50.895887170060384,48.0423161373982,NaN,NaN,-38.33033116885186,-136.21779374488057,-0.053019812221120455,-0.07810940890108142,-0.02508959667996097,21012855,17024089,36.91887087829744,62.89561053018282,NaN,NaN,-5.797051190296137,0.6433484830438911
2002-05-03T09:30:00-04:00,21.749989,21.831184,21.620098,21.73376,1014940,1711880.75,48.772879243917,48.08466100621286,NaN,NaN,-40.9874173297101,-105.34978160376086,-0.03680660814506278,-0.07109785686128944,-0.034291248716226665,19997915,18025973.6,41.087821272936644,60.181590060626334,NaN,NaN,-5.373540919502444,-0.21620714589129952
2002-05-06T09:30:00-04:00,21.676929,21.839295,21.230392,21.230392,784731,1743720.8,40.16672506278569,46.98788387560274,NaN,NaN,-102.01437898774918,-84.88322555951058,-0.056526165744795624,-0.1049489558972212,-0.04842279015242557,19213184,19146768.8,45.43247130658263,57.77580924140034,NaN,NaN,-7.7893061012694265,-1.2980784252310318
2002-05-07T09:30:00-04:00,21.3603,21.417131,21.116731,21.132976,1237390,1743394.4,38.74196496021869,45.72882185241927,NaN,NaN,-134.93331979309542,-84.34478853879311,-0.07169820760732941,-0.13804554966158733,-0.06634734205425792,17975794,19643277,47.28707729597103,55.499216275511664,NaN,NaN,-10.185207765919458,-2.567668331043664
2002-05-08T09:30:00-04:00,21.59575,21.806828,21.555148,21.758116,3542192,1899490.8,50.80213111143839,45.4458214752211,NaN,NaN,-16.563693394453633,-66.56582813477203,-0.03694936058513412,-0.11253404278567558,-0.07558468220054146,21517986,19943546.8,48.42862996580991,53.283426967162505,NaN,NaN,-8.171331027997095,-3.3681915734655825
2002-05-09T09:30:00-04:00,21.676929,21.717522,21.29535,21.498318,251394,1834862.2,46.68834326499338,44.820211629189195,NaN,NaN,-61.5276638740648,-71.20529467581461,-0.029123120235585304,-0.11198858249502308,-0.08286546225943778,21266592,19994294.2,48.63110241120362,51.01295501519773,NaN,NaN,-7.96041878547644,-4.024224032324277
2002-05-10T09:30:00-04:00,21.636327,21.636327,21.222282,21.222282,1596191,1847265.65,42.72921577155991,44.33717215002173,NaN,NaN,-87.89863435270972,-80.58753808041453,-0.03955160636531334,-0.13230497021607945,-0.09275336385076612,19670401,19928791.4,48.36714221727253,48.681379417956364,NaN,NaN,-9.15411876362368,-4.75706613679562
2002-05-13T09:30:00-04:00,21.287231,21.620098,21.189815,21.603861,450072,1840694.4,49.14865237456672,44.45072973848259,NaN,NaN,-54.815252795975795,-71.14771284205986,-0.018817523821427373,-0.11627526862755033,-0.09745774480612296,20120473,20110249.2,49.18990528405277,46.44390639365109,NaN,NaN,-7.893950816568742,-5.2051925196203515
2002-05-14T09:30:00-04:00,21.871778,21.936727,21.717522,21.936727,636924,1850160.2,53.99322257095382,45.087407298038194,NaN,NaN,46.9315168135921,-34.774745520722355,0.017295877265037563,-0.075837898224826,-0.09313377548986357,20757397,20666569.8,51.729501065193034,44.990729675460884,NaN,NaN,-5.138595112036399,-5.195678604251215
2002-05-15T09:30:00-04:00,21.871778,22.099101,21.831184,21.831184,1317452,1892925.7,52.292107802744184,45.848141248403586,NaN,NaN,70.70005294435457,-17.321996252960712,0.0331379541280393,-0.05171133282981444,-0.08484928695785374,19439945,20250961.6,49.72975628170326,44.25126611958323,NaN,NaN,-3.546436176484262,-4.96007254314165
2002-05-16T09:30:00-04:00,21.839295,22.099101,21.839295,22.090991,777587,1887438.35,55.96961042350376,46.96616067350409,NaN,NaN,100.69435376029956,15.12240727391216,0.05868414521684044,-0.011494105436803181,-0.07017825065364362,20217532,20041149.6,48.70610835100725,44.34568592378762,NaN,NaN,-1.005635053607325,-4.395152901779603
2002-05-17T09:30:00-04:00,22.237119,22.24523,22.058508,22.188407,251641,1742057.95,57.29874076504928,48.38943847242443,NaN,NaN,148.66263747709596,62.43466163987328,0.07847634626993999,0.027917182183781364,-0.050559164086158626,20469173,20200904,49.557516747243376,45.12099907235676,NaN,NaN,1.4472481102729575,-3.5605241857720946
2002-05-20T09:30:00-04:00,22.147814,22.147814,21.758116,21.806828,564006,1690996.8,50.82663959674742,48.92165807692835,NaN,NaN,76.3973697635306,88.67718615177458,0.06287731261008314,0.028037476676445294,-0.03483983593363784,19905167,20157842.8,49.31988072213223,46.24051281247291,NaN,NaN,1.491595016142188,-2.8387928712129114
2002-05-21T09:30:00-04:00,21.888023,22.017914,21.603861,21.603861,1061992,1671578.65,47.73784733043895,49.00456910349843,NaN,NaN,30.973388160481175,85.48556042115239,0.03716875625051951,0.011621109379511552,-0.02554764687100796,18843175,19774998.4,47.154917198277964,47.2529072141203,NaN,NaN,0.5407295450919767,-2.356003954597927
2002-05-22T09:30:00-04:00,21.59575,21.652573,21.449605,21.644454,1507014,1516627.75,48.41307057111901,48.8272250607169,NaN,NaN,-15.120286693234391,68.3214924936346,0.021930147007995598,0.0018650368889865376,-0.02006511011900906,20350189,19957047.2,48.31671063162725,48.06703862507243,NaN,NaN,-0.014476024648108623,-2.021499964605096
2002-05-23T09:30:00-04:00,21.676929,21.904253,21.636327,21.879896,463990,1289294.55,52.26529682678561,49.076683459493225,NaN,NaN,49.967775999649376,58.17617694150456,0.026437555595114254,0.01298183437488376,-0.013455721220230494,20814179,20076376.6,49.10653526101446,48.63980390993513,NaN,NaN,0.6761083600431883,-1.6361273467981985
2002-05-24T09:30:00-04:00,21.823066,21.961083,21.644454,21.73376,676586,1245851.65,49.780508501345494,49.763382276533214,NaN,NaN,37.363746662138546,35.91639877851308,0.018673426746452886,0.009886062212835611,-0.008787364533617273,20137593,20010060.6,48.661472434991715,48.87044684767864,NaN,NaN,0.5153991821955134,-1.328766414084811
2002-05-28T09:30:00-04:00,21.798718,21.798718,21.392783,21.506444,563883,1205081.6,46.10841568897427,50.289557328587186,NaN,NaN,-36.751201218433465,13.286684582120268,-0.0015985340294208568,-0.010785532070393344,-0.009186998040972488,19573710,19943769.2,48.19128171163511,48.93503287736893,NaN,NaN,-0.7227946528297623,-1.242199019619804
2002-05-29T09:30:00-04:00,21.409012,21.579505,21.409012,21.498318,662667,1144012.7,45.977848377758406,49.9449657047529,NaN,NaN,-62.194737089626244,-5.346940467901217,-0.01465563474400661,-0.02750654147098075,-0.01285090672697414,18911043,19957342.8,48.30143306931898,48.92594738476243,NaN,NaN,-1.7607519816263122,-1.3162780141921624
2002-05-30T09:30:00-04:00,21.270994,21.538911,21.206044,21.409012,6242749,1229980.95,44.486859139285684,49.78771683863092,NaN,NaN,-94.59760087110485,-21.242403303475307,-0.02765344094455924,-0.04741770790767319,-0.01976426696311395,12668294,18420963.8,38.35991618044585,48.19229122542259,NaN,NaN,-3.049147082843133,-1.5638307382851582
2002-05-31T09:30:00-04:00,21.352181,21.66881,21.352181,21.417131,4064074,1383373.75,44.66255097757683,49.925812210489276,NaN,NaN,-57.1365087083094,-42.663260245067065,-0.03365225233048452,-0.061829582376219605,-0.02817733004573508,16732368,17604601.6,34.31802902750181,47.18878314043898,NaN,NaN,-4.070784094851782,-1.92196693208039
2002-06-03T09:30:00-04:00,21.449605,21.587623,20.930009,20.994958,2348898,1450071.65,37.93879535285027,49.12510813750953,NaN,NaN,-136.02078214755656,-77.3401660070061,-0.06233329166346167,-0.10609394462506216,-0.0437606529616005,14383470,16453777,29.585470931626688,45.78846640097997,NaN,NaN,-7.011975990308139,-2.6491110832557827
2002-06-04T09:30:00-04:00,20.824457,21.003077,20.727041,20.85694,949905,1458330.35,36.02915146041665,47.84196020104259,NaN,NaN,-196.7158943691856,-109.33310463715654,-0.08545142612833388,-0.15057493562201785,-0.06512350949368396,13433565,15225748,25.53831429167333,43.91766734572856,NaN,NaN,-10.063414889125909,-3.7082973412372295
2002-06-05T09:30:00-04:00,20.913763,21.10862,20.897542,21.059908,755170,1434219.35,40.75215162242773,47.01767761673427,NaN,NaN,-146.1815337339651,-126.13046396602431,-0.0819152577839791,-0.16751758172365783,-0.08560232393967873,14188735,14281286.4,22.9392817989159,42.00406202552947,NaN,NaN,-11.343857374271371,-4.799091631670678
2002-06-06T09:30:00-04:00,20.986848,21.003077,20.597142,20.605261,2156872,1364953.35,34.5913791797027,45.4906610993199,NaN,NaN,-183.6030713353304,-143.93155805886943,-0.10363881215551743,-0.2151508391340755,-0.11151202697855808,12031863,14154000.2,22.60538436827069,40.139724598191144,NaN,NaN,-14.488048520623902,-6.183228330092567
2002-06-07T09:30:00-04:00,20.394174,20.791991,20.394174,20.670218,975279,1401147.6,36.07823780361361,43.97491088778878,NaN,NaN,-173.7613813576885,-167.25653258874524,-0.10665975953940665,-0.2448367264028164,-0.13817696686340974,13007142,13408955,20.705588966233222,38.078872613833276,NaN,NaN,-16.576307891228755,-7.667953981683451
2002-06-10T09:30:00-04:00,20.580913,20.946246,20.580913,20.78388,392550,1340965.55,38.70391561853015,43.109002032201836,NaN,NaN,-125.33383313138289,-165.11914278551052,-0.09444857365612522,-0.2562376839335663,-0.16178911027744106,13399692,13212199.4,20.22224807956495,36.000470282221336,NaN,NaN,-17.539644090788876,-9.078195425841368
2002-06-11T09:30:00-04:00,20.905653,20.994958,20.418522,20.418522,2653503,1451137.1,33.885593764674724,42.11955534893297,NaN,NaN,-128.53826139987189,-151.48361619164774,-0.10368498219606159,-0.29139533802251805,-0.18771035582645645,10746189,12674724.2,18.922776411312597,33.98388879743809,NaN,NaN,-19.908676437806303,-10.625406998979216
2002-06-12T09:30:00-04:00,20.377945,20.597142,20.183088,20.532184,957911,1467186.45,36.53270532619841,41.270957831438636,NaN,NaN,-132.78045669705332,-148.8034007842654,-0.09507388324373728,-0.30655270988112804,-0.21147882663739076,11704100,12177797.2,17.784869064913735,31.803042971244274,NaN,NaN,-21.056628727145473,-12.115581531574396
2002-06-13T09:30:00-04:00,20.459124,20.48348,20.036943,20.053189,2008942,1501760.95,30.915144391985734,39.74594694323865,NaN,NaN,-143.93893097677378,-140.87057271255406,-0.11333301296898973,-0.35314509284862794,-0.2398120798796382,9695158,11710456.2,16.763876745460024,29.4928530772761,NaN,NaN,-23.950132084606558,-13.80623161057899
2002-06-14T09:30:00-04:00,19.915171,20.353589,19.622898,20.239911,4253143,1675538.75,35.10434150433326,38.697649300594925,NaN,NaN,-140.5112996180918,-134.22055636463475,-0.10473389514936532,-0.37072944881634484,-0.2659955536669795,13948301,11898688,18.786176618902118,27.358903376126843,NaN,NaN,-24.983000255376332,-15.40291284555004
2002-06-17T09:30:00-04:00,20.540311,21.157332,20.337344,21.149214,2333008,1779607.1,50.76252919064503,39.03008597928569,NaN,NaN,-30.806372958952974,-115.31506433014874,-0.03339918699323585,-0.30774453740852437,-0.2743453504152885,16281309,12475011.4,24.809736835237885,25.68879302781275,NaN,NaN,-20.06408157941497,-16.068794093245028
2002-06-18T09:30:00-04:00,21.092383,21.270994,20.978721,21.189815,1547168,1828765.2,51.327238089321696,39.41218524439735,NaN,NaN,11.72947983202999,-87.26151608376837,0.018155081828280406,-0.25165149812993803,-0.26980657995821844,17828477,13891469,37.14824653837883,24.89213684703131,NaN,NaN,-16.181163614878606,-16.084846882049824
2002-06-19T09:30:00-04:00,21.149214,21.181688,20.92189,20.986848,692229,1810277.05,48.342337144226015,39.68757653046452,NaN,NaN,-0.32788274562578057,-60.771001293482854,0.03902347468001688,-0.22102723660819734,-0.2600507112882142,17136248,14977898.6,44.650587708909946,25.34147052763589,NaN,NaN,-14.050046415384923,-15.794161101097695
2002-06-20T09:30:00-04:00,20.946246,20.946246,20.515955,20.564667,4833409,1976596.8,42.770660317367415,39.5524414833067,NaN,NaN,-51.69699224292822,-42.32261354671376,0.025485931572872655,-0.22819329682212341,-0.25367922839499607,12302839,15499434.8,47.867613691558354,26.309298003639928,NaN,NaN,-14.136755347305446,-15.557388850555945
2002-06-21T09:30:00-04:00,20.29675,20.572786,20.215555,20.248038,2958478,2101321.2,39.12827669396835,39.637404436243706,NaN,NaN,-98.38393511461493,-33.89714064601837,-0.002228930802196216,-0.2564653918977413,-0.2542364610955451,9344361,14578646.8,43.10417314465288,27.274919590284657,NaN,NaN,-15.454538018695274,-15.54269587457585
2002-06-24T09:30:00-04:00,20.215555,20.475361,19.842103,20.304861,3756512,2255317.5,40.11392891263877,39.92917425425958,NaN,NaN,-113.49252098810264,-50.434370251848314,-0.013539088979541258,-0.27116032231997167,-0.2576212333404304,13100873,13942559.6,40.13303615054399,28.317399723061133,NaN,NaN,-16.167116857154294,-15.631898872087056
2002-06-25T09:30:00-04:00,20.377945,20.637735,20.11002,20.11002,1341101,2294178.4,37.85072746601027,39.72192967165834,NaN,NaN,-91.5751665989338,-71.09529953804108,-0.030003949421432807,-0.2951261701172214,-0.2651222206957886,11759772,12728818.6,35.15373008851327,29.18986031517523,NaN,NaN,-17.466588992862857,-15.893997460769313
2002-06-26T09:30:00-04:00,19.48488,19.833976,19.41993,19.728441,5432149,2532652.5,33.825743440528356,39.66724140457445,NaN,NaN,-184.10340705288925,-107.85040439949375,-0.06068536002438096,-0.3409789207262648,-0.2802935607018838,6327623,10567093.6,28.396223256799658,29.60349166435588,NaN,NaN,-19.898377080568775,-16.466051692169238
2002-06-27T09:30:00-04:00,19.890815,20.2318,19.720314,20.150622,8385704,2639800.25,41.26737621775366,40.037894148441595,NaN,NaN,-105.16925812835136,-118.5448575765784,-0.047236658924536545,-0.3393393843575545,-0.29210272543301796,14713327,11049191.2,31.5560923000982,30.3785276167748,NaN,NaN,-19.5300319361258,-16.903763155591605
2002-06-28T09:30:00-04:00,20.29675,20.540311,20.223682,20.410412,2208358,2547014.45,45.340723793710865,40.51195187524022,NaN,NaN,-32.63757473597695,-105.3955855008508,-0.017088814230624305,-0.31346374322129833,-0.296374928990674,16921685,12564656,40.45210039122089,31.823517067607366,NaN,NaN,-17.887462269718167,-17.044291600466828
2002-07-01T09:30:00-04:00,20.280513,20.48348,19.988239,19.988239,1533866,2506262.85,40.43319521110852,40.97963769284263,NaN,NaN,-71.66162358023628,-97.02940601927753,-0.021537006289670146,-0.32329618685276174,-0.3017591805630916,15387819,13022045.2,42.86578954124781,33.53373229117417,NaN,NaN,-18.11766166137752,-17.197630180596928
2002-07-02T09:30:00-04:00,19.97201,20.085672,19.663491,19.712204,5973862,2757460.7,37.56985906443315,41.05372010271655,NaN,NaN,-124.3324162150042,-103.5808559424916,-0.038060869422031796,-0.34933526734063136,-0.31127439791859957,9413957,12552882.2,41.0287208315505,35.194007417362506,NaN,NaN,-19.252606416150122,-17.491198214247383
2002-07-03T09:30:00-04:00,19.525474,19.760916,19.225073,19.492991,3746782,2907041.3,35.42438425314157,41.37580866422768,NaN,NaN,-167.7829529958829,-100.31676513109034,-0.057574325314950325,-0.3832423045622875,-0.32566797924733715,5667175,12420792.6,40.50243071514593,36.88961841519722,NaN,NaN,-20.872844891060012,-17.974290596649187
2002-07-05T09:30:00-04:00,19.712204,20.248038,19.712204,20.239911,476677,2823031.55,46.61162582521136,42.19775754429039,NaN,NaN,-53.53165105628367,-89.9892437166768,-0.01615109789915542,-0.34585685162128144,-0.329705753722126,6143852,10706897.6,34.346184199813095,38.001047528119436,NaN,NaN,-18.418917435869353,-18.037808716537782
2002-07-08T09:30:00-04:00,20.134376,20.394174,19.980121,20.134376,3120573,2930296.25,45.4144562043283,41.81575233098205,NaN,NaN,-30.022173338988086,-89.46616343727904,0.0069297130544944685,-0.3210436124040079,-0.3279733254585024,3023279,7927216.4,27.140854047913365,38.1675559004534,NaN,NaN,-16.904306310972604,-17.875879801457042
2002-07-09T09:30:00-04:00,20.215555,20.272394,19.582304,19.606652,1063101,2963823.8,39.8963548996254,40.999260674575176,NaN,NaN,-90.87610729618045,-93.30906018046787,-0.009654991415398606,-0.34004206472775067,-0.33038707331235206,1960178,5241688.2,22.278185968333048,37.1054087168787,NaN,NaN,-17.47669958532045,-17.818854056294672
2002-07-10T09:30:00-04:00,19.679737,19.760916,18.916571,18.981521,3820562,3022176.75,34.54216277359906,40.01353393381611,NaN,NaN,-184.80270286543362,-105.40311751055374,-0.05642615639184756,-0.4009197688021615,-0.34449361241031395,-1860384,2986820,19.172201809423825,35.285524009772544,NaN,NaN,-19.879512869471796,-18.113233886748546
2002-07-11T09:30:00-04:00,18.67301,19.257556,18.064108,19.241319,2441154,3096338.9,38.25101884114922,39.69070239980052,NaN,NaN,-207.1728946647031,-113.28110584431779,-0.06306308020237772,-0.4233224626632861,-0.3602593824609084,580770,1969539,17.955927038827866,33.148974963148945,NaN,NaN,-20.519035822951473,-18.45691987763468
2002-07-12T09:30:00-04:00,19.322506,19.322506,18.851621,18.957173,1984307,3095107.15,35.85795506350988,39.45710799762492,NaN,NaN,-148.39573078304014,-132.25392178966905,-0.07876622247792825,-0.4587171605583187,-0.37995093808039043,-1403537,460061.2,16.303193397457292,31.234619266920685,NaN,NaN,-21.836321341341357,-18.93969151530706
2002-07-15T09:30:00-04:00,18.648654,18.957173,18.194007,18.957173,4186507,3091775.35,35.85795506350986,39.15310986554429,NaN,NaN,-160.58618155345556,-158.36672343256254,-0.08101565212228706,-0.4812205032332493,-0.4002048511109622,-1403537,-425302,15.407407883827588,29.46850296215523,NaN,NaN,-22.85892700301529,-19.49958229926538
2002-07-16T09:30:00-04:00,18.843511,19.005877,18.48628,18.575586,10971339,3523691.9,32.67421355494871,38.78335887189702,NaN,NaN,-140.24611039637534,-168.24072405260154,-0.09888197633639878,-0.5238073215314607,-0.4249253451950619,-12374876,-3292312.8,12.9298807497413,27.881085152242946,NaN,NaN,-24.737542596862934,-20.247862341779317
2002-07-17T09:30:00-04:00,18.949046,19.046478,18.275186,18.461932,4071587,3649912.85,31.769444496721007,38.63648037591078,NaN,NaN,-133.25594411569134,-157.93137230265307,-0.10827585513380733,-0.5602701641123211,-0.4519943089785138,-16446463,-6209528.6,10.992901046754795,26.637990708668315,NaN,NaN,-26.53486124082068,-21.14600504164237
2002-07-18T09:30:00-04:00,18.510636,18.551238,17.771834,17.820547,4445539,3837578.35,27.193177892585283,37.63118049554162,NaN,NaN,-166.62342076100492,-149.82147752191344,-0.14529870360172137,-0.6336176884806655,-0.4883189848789441,-20892002,-10504083,8.883147763532705,25.01849467034221,NaN,NaN,-29.65627091067235,-22.361757308646652
2002-07-19T09:30:00-04:00,17.414612,17.763716,17.365899,17.438968,5116953,3851755.55,24.89557868754447,36.17081298795831,NaN,NaN,-184.8004265296929,-157.10241667124401,-0.18078667900074386,-0.7143023336298739,-0.5335156546291301,-26008955,-15425166.6,7.182158235843332,22.64207023067238,NaN,NaN,-33.03869846006744,-23.88703461599248
2002-07-22T09:30:00-04:00,17.171042,17.495799,16.675802,16.846303,3344993,3871081.3,21.812844303602517,34.84078792313645,NaN,NaN,-192.14571099593766,-163.4143225597404,-0.2265112533578878,-0.8166547213264899,-0.5901434679686021,-29353948,-21015248.8,5.819053470846427,19.995874797072283,NaN,NaN,-37.03605124075468,-25.76546556238708
2002-07-23T09:30:00-04:00,16.805709,16.86254,15.766515,15.888304,4144998,3890505.6,17.944788849262068,33.43899719348138,NaN,NaN,-212.30814075084552,-177.82672863063445,-0.29905346931027155,-0.9639603046064416,-0.66490683529617,-33498946,-25240062.8,5.040447941848754,17.425283876379304,NaN,NaN,-42.07791803486165,-28.095815915597733
2002-07-24T09:30:00-04:00,15.141367,16.86254,15.10079,16.846303,9544505,4300675.8,31.102199596840038,33.130269718031265,NaN,NaN,-172.38263325683374,-185.65206645886295,-0.26164556105177483,-0.9919637866108886,-0.7303182255591137,-23954441,-26741658.4,4.794879309020402,14.87474449022748,NaN,NaN,-41.33791477847748,-29.987544324580554
2002-07-25T09:30:00-04:00,16.683929,17.195398,15.993839,16.72453,6499809,4354058.8,30.434169012028917,31.97473708851823,NaN,NaN,-127.4030419761489,-177.80799070189173,-0.22559621272695796,-1.0123134914678111,-0.7867172787408532,-30454250,-28654108,4.494540955273365,12.742484258474642,NaN,NaN,-41.021055520032355,-31.563760209645096
2002-07-26T09:30:00-04:00,16.821946,17.236,16.72453,17.236,4012834,4135415.3,36.59426690747153,31.34472356731417,NaN,NaN,-89.08157276606522,-158.6642199491662,-0.15136188156568464,-0.975919630697959,-0.8245577491322743,-26441416,-28740600.2,4.480870997115943,11.123914040560537,NaN,NaN,-38.58358003338428,-32.56659161303641
2002-07-29T09:30:00-04:00,17.86114,18.388847,17.755597,18.388847,2449653,4147480.05,47.811859250234924,31.910116735214846,NaN,NaN,-18.246970611275877,-123.88447187223385,-0.015809263122631423,-0.8443193280355636,-0.8285100649129322,-23991763,-27668163.2,8.208756993710224,10.118954828087478,NaN,NaN,-32.131216366337014,-32.50439514922221
2002-07-30T09:30:00-04:00,18.226482,18.591815,17.934208,18.429449,4818505,4311712,48.15971480569886,32.88279902322198,NaN,NaN,-4.306608161816014,-82.28416535442794,0.08012573262280875,-0.7283528991344212,-0.80847863175723,-19173258,-24803025.6,17.4752396861889,9.997743247856409,NaN,NaN,-27.218187091255185,-31.749222569512636
2002-07-31T09:30:00-04:00,18.34827,18.713603,18.242719,18.713603,3555002,4190769,50.63941103784081,33.76768418012852,NaN,NaN,16.205557642556126,-44.56652717454998,0.1615603958859434,-0.6065281368998008,-0.7680885327857442,-15618256,-23135788.6,22.385378295575023,10.314132623338349,NaN,NaN,-22.475697860512778,-30.424433325369797
2002-08-01T09:30:00-04:00,18.583704,18.616171,18.210236,18.250838,1905846,4098722.2,46.71996222325546,34.54354183439606,NaN,NaN,6.820512794548187,-17.721816220410563,0.1816027375910786,-0.5410851107968959,-0.7226878483879745,-17524102,-20549759,29.401921392994353,11.249756051590996,NaN,NaN,-19.827633571027224,-28.910604789035144
2002-08-02T09:30:00-04:00,18.064108,18.218363,17.552629,17.788072,5635628,4356669.75,43.125330448193246,35.062640076159155,NaN,NaN,-23.184358894901013,-4.542373446177726,0.1617009356489013,-0.5205616788268479,-0.6822626144757492,-23159730,-19893421.8,31.104276389363335,12.37096094484355,NaN,NaN,-18.800094788106236,-27.46624621747387
2002-08-05T09:30:00-04:00,17.698766,17.698766,17.057381,17.089864,3527412,4377011.7,38.33313693180486,35.46684888879174,NaN,NaN,-58.67613764829043,-12.628206853580636,0.10241229611358382,-0.5542472443337694,-0.6566595404473532,-26687142,-20432497.6,30.454716339522506,13.622734915542209,NaN,NaN,-19.527746799107163,-26.332174871992912
2002-08-06T09:30:00-04:00,17.576977,17.999158,17.471442,17.650062,3837437,4515728.5,43.735432176564146,36.32156229449482,NaN,NaN,-17.248635207477985,-15.216612262713038,0.10161987099441439,-0.5296347017043352,-0.6312545726987496,-22849705,-21167787,29.548305810555547,14.948120970099405,NaN,NaN,-18.325202012209502,-25.188321606309568
2002-08-07T09:30:00-04:00,18.064108,18.064108,17.512044,17.877377,1521918,4400796.3,45.809950294449486,37.65133175177083,NaN,NaN,-1.5280420867925817,-18.763332208582778,0.11605785241926203,-0.4861822571746721,-0.6022401095939341,-21327787,-22309693.2,28.14722625416391,16.32412657657306,NaN,NaN,-16.699697099148917,-23.975660962429476
2002-08-08T09:30:00-04:00,18.18588,18.875977,18.177769,18.811028,2542402,4405858.7,53.40849073350641,39.6879683264824,NaN,NaN,77.00880605866064,-4.725673555760275,0.18409728882852938,-0.3721184985582724,-0.5562157873868018,-18785385,-22561949.8,27.833254205013745,17.799204860085233,NaN,NaN,-12.673692105216189,-22.361093982827576
2002-08-09T09:30:00-04:00,18.551238,19.127657,18.510636,18.973402,1541502,4383718.45,54.600763930612175,42.02996258555452,NaN,NaN,102.92801828317891,20.496801879855713,0.23252564784628538,-0.26555872757894505,-0.49808437542523043,-17243883,-21378780.4,31.68250653945897,19.646594364986125,NaN,NaN,-9.118094458092916,-20.469236907865483
2002-08-12T09:30:00-04:00,18.67301,18.892215,18.559348,18.762316,2080135,4278399.85,52.71230042811358,44.513356269758205,NaN,NaN,89.65869821495188,50.16376905250418,0.2417601511650741,-0.19588418646888783,-0.43764433763396193,-19324018,-19906155.6,36.24089503553429,21.875197728820808,NaN,NaN,-6.817981345325812,-18.51905754178839
2002-08-13T09:30:00-04:00,18.746078,19.030233,18.315787,18.315787,3276017,3893633.75,48.8623170309044,45.78193608647708,NaN,NaN,73.00784985737062,68.2150660654739,0.21036817460987411,-0.17468411937161932,-0.38505229398149343,-22600035,-19856221.6,36.39586719258068,24.132411149075114,NaN,NaN,-6.051344834671609,-16.737955726485993
2002-08-14T09:30:00-04:00,18.307669,19.119538,18.11282,19.046478,6043084,3992208.6,54.69373201337776,47.51476201514486,NaN,NaN,91.4595782307522,86.81259012898286,0.2298058853955568,-0.09779493723704746,-0.32760082263260426,-16556951,-18902054.4,39.42566024276948,26.62749109818198,NaN,NaN,-3.5153460192491326,-14.849011482595014
2002-08-15T09:30:00-04:00,19.281912,19.322506,19.030233,19.281912,5015704,4020716.85,56.41821159399691,48.930758064182385,NaN,NaN,120.13639940294622,95.43810879783997,0.2479537837260296,-0.017658592975067222,-0.26561237670109683,-11541247,-17453226.8,43.803069339374524,29.43621955120045,NaN,NaN,-0.9212230809623877,-12.859327425218925
2002-08-16T09:30:00-04:00,19.078945,19.29815,18.356381,19.143895,3328365,3931287.45,55.09431328858924,49.45093335263626,NaN,NaN,85.48945978405504,91.9503970980152,0.2399440025795605,0.034317626523353795,-0.2056263760562067,-14869612,-16978372.6,45.20082331710512,32.07851000287151,NaN,NaN,0.7978593721517414,-10.908300739880259
2002-08-19T09:30:00-04:00,19.16014,19.687847,19.078945,19.631008,3077586,3917917.1,58.77149209909645,50.20891744502181,NaN,NaN,120.3107718984017,98.08081183470514,0.25530643592341384,0.1135066688480606,-0.14179976707535324,-11792026,-15471974.2,49.49260257715527,34.365464495083394,NaN,NaN,3.3890604860502167,-8.865820564747334
2002-08-20T09:30:00-04:00,19.566075,19.566075,19.200717,19.363108,1093524,3765343.4,56.0529291362117,50.59559730919115,NaN,NaN,109.01670636302113,105.28258313583527,0.2357477355510426,0.15288490236344998,-0.0828628331875926,-12885550,-13529077.2,54.44786537438115,36.655642143569544,NaN,NaN,4.759239903174729,-6.919383355044182
2002-08-21T09:30:00-04:00,19.566075,19.566075,19.095182,19.403685,1853252,3380780.75,56.382030760444486,51.28574506184752,NaN,NaN,104.0267543571458,107.796018361114,0.21447540919816277,0.18523142831011086,-0.029243980888051913,-11032298,-12424146.6,57.02982098237824,38.62906354281125,NaN,NaN,5.968325547200447,-5.078282083294949
2002-08-22T09:30:00-04:00,19.48488,19.777153,19.281912,19.631008,1302917,3120936.15,58.26751316528026,52.36732954163944,NaN,NaN,121.92824787307936,108.15438805514061,0.2046730063832407,0.22659727709099897,0.021924270707758264,-9729381,-12061773.4,57.873164722605964,40.54112699518573,NaN,NaN,7.518856481082901,-3.278690859812399
2002-08-23T09:30:00-04:00,19.444286,19.509236,19.16014,19.216963,908150,2965701.95,53.7131610686258,53.465902694269516,NaN,NaN,84.56593394449924,107.96968288722947,0.16117648899578008,0.22339488195248336,0.06221839295670328,-10637531,-11215357.2,59.855060662235516,42.64115158966523,NaN,NaN,7.600641596178202,-1.724500508956599
2002-08-26T09:30:00-04:00,19.306269,19.598542,19.135784,19.501117,1282348,2907336.7,56.2410496529273,54.35916108543831,NaN,NaN,90.01794209553942,101.911116926657,0.14303138791251654,0.24100762784734897,0.09797623993483243,-9355183,-10727988.6,60.993009456504815,44.88720185009017,NaN,NaN,8.377148060463995,-0.28140785618222863
2002-08-27T09:30:00-04:00,19.67161,19.687847,19.216963,19.322506,2432409,2788031.9,54.235990927621124,54.961021130664854,NaN,NaN,81.64536781068603,96.43684921618998,0.11186868095040664,0.23781209112284074,0.1259434101724341,-11787592,-10508397,61.522239586551905,47.271131373832176,NaN,NaN,8.479409449918798,0.970137473260775
2002-08-28T09:30:00-04:00,19.16014,19.265675,18.827265,19.005877,3552662,2787914.9,50.779843883698966,54.773260641392895,NaN,NaN,31.496443249915366,81.9307869947439,0.06511743373188073,0.207340202337285,0.14222276860540428,-15340254,-11369988.2,58.18648237049763,49.439219099938164,NaN,NaN,7.601069526732782,1.9174134808996333
2002-08-29T09:30:00-04:00,18.632416,19.208844,18.632416,19.022106,2222769,2803761.05,50.95236745353179,54.51266089303001,NaN,NaN,18.61150666898287,61.2674387539246,0.032140173252451554,0.18239798517096872,0.15025781191851717,-13117485,-12047609,55.631695075591075,51.149875423947606,NaN,NaN,6.919664089570736,2.632020710709791
2002-08-30T09:30:00-04:00,18.916571,19.428041,18.916571,19.062708,2043553,2624157.3,51.41122905106411,54.41972722324077,NaN,NaN,37.439975852992525,51.84224713562325,0.011007077265387716,0.16401665850025182,0.1530095812348641,-11073932,-12134889.2,55.29492645567372,52.510877668243275,NaN,NaN,6.462198615972309,3.1791889828901505
2002-09-03T09:30:00-04:00,18.67301,18.754205,18.11282,18.129057,1085888,2502081.1,41.74079074455675,53.91104677421593,NaN,NaN,-98.76938122099712,14.084782472315933,-0.06379413184796931,0.07326691642490246,0.13706104827287177,-12159820,-12695816.6,53.07138440854013,53.7019860408118,NaN,NaN,3.1247590978882758,3.17141328503274
2002-09-04T09:30:00-04:00,18.104701,18.543111,18.080345,18.470043,2306650,2425541.75,45.754006468495206,53.272494949581464,NaN,NaN,-108.6109912207482,-23.966489333970912,-0.08682251627363564,0.02853290293082722,0.11535541920446286,-9853170,-12308932.2,54.43243762217661,54.77389871076946,NaN,NaN,1.4375313962689598,2.9237158723522
2002-09-05T09:30:00-04:00,18.137176,18.429449,17.909852,18.194007,1394558,2419173.75,43.161959128102154,52.32561977344612,NaN,NaN,-153.49691222519496,-60.965160428992974,-0.11537252771428014,-0.028860240438387308,0.08651228727589283,-11247728,-11490427,57.256854204625434,55.734883344001666,NaN,NaN,-0.7640777638030926,2.3968882100443007
2002-09-06T09:30:00-04:00,18.470043,18.632416,18.413203,18.470043,1290970,2356602.15,46.43023157184785,51.70675679367887,NaN,NaN,-88.10672078458435,-82.30880591970643,-0.1103918465925759,-0.05147752096482705,0.058914325627748856,-9956758,-10858281.6,59.35235838332866,56.745707277303346,NaN,NaN,-1.6873637249757003,1.8134236478985863
2002-09-09T09:30:00-04:00,18.396974,18.932817,18.202125,18.762316,1389877,2349020.9,49.72652392038104,51.06068763805634,NaN,NaN,-59.8513834111405,-101.76707777253303,-0.08336805974907296,-0.04529574905859235,0.038072310690480615,-8566881,-10356871.4,60.98616827587026,57.56667625578299,NaN,NaN,-1.5159693287732372,1.3377960798026116
2002-09-10T09:30:00-04:00,18.762316,18.811028,18.470043,18.648654,897064,2289867.35,48.4772569138328,50.51956819360071,NaN,NaN,-56.28276118244771,-93.26975376482315,-0.06966052353612864,-0.04900334372968018,0.020657179806448454,-9463945,-9817696.4,62.72136010249873,58.15764016493425,NaN,NaN,-1.7270510607624023,0.8999607740076097
2002-09-11T09:30:00-04:00,18.981521,18.981521,18.494399,18.543111,424082,2147270.6,47.289224779298124,49.870082052090254,NaN,NaN,-52.8428025268163,-82.11611602603676,-0.06434102090213091,-0.05976909632121519,0.004571924580915723,-9888027,-9824667.8,62.68254055973661,58.56140584903127,NaN,NaN,-2.2308352218176952,0.45270420317542326
2002-09-12T09:30:00-04:00,18.388847,18.461932,17.999158,18.023514,598371,1875034.95,41.85143529029545,48.69750506101991,NaN,NaN,-129.528220653766,-77.32237771175099,-0.09083514510321643,-0.10897200679810481,-0.018136861694888387,-10486398,-9672401.8,63.21801376780331,58.943180780831085,NaN,NaN,-4.278928258470966,-0.22324329134548937
2002-09-13T09:30:00-04:00,17.942335,18.242719,17.92609,18.161532,5472060,1897852.75,43.70324904580282,47.98251134510399,NaN,NaN,-119.11909819713074,-83.52485319426026,-0.09370608384087092,-0.13526946649597704,-0.04156338265510612,-5014338,-8683917.8,66.5714819421836,59.42292515797023,NaN,NaN,-5.469976704783596,-0.9727766361223618
2002-09-16T09:30:00-04:00,18.064108,18.202125,17.86114,18.120947,1679948,1815431.9,43.266905411684704,47.0557867564438,NaN,NaN,-110.17076864868548,-93.58873024176926,-0.09280441932552867,-0.15756890681201696,-0.06476448748648829,-6694286,-8309398.8,67.77043545324753,59.90702701488043,NaN,NaN,-6.575767276376365,-1.7732038704443622
2002-09-17T09:30:00-04:00,18.48628,18.48628,17.715012,17.731241,1237267,1723415.95,39.21783981147553,45.98306167671912,NaN,NaN,-110.64772317635885,-104.46172264055149,-0.11165399348814485,-0.20433197934666936,-0.0926779858585245,-7931553,-8002920.4,68.75793223699306,60.42386220419764,NaN,NaN,-8.72004858531154,-2.76561025828253
2002-09-18T09:30:00-04:00,17.309077,17.812428,17.309077,17.585104,2774458,1807462.65,37.789669974274446,45.05519211176023,NaN,NaN,-152.17488044865829,-124.3281382249199,-0.12609664898913397,-0.25029879709494196,-0.124202148105808,-10706011,-8166517.2,67.56783924179895,61.09395912357631,NaN,NaN,-10.93673346372892,-3.9329135733463003
2002-09-19T09:30:00-04:00,17.292831,17.414612,16.935608,16.976202,1934053,1811502.7,32.481927142237126,43.73587494666775,NaN,NaN,-185.82252141176522,-135.58699837651972,-0.16626520680930026,-0.33203365661743334,-0.16576844980813307,-12640064,-8597250.4,64.40695157493224,61.72076315924353,NaN,NaN,-14.616627450653382,-5.459158412961598
2002-09-20T09:30:00-04:00,16.968075,17.065507,16.683929,16.805709,3091997,1900956.7,31.16212836668744,42.289510612069414,NaN,NaN,-190.50235371886203,-149.86364948086597,-0.19209536941830035,-0.40588766158100853,-0.21379229216270818,-15732061,-10740795,51.49616317421359,61.44942292485353,NaN,NaN,-18.07852257139432,-7.261924721309129
2002-09-23T09:30:00-04:00,16.765107,16.943727,16.399774,16.813836,2355795,1973338.95,31.305412086005788,41.54412642217291,NaN,NaN,-178.06278077601385,-163.44205190633164,-0.1957475085686211,-0.45847667787348456,-0.26272916930486345,-13376266,-12077191,45.387531883173345,60.90057631589876,NaN,NaN,-20.857687178173375,-9.204176500861164
2002-09-24T09:30:00-04:00,16.56214,17.008676,16.367299,16.48908,3192383,2068840.7,28.731795830320678,40.32825423373187,NaN,NaN,-164.62908051069087,-174.23832337319806,-0.20610510832255946,-0.5203605547080628,-0.3142554463855033,-16568649,-13804610.2,38.95503101641579,59.79504727263012,NaN,NaN,-24.0576224906367,-11.326097356543384
2002-09-25T09:30:00-04:00,16.643335,16.943727,16.334824,16.813836,3058494,2100144.95,34.52825726359825,39.711561243410166,NaN,NaN,-133.83852239021732,-170.57105176150986,-0.17820250468808085,-0.5370085772456044,-0.3588060725575235,-13510155,-14365439,37.11586827679701,58.356405420642375,NaN,NaN,-25.177911624173937,-13.304927966204891
2002-09-26T09:30:00-04:00,16.935608,17.37401,16.886896,17.30095,3041250,2074574.35,42.13101437887558,39.404474301055004,NaN,NaN,-73.16680512625928,-148.03990850440866,-0.11701437956548694,-0.5050740470143822,-0.38805966744889525,-10468905,-13931207.2,39.497665255388775,56.93821305436096,NaN,NaN,-23.841995980029626,-14.810223396751281
2002-09-27T09:30:00-04:00,17.252238,17.382137,16.765107,16.765107,739527,2000412.25,37.036128808050826,38.49801750731713,NaN,NaN,-82.84178984355881,-126.50779572934803,-0.10318714353468378,-0.51704359686725,-0.4138564533325662,-11208432,-13026481.4,44.23672292122168,55.741824100457485,NaN,NaN,-24.27453993328855,-16.162268616256604
2002-09-30T09:30:00-04:00,16.602741,16.98432,16.229289,16.781353,2896030,2043036.1,37.283760428571526,37.69848204408418,NaN,NaN,-99.81734304891968,-110.85870818392918,-0.084301427242719,-0.5192332373859649,-0.43493181014324594,-8312402,-12013708.6,49.04800469500716,54.76515585706523,NaN,NaN,-24.542026052712764,-17.359376821464625
2002-10-01T09:30:00-04:00,16.927498,17.528273,16.700174,17.495799,4011849,2189334.15,47.13117037391433,37.68719244369962,NaN,NaN,-39.540658870658554,-85.84102385592273,-0.018485541094694857,-0.45803873651161453,-0.4395531954169197,-4300553,-9560089.4,58.41022560000062,54.45999050279837,NaN,NaN,-21.541241302311846,-17.95678603301423
2002-10-02T09:30:00-04:00,17.219771,17.503917,16.683929,16.79759,3381575,2243080.4,40.44724397365475,37.58689306393957,NaN,NaN,-57.73292086012855,-70.61990354990499,-0.01681512076979208,-0.46057209637915975,-0.44375697560936767,-7682128,-8394484,61.98389504603347,54.3718391655291,NaN,NaN,-21.179357214315594,-18.41715334462871
2002-10-03T09:30:00-04:00,16.813836,16.878769,16.123738,16.123738,4896719,2418188.45,35.251322156875545,36.98318400044476,NaN,NaN,-106.93993580343538,-77.3745296853402,-0.05384467001311488,-0.5110628131257613,-0.4572181431126464,-12578847,-8816472.4,59.97466667074982,53.900638074712404,NaN,NaN,-22.72516883180106,-19.03258412851047
2002-10-04T09:30:00-04:00,16.2374,16.294239,15.522954,15.67721,6435388,2675409.35,32.291093342817334,36.19919742409709,NaN,NaN,-145.25877269813455,-89.85792625625537,-0.09855945077473927,-0.5804174565810705,-0.4818580058063312,-19014235,-10377633,53.11505084784931,52.85382488861253,NaN,NaN,-25.0281293480196,-19.889090588440347
2002-10-07T09:30:00-04:00,15.531073,15.774626,15.10079,15.181969,7625479,2987189.45,29.347526188733795,35.49417502247268,NaN,NaN,-177.30341665112658,-105.35514097669675,-0.1486312760018671,-0.6676471008086651,-0.519015824806798,-26639714,-14043095.4,41.20001837349773,50.88540246979143,NaN,NaN,-27.957735187183047,-21.041754102546445
2002-10-08T09:30:00-04:00,15.42553,16.026322,15.263156,15.766515,9541426,3419407.55,36.68406178918068,35.4152030092517,NaN,NaN,-134.96905635007252,-124.44082047257955,-0.13018770059489282,-0.6817504505504139,-0.5515627499555211,-17098288,-16602642.4,35.25307671371594,48.577205146356924,NaN,NaN,-27.795084747418343,-22.006515623242432
2002-10-09T09:30:00-04:00,15.466123,15.555429,15.052062,15.10079,5567148,3676560.85,32.5398659298439,35.419341494080754,NaN,NaN,-163.31453837743686,-145.5571439760412,-0.1492594923888001,-0.7381371154415213,-0.5888776230527212,-22665436,-19599304,29.825105516329998,46.1070732850282,NaN,NaN,-29.1413256051323,-23.02577419208384
2002-10-10T09:30:00-04:00,15.068307,16.001966,15.035832,15.896415,3858253,3839554.95,41.10337054028336,36.129430220766174,NaN,NaN,-110.77498096245823,-146.32415300784578,-0.0972452791151166,-0.7104342219466169,-0.6131889428315003,-18807183,-20844971.2,27.90190994258934,44.42176948276932,NaN,NaN,-27.113503942581186,-23.609735585012032
2002-10-11T09:30:00-04:00,16.399774,17.033033,16.318595,16.732641,4512545,3791579.2,48.502645766454386,37.35780405508394,NaN,NaN,2.277124135077944,-116.81697364120328,-0.0005897034085953212,-0.6139260720922444,-0.613336368683649,-14294638,-19901051.8,31.50612554007654,43.4302404582624,NaN,NaN,-22.631588918721306,-23.4700003469705
2002-10-14T09:30:00-04:00,16.578385,16.992431,16.578385,16.854413,2362077,3825685.65,49.49763619292121,38.84107836669826,NaN,NaN,23.65539661616044,-76.62521098774587,0.07338592729779081,-0.5216039595614106,-0.5949898868592014,-11932561,-16959621.2,41.34606706219787,43.60102874724684,NaN,NaN,-18.900830191012087,-22.817261753262155
2002-10-15T09:30:00-04:00,18.064108,18.104701,17.67441,18.064108,8207469,4174195.75,58.14847801876711,40.52823699206747,NaN,NaN,161.0853612399377,-17.414327469743803,0.19852972596182084,-0.3468277294069253,-0.5453574553687461,-3725092,-14284982,48.57984902241339,44.419884514790866,NaN,NaN,-12.331690918972177,-21.3193230626493
2002-10-16T09:30:00-04:00,17.779945,17.974802,17.650062,17.739368,1559116,4113428.65,55.40476691110056,41.47636217294068,NaN,NaN,138.88685532188384,43.025951270120345,0.2508079499093112,-0.23184751798210712,-0.48265546789141833,-5284208,-10808736.4,56.14945392602753,45.60929799126506,NaN,NaN,-8.21306557019013,-19.44700056372656
2002-10-17T09:30:00-04:00,18.388847,18.405093,18.137176,18.267075,3503147,4191883.35,58.80628468736872,43.031373307177674,NaN,NaN,176.1049106785733,100.40192959832666,0.30850446639754453,-0.09702488489448768,-0.4055293512920322,-1781061,-7403512,62.0438813880294,46.881237881751325,NaN,NaN,-3.691695355968726,-17.196242676904014
2002-10-18T09:30:00-04:00,18.023514,18.526882,17.942335,18.250838,2124724,4143519.7,58.658029671194186,44.55810682450787,NaN,NaN,148.15176510810934,129.57685779293294,0.3311561375366614,0.008415820628794535,-0.32274031690786686,-3905785,-5325741.4,65.12440662125172,48.02955230505448,NaN,NaN,-0.27003422431294616,-14.778212897962433
2002-10-21T09:30:00-04:00,18.18588,18.60806,17.982912,18.551238,2840848,4167772.35,60.63532328907887,45.52268917559104,NaN,NaN,137.03935931705539,152.25365033311192,0.35010720230599635,0.11489368597462857,-0.23521351633136778,-1064937,-3152216.6,68.04600074644156,48.71782195837169,NaN,NaN,3.1515331918043876,-12.216820599424317
2002-10-22T09:30:00-04:00,18.250838,18.478153,18.202125,18.380737,2488206,4132563.5,58.91304568331388,46.84167501199527,NaN,NaN,116.81508704088665,143.39959549330175,0.3348955857221888,0.18340596582136826,-0.15148961990082055,-3553143,-3117826.8,68.09154711521464,49.154082820456054,NaN,NaN,5.423745406137304,-9.696739741486942
2002-10-23T09:30:00-04:00,18.283312,18.429449,17.804301,18.388847,3399805,4149629.05,58.97273939508939,48.53606195758197,NaN,NaN,93.2912746022837,134.2804793493817,0.30970412235454203,0.235640533042357,-0.07406358931218504,-153338,-2091652.8,69.48907336848893,49.833683298866,NaN,NaN,7.274333630926192,-7.272300688285066
2002-10-24T09:30:00-04:00,18.429449,18.616171,17.991039,18.055997,2508899,4123011.5,55.41430536247015,50.18771995898574,NaN,NaN,84.81222316364206,116.02194184639545,0.2571129135043829,0.24732755256829364,-0.009785360936089296,-2662237,-2267888,68.93070184647374,50.96337265591059,NaN,NaN,7.866712961849926,-5.109584452551496
2002-10-25T09:30:00-04:00,17.942335,18.543111,17.869251,18.510636,1323857,4152228,59.049053871719,52.30925765062754,NaN,NaN,81.0308123108767,102.59775128694892,0.23977468900147614,0.28993300031575586,0.05015831131427974,-1338380,-1754407,69.69478481271386,52.998713115854606,NaN,NaN,9.430435150517983,-3.0324387949701417
2002-10-28T09:30:00-05:00,18.835384,18.835384,18.315787,18.461932,4723662,4243609.6,58.49886864698943,53.86745814047102,NaN,NaN,86.78796199864341,92.54747182326652,0.21277258112548703,0.3161240377211385,0.1033514565956515,-6062042,-2753828,66.27822730551222,55.214795300982914,NaN,NaN,10.563544607613592,-1.090155451743894
2002-10-29T09:30:00-05:00,18.34827,18.429449,17.917979,18.258964,4217670,4253900.65,56.150858313398686,55.55395759643922,NaN,NaN,59.28341794781172,81.04113800465151,0.17079911364248693,0.31685034864876016,0.14605123500627323,-10279712,-4099141.8,61.88074786945151,57.50448404049159,NaN,NaN,10.892175027599848,0.6216060453052117
2002-10-30T09:30:00-05:00,18.34827,18.551238,18.226482,18.461932,2881372,4228890.5,57.9677131909332,56.75855350005707,NaN,NaN,66.13574988847488,75.61003306188977,0.14715880797495998,0.3299997449749732,0.18284093700001322,-7398340,-5548142.2,57.45874839761263,59.61568678727896,NaN,NaN,11.66066337673116,2.198614235508918
2002-10-31T09:30:00-05:00,18.551238,18.551238,18.161532,18.315787,1212139,4044661.5,56.16323221150122,57.305738246131845,NaN,NaN,57.243062154678086,70.09620086009696,0.11363365608893547,0.32488300711118256,0.2112493510222471,-8610479,-6737790.6,54.04409827831453,61.2255419828674,NaN,NaN,11.838120557645535,3.5756865672427205
2002-11-01T09:30:00-05:00,18.202125,18.624298,18.039751,18.575586,1629940,3804389.1,58.6287223554004,57.95795868630893,NaN,NaN,58.014545340198296,65.4929474659613,0.10131772158684613,0.33789650300580476,0.23657878141895863,-6980539,-7866222.4,50.95106434664193,61.91161321747054,NaN,NaN,12.64677466895624,4.871556296058937
2002-11-04T09:30:00-05:00,18.892215,19.168251,18.67301,18.729849,2812765,3563753.4,60.064964932785294,58.0948506087388,NaN,NaN,87.87481982087465,65.71031903040753,0.09597495073727841,0.35654746984055663,0.2605725191032782,-4167774,-7487368.8,51.94544295541469,62.15201278411349,NaN,NaN,13.718708896295947,6.135435238949938
2002-11-05T09:30:00-05:00,18.616171,18.867867,18.591815,18.794782,2162415,3194802.85,60.68367917495805,58.47191577044291,NaN,NaN,80.24913543269301,69.9034625273838,0.08936332241362605,0.3722766721203108,0.28291334970668475,-2005359,-5832498.2,56.12927553110146,62.1505714701902,NaN,NaN,14.787261676677211,7.371410444339548
2002-11-06T09:30:00-05:00,18.851621,18.99775,18.429449,18.835384,3863919,3109641.4,61.08962502033599,58.635011508512,NaN,NaN,86.09332793197242,73.8949781360833,0.08054656662252807,0.3835965579848448,0.30304999136231675,1858560,-3981118.2,60.294223871264805,62.025595933278446,NaN,NaN,15.799104991474245,8.575366808215934
2002-11-07T09:30:00-05:00,18.526882,18.60806,18.129057,18.153413,6604631,3246960.3,51.47570140177312,58.12198806069621,NaN,NaN,20.35569348916821,66.51750440298133,0.024513365846872803,0.33369169867090775,0.30917833282403495,-4746071,-3208236.6,61.919544440745966,61.79667720609946,NaN,NaN,14.100775972707346,9.36471097457185
2002-11-08T09:30:00-05:00,18.169651,18.445686,17.999158,18.055997,1976055,3120135.8,50.258966869011616,57.38081974497713,NaN,NaN,-25.39291049815334,49.836013235311,-0.020927771381797355,0.28301861859678823,0.3039463899785856,-6722126,-3156554,62.031468951866465,61.36706779220124,NaN,NaN,12.336817382987762,9.78929760434555
2002-11-11T09:30:00-05:00,17.958564,18.080345,17.739368,17.86114,2326727,3118368.3,47.82391034398985,56.58873864931112,NaN,NaN,-144.94323320604886,3.2724026299262903,-0.063518667235969,0.22454805593362437,0.28806672316959336,-9048853,-4132769.8,58.531996561542876,60.684242752653255,NaN,NaN,10.140634889750649,9.839488645117708
2002-11-12T09:30:00-05:00,17.917979,18.267075,17.917979,18.04787,3577789,2886884.3,50.30853101636953,55.9698666222597,NaN,NaN,-86.81092184617731,-30.139608825847773,-0.07759363910183559,0.19107467429229885,0.26866831339413444,-5471064,-4825910.8,56.111508795274474,59.72870242599508,NaN,NaN,8.899957630067973,9.705269928682032
2002-11-13T09:30:00-05:00,17.877377,18.559348,17.682529,17.958564,2943574,2956107.2,49.104166005700264,55.51914238249042,NaN,NaN,-102.33648090735393,-67.82557059371304,-0.09049667002456435,0.15554747586342899,0.24604414588799334,-8414638,-6880550.4,49.56801320157623,58.34565323707384,NaN,NaN,7.524319539747388,9.393705587405654
2002-11-14T09:30:00-05:00,18.242719,18.502509,18.242719,18.502509,1734390,2867669.35,56.01155807462262,55.302178396983535,NaN,NaN,26.67264999782602,-66.5621792919815,-0.06136989321940739,0.16933177936373411,0.2307016725831415,-6680248,-7267385.8,48.42306617702887,56.826244763096334,NaN,NaN,8.194584983132273,9.222402643938027
2002-11-15T09:30:00-05:00,18.364499,18.681121,18.210236,18.67301,3262591,2924562.7,57.93851963343706,55.26215346744408,NaN,NaN,59.69972291762525,-49.54365260882577,-0.031118970199165513,0.1918029598341846,0.22292193003335012,-3417657,-6606492,50.52565376272729,55.7010609386117,NaN,NaN,9.310209069596523,9.234946419032099
2002-11-18T09:30:00-05:00,18.819138,18.819138,18.250838,18.34827,2134947,2889267.65,53.16182082454807,55.04865078966903,NaN,NaN,39.0107767253569,-12.752850622544615,-0.033283454700556686,0.18131761165765425,0.21460106635821094,-5552604,-5907242.2,52.72172079899958,55.0468447192937,NaN,NaN,8.909830074253739,9.188501226920904
2002-11-19T09:30:00-05:00,18.283312,18.526882,18.161532,18.356381,1737962,2851755.45,53.265459472639925,54.712775524076655,NaN,NaN,-5.412821695081228,3.526769407674601,-0.034334189846317614,0.17168332905031392,0.20601751889663153,-3814642,-5575957.8,53.768739837464715,54.78327267928314,NaN,NaN,8.610590630762598,9.10594257032686
2002-11-20T09:30:00-05:00,18.34827,18.851621,18.34827,18.819138,1211277,2742329.05,58.85869466347585,54.90530855636056,NaN,NaN,98.2360854690942,43.64128268296423,-0.005539067052485774,0.19909368508102432,0.2046327521335101,-2603365,-4413703.2,57.338310166525446,55.01857352844106,NaN,NaN,9.971458384548471,9.229587686644233
2002-11-21T09:30:00-05:00,19.062708,19.306269,19.005877,19.265675,2324756,2733121.9,63.40944712376203,55.24678889695782,NaN,NaN,221.62911842109847,82.63257636761873,0.039430875516122815,0.2539213465286636,0.2144904710125408,-278609,-3133375.4,60.91812216639403,55.730506229851926,NaN,NaN,12.588909709354029,9.709490832745633
2002-11-22T09:30:00-05:00,19.208844,19.322506,19.103301,19.135784,2847623,2809310.2,61.28585224730682,55.33399513370936,NaN,NaN,178.7262424777273,106.43788027963913,0.05530532380204092,0.28362212576509194,0.228316801963051,-3126232,-3075090.4,61.078238251954566,56.38284875103334,NaN,NaN,14.11906146352662,10.339429494285774
2002-11-25T09:30:00-05:00,19.16014,19.290023,18.900334,19.103301,3094214,2727837.8,60.73802938236585,55.337877291381346,NaN,NaN,132.2725664387113,125.09023822231002,0.058201414111621136,0.30106856960257744,0.2428671554909563,-6220446,-3208658.8,60.466861981446755,56.692676354629434,NaN,NaN,15.214053321000357,11.035804326673572
2002-11-26T09:30:00-05:00,18.794782,18.957173,18.494399,18.583704,3415448,2687726.7,52.6333453919721,54.733857317926784,NaN,NaN,33.37682954377181,132.84816847008062,0.021591972946046117,0.26985712167351394,0.24826514872746783,-9635894,-4372909.2,55.27330538523417,56.33403931991296,NaN,NaN,13.759865919103257,11.424955982734955
2002-11-27T09:30:00-05:00,18.770434,19.184488,18.713603,19.16014,931676,2590241.9,59.14627253982123,55.28175525635879,NaN,NaN,96.666411457828,132.53423366782738,0.03203741045441699,0.2883119117954891,0.2562745013410721,-8704218,-5593079.8,50.38859795976148,55.51040028555693,NaN,NaN,14.539459621656661,11.869885074009485
2002-11-29T09:30:00-05:00,19.095182,19.176369,18.99775,18.99775,531735,2556221.7,56.7777655322824,55.74738373230671,NaN,NaN,93.03685273225115,106.81578053005792,0.024205198189999777,0.2865309990785718,0.26232580088857205,-9235953,-7384548.6,44.210910225925,54.23750323370397,NaN,NaN,14.431256641215331,12.235795297896034
2002-12-02T09:30:00-05:00,19.241319,19.379337,18.811028,18.99775,2690701,2609259.75,56.7777655322824,56.38694481718475,NaN,NaN,84.77971003710988,88.02647404193442,0.015635668538399705,0.2818703865615717,0.266234718023172,-9235953,-8606492.8,40.558323926284146,52.95366947404262,NaN,NaN,14.345038494835835,12.53711575460172
2002-12-03T09:30:00-05:00,18.916571,18.957173,18.689247,18.721722,1063470,2521795,52.62353550785833,56.55230228086251,NaN,NaN,32.23021574113176,68.01800390241851,-0.010597867422090457,0.25298738374555896,0.2635852511676494,-10299423,-9422288.2,38.284244289173365,51.680293437892544,NaN,NaN,13.036023365109642,12.608388270388566
2002-12-04T09:30:00-05:00,18.551238,18.85974,18.526882,18.721722,693337,2448341.1,52.62353550785833,56.80368581673095,NaN,NaN,15.709610562915325,64.48456010624722,-0.028888038232570135,0.22747520337693672,0.25636324160950685,-10299423,-9554994,37.91185766696586,50.84771089970609,NaN,NaN,11.974272057441986,12.517800239967626
2002-12-05T09:30:00-05:00,18.754205,18.754205,18.356381,18.396974,988335,2304561.9,47.84683341036934,56.220491197855715,NaN,NaN,-21.629145440786814,40.82544872652426,-0.06189947768549536,0.17898889450263766,0.24088837218813303,-11287758,-10071702,36.42617016928516,49.990789756295825,NaN,NaN,9.639238758263147,12.1065771711527
2002-12-06T09:30:00-05:00,18.11282,18.664899,17.974802,18.543111,1547168,2051688.75,50.04434501739391,55.65662158242406,NaN,NaN,-44.799340117337714,13.25821015660648,-0.07221554686279483,0.15061893860963949,0.2228344854724343,-9740590,-10172629.4,36.128353395177605,48.9624111586137,NaN,NaN,8.284071994560199,11.560505003068057
2002-12-09T09:30:00-05:00,18.34827,18.478153,18.145303,18.18588,990675,2002419.75,45.04751093188794,55.077028018662624,NaN,NaN,-72.10937803929137,-18.11960745867377,-0.09972498820251718,0.09817825021928783,0.19790323842180502,-10731265,-10471691.8,35.20973361119273,47.71155493091321,NaN,NaN,5.58766003351013,10.707241435988353
2002-12-10T09:30:00-05:00,18.307669,18.470043,18.129057,18.461932,557232,1913945,49.263386982580734,54.79116569794411,NaN,NaN,-64.15595961300961,-37.396842529502045,-0.0959268767346031,0.07799464250355115,0.17392151923815424,-10174033,-10446613.8,35.35816203972942,46.39651365964641,NaN,NaN,4.508554177586465,9.821714684788082
2002-12-11T09:30:00-05:00,18.470043,18.624298,18.388847,18.478153,565361,1763323.6,49.508513352107386,54.12329560427493,NaN,NaN,-39.88556455786767,-48.51587755365865,-0.08906807162549732,0.06258642970628259,0.1516545013317799,-9608672,-10308463.6,36.22492748302229,44.88841489653903,NaN,NaN,3.7019907426488015,8.947468407339613
2002-12-12T09:30:00-05:00,18.551238,18.624298,18.356381,18.396974,1038343,1668062.05,48.2520915596341,53.04062734969437,NaN,NaN,-57.15545998178249,-55.621140461857784,-0.08666326923903084,0.043325414782991345,0.12998868402202218,-10647015,-10180315,37.06788799410188,43.18482674137532,NaN,NaN,2.6784428033071084,8.051893321049256
2002-12-13T09:30:00-05:00,18.18588,18.413203,18.120947,18.18588,949043,1628794.7,45.050457741199864,51.88095631354387,NaN,NaN,-107.49722481794075,-68.16071740197839,-0.09526956185968491,0.01090173169741604,0.10617129355710095,-11596058,-10551408.6,35.6004296226581,41.364983267854136,NaN,NaN,0.8868222949451628,7.0283117458915285
2002-12-16T09:30:00-05:00,18.267075,18.73796,18.267075,18.705477,1765430,1553936.65,53.26966350100613,51.347501607732454,NaN,NaN,-26.909441650564766,-59.12073012423307,-0.06347810823492413,0.026823658263445793,0.09030176649836992,-9830628,-10371281.2,36.90610815715502,39.682072280404725,NaN,NaN,1.7044321422156279,6.267757516794972
2002-12-17T09:30:00-05:00,18.60806,18.819138,18.591815,18.616171,1375096,1515944.1,51.834557902166445,51.290445358460616,NaN,NaN,-3.297189210163228,-46.94897604366379,-0.046746777932428846,0.03186829408283387,0.07861507201526272,-11205724,-10577619.4,36.00555906338127,38.30580468598665,NaN,NaN,1.955855210703188,5.6517714730675745
2002-12-18T09:30:00-05:00,18.388847,18.494399,18.218363,18.267075,1388892,1498490.6,46.55476418701388,50.391051904688666,NaN,NaN,-92.20045878527596,-57.41195488914544,-0.05680457066730929,0.0076093586811261105,0.0644139293484354,-12594616,-11174808.2,33.460715630304506,37.096670233882584,NaN,NaN,0.573618527663337,4.926321052295541
2002-12-19T09:30:00-05:00,18.226482,18.534992,18.023514,18.104701,1297252,1502789.35,44.29477502559317,49.499409725639445,NaN,NaN,-105.12810703970382,-67.00648430072971,-0.07108038968528574,-0.024436557758171773,0.046643831927113966,-13891868,-11823778.8,30.90442499492157,36.14620700309662,NaN,NaN,-1.2604031859908678,4.042503303968911
2002-12-20T09:30:00-05:00,18.323914,18.470043,18.226482,18.388847,1750649,1474084,48.96384037978548,48.9412722147468,NaN,NaN,-65.5381054437216,-58.61466042588588,-0.058593754004127606,-0.026598360578045543,0.03199539342608206,-12141219,-11932811,30.483070003165707,35.42654600858817,NaN,NaN,-1.4329144573821686,3.260300766633043
2002-12-23T09:30:00-05:00,18.332025,18.510636,18.242719,18.34827,766009,1370003.3,48.340722477410935,48.635356998286284,NaN,NaN,-59.150945688254915,-65.06296123342392,-0.0505770164982372,-0.031225877196714436,0.01935113930152276,-12907228,-12548131,28.15045118310313,34.70270364386886,NaN,NaN,-1.753044671084806,2.5441085612447787
2002-12-24T09:30:00-05:00,18.34827,18.34827,18.153413,18.18588,880313,1259308.25,45.82720364675879,48.14990472249345,NaN,NaN,-91.99424616117392,-82.80237262362604,-0.053440721030718744,-0.04744976198687567,0.005990959043843072,-13787541,-13064494.4,26.329623590260738,33.87540120981849,NaN,NaN,-2.7465883911792894,1.7882947108984832
2002-12-26T09:30:00-05:00,18.34827,18.494399,18.096574,18.129057,735462,1125308.95,44.9465305279497,47.942740230892056,NaN,NaN,-81.76138241630586,-80.71455734983203,-0.05611511419061009,-0.06415293369441954,-0.008037819503809452,-14523003,-13450171.8,25.027493868095178,33.06121004544778,NaN,NaN,-3.817136985302271,0.9875187542983755
2002-12-27T09:30:00-05:00,18.104701,18.153413,17.747478,17.79619,521142,1104782.25,40.08668173266929,47.23147856769744,NaN,NaN,-172.65369855525918,-94.2196756529431,-0.07601924003578454,-0.10306186954854013,-0.027042629512755587,-15044145,-13680627.2,24.25558033813904,32.213154827087884,NaN,NaN,-6.20611301655105,-0.040142927251542226
2002-12-30T09:30:00-05:00,17.820547,18.04787,17.739368,17.92609,2009188,1178654.9,42.6908763879512,47.063147528844816,NaN,NaN,-163.60430568838387,-113.83291570187558,-0.0759732493088314,-0.12200919114879483,-0.046035941839963436,-13034957,-13859374.8,23.64638843451705,31.387201600182472,NaN,NaN,-7.479436624914013,-1.1028991697747523
2002-12-31T09:30:00-05:00,17.982912,17.982912,17.666283,17.86114,460295,1067134.6,41.71455594638838,46.52394531197393,NaN,NaN,-176.22477829115388,-137.24768222245535,-0.07568703631424448,-0.14064473723276905,-0.06495770091852457,-13495252,-13976979.6,23.232944879280012,30.52111466015037,NaN,NaN,-8.813439290671708,-2.2044049013314604
2003-01-02T09:30:00-05:00,17.901734,18.518755,17.901734,18.510636,883269,1058124.55,53.232681115106786,46.78995729504532,NaN,NaN,-3.002832047868578,-119.44939939979429,-0.02949847970475486,-0.10183080054946814,-0.07233232084471328,-12611983,-13741868,26.01786016172416,29.792038422914793,NaN,NaN,-6.446183703491798,-2.81037330164008
2003-01-03T09:30:00-05:00,18.429449,18.591815,18.413203,18.494399,683853,1057650.35,52.95096637695879,47.12559121056851,NaN,NaN,78.80223638317236,-87.33667563989863,0.000621204361793179,-0.0715558153924718,-0.07217701975426498,-13295836,-13496434.6,28.916858784275192,29.20982205078431,NaN,NaN,-4.648081083833308,-3.0729029848105407
2003-01-06T09:30:00-05:00,18.591815,19.16014,18.567467,19.119538,1277913,1072129.25,61.41704345131148,48.29463304700506,NaN,NaN,225.99609195833483,-7.606717537179833,0.060020008913353115,0.0028479913874264184,-0.0571720175259267,-12017923,-12891190.2,35.616862683601525,29.210995840851695,NaN,NaN,-0.08808861689149962,-2.6465009322506776
2003-01-07T09:30:00-05:00,19.078945,19.143895,18.851621,18.908444,740635,1031802.6,57.64499636340926,48.60715682289099,NaN,NaN,191.74849268820324,63.46384213813759,0.08115338125927972,0.044269709048172956,-0.03688367221110676,-12758558,-12835910.4,36.20827876747882,29.16115088444625,NaN,NaN,2.4225548467712215,-1.9223501066761206
2003-01-08T09:30:00-05:00,18.713603,18.940927,18.67301,18.713603,489856,1006761.65,54.32831623537535,48.78528241812021,NaN,NaN,112.48532401154297,121.20586259867696,0.07804713924220932,0.0606752518416549,-0.01737188740055443,-13248414,-12786542.8,36.7669105385822,29.215533132674892,NaN,NaN,3.4297729244511808,-1.1577611022293635
2003-01-09T09:30:00-05:00,18.67301,19.127657,18.67301,19.087056,829689,1020384.5,59.17663392987814,49.686844542610515,NaN,NaN,139.13399544242637,149.63322809673596,0.09600012110508713,0.10262826398080449,0.006628142875717356,-12418725,-12747891.2,37.23037982285485,29.484794860714203,NaN,NaN,5.897657253103999,-0.1498441943245974
2003-01-10T09:30:00-05:00,18.835384,19.225073,18.835384,19.078945,728688,1028550.85,59.03006549698212,50.739365290566866,NaN,NaN,137.62296671116692,161.39737416233487,0.1016421647640543,0.13368084883078524,0.03203868406673093,-13147413,-12718206.6,37.60860432931857,29.963664813171135,NaN,NaN,7.788951095712343,0.9842694185378225
2003-01-13T09:30:00-05:00,19.241319,19.48488,19.013995,19.135784,2055378,1079402.6,59.78180856796017,51.51207730400791,NaN,NaN,146.01330365222302,145.4008165011125,0.10318547981904046,0.1610205338405315,0.05783505402149104,-11092035,-12533029,40.03595766976989,30.646013932214288,NaN,NaN,9.548634035371416,2.2077500780854784
2003-01-14T09:30:00-05:00,19.038351,19.281912,18.989639,19.281912,1459593,1104930.1,61.726173344085396,52.468180937341806,NaN,NaN,121.72937118433236,131.39699220033833,0.10754192286906139,0.1922624576078178,0.0847205347387564,-9632442,-11907805.8,47.46733104116928,32.0257910649333,NaN,NaN,11.601789668350552,3.5497557338376318
2003-01-15T09:30:00-05:00,19.322506,19.322506,18.932817,18.99775,4901400,1261728.6,56.05127664473314,53.198471865768546,NaN,NaN,91.26305804424096,127.15253900687794,0.08572799574384708,0.19188052941856526,0.10615253367471818,-14533842,-12164891.4,44.99789529443846,33.359239043803136,NaN,NaN,11.730558151541102,4.718441793509556
2003-01-16T09:30:00-05:00,18.99775,19.111412,18.770434,18.811028,804069,1233177.25,52.6274252816601,53.74710720531929,NaN,NaN,55.557104994123314,110.43716091721733,0.05467751142193031,0.17449942295213106,0.11982191153020075,-15337911,-12748728.6,39.918875437943434,34.42290915593516,NaN,NaN,10.823010602114353,5.59052305188167
2003-01-17T09:30:00-05:00,18.697366,18.900334,18.640543,18.754205,531242,1190294.75,51.59455305332012,54.5690980139372,NaN,NaN,29.974947307308216,88.90755703644558,0.027630679291210825,0.15436026064421426,0.12672958135300344,-15869153,-13293076.6,35.85528070667063,35.25145918225884,NaN,NaN,9.779959879832337,6.189014027303194
2003-01-21T09:30:00-05:00,18.754205,18.884088,18.445686,18.445686,2113762,1231120.25,46.28325349023631,54.825696378386134,NaN,NaN,-2.183076443274857,59.268281017346,-0.011614528196096291,0.11221142110788307,0.12382594930397936,-17982915,-14671252.6,28.06560702803003,35.56711765322405,NaN,NaN,7.260732375646689,6.3421166484951215
2003-01-22T09:30:00-05:00,18.307669,18.429449,18.145303,18.153413,2386958,1262935.7,41.884388919265575,54.83782730502022,NaN,NaN,-61.38691044024181,22.64502469243117,-0.05538488878348306,0.05459483832462553,0.10997972710810859,-20369873,-16818738.8,20.567419138163928,35.37672295743005,NaN,NaN,3.694030876384084,5.963818681050688
2003-01-23T09:30:00-05:00,18.267075,18.445686,18.11282,18.429449,1341101,1291690.3,47.007059632806616,54.393140056284494,NaN,NaN,-45.88547790654625,-4.784682497726273,-0.06330262696682828,0.030851443399573242,0.09415407036640153,-19028772,-17717724.8,18.35647215417795,34.82948095689103,NaN,NaN,2.185945398857795,5.4241224978802745
2003-01-24T09:30:00-05:00,18.234608,18.234608,17.658173,17.723122,3862564,1440802.85,37.82045294579316,53.312389096915524,NaN,NaN,-115.66604612574544,-39.029312721700016,-0.11088140727828015,-0.044447688731448665,0.06643371854683149,-22891336,-19228409.8,15.367007024633182,33.86163440263089,NaN,NaN,-2.467123260193817,4.296801675298261
2003-01-27T09:30:00-05:00,17.495799,17.812428,17.37401,17.455205,2974983,1552778.9,35.024420884988515,51.4272017707496,NaN,NaN,-149.19718189505255,-74.86373856217217,-0.15259377899893045,-0.12430850520183157,0.028285273797098873,-25866319,-21227843,12.471954456787685,32.208426672144185,NaN,NaN,-7.22271147984405,2.6511569388493594
2003-01-28T09:30:00-05:00,17.5364,17.723122,17.520155,17.706885,4355746,1744509.1,39.54583964538181,50.134404862319066,NaN,NaN,-128.00397269194585,-100.02791781190635,-0.1549353092585134,-0.1653838627760429,-0.010448553517529484,-21510573,-21933374.6,11.63872104262569,30.453458263226103,NaN,NaN,-9.58886901688136,0.9025818023163996
2003-01-29T09:30:00-05:00,17.414612,17.812428,17.333433,17.739368,852230,1686661.2,40.12495164030031,49.11987881981371,NaN,NaN,-125.0086827473283,-112.75227227332365,-0.14611272349069493,-0.19308945788089815,-0.046976734390203216,-20658343,-21991068.6,11.570645889431333,28.65372507400104,NaN,NaN,-11.256875978740668,-0.8344835949774672
2003-01-30T09:30:00-05:00,17.779945,17.779945,17.292831,17.292831,1814206,1754356.75,35.14137522871134,47.40307462687321,NaN,NaN,-140.42523318289483,-131.6602233285934,-0.16099209747588894,-0.2482168562350644,-0.08722475875917546,-22472549,-22679824,10.761416133515723,26.76308481047682,NaN,NaN,-14.36873029621516,-2.7679474094399947
2003-01-31T09:30:00-05:00,17.37401,17.658173,17.227881,17.633816,1939473,1807166.95,41.15201504413625,46.12607102309851,NaN,NaN,-116.73153822102773,-131.87332174764984,-0.13932265147918343,-0.26137807310815475,-0.12205542162897132,-20533076,-22208172,15.138321967536086,25.158064641778065,NaN,NaN,-15.0051338276807,-4.516116897760096
2003-02-03T09:30:00-05:00,17.576977,17.804301,17.576977,17.67441,658726,1805910.6,41.84299626970272,44.84472728750869,NaN,NaN,-83.5790860979545,-118.74970258823024,-0.11473376869939783,-0.2654726325032186,-0.1507388638038208,-19874350,-21009778.2,25.179765592092792,24.096908064801134,NaN,NaN,-15.290123674022011,-6.055260722940369
2003-02-04T09:30:00-05:00,17.236,17.292831,17.081737,17.252238,2823481,1883189,36.979902193864795,43.077136491064365,NaN,NaN,-120.98683514188029,-117.3462750782171,-0.11887517291650851,-0.2993328299494564,-0.18045765703294792,-22697831,-21247229.8,24.559657950285498,22.46064570116658,NaN,NaN,-17.10706889101845,-7.634090461237238
2003-02-05T09:30:00-05:00,17.398366,17.5364,17.089864,17.089864,2098242,1951069.35,35.2814696246881,41.59357884677543,NaN,NaN,-104.6248459476985,-113.26950771829115,-0.12395642318316061,-0.33540318601189867,-0.21144676282873806,-24796073,-22074775.8,22.481658300022644,20.852343058708303,NaN,NaN,-19.122759234505395,-9.275328857418403
2003-02-06T09:30:00-05:00,17.04927,17.089864,16.838192,16.886896,1260916,1989622.35,33.22713487836208,40.20784381796843,NaN,NaN,-119.1498019377268,-109.01442146925756,-0.13166847569324985,-0.3760323574453004,-0.24436388175205054,-26056989,-22791663.8,20.836906924427254,19.489345307742862,NaN,NaN,-21.437635489950917,-11.012801233494477
2003-02-07T09:30:00-05:00,16.919371,17.097982,16.683929,16.773234,1148829,2005579.35,32.09993457595441,38.81537106958517,NaN,NaN,-114.9281744489515,-108.6537487148423,-0.13462578617147491,-0.4126461144663942,-0.2780203282949193,-27205818,-24126212.2,18.1716772939685,18.22623077826414,NaN,NaN,-23.674506389281206,-12.821616255749724
2003-02-10T09:30:00-05:00,16.813836,16.903142,16.610868,16.886896,931922,2015741.05,34.49313834993782,37.97321998813528,NaN,NaN,-110.68805526588244,-114.07554254842788,-0.11963376334842807,-0.4275625324804544,-0.3079287691320263,-26273896,-25406121.4,16.0511794018158,17.368057376391693,NaN,NaN,-24.83828318657801,-14.538282960153765
2003-02-11T09:30:00-05:00,16.886896,17.065507,16.586496,16.651446,3492800,2087612.15,31.978714043127837,37.26567178269686,NaN,NaN,-107.63940542059997,-111.40605660417182,-0.11618419546266218,-0.45315901346035403,-0.33697481799769186,-29766696,-26819894.4,14.094666011468306,16.90571786734201,NaN,NaN,-26.579660449899784,-16.258479744403196
2003-02-12T09:30:00-05:00,16.748878,16.813836,16.440367,16.440367,1497653,2089515.15,29.876094498425445,36.04203141595536,NaN,NaN,-123.6881349357142,-115.21871440177495,-0.11832993919777873,-0.4848872419949153,-0.36655730279713655,-31264349,-28113549.6,12.583224458120839,16.493343031909358,NaN,NaN,-28.689694440014595,-18.034367558061966
2003-02-13T09:30:00-05:00,16.440367,16.643335,16.318595,16.56214,1473511,1918120.7,32.62822091054623,35.671157699152005,NaN,NaN,-122.38100805359625,-115.86495562494883,-0.10235869752124277,-0.49450567469869,-0.39214697717744723,-29790838,-28860319.4,11.796805662177931,16.238328648876838,NaN,NaN,-29.66699554393555,-19.696171556043907
2003-02-14T09:30:00-05:00,16.545911,16.951846,16.480961,16.935608,2092330,1982533.75,40.359173493842064,36.05221145692725,NaN,NaN,-81.85960355402976,-109.25124144596448,-0.05957343618165367,-0.4666137724045143,-0.4070403362228606,-27698508,-28958857.4,11.692960065035962,16.182686192323146,NaN,NaN,-28.20166151392141,-20.911241550026407
2003-02-18T09:30:00-05:00,17.162932,17.317187,17.106109,17.203525,941776,2003060.45,45.21587366219965,36.45721388669996,NaN,NaN,-22.196959366784874,-91.55302226614498,-0.008824779211950962,-0.4180713102377993,-0.40924653102584835,-26756732,-29055424.6,11.58532777819444,16.17887238772091,NaN,NaN,-25.43957554048418,-21.558146405806088
2003-02-19T09:30:00-05:00,17.203525,17.203525,17.008676,17.162932,1224457,1958595.2,44.622959841489816,36.778500186784925,NaN,NaN,-26.787258215462277,-75.38259282511744,0.024586577398072296,-0.378513309278258,-0.4030998866763303,-27981189,-28698323.2,14.711793561139459,16.403240078557207,NaN,NaN,-23.372128011769444,-21.817286635229426
2003-02-20T09:30:00-05:00,17.244127,17.244127,16.951846,17.000558,692598,1873877.2,42.23710085401188,37.285337731449246,NaN,NaN,-30.26789884426215,-56.69854560682703,0.03755195479819845,-0.35615994317858224,-0.3937118979767807,-28673787,-28180210.8,19.177388576152453,17.004380967316973,NaN,NaN,-22.29233197700931,-21.885150255483694
2003-02-21T09:30:00-05:00,16.927498,17.30095,16.813836,17.252238,1304026,1872023.45,46.969976731855134,37.70090642342917,NaN,NaN,-11.212907474208277,-34.464925490949426,0.06336089249981147,-0.31451078235201635,-0.3778716748518278,-27369761,-27695995.4,23.22332405531904,17.581881116444325,NaN,NaN,-19.94662173186773,-21.608217609252844
2003-02-24T09:30:00-05:00,17.130465,17.130465,16.789463,16.79759,992892,1728539.85,40.51232571538677,37.605858526692316,NaN,NaN,-49.905464762121916,-28.07409773256786,0.050646362676121215,-0.31456372150667633,-0.36521008418279755,-28362653,-27828824.4,22.884890127278126,17.417961440386133,NaN,NaN,-19.81982451633846,-21.352732881693647
2003-02-25T09:30:00-05:00,16.578385,16.976202,16.505317,16.959964,971337,1628357.55,43.49996937450549,38.07157761102379,NaN,NaN,-63.63092185152508,-36.3608902295159,0.05371405565313597,-0.2980675146163776,-0.35178157026951357,-27391316,-27955741.2,22.546790159739203,17.27418516963283,NaN,NaN,-18.792069060715217,-20.986923764411014
2003-02-26T09:30:00-05:00,16.927498,16.927498,16.683929,16.765107,534568,1437298.65,40.84864039375699,38.46923266595729,NaN,NaN,-62.08485472217652,-43.42040953085874,0.04359285353287229,-0.2972905033534232,-0.3408833568862955,-27925884,-27944680.2,22.654039319291144,17.28649809958058,NaN,NaN,-18.7336426929398,-20.665026468486555
2003-02-27T09:30:00-05:00,16.765107,17.097982,16.765107,17.008676,1913853,1490379.8,45.33386047390209,39.333998779924435,NaN,NaN,-15.613073915197388,-40.489444545045785,0.05361564376242789,-0.2738638021832607,-0.32747944594568856,-26012031,-27412329,27.833434434828675,17.786250064609252,NaN,NaN,-17.305116674239066,-20.185039355022628
2003-02-28T09:30:00-05:00,17.089864,17.252238,16.968075,17.089864,4043874,1601863.2,46.782395046314726,40.38274595637874,NaN,NaN,30.82802328823123,-32.081258392557885,0.06525390995131553,-0.24591205850654418,-0.3111659684578597,-21968157,-26332008.2,37.04643166477987,19.134446805381494,NaN,NaN,-15.706918844605312,-19.54530785353444
2003-03-03T09:30:00-05:00,17.292831,17.292831,16.86254,16.903142,990922,1554435.65,43.901184296340205,41.05474923826463,NaN,NaN,15.248907027410688,-19.050384034651366,0.06004851085592061,-0.23610532988795896,-0.29615384074387957,-22959079,-25251293.4,44.65782508078966,21.177778639593914,NaN,NaN,-15.186575267512692,-18.922631769817045
2003-03-04T09:30:00-05:00,16.886896,16.959964,16.659572,16.659572,252257,1534112.2,40.4053974299037,41.65665519446291,NaN,NaN,-64.98577906608918,-19.321355477564236,0.04079393504294393,-0.24516142194019963,-0.28595535698314356,-23211336,-24415297.4,49.72190357564622,23.722581322749477,NaN,NaN,-15.777751811264974,-18.473363204309607
2003-03-05T09:30:00-05:00,16.602741,16.903142,16.602741,16.895015,566593,1421267.8,44.96720489461798,42.7345916513338,NaN,NaN,-43.78981399840032,-15.662347332808995,0.04421947709052365,-0.23068101061998902,-0.2749004877105127,-22644743,-23359069.2,55.2886362370943,26.77296787839044,NaN,NaN,-14.913922444899367,-17.964871667251
2003-03-06T09:30:00-05:00,16.830065,16.886896,16.651446,16.659572,918619,1362286.65,41.542615240412474,43.371334103467106,NaN,NaN,-65.48225462139742,-25.636183474048995,0.031529275474214635,-0.23548889336774437,-0.267018168841959,-23563362,-22869335.4,57.63101234487244,30.04683978429719,NaN,NaN,-15.210393161331826,-17.571374737833974
2003-03-07T09:30:00-05:00,16.497207,16.846303,16.416011,16.805709,690011,1333741.4,44.37431440069987,43.65812988252838,NaN,NaN,-76.90083126705363,-47.18195438510597,0.03368296184452907,-0.22491446653629765,-0.2585974283808267,-22873351,-23050374.2,56.453605214367585,33.244028723535166,NaN,NaN,-14.614754593294728,-17.149000431471226
2003-03-10T09:30:00-05:00,16.700174,16.700174,16.164332,16.196806,2398783,1396239.1,36.451256304840165,43.032085785574125,NaN,NaN,-186.13757844042203,-87.45925147867251,-0.0032340493396624814,-0.26263999005540484,-0.25940594071574236,-25272134,-23512985.2,53.4486622754078,36.23426690190755,NaN,NaN,-16.680674126188052,-17.08209667357363
2003-03-11T09:30:00-05:00,16.17245,16.351062,15.896415,15.928889,3656496,1532467.8,33.60785100484567,42.24529229724241,NaN,NaN,-242.19694667515986,-122.90148500048664,-0.04093626512992504,-0.31057627212814864,-0.2696400069982236,-28928630,-24656444,46.815461993590176,38.52738607565403,NaN,NaN,-19.34406855506987,-17.405235513787378
2003-03-12T09:30:00-05:00,15.904533,15.961364,15.547302,15.953237,5847981,1650226.85,34.110873862592385,41.66484751214101,NaN,NaN,-241.7822899241787,-162.49998018564233,-0.05840924795918989,-0.342651566947211,-0.2842423189880211,-23080649,-24743625.2,46.34322551379107,40.467802999771074,NaN,NaN,-21.282753991273392,-17.959166724856807
2003-03-13T09:30:00-05:00,16.399774,16.635224,16.139976,16.635224,3561900,1753439.2,46.36808770342039,41.621855438681386,NaN,NaN,-71.60715548883803,-163.72496035913045,-0.020184865734767965,-0.30947340115648103,-0.28928853542171307,-19518749,-23934702.6,51.25634288560754,42.47016148764882,NaN,NaN,-18.894231588001023,-18.092747419591696
2003-03-14T09:30:00-05:00,16.72453,16.878769,16.545911,16.708285,1994038,1779465.55,47.494956205045916,42.12061475937132,NaN,NaN,-14.261904245558476,-151.1971749548314,0.012131531223185665,-0.274124121392731,-0.2862556526159167,-17524711,-22864974.6,56.87935367606075,44.898337455419004,NaN,NaN,-16.658840289536673,-17.887903543869548
2003-03-17T09:30:00-05:00,16.521563,17.30095,16.521563,17.219771,2148127,1782255.4,54.67490721829099,42.918824605356,NaN,NaN,60.67622579525847,-101.83441410769532,0.06700244758960927,-0.20250259312890506,-0.26950504071851433,-15376584,-20885864.6,64.93810032401345,47.9262881814386,NaN,NaN,-12.219651532218334,-17.078153256490804
2003-03-18T09:30:00-05:00,17.406493,17.406493,17.146694,17.317187,1623412,1816337.2,55.9115008245274,43.99474320755389,NaN,NaN,128.45117820093813,-27.704789132475717,0.10655598347355016,-0.13631006137657664,-0.2428660448501268,-13753172,-17850773,73.20761713517302,51.53725802543016,NaN,NaN,-8.314985452899332,-15.826272141692023
2003-03-19T09:30:00-05:00,17.292831,17.576977,17.284704,17.568867,2117949,1861011.8,59.02208027011023,44.97247319299733,NaN,NaN,162.0941983780953,53.07050852797909,0.14403732575866166,-0.06281938765179973,-0.20685671341046138,-11635223,-15561687.8,77.51499122363265,55.085940653201874,NaN,NaN,-4.0542353074417825,-14.144552593941988
2003-03-20T09:30:00-05:00,17.463316,17.706885,17.162932,17.593223,1226058,1887684.8,59.32118700905424,45.86810119033586,NaN,NaN,148.2881959223889,97.04957881022447,0.16341944653267565,-0.0025824052446168366,-0.1660018517772925,-10409165,-13739771,80.23818941096991,58.171066206501166,NaN,NaN,-0.5815407106779136,-12.206979467761407
2003-03-21T09:30:00-05:00,17.779945,18.007268,17.512044,17.958564,1205734,1882770.2,63.61175273184865,47.27599893572932,NaN,NaN,190.92436702383117,138.0868330641024,0.19182968322717264,0.07378525225667332,-0.11804443097049933,-9203431,-12075515,82.34198847712354,60.86279216338215,NaN,NaN,3.8213012511743942,-9.917225079342007
2003-03-24T09:30:00-05:00,17.455205,17.576977,17.292831,17.333433,941406,1880195.9,53.26018228997124,48.19419785430557,NaN,NaN,94.96394533724121,144.94437697249893,0.16076242875570568,0.08290860497413277,-0.0778538237815729,-10144837,-11029165.6,83.52921376372058,63.2776000339589,NaN,NaN,4.3700598647339355,-7.876184373045444
2003-03-25T09:30:00-05:00,17.398366,17.585104,17.260348,17.463316,1823690,1922813.55,54.90224508255129,48.90384358201509,NaN,NaN,89.6798603027601,137.19011339286334,0.141861251443094,0.0994727405222946,-0.042388510920799406,-8321147,-9942760.6,84.68087564703434,65.37704570609746,NaN,NaN,5.334697316710154,-5.988915560223216
2003-03-26T09:30:00-05:00,17.37401,17.487672,17.260348,17.382137,1739564,1983063.35,53.633954879187044,49.76751069907042,NaN,NaN,71.8845312791297,119.1481799730702,0.11778355229670978,0.10484092945008783,-0.012942622846621961,-10060711,-9627858.2,85.00809308333501,67.33255147313051,NaN,NaN,5.717260412926272,-4.316604706916146
2003-03-27T09:30:00-05:00,17.171042,17.422738,17.106109,17.276594,287730,1901757.2,51.95354906678759,50.30888460379098,NaN,NaN,49.82145959817585,99.4548327082276,0.08990019622447312,0.09943262243396944,0.00953242620949632,-10348441,-9615713.4,85.02138150301363,69.37310692231951,NaN,NaN,5.531383145615444,-2.909749299411633
2003-03-28T09:30:00-05:00,17.130465,17.317187,17.130465,17.260348,903100,1744718.5,51.68511259798398,51.397017196158394,NaN,NaN,42.99777946472075,69.8695151964055,0.06658704491310055,0.092766232350872,0.026179187437771458,-11251541,-10025335.4,82.36946235168699,71.43887835633946,NaN,NaN,5.3045120215192085,-1.7362833964215127
2003-03-31T09:30:00-05:00,16.886896,17.130465,16.854413,16.854413,820697,1736207.25,45.376268337169314,52.237618434181506,NaN,NaN,-1.7895108617055067,50.51882395661616,0.022339716381177883,0.05410383291424381,0.03176411653306593,-12072238,-10410815.6,79.84548208649619,73.79816550583273,NaN,NaN,3.202690908246262,-1.0307156386118308
2003-04-01T09:30:00-05:00,16.968075,17.333433,16.895015,17.30095,624976,1754843.2,52.27703570773501,53.53520142312027,NaN,NaN,31.217819348315256,38.82641576572721,0.021642623984191416,0.0588173965133052,0.03717477252911378,-11447262,-11036038.6,75.78905415522718,75.90143898022104,NaN,NaN,3.4696518160587697,-0.38780600223031647
2003-04-02T09:30:00-05:00,17.658173,17.893607,17.60946,17.755597,1873452,1820186.15,58.08339239449306,54.37200890105403,NaN,NaN,109.11287208288728,46.27208392647874,0.048746751959293316,0.09810821247823043,0.04936146051893711,-9573810,-10938658.4,75.99362344184927,77.66838759138115,NaN,NaN,5.61173608893372,0.46927143936454585
2003-04-03T09:30:00-05:00,17.942335,17.942335,17.60946,17.67441,1879980,1868254.2,56.755445571387796,55.033472427221305,NaN,NaN,97.49041160871788,55.80587432858714,0.05754852530633403,0.12129711715185465,0.06374859184552062,-11453790,-11159728.2,74.45557735324202,78.92383213975124,NaN,NaN,6.90283042240554,1.3883512940846878
2003-04-04T09:30:00-05:00,17.79619,17.901734,17.723122,17.853029,1320654,1899786.35,58.9776067076482,55.34080810503253,NaN,NaN,101.22399863409488,67.45111816246197,0.0708663810807109,0.15233156819640925,0.08146518711569835,-10133136,-10936047.2,75.00676444720463,79.6430224342649,NaN,NaN,8.653856413657364,2.426280596880784
2003-04-07T09:30:00-04:00,18.429449,18.445686,17.836784,17.917979,7269020,2143298.2,59.786793910600615,55.61761475403777,NaN,NaN,130.2888220755091,93.8667847499049,0.07890107697731302,0.18009153333733963,0.1011904563600266,-2864116,-9094422.8,79.02054635325786,80.05823166412812,NaN,NaN,10.316142073866603,3.553403665021615
2003-04-08T09:30:00-04:00,17.982912,18.007268,17.79619,17.917979,676955,1994321.15,59.786793910600615,55.672237156929945,NaN,NaN,102.54820024922016,108.13286093008587,0.0788784097993012,0.1997884686091531,0.12091005880985191,-2864116,-7377793.6,81.93310643672714,80.37381132220628,NaN,NaN,11.667411957721791,4.712547706835926
2003-04-09T09:30:00-04:00,17.942335,18.153413,17.617579,17.666283,1121115,1757977.85,54.91812503633856,55.35773273030738,NaN,NaN,83.01798829336225,102.91388417218086,0.057564301230464965,0.1928654353479331,0.13530113411746814,-3985231,-6260077.8,83.53583510132938,80.60935744294625,NaN,NaN,11.48319412697128,5.679782909712404
2003-04-10T09:30:00-04:00,17.739368,17.812428,17.625706,17.812428,781652,1618965.45,57.10251003933886,54.892786823699545,NaN,NaN,63.30286293716645,96.07637443787058,0.04928053297702012,0.19690180033874327,0.14762126736172315,-3203579,-4610035.6,85.57084186096374,80.83998982750627,NaN,NaN,11.935513458835532,6.573458702444279
2003-04-11T09:30:00-04:00,17.999158,18.120947,17.739368,17.804301,1570202,1597773.65,56.937292932639636,55.15543758389015,NaN,NaN,85.3852434305953,92.90862339717066,0.03964057947817837,0.1971719917094461,0.15753141223126774,-4773781,-3538164.6,86.71921262061826,81.06784688871323,NaN,NaN,12.264327686442064,7.386439985872534
2003-04-14T09:30:00-04:00,17.828673,18.258964,17.828673,18.161532,1384334,1559584,62.12479590268198,55.67133407104234,NaN,NaN,118.85823116980836,90.62250521603053,0.05288188275087624,0.22363376566986304,0.1707518829189868,-3389447,-3643230.8,85.99672859257734,81.16183638482346,NaN,NaN,14.047757484590006,8.338056771403602
2003-04-15T09:30:00-04:00,18.267075,18.518755,18.137176,18.470043,945102,1525668.5,65.94071181187849,56.550388137663155,NaN,NaN,164.63881948617097,103.0406290634207,0.07654085839770214,0.26642795591611446,0.18988709751841232,-2444345,-3559276.6,86.09640767591894,81.2395731414366,NaN,NaN,16.774823253542372,9.543309125994854
2003-04-16T09:30:00-04:00,18.729849,18.729849,18.18588,18.218363,2808947,1560218.4,60.57871438270266,57.16647137451423,NaN,NaN,145.5514982535338,115.54733105545498,0.06956465365617767,0.2768429145886344,0.20727826093245674,-5253292,-3812888.8,84.14777683004449,81.17717280765308,NaN,NaN,17.520593866135226,10.682921231729193
2003-04-17T09:30:00-04:00,18.332025,18.543111,18.194007,18.543111,1001391,1548985.05,64.58086463175519,58.087596519783595,NaN,NaN,140.18768604128857,130.9242956762794,0.08038035193141144,0.30775370084672105,0.2273733489153096,-4251901,-4022553.2,82.48565742626499,81.18547245583723,NaN,NaN,19.416049820079696,11.930511030064979
2003-04-21T09:30:00-04:00,18.510636,18.599942,18.405093,18.478153,604653,1518931,63.19875662587949,59.360631397548616,NaN,NaN,135.1942258214538,140.8860921544511,0.07672736397837629,0.32328255388828,0.2465551899099037,-4856554,-4039107.8,82.34734924316523,81.36417725274215,NaN,NaN,20.542400295961038,13.160780925192988
2003-04-22T09:30:00-04:00,18.405093,19.054589,18.332025,19.046478,2188650,1581293.2,69.37427366047181,60.58186267988693,NaN,NaN,166.75368716636598,150.46518335376263,0.10443694387985114,0.37710136975971764,0.2726644258798665,-2667904,-3894799.2,82.62091054382934,81.85216699478516,NaN,NaN,23.615972458773175,14.654379715704444
2003-04-23T09:30:00-04:00,19.127657,19.241319,18.932817,19.184488,5355166,1757867,70.66176209518105,61.4803176585075,NaN,NaN,182.2995001054509,153.99731947761862,0.12265166082606294,0.4259790019124452,0.30332734108638226,2687262,-2868477.8,84.46480968970633,82.45725172677496,NaN,NaN,26.515741589083735,16.34885998333006
2003-04-24T09:30:00-04:00,19.16014,19.16014,18.681121,18.786672,2341138,1787945.7,62.50482926507409,61.890987922342234,NaN,NaN,125.79000471817916,150.0450207705477,0.0994856245795982,0.42768437181088004,0.32819874723128184,346124,-1748594.6,86.18696841994606,83.29520823153953,NaN,NaN,26.37480001908682,17.78113713129531
2003-04-25T09:30:00-04:00,18.835384,18.835384,18.534992,18.583704,1956470,1871382.7,58.77680761010641,61.87664512966068,NaN,NaN,84.42603301463649,138.8926901652173,0.06380533210772643,0.4079554123659399,0.3441500802582135,-1610346,-1220283.6,86.92343313747138,84.14639885227288,NaN,NaN,25.053816903991738,18.82009138453766
2003-04-28T09:30:00-04:00,18.624298,18.99775,18.616171,18.908444,543806,1853418,62.61843492647765,62.078905202223325,NaN,NaN,99.42656091858099,131.73915718464272,0.05568343264499154,0.4137543710644529,0.35807093841946136,-1066540,-462280.8,87.9187061509509,84.78198169496524,NaN,NaN,25.165555751661305,19.72658629412675
2003-04-29T09:30:00-04:00,19.038351,19.103301,18.73796,18.932817,3209134,1972839.85,62.897901563252844,62.30112717741277,NaN,NaN,101.88732948884137,118.7658856491378,0.045964729381706704,0.41552685014659474,0.36956212076488804,2142594,499818.8,89.05715291676854,85.29084215782534,NaN,NaN,25.33852841775419,20.528292311787812
2003-04-30T09:30:00-04:00,18.819138,19.062708,18.786672,18.973402,1809033,2032042.7,63.38872867457462,62.90617029442963,NaN,NaN,97.091701185341,101.72432586511582,0.036684499965774386,0.415417745722106,0.3787332457563316,3951627,752691.8,89.34144497121532,85.70552857710291,NaN,NaN,25.6203053722652,21.255722748998867
2003-05-01T09:30:00-04:00,18.965283,19.038351,18.640543,18.965283,1845369,2030638.55,63.20858136197678,63.342318246046624,NaN,NaN,80.54579704716494,92.675484330913,0.024973795529031118,0.40995049016762053,0.3849766946385894,2106258,1104718.6,89.74101839323787,86.00339832940821,NaN,NaN,25.8007165585954,21.90500757894123
2003-05-02T09:30:00-04:00,18.835384,19.460524,18.835384,19.265675,14000884,2636683.75,66.95093967156754,64.05757872739862,NaN,NaN,117.7156172426098,99.33340117650764,0.03198514186333262,0.4249581219677552,0.39297298010442255,16107142,4648216.2,92.70543267413996,86.43098547608834,NaN,NaN,27.034863632719897,22.63784415805247
2003-05-05T09:30:00-04:00,19.428041,19.428041,19.127657,19.184488,1479793,2644640.7,65.02577801117688,64.26479173514825,NaN,NaN,114.67669809227219,102.38342861124588,0.025939179603862994,0.4253969546092513,0.3994577750053883,14627349,7786994,94.2816568134904,87.0227660632964,NaN,NaN,27.527975443595036,23.33643434170141
2003-05-06T09:30:00-04:00,19.241319,19.468643,19.168251,19.330625,2683680,2415373.7,66.87232297750208,64.33133538983564,NaN,NaN,114.04914255427232,104.81579122433206,0.02647425458445657,0.432550593235959,0.40607633865150244,17311029,10820681,95.33163074991977,87.68242485429646,NaN,NaN,28.465555726638105,24.069165968120938
2003-05-07T09:30:00-04:00,19.281912,19.403685,19.119538,19.208844,1212755,2442163.7,63.84710237487082,64.56479167499052,NaN,NaN,94.40887995992438,104.27922697924876,0.013947905660500859,0.42351122072712855,0.4095633150666277,16098274,13250010.4,95.96979917065306,88.52685502148279,NaN,NaN,28.430514126139638,24.692215704980754
2003-05-08T09:30:00-04:00,18.835384,19.200717,18.835384,18.989639,9821153,2877165.6,58.69954737498719,64.14469758522138,NaN,NaN,51.0845559133632,98.3869787524884,-0.012357600993735507,0.39411631382445833,0.40647391481819384,6277121,14084183,96.16372431224053,89.50385979905249,NaN,NaN,26.933939595128482,25.01246197500186
2003-05-09T09:30:00-04:00,19.070834,19.143895,18.851621,19.111412,2300491,2953107.55,60.599934085210506,63.95906740374502,NaN,NaN,51.67067591759022,85.1779904874845,-0.024132053794492347,0.37630884757507843,0.4004409013695708,8577612,12578277,87.93736796270612,89.90314685044827,NaN,NaN,26.183934243617962,25.17981515623273
2003-05-12T09:30:00-04:00,19.013995,19.403685,18.981521,19.330625,730412,2911118.05,63.82675338703239,63.5628159556422,NaN,NaN,92.35724174359223,80.71409921774848,-0.019908092286601786,0.37555578601131856,0.39546387829792035,9308024,11514412,82.5638405224787,89.89907042035179,NaN,NaN,26.44163734000724,25.360075468200517
2003-05-13T09:30:00-04:00,19.314379,19.436168,19.225073,19.273802,2093561,2946579.4,62.4001415950047,62.97270020562961,NaN,NaN,105.29363286699898,78.96299728029382,-0.023448659753108336,0.36615305360653494,0.3896017133596433,7214463,9495098.8,73.3961276707687,89.10845027614197,NaN,NaN,26.259149753504314,25.488514651815343
2003-05-14T09:30:00-04:00,19.436168,19.436168,19.176369,19.265675,1344303,2966539.45,62.18605629132736,62.94993070750484,NaN,NaN,92.3225192113664,78.54572513058221,-0.02850917196372016,0.3539652484049931,0.38247442036871326,5870160,7449476,65.46578342539527,87.62836563367405,NaN,NaN,26.050813168806265,25.568843011385475
2003-05-15T09:30:00-04:00,19.379337,19.468643,19.257556,19.460524,2837276,2967955.9,65.26317340540997,63.41324255002653,NaN,NaN,112.54250075577859,90.8373140990653,-0.021238643380764366,0.3559261161427578,0.3771647595235222,8707436,7935539,66.39491159110871,86.1620426660767,NaN,NaN,26.70291313375784,25.73085302886724
2003-05-16T09:30:00-04:00,19.387456,19.598542,19.29815,19.509236,3374431,3086607.9,66.00789269753457,63.65534667653059,NaN,NaN,123.49062488037028,105.20130389162132,-0.015898105215574054,0.35729212800405463,0.3731902332196287,12081867,8636390,67.74255145191137,84.72088875900246,NaN,NaN,27.45242931854562,25.976792498821293
2003-05-19T09:30:00-04:00,19.48488,19.48488,18.965283,18.981521,3056277,3209189.1,52.80119159978567,62.93415310771151,NaN,NaN,16.399078761160627,90.00967129513498,-0.048797196993334846,0.31219373697796016,0.360990933971295,9025590,8579903.2,67.50757342010421,83.18163308066927,NaN,NaN,24.11352090679204,25.710610842817115
2003-05-20T09:30:00-04:00,19.119538,19.119538,18.802909,18.99775,4162981,3307905.65,53.11188942821713,62.200093161543116,NaN,NaN,-48.43669529842444,59.263605662050296,-0.06911506923019661,0.2745970974335492,0.3437121666637458,13188571,9774724.8,69.88694010263448,81.79202559005635,NaN,NaN,21.517842357886437,25.111643916398446
2003-05-21T09:30:00-04:00,18.884088,19.111412,18.843511,19.038351,3391060,3209700.35,53.92896976810567,61.537263761980896,NaN,NaN,-36.314784387519325,33.53614494227315,-0.07876928903531838,0.24525055536959783,0.3240198444049162,16579631,11916619,73.61675344936411,80.64029237977967,NaN,NaN,19.60027247927393,24.32430513966637
2003-05-22T09:30:00-04:00,19.078945,19.200717,18.989639,19.095182,5015827,3343434.8,55.10820977377597,60.69135448356722,NaN,NaN,-5.667920313486997,9.894060728420028,-0.08001835610361685,0.22399689927539512,0.304015255379012,21595458,14494223.4,77.26605642636343,79.53747979065278,NaN,NaN,18.30576632298093,23.46451388013988
2003-05-23T09:30:00-04:00,19.16014,19.192607,19.013995,19.168251,1984061,3344814.35,56.644765682923605,60.09271074583483,NaN,NaN,-3.8720019114644253,-15.578464629946911,-0.07471510886695548,0.2106213692953176,0.2853364781622731,23579519,16793753.8,79.93277171610744,78.51255942655398,NaN,NaN,17.610906532101612,22.628284258991556
2003-05-27T09:30:00-04:00,18.957173,19.566075,18.957173,19.517347,3225516,3478899.85,63.13667366505308,59.82587865208848,NaN,NaN,85.52218188319932,-1.753844005539173,-0.04779731380969687,0.22558983590015202,0.2733871497098489,26805035,20349642.8,83.21214469743605,77.64688185137659,NaN,NaN,18.871277356973767,22.09156898727473
2003-05-28T09:30:00-04:00,19.687847,19.874578,19.606652,19.752797,13517068,3994296.55,66.75265584951137,60.03341818599137,NaN,NaN,225.3000012927394,52.9934953126936,-0.01588669669396081,0.2535287788423979,0.2694154755363587,40322103,25776349.2,86.76643625545809,76.98949878600551,NaN,NaN,21.095672960495847,21.949298126306317
2003-05-29T09:30:00-04:00,19.777153,19.850221,19.509236,19.541719,1374850,3972587.4,60.97790538579821,60.19615804390644,NaN,NaN,159.85142845357674,92.22673788091281,-0.01097964751186814,0.2556909161465235,0.26667056365839165,38947253,30249873.6,88.86022321085518,76.46782013590655,NaN,NaN,21.231470627102524,21.846751340705776
2003-05-30T09:30:00-04:00,19.663491,19.97201,19.606652,19.939527,2901819,4025409.9,66.8061471984157,60.63945898056396,NaN,NaN,204.80184984966252,134.3206919135427,0.015627559697738602,0.2862050132805649,0.2705774535828263,41849072,34300596.4,90.34919542934735,76.64009352638094,NaN,NaN,23.303104809124488,22.054801836194162
2003-06-02T09:30:00-04:00,20.134376,20.418522,20.053189,20.118139,7484817,3699606.55,69.041896658485,61.01196921423914,NaN,NaN,250.95233016604624,185.28555832904485,0.040417016780959214,0.32109872455902533,0.2806817077780661,49333889,39451470.4,91.84236014631888,77.30284492808381,NaN,NaN,25.748968540036614,22.582539936743085
2003-06-03T09:30:00-04:00,20.053189,20.272394,20.036943,20.2318,2106987,3730966.25,70.40782489083661,61.58394659251285,NaN,NaN,190.57228318429154,206.29557858926327,0.058530499358305677,0.3538448319759482,0.2953143326176425,51440876,44378638.6,92.96381677701835,78.70053700710164,NaN,NaN,28.172257049786587,23.381070952892156
2003-06-04T09:30:00-04:00,20.239911,20.580913,20.183088,20.524074,2221661,3707865.3,73.6298540295584,62.401360716672215,NaN,NaN,192.28611845559044,199.6928020218335,0.08277533330259856,0.39878349924589074,0.3160081659432922,53662537,47046725.4,93.48603344446425,80.70198343703514,NaN,NaN,31.339129446297182,24.517936451950018
2003-06-05T09:30:00-04:00,20.377945,20.727041,20.377945,20.653973,3678175,3831136.3,74.93603301739206,63.09227926038521,NaN,NaN,176.49170326505808,203.02085698412975,0.09904117035091453,0.4398096288819353,0.3407684585310208,57340712,50725417.2,94.13263242938905,82.68324921119802,NaN,NaN,34.34411665853602,25.921676481462303
2003-06-06T09:30:00-04:00,20.897542,21.076153,20.580913,20.637735,5209948,3600576.05,74.43966251213175,63.694548532856444,NaN,NaN,168.25619182547118,195.7117253792915,0.0999013878690726,0.46564519336736154,0.36574380549828894,52130764,52781755.6,94.46346870121036,84.59188615757651,NaN,NaN,36.58837295755906,27.44549026376184
2003-06-09T09:30:00-04:00,20.29675,20.459124,20.134376,20.207444,4172712,3694187.1,62.60539373000933,64.39484868501528,NaN,NaN,85.54333970004075,162.62992728609038,0.06440897687080682,0.4462550265867975,0.3818460497159907,47958052,52506588.2,93.70208051507313,86.46292237864573,NaN,NaN,34.808394396287206,28.497333711265465
2003-06-10T09:30:00-04:00,20.256156,20.394174,20.174978,20.377945,4224321,3868882.55,64.9810802312231,65.24264802808713,NaN,NaN,81.77015867218742,140.86950238366958,0.046186354212311265,0.43957899248137977,0.3933926382690685,52182373,52654887.6,93.73140561572306,88.1660984867235,NaN,NaN,34.09146205394221,29.29649490307643
2003-06-11T09:30:00-04:00,20.386056,20.727041,20.3617,20.686448,2839124,3906160.7,68.83864829589864,66.30762506578662,NaN,NaN,104.48835821745614,123.3099503360427,0.048445057503373135,0.4539489601482849,0.40550390264491176,55021497,52926679.6,93.78849055143506,89.60693685115713,NaN,NaN,34.73723766891628,30.07374386962498
2003-06-12T09:30:00-04:00,20.865059,20.881296,20.467251,20.645846,3426656,4010278.35,67.78039971037586,67.21278148982947,NaN,NaN,101.02495402499957,108.216600488031,0.041033172539008955,0.45679536831867296,0.415762195779664,51594841,51777505.4,90.05435608139798,90.52038682651674,NaN,NaN,34.91780824510148,30.765753066121622
2003-06-13T09:30:00-04:00,20.678329,20.767635,20.467251,20.572786,1011984,3919013.75,65.81962502715936,67.8681285858463,NaN,NaN,83.59855829313793,91.28507378156435,0.025783576831392097,0.4479916668189041,0.422208089987512,50582857,51467924,89.02602944010556,91.16990523537376,NaN,NaN,34.47706089065951,31.295939898198462
2003-06-16T09:30:00-04:00,20.662092,21.10862,20.662092,21.076153,1192185,3809901.45,71.85969673532958,68.49120166229463,NaN,NaN,111.25248340400049,96.4269025223563,0.04314832339169783,0.4761434942271343,0.4329951708354365,51775042,52231322,89.34901057553323,91.608252798095,NaN,NaN,36.05744116173214,31.97615436441756
2003-06-17T09:30:00-04:00,21.311587,21.311587,20.986848,21.068027,2486358,3781405.5,71.63960930414325,68.84026976619691,NaN,NaN,120.48158561528163,104.16918791097514,0.047304187056047886,0.49212540465549637,0.4448212175994485,49288684,51652584.2,87.25245425975469,91.64296836983046,NaN,NaN,37.22387768323815,32.725829124249074
2003-06-18T09:30:00-04:00,21.019314,21.019314,20.743279,20.865059,4557503,3801131.6,66.18684206547712,69.21233667188825,NaN,NaN,87.86858431156529,100.84523312979698,0.03042094451475802,0.482847398242896,0.452426453728138,44731181,49594521,80.05822484922017,91.01425420114224,NaN,NaN,36.52241111194363,33.26819797963401
2003-06-19T09:30:00-04:00,20.800109,20.881296,20.3617,20.369818,4697919,3866474.55,55.15554385861854,68.3801507190456,NaN,NaN,40.978401595788284,88.83592264395472,-0.017485670271811193,0.430569365888374,0.4480550361601852,40033262,47282205.2,72.79573270864509,89.76043543537779,NaN,NaN,32.11556179258623,33.103535667198614
2003-06-20T09:30:00-04:00,20.377945,20.507828,20.280513,20.337344,4352051,3833285.75,54.51394080724751,67.34243958681436,NaN,NaN,10.953115023723914,74.30683399007192,-0.05275322763863888,0.3821135016118866,0.4348667292505255,35681211,44301876,64.65466511968016,87.81845721918931,NaN,NaN,28.47015350318125,32.44162392948185
2003-06-23T09:30:00-04:00,20.29675,20.29675,19.931409,20.020714,2500523,3859108.85,48.580091222010786,65.78331575332679,NaN,NaN,-50.57096933210861,41.9421434428501,-0.09626402184306304,0.3145367019466967,0.41080072378975974,33180688,40583005.2,56.207664689019786,85.19301778433227,NaN,NaN,23.350328499576158,31.142867439495323
2003-06-24T09:30:00-04:00,19.97201,20.191207,19.915171,20.134376,2103415,3803003.8,50.6564723174217,64.1423599167456,NaN,NaN,-64.8648046959339,4.87286538060699,-0.11498097409146124,0.26707450617543316,0.3820554802668944,35284103,37782089,50.822125590935485,82.1455957947945,NaN,NaN,19.8503166846301,29.529645903086006
2003-06-25T09:30:00-04:00,20.061316,20.345462,19.996358,20.004477,3578898,3306095.3,48.25807591489358,62.236791552281424,NaN,NaN,-65.17256964841378,-25.73536541138882,-0.1324578820920851,0.216483127651788,0.3489410097438731,31705205,35176893.8,46.371606946081776,78.73409397455826,NaN,NaN,16.221707653101067,27.628511867373874
2003-06-26T09:30:00-04:00,20.028833,20.207444,19.890815,20.174978,2813997,3378052.65,51.503715520296524,60.59850962429319,NaN,NaN,-81.67811784239574,-50.26666929902562,-0.12876866146764732,0.18798018290931395,0.31674884437696127,34519202,34074081.8,44.59146183106782,75.17180776954808,NaN,NaN,14.145508518065276,25.70236853175836
2003-06-27T09:30:00-04:00,20.256156,20.256156,19.947654,20.004477,605762,3263249.8,48.244660743271716,59.572742982383375,NaN,NaN,-93.03434885077299,-71.064162073925,-0.13347477768880472,0.14990537226595535,0.2833801499547601,33913440,33720527.6,44.008183417799,71.62224369117135,NaN,NaN,11.40215839062874,23.659481368739844
2003-06-30T09:30:00-04:00,20.012587,20.118139,19.890815,19.931409,1039082,2940963.05,46.87571579051686,58.27950266519007,NaN,NaN,-108.54972464663918,-82.65991313683112,-0.1366740635550039,0.11253757051100521,0.2492116340660091,32874358,33659261.6,43.901019887369415,68.06293042486037,NaN,NaN,8.744211240879025,21.528728493331155
2003-07-01T09:30:00-04:00,19.769043,20.199326,19.720314,20.166851,2532548,2962241.1,51.637671305928244,57.05086145162075,NaN,NaN,-92.7282350134457,-88.23259920033347,-0.11876129019364451,0.10076002132395345,0.21952131151759796,35406906,33683822.2,43.9599335930647,64.50374778497678,NaN,NaN,7.835655737898405,19.572575242555047
2003-07-02T09:30:00-04:00,20.29675,20.418522,20.215555,20.418522,854077,2893861.9,56.16127053478737,56.22092365336443,NaN,NaN,-16.536109926303862,-78.50530725591149,-0.08724852642667585,0.11046065348425316,0.197709179910929,36260983,34594977.8,46.21650287869385,61.3724725562122,NaN,NaN,8.435073364588842,17.981503545702733
2003-07-03T09:30:00-04:00,20.394174,20.467251,20.256156,20.321106,678556,2743880.95,54.05369053081686,55.38049976076854,NaN,NaN,-14.761787994931327,-65.12204128641861,-0.07094256306693478,0.10903097607726053,0.1799735391441953,35582427,34807622.8,46.75535952071886,58.35313899054172,NaN,NaN,8.306700737665274,16.59938885884024
2003-07-07T09:30:00-04:00,20.580913,20.78388,20.410412,20.670218,735462,2520156.65,59.866351060142335,54.523832212540874,NaN,NaN,53.09568409621276,-35.896034697021456,-0.036364646900800934,0.13451773051819416,0.1708823774189951,36317889,35288512.6,48.02361100794056,55.40132473571367,NaN,NaN,10.03246695856978,15.661257158801602
2003-07-08T09:30:00-04:00,20.62149,20.897542,20.597142,20.808228,1430647,2383053.4,61.917424006091146,53.829390405537154,NaN,NaN,78.6049990883591,1.5349100499781998,-0.00553601028603104,0.1639623645614563,0.16949837484748734,37748536,36263348.2,50.59276721457886,52.782775661058245,NaN,NaN,12.100126096727513,15.152524149933875
2003-07-09T09:30:00-04:00,20.702685,20.946246,20.662092,20.775753,851737,2214424.2,61.125797577256584,53.46788722780712,NaN,NaN,75.97977833225143,35.276512719117626,0.010459225739607697,0.18257240702199695,0.17211318128238925,36896799,36561326.8,51.38381668715087,50.73460364948187,NaN,NaN,13.540555744499533,14.92224294915754
2003-07-10T09:30:00-04:00,20.775753,20.775753,20.3617,20.475361,630273,2103981.65,54.220324962719936,53.40108587810007,NaN,NaN,19.67538833342157,42.5188123710627,-0.0008029987848130749,0.17110943280137292,0.171912431586186,36266526,36562435.4,51.38693515017876,49.20540382387713,NaN,NaN,12.72590883580021,14.608480932963637
2003-07-11T09:30:00-04:00,20.580913,20.767635,20.524074,20.759524,2407281,2053012.9,58.94526178294059,53.71760880493529,NaN,NaN,52.04017779488918,55.8792055290268,0.008747477571862006,0.1828467785510135,0.1740993009791515,38673807,37180711.4,53.190316767680066,48.38652179873426,NaN,NaN,13.506252608625408,14.451019743772461
2003-07-14T09:30:00-04:00,21.149214,21.335944,20.337344,21.149214,2325002,2118663.8,64.37538728749603,54.84584423818423,NaN,NaN,100.0139217999237,65.26285306976898,0.03755684921861996,0.22104536250242646,0.1834885132838065,40998809,38116895.4,55.86041008214546,48.36171789824324,NaN,NaN,16.015891182165845,14.674572806400088
2003-07-15T09:30:00-04:00,21.189815,21.279121,20.970602,21.035552,3561530,2237131.05,61.807542485166735,55.64234925016603,NaN,NaN,128.1062404774077,75.16310134757872,0.044718740085160885,0.2393869383902576,0.1946681983050967,37437279,38054644,55.633163643246945,48.70536347340835,NaN,NaN,17.21827455097348,15.037958769910572
2003-07-16T09:30:00-04:00,21.124857,21.189815,20.791991,20.930009,1720349,2198830.6,59.43670142185968,56.4408225006636,NaN,NaN,106.45495468647216,81.25813661842287,0.03835318378457811,0.24260967803581934,0.20425649425124123,35716930,37818670.2,54.7243539376168,49.301988258517994,NaN,NaN,17.46868381703017,15.385205205213373
2003-07-17T09:30:00-04:00,20.702685,20.865059,20.515955,20.580913,3608336,2151372.25,52.291822633372675,56.49711586588332,NaN,NaN,43.34697122966126,85.99245319767081,0.008212180510024703,0.2145217198887721,0.2063095393787474,32108594,36987083.8,51.52969121311933,49.797576071521675,NaN,NaN,15.386660788910634,15.385413145741552
2003-07-18T09:30:00-04:00,20.653973,20.881296,20.605261,20.832584,1804106,2006681.6,56.364269292514955,57.07708790511498,NaN,NaN,64.38117806801218,88.4606532522954,0.003070058094644168,0.2101471119970526,0.20707705390240844,33912700,36034862.4,48.06928356373897,50.08765465337452,NaN,NaN,14.941681168483795,15.322022863276159
2003-07-21T09:30:00-04:00,20.816347,20.832584,20.540311,20.589023,462512,1812204.65,51.75946073383769,57.425926829637895,NaN,NaN,35.93255894180866,75.6443806806724,-0.017745238124193957,0.184895506247166,0.20264074437135995,33450188,34525138.2,43.124593241733834,50.03219560725769,NaN,NaN,13.072623146079218,15.000680046533738
2003-07-22T09:30:00-04:00,20.824457,20.848813,20.491607,20.791991,2536243,1813990.65,55.05476740627222,57.67000512251961,NaN,NaN,43.252367032379574,58.673605991666776,-0.018756121225753597,0.17919559283916797,0.19795171406492157,35986431,34234968.6,42.225539539818286,49.90831031774009,NaN,NaN,12.573474862368448,14.65393644879584
2003-07-23T09:30:00-04:00,20.840703,20.865059,20.589023,20.727041,875755,1752607.65,53.78854570482579,57.50052477752236,NaN,NaN,42.49884049157096,45.88238315268653,-0.024356141558508376,0.1675065371167861,0.19186267867529447,35110676,34113717.8,41.83307735204436,49.595208494407984,NaN,NaN,11.786036909417497,14.244236514598933
2003-07-24T09:30:00-04:00,20.808228,20.978721,20.637735,20.637735,989444,1623134.95,52.01702396014536,57.35504859390296,NaN,NaN,43.96503517646807,46.00599594204789,-0.03403781232856484,0.14931541326458841,0.18335322559315326,34121232,34516245.4,43.70375007462488,49.37723639111556,NaN,NaN,10.614403720787543,13.725688972625877
2003-07-25T09:30:00-04:00,20.743279,21.124857,20.662092,21.124857,900267,1527448.45,59.79517918295459,57.34996488838955,NaN,NaN,96.41194637392199,52.41214960322985,-0.008906385959521312,0.17222024314375162,0.18112662910327293,35021499,34738005.2,44.75780797962028,49.14396474623554,NaN,NaN,12.037219414520157,13.484479035753631
2003-07-28T09:30:00-04:00,21.230392,21.230392,20.946246,21.04367,2603495,1627335.1,58.10460810632474,57.077620895549096,NaN,NaN,121.81890339654646,69.58941849417741,0.00047993110519151116,0.18172654298476232,0.1812466118795708,32418004,34531568.4,43.9331640503307,48.668278805932104,NaN,NaN,12.660829725858042,13.36681484862569
2003-07-29T09:30:00-04:00,21.003077,21.04367,20.743279,20.816347,5170778,1833919.9,53.540157848997424,56.53578948638772,NaN,NaN,54.50596887481478,71.84013886266446,-0.009821679539005868,0.1689695124558135,0.17879119199481935,27247226,32783727.4,37.614161508581105,47.684732007462834,NaN,NaN,11.776610855877623,13.13964284966168
2003-07-30T09:30:00-04:00,20.946246,20.946246,20.751397,20.824457,3983150,1906450,53.67995843805602,56.49719187748316,NaN,NaN,36.66820241354345,70.67401124705896,-0.01687610476005602,0.1576960610447493,0.17457216580480533,31230376,32007667.4,35.19369554062446,46.528072035351805,NaN,NaN,11.11108654988048,12.84984909255008
2003-07-31T09:30:00-04:00,21.068027,21.132976,20.78388,20.800109,1986648,1963078.55,53.162749728671784,56.084155302178246,NaN,NaN,57.747814751438334,73.43056716205301,-0.023558382115102056,0.14512418816092776,0.16868257027602981,29243728,31032166.6,32.37364907422217,45.04116720010482,NaN,NaN,10.421646480775442,12.502963005153703
2003-08-01T09:30:00-04:00,20.848813,20.848813,20.377945,20.394174,7991182,2328709.85,45.322261314372625,54.723217732669426,NaN,NaN,-128.80057335966941,28.38806321533473,-0.05395540494153034,0.10123831409911688,0.15519371904064722,21252546,28278376,26.032179788728698,42.91057932200362,NaN,NaN,7.389532682381306,11.77247295904336
2003-08-04T09:30:00-04:00,20.337344,20.475361,19.988239,20.418522,8354044,2709638.95,45.83822607363698,53.58255227470302,NaN,NaN,-220.74156609997792,-40.12403068397015,-0.07004027751081954,0.0676433721521228,0.13768364966294233,29606590,27716093.2,24.957194380512064,40.7194386603797,NaN,NaN,5.084080287869243,10.816988291732773
2003-08-05T09:30:00-04:00,20.580913,20.580913,20.085672,20.085672,3525194,2814366.3,40.24693322157307,52.21185454611112,NaN,NaN,-194.84090161632665,-89.99340478219844,-0.09894728189248898,0.013999547297331105,0.11294682918982009,26081396,27482927.2,24.50528955417616,38.56093406156251,NaN,NaN,1.2794795461198323,9.454487042359496
2003-08-06T09:30:00-04:00,20.199326,20.532184,20.101893,20.3617,5907839,3067171.4,46.116785777846076,51.77078048500208,NaN,NaN,-139.02533402658375,-125.13211207022387,-0.09529290477155442,-0.006169301774622937,0.08912360299693148,31989235,27634699,25.451527829253436,36.6982081055721,NaN,NaN,-0.2054071282699408,8.074502160841005
2003-08-07T09:30:00-04:00,20.345462,20.491607,20.166851,20.459124,1838225,3127569,48.05631897224691,51.17735546212579,NaN,NaN,-116.44755692928534,-159.97118640636862,-0.08260215125357331,-0.014129086070035157,0.06847306518353816,33827460,28551445.4,31.071397841018424,35.484073411092055,NaN,NaN,-0.8337859558976257,6.801889572735487
2003-08-08T09:30:00-04:00,20.580913,20.62149,20.48348,20.556557,2423663,3128388.1,49.99489512741192,51.051315061666806,NaN,NaN,-51.726135496871045,-144.55629883380894,-0.06472400097313094,-0.012431936032875512,0.05229206494025542,36251123,31551160.8,45.538792062232766,35.656516183984834,NaN,NaN,-0.7825290879805898,5.71840119263319
2003-08-11T09:30:00-04:00,20.62149,20.678329,20.402293,20.515955,968258,3060550.9,49.17134830474355,50.63107084012905,NaN,NaN,-52.25335651539024,-110.85865691689139,-0.05319324521303345,-0.014199491576036394,0.03899375363699706,35282865,32686415.8,49.8304864525041,36.1997266777481,NaN,NaN,-0.9715822916018839,4.762689266313894
2003-08-12T09:30:00-04:00,20.662092,20.775753,20.589023,20.759524,2064369,2985692.85,54.060242131680994,50.650477727761555,NaN,NaN,12.020997349778208,-69.48627712367042,-0.027989007128982182,0.004007494725769334,0.031996501854751516,37347234,34939583.4,57.062554154126246,37.28754644932538,NaN,NaN,0.2955764814647148,4.124530297049726
2003-08-13T09:30:00-04:00,20.881296,20.881296,20.540311,20.605261,2879525,3043651.65,50.73204653588074,50.558693626028365,NaN,NaN,6.182316189151425,-40.444747080523385,-0.020860659255108216,0.005920677785866246,0.026781337040974462,34467709,35435278.2,58.48056507636233,38.34303323516377,NaN,NaN,0.41487698808716195,3.5945798243407885
2003-08-14T09:30:00-04:00,20.597142,20.848813,20.524074,20.800109,2604973,2993483.5,54.53909006110946,50.18325868875372,NaN,NaN,23.08921971640873,-12.537391751384561,-0.0031086148562068164,0.022895568470715943,0.02600418332692276,37072682,36084322.6,60.328012368276354,39.45519069149635,NaN,NaN,1.6501281340980722,3.316801011448972
2003-08-15T09:30:00-04:00,20.78388,20.816347,20.686448,20.78388,350671,2920811.75,54.163674791927455,49.901763452011046,NaN,NaN,37.62728302230571,5.3332919524507885,0.006908209344552423,0.03463944500761329,0.027731235663060867,36722011,36178500.2,60.6019509695359,40.645818328582436,NaN,NaN,2.5517096874319605,3.207502250875113
2003-08-18T09:30:00-04:00,20.743279,20.881296,20.727041,20.808228,886718,2942022.05,54.66783288376791,49.98231166878037,NaN,NaN,49.828398476822045,25.749642950893254,0.014125433042858702,0.04538802696663424,0.03126259392377554,37608729,36643673,61.99777191552351,42.387504786221186,NaN,NaN,3.437547891276333,3.240365913789573
2003-08-19T09:30:00-04:00,20.832584,20.881296,20.645846,20.78388,3429120,2986665.9,54.02786316565211,50.007162006465805,NaN,NaN,35.39819284336735,30.42508204961108,0.016069722914891102,0.051349747567389414,0.03528002465249831,34179609,36010148,58.935350225172726,44.08333726368892,NaN,NaN,4.016543239627793,3.3512483889093185
2003-08-20T09:30:00-04:00,20.662092,20.840703,20.662092,20.735152,2125217,3049139,52.69825468848055,49.97398378930929,NaN,NaN,26.10936874253129,34.410492560287054,0.013014616337470863,0.05154829507433689,0.03853367873686603,32054392,35527484.6,56.63985529033273,45.81663770769681,NaN,NaN,4.1744429405742745,3.468847610575741
2003-08-21T09:30:00-04:00,20.905653,20.962492,20.645846,20.735152,2817322,3140532.9,52.698254688480546,50.500840458888426,NaN,NaN,38.09171904730094,37.4109924264655,0.01006618283433549,0.05111640727978539,0.0410502244454499,32054392,34523826.6,52.09593818594214,47.6783347360692,NaN,NaN,4.308033235391167,3.5887312712636588
2003-08-22T09:30:00-04:00,20.78388,20.85694,20.337344,20.337344,8039954,3497517.25,42.739598947712416,50.279509949893814,NaN,NaN,-51.584927551589026,19.568550311686547,-0.018070948370982512,0.01846153898172176,0.03653248735270427,24014438,31982312,42.74447102144593,48.9488544961359,NaN,NaN,1.597993572675335,3.3043401714653267
2003-08-25T09:30:00-04:00,20.29675,20.426649,20.215555,20.410412,5582419,3646463.45,44.80288415242148,50.60493501638298,NaN,NaN,-97.78941944991995,-9.955013273661852,-0.03042947878315593,-0.0015043611262406387,0.02892511765691529,29596857,30379937.6,38.10075604401011,49.919959245409764,NaN,NaN,-0.11582736954976211,2.815744808463171
2003-08-26T09:30:00-04:00,20.345462,20.532184,20.183088,20.451005,4571667,3616507.9,45.96772540036655,50.59428784656302,NaN,NaN,-75.50299044063172,-32.13524993046167,-0.034253557009851124,-0.013891828605398615,0.02036172840445251,34168524,30377720.6,38.0945895929869,50.82303508567644,NaN,NaN,-1.2385321570833019,2.236562384813675
2003-08-27T09:30:00-04:00,20.418522,20.418522,20.312987,20.369818,1330754,3483888.1,43.969159172548196,50.302347860870256,NaN,NaN,-76.24846917712449,-52.60681751439282,-0.04022158576137819,-0.029915253797270225,0.010306331964107962,32837770,30534396.2,38.84783053628193,51.37849456390955,NaN,NaN,-2.747990973275789,1.5244833336580372
2003-08-28T09:30:00-04:00,20.337344,20.499718,20.223682,20.459124,2552255,3512168.45,46.71364126686493,50.0679725851169,NaN,NaN,-60.50572670565467,-72.32630666498395,-0.03624840915058649,-0.03500417947412515,0.0012442296764613395,35390025,31201522.8,42.079515881576,51.131403408148344,NaN,NaN,-3.319506807184611,0.8324847421090875
2003-08-29T09:30:00-04:00,20.418522,20.597142,20.369818,20.556557,1860150,3205616.85,49.61337835178949,50.0995461599059,NaN,NaN,-13.519649412370356,-64.71325103714021,-0.02565129448454588,-0.03081988842922101,-0.005168593944675131,37250175,33848670.2,52.74978833715255,51.33992497133752,NaN,NaN,-3.030343658428037,0.2806521134609269
2003-09-02T09:30:00-04:00,20.613379,20.938119,20.556557,20.92189,4218286,2998828.95,58.69070345214043,50.43029339708157,NaN,NaN,94.88460729732456,-26.178445687691333,0.005697274591430159,0.0019529992946125674,-0.003744275296817591,41468461,36222991,59.88763968745318,51.54171679514659,NaN,NaN,0.05982759983635366,0.24910575437170215
2003-09-03T09:30:00-04:00,20.978721,21.027425,20.824457,20.962492,5721114,3108624.95,59.56260810121322,51.06104779460532,NaN,NaN,131.79684567288254,15.281521535011517,0.027672550446652667,0.030846412761498243,0.0031738623148455758,47189575,38827201.2,65.96138935108496,52.076061386198205,NaN,NaN,2.841508944539629,0.6194490672528346
2003-09-04T09:30:00-04:00,20.986848,20.986848,20.800109,20.873186,4945619,3060513.95,56.726485717533805,51.21729034149278,NaN,NaN,102.00576125908377,50.932367622253174,0.0342673510179424,0.04600805108727357,0.011740700069331176,42243956,40708438.4,69.5484615253766,52.73466489741965,NaN,NaN,4.3768516175563565,1.1562208601533377
2003-09-05T09:30:00-04:00,20.78388,20.986848,20.727041,20.775753,5866332,3261919.3,53.72106028367578,51.1856750194748,NaN,NaN,73.67043377321167,77.76759971802645,0.030279508928859996,0.04959008623040617,0.019310577301546176,36377624,40905958.2,69.90704060774316,53.39931415729159,NaN,NaN,4.823621706652805,1.6801352667961187
2003-09-08T09:30:00-04:00,20.889415,21.04367,20.702685,20.978721,4397994,3360635.85,58.63732112602489,51.46920989392173,NaN,NaN,97.25413771268124,99.92235714303675,0.03896959761474354,0.0680225743199756,0.02905297670523206,40775618,41611046.8,71.21029921800204,54.057351821754345,NaN,NaN,6.7064345001983385,2.398178014425007
2003-09-09T09:30:00-04:00,20.92189,20.92189,20.767635,20.873186,3321221,3478284,55.34513347512516,51.56330063031266,NaN,NaN,69.95461138472717,94.93635796051727,0.035373658552994625,0.07327004989647534,0.03789639134348072,37454397,40808234,67.6194857453131,54.67764721605009,NaN,NaN,7.320152000808585,3.1013171553369467
2003-09-10T09:30:00-04:00,20.735152,20.881296,20.499718,20.532184,4419303,3596030.7,46.29962423196732,51.10625559770457,NaN,NaN,-18.26047203996505,64.92489441794774,0.009158002817215613,0.04934389486500024,0.040185892047784624,33035094,37977337.8,56.752074180687025,54.6856628510754,NaN,NaN,4.929788791119336,3.362527389020145
2003-09-11T09:30:00-04:00,20.540311,20.759524,20.540311,20.62149,3576434,3630876.15,48.66591340437704,50.81823122026861,NaN,NaN,-16.21723070277648,41.2802960255757,-0.002420606778972323,0.03716013357406922,0.039580740353041544,36611528,36850852.2,53.095311259643935,54.7570466420541,NaN,NaN,3.7305874719721235,3.415107400870428
2003-09-12T09:30:00-04:00,20.580913,20.718922,20.499718,20.653973,7497260,3875490.5,49.536925874881575,51.303754572209264,NaN,NaN,-20.62400176908717,22.421408917115933,-0.007838823632411306,0.02978221081252741,0.037621034444938715,44108788,38397085,57.174308149191624,55.78774929403594,NaN,NaN,3.026927607609282,3.359653144690264
2003-09-15T09:30:00-04:00,20.662092,20.694574,20.515955,20.653973,2610516,3988482.75,49.53692587488159,51.64190040952784,NaN,NaN,-19.070000172970346,-0.8434186600143831,-0.01116691668980227,0.023662388582685878,0.03482930527248815,44108788,39063719,58.83637317135229,57.268864803131805,NaN,NaN,2.4589038543085944,3.23097467463574
2003-09-16T09:30:00-04:00,20.613379,20.946246,20.613379,20.897542,6240531,4256173.4,56.025570585890264,52.36031792277953,NaN,NaN,60.64670424052415,-2.705000088854986,0.0025589597135992487,0.03802800491448721,0.035469045200887964,50349319,41642703.4,64.56581153220009,59.15966637021846,NaN,NaN,3.9030974187309315,3.3269922095064817
2003-09-17T09:30:00-04:00,20.946246,21.011196,20.865059,20.930009,3346718,4252053.3,56.82254100662038,53.27841662521326,NaN,NaN,99.40030930714516,20.827156180567055,0.012776531808688263,0.05143970996174829,0.03866317815306003,53696037,45774892,71.42790472925853,61.48681452685964,NaN,NaN,5.315485910671758,3.611062738244378
2003-09-18T09:30:00-04:00,20.986848,21.465843,20.954365,21.43336,13463733,4818979.1,66.85262535052176,54.71691548833161,NaN,NaN,193.41310016310723,62.753222353743794,0.05028114122620901,0.1015146046858213,0.051233463459612286,67159770,51884540.4,78.16186362678678,64.06412508008898,NaN,NaN,10.203022512469062,4.552771277419333
2003-09-19T09:30:00-04:00,21.230392,21.311587,21.132976,21.287231,4962986,4926262.3,62.32607415470118,55.62496518853958,NaN,NaN,154.31511736550004,97.74104618066124,0.06135978621259251,0.12793319622535293,0.06657341001276042,62196784,55502139.6,81.01503059556897,66.08307095569016,NaN,NaN,12.672698459158498,5.712760874810642
2003-09-22T09:30:00-04:00,21.027425,21.068027,20.881296,20.978721,4513900,4749959.6,54.01128905792691,55.29072130323862,NaN,NaN,67.53856035665528,115.06275828658636,0.044791760339809084,0.12256311043752177,0.07777135009771269,57682884,58216958.8,82.82817809677324,67.72168084207017,NaN,NaN,11.902787756566093,6.597050429347135
2003-09-23T09:30:00-04:00,21.019314,21.165459,20.946246,21.124857,5886165,4765146.9,56.94158794269868,55.10350557763043,NaN,NaN,91.94854647663414,121.32312673380837,0.04067621617292061,0.12861662031386345,0.08794040414094284,63569049,60860904.8,84.39160582674491,69.03812487604588,NaN,NaN,12.280336206514333,7.4089483975138775
2003-09-24T09:30:00-04:00,21.230392,21.230392,20.743279,20.759524,5226947,4797910.9,48.60385844053459,54.52331791498763,NaN,NaN,34.19383269642551,108.28183141166444,0.011847923900701399,0.10275030901681959,0.09090238511611819,58342102,61790117.8,84.91154621210794,70.13548806795525,NaN,NaN,9.60167646147787,7.722195263794448
2003-09-25T09:30:00-04:00,20.824457,20.905653,20.3617,20.662092,3600453,4911395.85,46.64232457054005,54.017693935477936,NaN,NaN,-70.06427933887942,55.58635551126711,-0.01388880126178392,0.07354138353888828,0.0874301848006722,54741649,59306493.6,77.48216935880039,70.67656869303077,NaN,NaN,6.8335057650322915,7.59523962111414
2003-09-26T09:30:00-04:00,20.605261,20.718922,20.540311,20.54843,1633635,4865464.85,44.39159077512188,53.00014176755629,NaN,NaN,-95.33262994441516,5.656806049284066,-0.03734273568882872,0.0407517651896363,0.07809450087846502,53108014,57488739.6,72.48345377023352,70.76750830390445,NaN,NaN,3.8665460223347137,7.062569107002793
2003-09-29T09:30:00-04:00,20.678329,20.791991,20.572786,20.767635,763545,4810634.6,49.457108876430716,52.57956858193527,NaN,NaN,-59.1748549128141,-19.685877004609807,-0.03680846115915769,0.03208392442951791,0.0688923855886756,53871559,56726474.6,70.43144685735277,70.96836266905015,NaN,NaN,3.033317210267869,6.486961693183519
2003-09-30T09:30:00-04:00,20.767635,20.78388,20.475361,20.629617,2793673,4739403.95,46.58002155993185,52.599596962504165,NaN,NaN,-85.60284194378752,-55.19615468869413,-0.04398009293131792,0.0139172694245282,0.05789736235584612,51077886,54228242,64.03325719554888,71.48844717011171,NaN,NaN,1.4199679504583487,5.76310544422278
2003-10-01T09:30:00-04:00,20.702685,21.181688,20.702685,21.149214,2845775,4595637,56.77478338699354,53.17880196126248,NaN,NaN,67.53285607264979,-48.52835001344927,-0.013537996177692538,0.04097486713373044,0.05451286331142298,53923661,53344553.8,61.891489793132706,72.11674563678947,NaN,NaN,3.5796447821520228,5.451182492498386
2003-10-02T09:30:00-04:00,21.10862,21.254748,21.084264,21.189815,2235086,4460110.35,57.45798086285253,53.7445916032604,NaN,NaN,117.41300168869552,-11.032893807934292,0.008346282035611927,0.06494571585593789,0.056599433820325964,56158747,53627973.4,62.32671665403632,72.48477481570696,NaN,NaN,5.463166035184193,5.452894427167787
2003-10-03T09:30:00-04:00,21.43336,21.603861,21.270994,21.352181,1857070,4259647.25,60.169238153087,54.504042480275075,NaN,NaN,168.01415506381835,41.63646319371241,0.03147121032406355,0.09593844672540541,0.06446723640134186,58015817,54609534,63.865874595022596,72.8440249173977,NaN,NaN,7.89757274698483,5.80213418714165
2003-10-06T09:30:00-04:00,21.376537,21.514555,21.303477,21.449605,1691896,4124342.35,61.744671793851225,54.912549709415146,NaN,NaN,145.9838805559974,82.66821028747471,0.049945331113272415,0.12689890029293238,0.07695356917965997,59707713,55776764.8,65.66244164669533,72.92235563986164,NaN,NaN,10.36467047474768,6.453925085371083
2003-10-07T09:30:00-04:00,21.311587,21.587623,21.262875,21.579505,837326,4000147.6,63.80061257272879,55.410983392708594,NaN,NaN,137.19963345890793,127.22870536801379,0.06649467886189869,0.16007191775703333,0.09357723889513464,60545039,57670195.4,68.4065442838043,72.70654417947205,NaN,NaN,13.048380520205912,7.395990147490344
2003-10-08T09:30:00-04:00,21.587623,21.652573,21.473961,21.547022,1105226,3834443.75,62.89041681721749,55.12796849747258,NaN,NaN,137.35616953239713,141.19336805996326,0.0704556134749296,0.18164675573879663,0.11119114226386703,59439813,58773425.8,69.91516506580554,72.1174942822591,NaN,NaN,14.95014615593045,8.475155291553216
2003-10-09T09:30:00-04:00,21.790591,21.814947,21.571394,21.603861,2748469,3793045.5,63.86193260082904,55.237672672196005,NaN,NaN,140.71153003368042,145.85307372896028,0.07185847464781941,0.2010142355736413,0.12915576092582187,62188282,59979332.8,71.51624311507561,71.43900946222386,NaN,NaN,16.803556017223325,9.664926823791802
2003-10-10T09:30:00-04:00,21.59575,21.693166,21.579505,21.603861,2757830,3556074,63.86193260082904,55.94129006811759,NaN,NaN,117.05567172984743,135.66137706216608,0.06779333245281188,0.21389742649183674,0.14610409403902486,62188282,60813825.8,72.60282923326156,70.70862740054446,NaN,NaN,18.32384118931445,10.901914590295037
2003-10-13T09:30:00-04:00,21.798718,21.961083,21.73376,21.944846,1917917,3521444.05,69.43014047706683,56.83332953485817,NaN,NaN,150.94826212341982,136.65425337565057,0.08212040452985431,0.24875459970134273,0.16663419517148842,64106199,61693523,73.74007808598256,69.94780399049002,NaN,NaN,21.43074809015861,12.406033661704118
2003-10-14T09:30:00-04:00,21.961083,22.090991,21.863651,22.074745,3367657,3377800.35,71.24765938603635,58.4507438881083,NaN,NaN,154.1258799560388,140.03950267507673,0.09356612700578465,0.2835918539287192,0.19002572692293457,67473856,63079286.4,75.46762535590348,69.27323821504685,NaN,NaN,24.611490033435974,14.14967028623724
2003-10-15T09:30:00-04:00,22.261475,22.269586,21.896134,22.017914,2198258,3320377.35,69.30622850003901,60.06959416878679,NaN,NaN,142.6619114345265,141.10065105550262,0.0904759431928071,0.30312065591394344,0.21264471272113633,65275598,64246443.4,76.84905901259773,69.22801604746094,NaN,NaN,26.693900144959482,15.941703123197561
2003-10-16T09:30:00-04:00,22.017914,22.131568,21.928601,22.042262,7781663,3036273.85,69.68732787234202,61.87643253287394,NaN,NaN,118.99911673147909,136.75816839506234,0.083411368622123,0.3169089234987901,0.23349755487666707,73057261,66420239.2,79.19847426807492,69.70766036873532,NaN,NaN,28.520831828062626,17.738721509606854
2003-10-17T09:30:00-04:00,22.009796,22.042262,21.725633,21.847422,3811570,2978703.05,62.95146369557583,62.84031501995573,NaN,NaN,82.85006264981533,129.91704657905592,0.06004788211556336,0.30855740752112126,0.2485095254055579,69245691,67831721,80.57680377899065,70.43232872028088,NaN,NaN,28.242443728524265,19.239253255166485
2003-10-20T09:30:00-04:00,21.847422,21.92049,21.701285,21.85554,1655191,2835767.6,63.11145142928163,64.021131439195,NaN,NaN,69.47626661089912,113.62264747655179,0.040508750082322575,0.2991454630084611,0.25863671292613855,70900882,69190657.6,81.82542503487183,71.70319785166109,NaN,NaN,28.056573750252145,20.49887046875015
2003-10-21T09:30:00-04:00,21.961083,21.961083,21.749989,21.847422,3413354,2712127.05,62.819309780883444,64.45288332447286,NaN,NaN,67.98895090073582,96.39526166549118,0.023262451705709064,0.2877147775582749,0.26445232585256584,67487528,69193392,81.82795643809453,73.12723118344408,NaN,NaN,27.82486709574037,21.54544141546304
2003-10-22T09:30:00-04:00,21.555148,21.701285,21.43336,21.538911,10442803,2972919.85,52.813804013471476,64.12115640665992,NaN,NaN,17.77721269222404,71.41832191703071,-0.010866062815568345,0.2508697473331054,0.26173581014867375,57044725,67547217.4,75.05075111984004,74.03609078814434,NaN,NaN,24.672690677637892,21.992191310059447
2003-10-23T09:30:00-04:00,21.392783,21.806828,21.392783,21.685056,2906499,2938222.15,56.359742386177636,63.84904956616639,NaN,NaN,23.919201330665814,52.40233883686805,-0.024747100511722298,0.23080193450902087,0.25554903502074316,59951224,64926010,65.71736464527898,74.16834007744838,NaN,NaN,22.965385480116414,22.131219048639014
2003-10-24T09:30:00-04:00,21.555148,21.676929,21.441487,21.660683,1062239,2909652.35,55.60920451843512,63.41080190363668,NaN,NaN,9.550329590401905,37.74239222498537,-0.0360354018103132,0.21050478275785167,0.24654018456816487,58888985,62854668.8,59.42795432750177,73.72301955464881,NaN,NaN,21.3509565272528,22.01975297415527
2003-10-27T09:30:00-05:00,21.676929,21.952957,21.563267,21.660683,7609837,3251966.95,55.60920451843513,62.82570132832999,NaN,NaN,32.413123110452005,30.329763524895917,-0.043469314867289305,0.19220354098405323,0.23567285585134254,58888985,60452289.4,53.08259043750558,72.62845142277034,NaN,NaN,20.021784287147888,21.734328876011357
2003-10-28T09:30:00-05:00,21.879896,21.936727,21.652573,21.936727,2154778,3220022.2,62.21806387029463,62.7776761178355,NaN,NaN,55.94696790631867,27.92136692601249,-0.030382115487519262,0.19769521149194347,0.22807732697946273,61043763,59163536.4,49.998443814697666,71.20582847626264,NaN,NaN,20.69000414075474,21.585139628117556
2003-10-29T09:30:00-05:00,21.798718,22.034152,21.798718,21.969202,2229790,3189222.95,62.91751589590884,62.71021778176977,NaN,NaN,76.96021281434513,39.75796695043671,-0.020593490581006624,0.20233546375320444,0.22292895433421106,63273553,60409302,52.85021052226713,69.87254043391917,NaN,NaN,21.439164669820183,21.564286062646502
2003-10-30T09:30:00-05:00,22.042262,22.204653,21.92049,22.001685,2497936,3202365.45,63.64255058703431,62.69454763792728,NaN,NaN,105.25279780299064,56.02468624490167,-0.01333803687087981,0.2062564082456113,0.21959444511649112,65771489,61573355,55.40935793519893,68.64443534120042,NaN,NaN,22.263799466850422,21.66421654896135
2003-10-31T09:30:00-05:00,22.123457,22.131568,22.026033,22.058508,1427568,3180890.35,64.93414773271388,62.373405299044926,NaN,NaN,106.52622396779833,75.41986512038095,-0.006466946642165572,0.21151076181378414,0.21797770845594971,67199057,63235369.4,58.844101683827795,67.58043702676079,NaN,NaN,23.317878374238337,21.90045395257235
2003-11-03T09:30:00-05:00,22.123457,22.358892,22.082864,22.293958,2653794,3228985.25,69.73228361845497,62.26516417278912,NaN,NaN,158.16333532386238,100.56990756306303,0.011217335413315904,0.2319993777225946,0.2207820423092787,69852851,65428142.6,62.904051889256145,66.68303892200026,NaN,NaN,25.716604944860787,22.445618380042127
2003-11-04T09:30:00-05:00,22.237119,22.285831,22.147814,22.180297,1507608,3262499.35,65.10127987034721,61.964810699239706,NaN,NaN,131.41812189404507,115.6641383606083,0.01244706232274867,0.23634087021271455,0.22389380788996588,68345243,66888438.6,65.35514196699023,65.86204484731402,NaN,NaN,26.423041434546718,23.013821673542783
2003-11-05T09:30:00-05:00,22.155924,22.188407,21.936727,22.131568,2739601,3344218.1,63.1645226974724,61.498896043891875,NaN,NaN,77.61230264825612,115.7945563273905,0.007414367701920138,0.23316176751736606,0.22574739981544592,65605642,67354856.4,66.12503528769713,64.92822777728703,NaN,NaN,26.458388282944867,23.50590261774308
2003-11-06T09:30:00-05:00,22.164051,22.237119,21.961083,22.237119,2705236,3342056.45,65.55493178946901,61.68485805059856,NaN,NaN,90.64145381185571,112.87228752916353,0.008549221087370162,0.23643392617465864,0.22788470508728847,68310878,67862734.2,66.98536913361201,63.957411016902846,NaN,NaN,27.172318007430302,24.029676244841255
2003-11-07T09:30:00-05:00,22.24523,22.310188,22.001685,22.001685,3149149,3361622.4,56.71418171882578,61.227910214137424,NaN,NaN,68.31238918178046,105.22952057195994,-0.00829006831288051,0.21752211969618784,0.22581218800906835,65161729,67455268.6,65.54704204950595,62.794669375091,NaN,NaN,25.100400560275194,24.18263686133182
2003-11-10T09:30:00-05:00,22.066618,22.066618,21.92049,22.026033,3743456,3452899.35,57.35470317174098,60.837581170627246,NaN,NaN,25.250405288641325,78.64693456491572,-0.018914883733756327,0.20216858334187293,0.22108346707562926,68905185,67265735.4,64.84951116902363,61.58192328444307,NaN,NaN,23.607106306595046,24.100418210655135
2003-11-11T09:30:00-05:00,21.879896,22.034152,21.879896,21.952957,1074679,3338250.45,54.73674229524995,60.97493390504,NaN,NaN,6.7265616013781635,53.70862250638235,-0.03126187811134523,0.18200611943644773,0.21326799754779296,67830506,67162788,64.44833345107917,60.824607736674444,NaN,NaN,21.584887179387593,23.741056634759772
2003-11-12T09:30:00-05:00,22.042262,22.131568,21.977329,22.123457,1363765,3296525.8,59.39388797776707,61.19165859015352,NaN,NaN,56.17837631053065,49.421837238837256,-0.02842534762124066,0.17773631302124215,0.2061616606424828,69194271,67880513.8,66.026310453281,60.846675294388874,NaN,NaN,21.169903835160987,23.373749091959947
2003-11-13T09:30:00-05:00,22.123457,22.123457,21.977329,22.050389,1315235,2973204.4,56.70139085572142,61.26967189995969,NaN,NaN,44.57760677493255,40.20906783145263,-0.03169992713691844,0.16653675172133475,0.1982366788582532,67879036,67794145.4,65.64869669125265,61.29101403465679,NaN,NaN,20.027055627161587,22.895650025560183
2003-11-14T09:30:00-05:00,22.082864,22.090991,21.717522,21.766235,2112160,2888233.9,47.65398709144431,60.701442083746066,NaN,NaN,-33.23894054009751,19.89880188707703,-0.052031937981577736,0.13319675638128103,0.18522869436285877,65766876,67915174.8,65.9426392451175,62.20958894948621,NaN,NaN,16.027841737821795,21.91453455588327
2003-11-17T09:30:00-05:00,21.547022,21.73376,21.530792,21.709412,5485974,3079773.05,46.07087456586432,59.5480714191439,NaN,NaN,-104.98891924041813,-6.149063018734864,-0.06736305407538024,0.10102487676863348,0.1683879308440137,60280902,66190318.2,58.28768111077486,62.80167732777744,NaN,NaN,12.293647983244107,20.54012218836339
2003-11-18T09:30:00-05:00,21.782472,21.806828,21.457716,21.457716,3697266,3093968.65,39.76869566105037,57.89458425951115,NaN,NaN,-120.24571009691753,-31.543517358394002,-0.09103882935843136,0.054589394145974524,0.14562822350440588,56583636,63940944.2,50.117054036632666,62.60645186451784,NaN,NaN,6.845267489160253,18.583714374191516
2003-11-19T09:30:00-05:00,21.514555,21.628217,21.3603,21.620098,932661,2618461.55,44.99629694230861,56.5627089991736,NaN,NaN,-132.21440522678137,-69.2220736658564,-0.09207076559002544,0.030539766516874067,0.12261053210689951,57516297,61605349.4,43.325857623537104,61.74334469939913,NaN,NaN,3.9797900783491347,16.497439474785462
2003-11-20T09:30:00-05:00,21.530792,21.693166,21.400893,21.43336,2343109,2590292.05,40.62915345442425,54.82663797929577,NaN,NaN,-134.53893031733412,-105.04538108430975,-0.10092606127901911,-0.0035470444918743738,0.09737901678714474,55173188,59064179.8,37.389367966631596,60.2108637195994,NaN,NaN,0.08713926354409016,14.153110873179552
2003-11-21T09:30:00-05:00,21.514555,21.587623,21.449605,21.555148,1747324,2624546.3,44.41803528323828,53.01847738392315,NaN,NaN,-123.92095270660921,-123.18178351761208,-0.09430123842364294,-0.02049753124240894,0.073803707181234,56920512,57294907,33.90595938248491,58.13957139768718,NaN,NaN,-1.8624977660062543,11.865166781867293
2003-11-24T09:30:00-05:00,21.758116,21.798718,21.676929,21.758116,1653466,2326727.75,50.12999325155956,51.949099768295454,NaN,NaN,-54.257448332955214,-113.03548933611951,-0.07292541177920644,-0.017353057542774053,0.055572354236432385,58573978,56953522.2,33.26202874136848,55.84720616728562,NaN,NaN,-1.6127110387701058,9.93975566463338
2003-11-25T09:30:00-05:00,21.758116,21.92049,21.717522,21.879896,3934989,2415738.3,53.23528548459337,51.239868538804096,NaN,NaN,-22.88388398099567,-93.56312411293513,-0.04843951461408588,-0.004977039031174968,0.043462475582910914,62508967,58138588.4,37.686185487998365,53.81585975302143,NaN,NaN,-0.3847464399170605,8.464826792554746
2003-11-26T09:30:00-05:00,22.042262,22.042262,21.814947,22.009796,1164348,2362466.2,56.35701561100159,50.58287452605642,NaN,NaN,15.130372980261178,-64.09416847152661,-0.022659273806790184,0.015138383324423188,0.03779765713121337,63673315,59369992,41.989532436393496,52.03044284607726,NaN,NaN,1.6487509136204448,7.491101666992703
2003-11-28T09:30:00-05:00,22.050389,22.082864,21.952957,21.977329,1085395,2291839.15,55.36227760775308,50.486309946694085,NaN,NaN,32.01518776116577,-30.78334485582664,-0.007729443855707938,0.028135852311578446,0.035865296167286384,62587920,60852938.4,46.758073274168595,50.688373647838866,NaN,NaN,2.971270295234733,6.845411471027279
2003-12-01T09:30:00-05:00,22.099101,22.24523,22.066618,22.229001,1461687,2293545.1,61.09480044144464,50.75345975167293,NaN,NaN,86.64580291662661,11.33000626882052,0.01776761656721898,0.05807481687631011,0.04030720030909113,64049607,62278757.4,50.93427073996486,49.6944279029061,NaN,NaN,6.019866948513989,6.727476539239666
2003-12-02T09:30:00-05:00,22.164051,22.285831,22.115347,22.164051,4230357,2372373.25,58.98934395178984,51.057217012854345,NaN,NaN,91.21267981475276,40.42403189836212,0.028304841943909274,0.07568825273897772,0.04738341079506845,59819250,62527811.8,51.647712929162225,48.78009786562632,NaN,NaN,7.841321928616088,6.886597309150583
2003-12-03T09:30:00-05:00,22.318314,22.318314,22.115347,22.123457,1877517,2390868.7,57.65205821602633,50.932800601301444,NaN,NaN,90.97562435820073,63.195933566201404,0.03040298432726917,0.08538714120415491,0.054984156876885744,57941733,61614365,48.84258364646788,47.55268880799681,NaN,NaN,8.927804943767198,7.1781983998101
2003-12-04T09:30:00-05:00,22.155924,22.237119,22.090991,22.180297,857772,2296777.25,59.05184500299542,51.10069018324959,NaN,NaN,82.87473025372239,76.74480502089366,0.03325040059710184,0.09654715762326305,0.06329675702616121,58799505,60639603,45.97308857200942,46.14728822805086,NaN,NaN,10.236594433043889,7.6151121188434985
2003-12-05T09:30:00-05:00,22.147814,22.147814,21.969202,22.001685,1218668,2222448.85,53.11091280934694,51.490470591671205,NaN,NaN,43.401100062356996,79.0219874811319,0.021316399987112003,0.08994225701005121,0.0686258570229392,57580837,59638186.4,43.16725342627252,44.52047495527622,NaN,NaN,9.63267016282453,7.903334696555074
2003-12-08T09:30:00-05:00,21.936727,22.237119,21.936727,22.204653,1123209,2121151.85,58.25098248713943,52.36047830033372,NaN,NaN,71.3719224901531,75.9672113958372,0.025046253444564223,0.09993367382864449,0.07488742038408026,58704046,58569074.2,40.33681777968486,43.23827043162694,NaN,NaN,10.69392281761649,8.30199014242099
2003-12-09T09:30:00-05:00,22.188407,22.237119,21.969202,22.009796,4363013,2152129.7,52.321086141371325,53.25707762035664,NaN,NaN,51.74507593217468,68.07369061932158,0.012953034504479613,0.09107871351467978,0.07812567901020016,54341033,57473430.8,37.61481582513624,42.34525341652005,NaN,NaN,9.726821557502484,8.505537487432633
2003-12-10T09:30:00-05:00,22.123457,22.123457,21.814947,21.888023,1097959,2153293.7,48.966329113449625,53.5406513468667,NaN,NaN,9.786307541619184,51.83582725600528,-0.003789305593907319,0.07338904701781601,0.07717835261172333,53243074,56533699,35.407801551936956,41.77967798283432,NaN,NaN,7.860705101215651,8.413418575115921
2003-12-11T09:30:00-05:00,22.001685,22.204653,21.928601,22.139695,3172182,2243714.55,55.33976861253695,54.59140957244619,NaN,NaN,57.89995392718384,46.84087199069755,0.0012730604258234107,0.0787696781440026,0.07749661771817919,56415256,56056849.2,34.30778002612347,41.559564558512314,NaN,NaN,8.310594698346032,8.39872944986308
2003-12-12T09:30:00-05:00,22.164051,22.269586,22.115347,22.204653,4802123,2418058.95,56.83807387184495,55.4785551859181,NaN,NaN,87.33046142544613,55.62674426331538,0.0078182633768418,0.08726944693923144,0.07945118356238964,61217379,56784157.6,37.497281521408766,41.81608756843544,NaN,NaN,9.14574119152649,8.505445412957853
2003-12-15T09:30:00-05:00,22.651165,22.651165,22.090991,22.147814,3041373,2464519.6,55.09626708892695,55.83328903144434,NaN,NaN,107.3757126094229,62.82750228716934,0.00715915003123177,0.08840012110142936,0.08124097107019759,58176006,56678549.6,37.21473710779111,42.098423880322784,NaN,NaN,9.297836416868883,8.618644127802286
2003-12-16T09:30:00-05:00,22.082864,22.342662,22.082864,22.342662,3181543,2349298.05,59.660099187653664,56.29220429594864,NaN,NaN,88.38317381077125,70.15512186288865,0.018064821814613358,0.10382199833846428,0.08575717652385093,61357549,58081852.8,43.325736080673245,42.5012489226567,NaN,NaN,10.85855196651771,8.93863096190449
2003-12-17T09:30:00-05:00,22.326425,22.326425,22.139695,22.261475,1644351,2246652.3,57.05791327243816,56.34226841462267,NaN,NaN,79.84820366761899,84.16750108808861,0.01799030131910924,0.10824505317273747,0.09025475185362823,59713198,59375877.6,48.320852368508675,42.95348606066493,NaN,NaN,11.35723445128688,9.284145746101974
2003-12-18T09:30:00-05:00,22.285831,22.48068,22.212763,22.456324,3727690,2386403.75,61.4084509390939,56.774137938289876,NaN,NaN,123.19856146680972,97.22722259601379,0.028612484626191176,0.1260203576363672,0.09740787301017603,63440888,60781004,53.14955955228319,43.41002079481597,NaN,NaN,13.157274268248873,9.837449820694388
2003-12-19T09:30:00-05:00,22.367018,22.431968,22.293958,22.391375,1825538,2360525.2,59.2535221172455,56.64261805798994,NaN,NaN,117.45161280230988,103.25145287138655,0.02873740718118871,0.13332963198666192,0.10459222480547321,61615350,60860598.2,53.415088281445726,43.58722204777889,NaN,NaN,13.981084017467154,10.429397563090498
2003-12-22T09:30:00-05:00,22.24523,22.529392,22.24523,22.513155,1724044,2359361.2,61.94971458269937,56.854073103054915,NaN,NaN,139.05002402842828,109.58631515518762,0.034127411598816285,0.14725148930399357,0.11312407770517728,63339394,61893275.8,56.83341484974241,43.95762932782033,NaN,NaN,15.495585909423504,11.153138755423784
2003-12-23T09:30:00-05:00,22.529392,22.618698,22.488799,22.54563,1846231,2368999.45,62.65929432895986,57.2117328254073,NaN,NaN,185.82985669574205,129.07565173218177,0.036757894646691464,0.15907144601354162,0.12231355136685015,65185625,62658891,59.222436159680775,44.6990473644784,NaN,NaN,16.93899256496694,11.979689299644235
2003-12-24T09:30:00-05:00,22.610588,22.610588,22.488799,22.54563,978235,2221161.75,62.65929432895987,57.46940777726191,NaN,NaN,161.85612414467,145.47723582759198,0.03536461158304355,0.1665193158456546,0.13115470426261105,65185625,63753376.4,62.42403274269842,45.8741148052419,NaN,NaN,18.11727995847691,12.85648796519176
2003-12-26T09:30:00-05:00,22.586232,22.594342,22.537503,22.537503,115166,2168702.65,62.321979836851284,58.12734113636936,NaN,NaN,143.60022643301093,149.55756882083222,0.030923098817312894,0.16980857778425218,0.13888547896693929,65070459,64079290.6,63.34688921977966,47.315517361920975,NaN,NaN,19.010846214610392,13.735682000822994
2003-12-29T09:30:00-05:00,22.529392,22.846022,22.529392,22.846022,2196410,2224253.4,69.11846943137377,58.90359020381466,NaN,NaN,186.61272034641541,163.38979032965332,0.04494097414667653,0.19506169665028494,0.15012072250360842,67266869,65209594.4,66.42650890567,49.17906672806277,NaN,NaN,21.922930788498523,14.905288970490925
2003-12-30T09:30:00-05:00,22.894734,22.894734,22.756716,22.894734,4979122,2400125.15,70.03746592112287,60.169045902368346,NaN,NaN,184.93734053463783,172.56725363089524,0.05311129077388435,0.21650983597096385,0.1633985451970795,72245991,66990913.8,70.61656726751488,51.53633468823268,NaN,NaN,24.60211241187076,16.290549462116616
2003-12-31T09:30:00-05:00,22.894734,22.975921,22.79731,22.837903,2225725,2299893.55,67.51318518061598,61.49382133573737,NaN,NaN,159.8619973965043,167.37368177104767,0.050331610326918436,0.22631305810572755,0.1759814477788091,70020266,67957842,72.61450211636873,54.19395615712067,NaN,NaN,26.14358763354277,17.698126343748925
2004-01-02T09:30:00-05:00,22.878488,23.081456,22.716123,22.805428,2713611,2341698.25,66.04825435222136,62.258713174286264,NaN,NaN,136.857156382005,162.37388821851468,0.0422740263917637,0.22882398076851374,0.18654995437675004,67306655,68382048,73.4668841899977,56.99103502596882,NaN,NaN,27.03229547607072,19.031579076937753
2004-01-05T09:30:00-05:00,22.894734,23.024633,22.829784,22.992167,2382524,2417935.85,70.0699280752342,63.20384561738549,NaN,NaN,136.37102749148065,160.92804843020863,0.04522412096342049,0.24308010558102566,0.19785598461760517,69689179,69305792,75.27183380985304,59.68921733228627,NaN,NaN,29.01647667978791,20.45799302020206
2004-01-06T09:30:00-05:00,22.959684,23.024633,22.73236,22.98404,1533496,2433677.25,69.68306977992532,64.24576009531394,NaN,NaN,112.1261016137416,146.0307246836739,0.042379998539663205,0.2508309827921842,0.20845098425252098,68155683,69483554.8,75.61559975000164,62.43213609244416,NaN,NaN,30.533298392899937,21.8973223591589
2004-01-07T09:30:00-05:00,23.016523,23.024633,22.870378,23.000277,6827076,2718870.6,70.03897723971592,64.98710852760411,NaN,NaN,111.045957648679,131.2524481064821,0.03751152772494873,0.2553403939087069,0.21782886618375816,74982759,70030908.4,76.69013927024207,64.81530774884193,NaN,NaN,31.89499270502657,23.32556097999714
2004-01-08T09:30:00-05:00,23.081456,23.178889,22.959684,23.081456,1369307,2569185.3,71.82017734537473,66.04155596138528,NaN,NaN,123.82268466953926,124.0445855610891,0.03568839820596301,0.2624393639412119,0.22675096573524892,76352066,71297268.4,78.99625424544922,67.00640788290912,NaN,NaN,33.57074793219864,24.789159116025925
2004-01-09T09:30:00-05:00,22.878488,23.211363,22.772954,23.000277,7664649,2897519.8,67.4986632563633,66.47657112690453,NaN,NaN,93.7050932383322,115.41417293235455,0.02542695173439727,0.2585346554032455,0.23310770366884823,68687417,71573420.8,79.47316765473272,68.88666560451266,NaN,NaN,33.86325743627465,26.085458876061455
2004-01-12T09:30:00-05:00,23.097701,23.097701,22.98404,23.097701,868119,2782316.65,69.84382428291272,67.23302128159504,NaN,NaN,98.8414631349436,107.90826006104714,0.02175452669907668,0.2603008620426941,0.2385463353436174,69555536,71546692.2,79.2855175894742,70.73455341222896,NaN,NaN,34.76656196123559,27.32561645965776
2004-01-13T09:30:00-05:00,22.975921,23.138295,22.813555,22.98404,2654612,2674941.1,64.03830009127921,67.38220596077932,NaN,NaN,72.25995753296662,99.93503124489214,0.008883952704394321,0.24965127622411032,0.240767323519716,66900924,71295740.4,77.43678416975797,72.20622264937295,NaN,NaN,33.907934242426045,28.2659475714818
2004-01-14T09:30:00-05:00,23.178889,23.195134,23.000277,23.162651,2688730,2657308.95,68.47311862098911,67.7974791244957,NaN,NaN,100.26956043653648,97.77975180246364,0.009554721810223904,0.25271072578249587,0.24315600397227197,69589654,70217119.4,69.89318666820303,72.96841911426739,NaN,NaN,34.45180862238012,29.149642007324417
2004-01-15T09:30:00-05:00,23.54423,23.54423,23.21949,23.3575,10522375,3024350.55,72.46273475310124,68.49772486907722,NaN,NaN,154.4544545474558,103.90610577804694,0.019692273688467515,0.26777134608285635,0.24807907239438884,80112029,70969112,71.94514530235317,73.64849858281416,NaN,NaN,36.2093548679472,30.158172415984815
2004-01-16T09:30:00-05:00,23.625425,23.625425,23.381856,23.430568,1944523,3039359.15,73.80160504717011,69.3176980983857,NaN,NaN,173.77114120992215,119.91931537236492,0.027415332792978864,0.2823482383856124,0.25493290559263354,82056552,73642939,77.75155731930249,74.67740344706579,NaN,NaN,38.07277550016303,31.288829999438846
2004-01-20T09:30:00-05:00,23.779664,23.787791,23.341263,23.398102,4651853,3085567.3,72.12364501230306,69.53235349702351,NaN,NaN,166.01985394957168,133.35499353529053,0.026422760661084843,0.28796135641898957,0.2615385957579047,77404699,75212771.6,80.32607332908367,75.67022947730962,NaN,NaN,39.0856418563551,32.402660264712594
2004-01-21T09:30:00-05:00,23.446806,23.787791,23.3575,23.747198,4062719,3197426.35,77.93333839694253,70.09634438815348,NaN,NaN,178.11415579564093,154.5258331878254,0.04430960461662348,0.3169256015286841,0.2726159969120606,81467418,78126070.4,84.02138782234282,76.62771665979733,NaN,NaN,42.053437415242854,33.781342714788344
2004-01-22T09:30:00-05:00,23.787791,23.917698,23.747198,23.747198,2897754,3256111.85,77.93333839694253,70.84064104646252,NaN,NaN,187.12645246286667,171.8972115930914,0.050712561184012295,0.336006698392076,0.2852941372080637,81467418,80501623.2,86.28374087185065,77.60409085661747,NaN,NaN,44.34333182077301,35.290198301357584
2004-01-23T09:30:00-05:00,23.909572,23.909572,23.568586,23.633536,5283236,3427962.1,72.24767810081264,71.28345702850476,NaN,NaN,137.79859945791904,168.56604057518408,0.04221275856285611,0.3380600854116338,0.2958473268487777,76184182,79716053.8,82.14192531266855,78.22373665109396,NaN,NaN,44.47392206855661,36.602158839528876
2004-01-26T09:30:00-05:00,23.649773,23.982632,23.584824,23.958276,2829270,3520513.85,77.33528039481882,71.80241076561795,NaN,NaN,141.4641609126914,162.10464451573793,0.05269934893286593,0.3617215130148601,0.3090221640819942,79013452,79107433.8,78.97878412106496,78.48851881618053,NaN,NaN,46.35816262726189,37.995873666347876
2004-01-27T09:30:00-05:00,23.852741,23.974521,23.747198,23.79591,1515636,3590537.35,70.38739404983718,71.85271964204023,NaN,NaN,121.35854127697797,153.1723819812192,0.04333043877894671,0.3631852125556776,0.3198547737767309,77497816,79126057.2,79.00542559263889,78.73064923351176,NaN,NaN,45.48260992574752,39.06540741769068
2004-01-28T09:30:00-05:00,23.787791,23.958276,23.300669,23.373729,4769359,3719184.8,56.23916242688683,70.867018583981,NaN,NaN,55.5476329767243,128.65907741743587,0.005328074153645557,0.3265148664687878,0.32118679231514224,72728457,77378265,70.03467093918945,78.25525863843656,NaN,NaN,39.184272124007045,39.08238809002159
2004-01-29T09:30:00-05:00,23.422458,23.584824,23.276313,23.568586,9110323,3925744.85,60.214167900606604,70.0380179093547,NaN,NaN,36.780631599274535,98.58991324471745,-0.009263258374562544,0.3096077193469391,0.31887097772150164,81838780,77452537.4,70.18957491879164,77.62621011510387,NaN,NaN,35.67750367947242,38.595976031371706
2004-01-30T09:30:00-05:00,23.536119,23.698485,23.438687,23.584824,6241637,4126540.45,60.535871434148554,69.54067563633937,NaN,NaN,51.53780508931679,81.33775437099699,-0.019794042223059527,0.2941284249426772,0.31392246716573674,88080417,79831784.4,74.70126347236818,77.28535981636355,NaN,NaN,33.17071927246313,37.82093935152762
2004-02-02T09:30:00-05:00,23.601069,23.901453,23.592942,23.722841,1323610,4057040.4,63.255470048253414,69.07007890529228,NaN,NaN,80.7025742313563,69.18543703472999,-0.019410945826181858,0.28965878488300945,0.3090697307091913,89404027,81909899.4,77.85395736302202,77.18310551447412,NaN,NaN,32.0492714085175,36.99641535966903
2004-02-03T09:30:00-05:00,23.666002,23.779664,23.633536,23.747198,2216734,4048750.9,63.73049866667112,69.04809308924884,NaN,NaN,70.70657963773603,59.05504470688161,-0.019416597472204977,0.2847989838689351,0.3042155813411401,91620761,84734488.4,81.27045130872548,77.45693888154322,NaN,NaN,31.32289805162676,36.18591288709156
2004-02-04T09:30:00-05:00,23.576697,23.714731,23.536119,23.552341,2573195,4100735.85,57.34361447271596,68.25312850722933,NaN,NaN,38.44753735985979,55.63502558350871,-0.03361108359450804,0.262201726848005,0.29581281044251306,89047566,87998310.2,84.28693679432169,78.4850638905517,NaN,NaN,28.62845286193326,35.10627574064038
2004-02-05T09:30:00-05:00,23.666002,23.666002,23.463035,23.54423,5517508,4035257.45,57.0871523822547,67.15487262359743,NaN,NaN,22.307275938232642,52.74035445130032,-0.04396045795970471,0.2408622379928822,0.2848226959525869,83530058,88336565.8,84.56439703971265,79.3864390146488,NaN,NaN,26.425697575464575,33.86619314561526
2004-02-06T09:30:00-05:00,23.592942,23.950165,23.576697,23.942054,4892901,4211437.15,65.28739317299727,66.5467146325851,NaN,NaN,94.10341840122446,61.25347711368185,-0.02535124132418687,0.2531336442973533,0.27848488562154017,88422959,88405074.2,84.62361829013116,79.87730051256514,NaN,NaN,27.105777218752923,32.900419441777785
2004-02-09T09:30:00-05:00,23.86897,23.966402,23.844622,23.844622,1442718,3900340.6,62.15476382506784,65.83465169063972,NaN,NaN,109.08764585154012,66.93049143771862,-0.021115167061537155,0.25209092679461875,0.2732060938561559,86980241,87920317,82.21983290301029,80.0125690535599,NaN,NaN,26.62698527656755,32.004214561033464
2004-02-10T09:30:00-05:00,23.812147,23.958276,23.79591,23.917698,5066082,4110238.75,63.56676560741261,64.808467919959,NaN,NaN,104.08695232922453,73.60656597601631,-0.015180414037674783,0.25423057630906243,0.2694109903467372,92046323,88005429.4,82.31482048329244,79.89067138648487,NaN,NaN,26.68540124276746,31.244384086995463
2004-02-11T09:30:00-05:00,23.950165,24.331744,23.828393,24.283032,8248486,4389932.45,69.66107176512813,64.21759173197228,NaN,NaN,183.13015366063178,102.54308923617073,0.010193750390909528,0.2821531783353741,0.2719594279444646,100294809,90254878,84.64900618106712,79.77390462285747,NaN,NaN,28.83527409279071,30.900225516394784
2004-02-12T09:30:00-05:00,24.3561,24.3561,24.16937,24.242438,2117210,4361356.45,68.29407956939033,63.93519183687068,NaN,NaN,204.43770618327056,138.9691752851783,0.020493395398527514,0.297576172192624,0.2770827767940965,98177599,93184386.2,87.04677434608152,80.12425098238695,NaN,NaN,30.07679510853139,30.782592600985726
2004-02-13T09:30:00-05:00,24.3561,24.380456,24.153132,24.193726,4071710,4038823.2,66.60503260485966,63.168745566159316,NaN,NaN,171.6970966842466,154.48791094178273,0.020239918876026164,0.3023826753891292,0.28214275651310305,94105889,94320972.2,87.84034262328477,80.75721944683123,NaN,NaN,30.556602036687508,30.75030823465741
2004-02-17T09:30:00-05:00,24.3561,24.485999,24.29115,24.372337,3371845,4110189.3,69.57621203165542,63.11080399343205,NaN,NaN,188.46651926426364,170.36368562432745,0.02784632980733487,0.3169506687722716,0.28910433896493676,97477734,96420470.8,89.16128028735162,81.48263763931072,NaN,NaN,31.897699815851748,30.914221317685172
2004-02-18T09:30:00-05:00,24.42105,24.429168,24.218082,24.242438,2639092,4009551.25,65.0437349573669,63.73970203132348,NaN,NaN,138.0628469353438,177.1588645455513,0.02022857041059417,0.3143900519781795,0.2941614815675853,94838642,96978934.6,89.48839066212591,82.87218904809188,NaN,NaN,31.62621683102404,31.01593496244787
2004-02-19T09:30:00-05:00,24.437295,24.437295,24.193726,24.234328,2058827,3909356.65,64.76008548588591,64.064410430272,NaN,NaN,115.94820450153617,163.72247471373217,0.011194115983661435,0.3081541265471621,0.2969600105635007,92779815,95475935.8,82.29036163067633,83.73653095608366,NaN,NaN,31.326246390763263,31.060265166492925
2004-02-20T09:30:00-05:00,24.234328,24.29115,24.047589,24.16937,2357520,3882344.95,62.41237942406962,64.19844671526637,NaN,NaN,72.3674507646987,137.30842363001778,-0.0019081146198360321,0.29457486728870563,0.29648298190854167,90422295,93924875,75.53783506751492,83.7962860700227,NaN,NaN,30.407274146670403,30.96698073508971
2004-02-23T09:30:00-05:00,24.3561,24.3561,24.10442,24.16937,1799056,3708135.95,62.41237942406963,64.1382259563961,NaN,NaN,73.26786906787342,117.62257810674316,-0.012723291160780859,0.2805788679575656,0.29330215911834645,90422295,93188156.2,72.49496916407836,83.41350119866958,NaN,NaN,29.654133267860576,30.77943109691412
2004-02-24T09:30:00-05:00,24.153132,24.185599,23.909572,24.071937,3774372,3755391.05,58.709917710136764,63.779613030929355,NaN,NaN,30.544516145202103,86.03817748293083,-0.027726984581945224,0.2586434283909149,0.28637041297286014,86647923,91022194,64.29471422659822,82.2009485499462,NaN,NaN,27.98729844942502,30.380555004415676
2004-02-25T09:30:00-05:00,23.958276,24.193726,23.958276,24.177489,3570522,3858135.35,61.38260348945177,64.0681122464105,NaN,NaN,40.21537847722974,66.46868379130802,-0.031552216940524846,0.24693014179720407,0.2784823587377289,90218445,90098154.6,61.118453524497426,80.5460568878159,NaN,NaN,27.255743306655404,29.934153333307066
2004-02-26T09:30:00-05:00,24.153132,24.209972,24.03136,24.201845,779927,3658663.75,61.9939384101696,64.41859696269013,NaN,NaN,44.34169667131093,52.14738222526298,-0.03328030661329762,0.2368819754711069,0.2701622820844045,90998372,89741866,59.88990970917273,78.78359350706306,NaN,NaN,26.804268711024044,29.487026958695207
2004-02-27T09:30:00-05:00,24.274905,24.347989,24.161243,24.258676,933893,3249842.25,63.44796320082816,64.28720910753518,NaN,NaN,67.57985647328483,51.18986336698022,-0.03145502737966249,0.23084349785982639,0.2622985252394889,91932265,90043860,60.61260728447558,77.06852129237336,NaN,NaN,26.79744650812007,29.102801180041617
2004-03-01T09:30:00-05:00,24.283032,24.494118,24.283032,24.429168,1466367,3011078.75,67.46884920771458,64.66678663486708,NaN,NaN,103.9355465195176,57.32339885730905,-0.020172977651974233,0.23708230317452106,0.2572552808264953,93398632,90639127.4,62.06357525262149,75.62878860305989,NaN,NaN,27.91734520629372,28.93345032664906
2004-03-02T09:30:00-05:00,24.437295,24.477872,24.307388,24.307388,2630593,3076427.9,62.205126485379346,64.569526697579,NaN,NaN,86.98520393252386,68.6115364147734,-0.022161169018804217,0.22955381955299003,0.25171498857179425,90768039,91463150.6,64.03849940477177,74.32333709745127,NaN,NaN,27.406748804917598,28.71535010925885
2004-03-03T09:30:00-05:00,24.307388,24.518474,24.274905,24.453524,1878502,3059516.3,65.66668276516569,64.28421319758168,NaN,NaN,99.18323873032128,80.40510846539169,-0.015214383133294485,0.23269700965517615,0.24791139278847063,92646541,91948769.8,65.18865326193944,72.93331188894214,NaN,NaN,27.97176911322759,28.609124252682957
2004-03-04T09:30:00-05:00,24.485999,24.559067,24.453524,24.518474,1432372,3002475.15,67.10855912923587,64.19953316614206,NaN,NaN,129.55637314938866,97.44804376100724,-0.008177912798419312,0.2376890017904465,0.2458669145888658,94078913,92564878,66.64615751678576,71.47612497256388,NaN,NaN,28.8643626406533,28.645586879535863
2004-03-05T09:30:00-05:00,24.461643,24.851341,24.461643,24.729568,3448212,2899010.35,71.32373973271409,64.53658367527453,NaN,NaN,189.02883705151157,121.7378398766526,0.007891114388130366,0.2557308075740288,0.2478396931858984,97527125,93683850,69.1707908069049,70.14258555710818,NaN,NaN,30.9811780292176,28.979242758061826
2004-03-08T09:30:00-05:00,24.802628,24.802628,24.575305,24.599661,1070245,2707877.55,65.74024685840354,64.2625861628994,NaN,NaN,164.45906982794352,133.8425445383378,0.0069993356362946235,0.2565888627312667,0.24958952709497206,96456880,94295499.6,70.48586614622405,68.8086274041705,NaN,NaN,31.06877817603808,29.27774781777272
2004-03-09T09:30:00-05:00,24.624017,24.624017,24.315506,24.437295,3394755,2805479.4,59.47349443158465,63.86471183962923,NaN,NaN,72.03248236239165,130.85200022431133,-0.0065638096281387115,0.24138476505979867,0.24794857468793738,93062125,94754316.8,71.46903122673278,67.5215303016424,NaN,NaN,29.161542584678717,29.261147070187864
2004-03-10T09:30:00-05:00,24.437295,24.437295,24.015115,24.047589,7625114,2933431,47.716279333610295,62.64729711446669,NaN,NaN,-69.43810384400214,97.12773170944665,-0.041851466893147976,0.1956342410715024,0.23748570796465038,85437011,93312410.8,64.22796519213804,66.2313591274611,NaN,NaN,23.1584879985935,28.389338631388668
2004-03-11T09:30:00-05:00,23.909572,24.128776,23.633536,23.657892,5818049,2811909.15,39.340972098286386,60.999339448339306,NaN,NaN,-212.99551619450577,28.61735384066777,-0.0888098277847593,0.12647342323370125,0.21528325101846055,79618962,90420420.6,52.69592393031547,64.59979404623257,NaN,NaN,14.606667049439695,26.4203855482531
2004-03-12T09:30:00-05:00,23.666002,24.023233,23.666002,24.007004,3147301,2863413.7,48.12536283213492,59.97883826320111,NaN,NaN,-148.15402232202644,-38.81921803403983,-0.09327004478810605,0.09869569503332798,0.19196573982143403,82766263,87468248.2,44.00921568821369,62.56509736938509,NaN,NaN,10.911930104902785,24.20489191348877
2004-03-15T09:30:00-05:00,23.950165,23.950165,23.576697,23.657892,5034180,2911537.2,41.63253692492999,58.75902534997205,NaN,NaN,-177.5360705089279,-107.21824610141411,-0.115205879785438,0.04795839008963654,0.16316426987507454,77732083,83723288.8,35.9200272772692,60.5383340158616,NaN,NaN,5.2976064722654455,21.50385113617115
2004-03-16T09:30:00-05:00,23.950165,23.958276,23.690358,23.877097,4396886,2962789.25,46.51214854616308,57.69684999688001,NaN,NaN,-121.17041891446864,-145.85882635678618,-0.11041394011296232,0.02514684473387163,0.13556078484683395,82128969,81536657.6,32.19858552384943,58.472629158672454,NaN,NaN,2.8274036452183426,18.835787208892178
2004-03-17T09:30:00-05:00,24.10442,24.218082,23.974521,24.153132,3329104,2997289.85,51.95876712671575,56.98005204806187,NaN,NaN,-31.33822539146537,-138.2388506662788,-0.08524233693771019,0.02900786367469621,0.1142502006124064,85458073,81540870,32.21315549637886,56.49571814347288,NaN,NaN,2.936211230123808,16.56441921192527
2004-03-18T09:30:00-05:00,24.153132,24.226201,23.958276,24.161243,3015507,3045123.85,52.113073444259676,56.17041706544984,NaN,NaN,-28.60704339740834,-101.36115610685934,-0.06552069176321103,0.03234933590839262,0.09787002767160365,88473580,83311793.6,38.22348508065632,54.89649512891436,NaN,NaN,3.0705379032131543,14.636721882109253
2004-03-19T09:30:00-05:00,24.03136,24.157192,23.747198,23.787791,5649919,3209743.8,44.95362802916368,54.56218698126764,NaN,NaN,-88.12619496506176,-89.35559063546641,-0.07444994025812803,0.004807602348943618,0.07925754260707164,82823661,83323273.2,38.26169878670951,53.196361095634934,NaN,NaN,0.6137656639907106,12.633442422378032
2004-03-22T09:30:00-05:00,23.463035,23.601069,23.341263,23.47928,5937036,3416642.8,40.05765753580772,52.98022491344109,NaN,NaN,-180.47766316304566,-89.94390916628996,-0.09655485850449372,-0.0414360305235455,0.055118827980948214,76886625,83154181.6,37.88990745476227,51.32860452777711,NaN,NaN,-3.1936365702315626,10.372431137719518
2004-03-23T09:30:00-05:00,23.706604,23.706604,23.463035,23.471162,7121213,3583984.85,39.93440826045311,51.142205305961625,NaN,NaN,-140.59560972882204,-93.82894732916063,-0.10636880741406018,-0.07784218128662701,0.028526626127433168,69765412,80681470.2,32.86121867777972,49.01950205747999,NaN,NaN,-6.105162619190307,8.018489172446685
2004-03-24T09:30:00-05:00,23.381856,23.495518,23.211363,23.29255,7132670,3762092.25,37.22089524085362,49.00737217107718,NaN,NaN,-157.84473996381107,-119.13025024362976,-0.11860264418697522,-0.11972667910628587,-0.0011240349193106444,62632742,76116404,26.00047957714618,46.116239347505726,NaN,NaN,-9.386321356260456,5.532087668345666
2004-03-25T09:30:00-05:00,23.54423,23.60918,23.333152,23.536119,5960684,4021130.1,42.91711377927414,46.97832746011719,NaN,NaN,-107.568152800793,-134.9224721243067,-0.10449897730737255,-0.13174775655352633,-0.027248779246153782,68593426,72140373.2,21.742659979027692,42.72851571694308,NaN,NaN,-10.276090774603535,3.2737764622100656
2004-03-26T09:30:00-05:00,23.503637,23.657892,23.438687,23.519874,1678717,4058371.3,42.63922995727144,45.32825482432203,NaN,NaN,-87.95760278563583,-134.8887536884215,-0.0909693591035081,-0.1409604781255389,-0.04999111902203081,66914709,68958582.8,19.053659885836012,39.05478669834393,NaN,NaN,-11.058500667735757,1.226308300789234
2004-03-29T09:30:00-05:00,23.706604,23.893326,23.641654,23.820266,3788660,4174485.95,49.19057357010316,44.59376047707336,NaN,NaN,-38.62484302227722,-106.51818966026784,-0.058094417242467236,-0.12260914057511485,-0.06451472333264761,70703369,67721931.6,18.115886150270043,35.24384776431088,NaN,NaN,-9.643014235459301,-0.32645206153198547
2004-03-30T09:30:00-05:00,23.86897,23.982632,23.812147,23.982632,2435488,4164730.7,52.357933438039204,44.92530719881829,NaN,NaN,-8.671979569803609,-80.13346362846413,-0.023493648007839166,-0.09388178334244657,-0.0703881353346074,73138857,68396620.6,20.41722116757147,32.114508905413274,NaN,NaN,-7.462042964536843,-1.3458221905326793
2004-03-31T09:30:00-05:00,23.990759,23.990759,23.79591,23.86897,2711887,4206399.95,50.007783306042995,45.68722228508661,NaN,NaN,-12.420030791792342,-51.04852179406039,-0.007186908440791853,-0.07937177088559721,-0.07218486244480536,70426970,69955466.2,25.618714290681183,30.180422502582246,NaN,NaN,-6.3822127007949705,-2.065306549141578
2004-04-01T09:30:00-05:00,24.071937,24.185599,23.925809,24.120666,3299419,4299752.3,54.84167221241872,46.1669586693926,NaN,NaN,36.76247591802663,-22.182396050296454,0.020131335946341256,-0.04702069251187879,-0.06715202845822005,73726389,70982058.8,28.913852381470207,29.102182266386283,NaN,NaN,-3.9200961417016185,-2.3302764909358693
2004-04-02T09:30:00-05:00,24.559067,24.559067,23.909572,24.03136,13609076,4807795.5,52.887615060875575,46.97089282196014,NaN,NaN,71.56336346075311,9.721797198981331,0.0311114763304539,-0.02826268304515267,-0.05937415937560657,60117313,69622579.6,27.195671633682025,28.479014006130058,NaN,NaN,-2.494030520032354,-2.3536699236639387
2004-04-05T09:30:00-04:00,23.974521,24.136895,23.950165,24.096293,3418527,4925209.6,54.16634999791026,47.51762149708494,NaN,NaN,58.01143519688343,29.049052842813456,0.04104787584619668,-0.00806431456786072,-0.0491121904140574,63535840,68189073.8,25.47651859099264,27.998866368068857,NaN,NaN,-0.9482940016796874,-2.1529019348090457
2004-04-06T09:30:00-04:00,24.063827,24.145022,24.023233,24.080064,1718132,4841378.45,53.77350182663893,47.64724540422231,NaN,NaN,75.74135499029204,45.93171975483258,0.04453607068157939,0.0065578979379168345,-0.03797817274366255,61817708,65924844,23.003052541184886,27.341001871269288,NaN,NaN,0.20734612349649773,-1.8157236407653967
2004-04-07T09:30:00-04:00,24.153132,24.153132,23.942054,24.015115,2322908,4576268.15,52.143599558854774,47.64942584097911,NaN,NaN,64.83094864592157,61.38191564237536,0.04058909551355239,0.01275819664827793,-0.027830898865274456,59494800,63738410,20.8935561299609,26.103149803362474,NaN,NaN,0.7457174684912575,-1.4498034823001604
2004-04-08T09:30:00-04:00,24.315506,24.315506,23.901453,23.974521,2652025,4417966.95,51.10104900808908,48.08852733947378,NaN,NaN,67.26795531125924,67.48301152102188,0.03365057523421555,0.014232320177494984,-0.019418255056720568,56842775,60361687.2,18.12852784187689,24.665066164445854,NaN,NaN,0.9266903093446388,-1.1103043692080463
2004-04-12T09:30:00-04:00,24.063827,24.193726,23.974521,24.120666,3343269,4427765.35,54.61890368750764,49.128616350309485,NaN,NaN,71.77180666136164,67.52470016114358,0.03704129138925225,0.026883359179844746,-0.010157932209407505,60186044,60375433.4,18.176000095799765,23.256929924519966,NaN,NaN,2.0366878051636355,-0.6607340585835204
2004-04-13T09:30:00-04:00,24.153132,24.185599,23.54423,23.60918,6387477,4495430.2,42.968034768852746,49.34530395805232,NaN,NaN,-26.904865109960095,50.54144009977488,0.004675527217220293,-0.00431352318788214,-0.008989050405102433,53798567,58427978.8,16.69872951421364,22.102466412836673,NaN,NaN,-0.511899434226736,-0.6394719693896941
2004-04-14T09:30:00-04:00,23.21949,23.60918,23.146406,23.325025,13824383,4966805.05,38.1050380982022,49.40845701929151,NaN,NaN,-132.47399924639055,8.89836925243836,-0.03390796240485338,-0.051374003411169156,-0.017466041006315776,39974184,54059274,13.95805912390297,21.2422935233193,NaN,NaN,-4.336916246577652,-1.1676782947022595
2004-04-15T09:30:00-04:00,23.341263,24.007004,22.975921,23.187007,13430105,5471855.1,35.975291589285646,48.91261257714948,NaN,NaN,-108.68288889501025,-25.804398255748005,-0.06496258655695017,-0.09866927420250349,-0.03370668764555332,26544079,47469129.8,11.019886006203038,20.47638109668897,NaN,NaN,-8.160562632768395,-2.16666177156885
2004-04-16T09:30:00-04:00,23.227601,23.527993,23.227601,23.438687,9033220,5772740.75,42.307596333221014,48.88892446114587,NaN,NaN,-94.42510350091084,-58.14301001818203,-0.06465265014768569,-0.11452250033016043,-0.04986985018247474,35577299,43216034.6,9.61343160075728,19.802079076326205,NaN,NaN,-9.389117316843897,-3.1984411351795714
2004-04-19T09:30:00-04:00,23.536119,23.536119,23.260067,23.398102,4933302,5736909.9,41.59320186946015,48.34625505395709,NaN,NaN,-83.41031555051342,-89.17943446055703,-0.06320457523788724,-0.1288755692298338,-0.06567099399194655,30643997,37307625.2,8.072132283869621,19.084668085869033,NaN,NaN,-10.585662660310268,-4.253758495912528
2004-04-20T09:30:00-04:00,23.503637,23.503637,22.951565,22.967794,8385578,5859337,34.87007686375513,47.097122441508226,NaN,NaN,-132.52755650822948,-110.30397274021092,-0.08584620302903322,-0.17297874777823807,-0.08713254474920486,22258419,30999595.6,6.815729923160475,18.113132996982536,NaN,NaN,-13.937996606262198,-5.637221083105338
2004-04-21T09:30:00-04:00,22.935328,23.048989,22.862259,22.959684,8804981,5943525.4,34.75605047534343,46.00771295360111,NaN,NaN,-150.83979985052676,-113.97713286103817,-0.0952605273456168,-0.20620820393122585,-0.11094767658560906,13453438,25695446.4,5.973762789096256,16.709922175440756,NaN,NaN,-16.583988068711953,-7.201044938191997
2004-04-22T09:30:00-04:00,22.894734,23.430568,22.894734,23.3575,7991427,5986463.25,44.36633434231511,45.25947453430799,NaN,NaN,-93.06682789195833,-110.85392066042778,-0.06976835264879439,-0.19815811739660205,-0.12838976474780767,21444865,24675603.6,5.824770507380947,15.060702041577235,NaN,NaN,-15.77378218066163,-8.42572168711623
2004-04-23T09:30:00-04:00,23.398102,23.398102,23.113939,23.235719,4555285,5916193.3,42.31168250372387,44.50405078022573,NaN,NaN,-82.97210467939469,-108.56332089612457,-0.05673425302135296,-0.19930758102449886,-0.1425733280031459,16889580,20938059.8,5.302785971930589,13.496924494309278,NaN,NaN,-15.776553428401538,-9.475840507299845
2004-04-26T09:30:00-04:00,23.260067,23.3575,23.113939,23.187007,1432864,5903900.65,41.48410714830207,43.598176290968006,NaN,NaN,-81.49887883100556,-108.18103355222297,-0.047399500818391366,-0.2018227040261351,-0.15442320320774375,15456716,17900603.6,4.917130935623234,12.028396804640035,NaN,NaN,-16.03020462396439,-10.412178238251922
2004-04-27T09:30:00-04:00,23.21949,23.471162,23.21949,23.243838,2972889,5863112.1,42.88760466801169,42.820612208208914,NaN,NaN,-58.46483851396884,-93.36848995337084,-0.03402923030564134,-0.19695974108979541,-0.16293051078415408,18429605,17134840.8,4.82192064484795,10.729744526330252,NaN,NaN,-15.825205662559416,-11.18546787029585
2004-04-28T09:30:00-04:00,23.187007,23.187007,22.854132,22.910971,8120632,6147369.3,37.25180821748309,41.75691282668237,NaN,NaN,-104.29007540911289,-84.05854506508807,-0.04362252322604532,-0.21745866481671072,-0.1738361415906654,10308973,16505947.8,4.740733946385944,9.575971513217755,NaN,NaN,-17.388736341177793,-12.071649080421842
2004-04-29T09:30:00-04:00,22.862259,23.187007,22.740471,22.837903,14615150,6742532.45,36.129463711559495,40.68751387693026,NaN,NaN,-104.17272419743996,-86.2797243261844,-0.05042684676462034,-0.2368697000464408,-0.18644285328182048,-4306177,11355739.4,4.127796904083738,8.57591930337539,NaN,NaN,-19.00075175521697,-13.061520891106861
2004-04-30T09:30:00-04:00,22.975921,23.008396,22.740471,22.829784,5471809,6851151.95,35.999674854052216,39.357568960254866,NaN,NaN,-107.21609167652274,-91.12852172561,-0.05086657801110256,-0.2500260757956987,-0.19915949778459613,-9777986,6022226.2,3.6076061186609536,7.535319733579759,NaN,NaN,-20.34061935639891,-14.101392100434296
2004-05-03T09:30:00-04:00,22.854132,22.992167,22.781072,22.98404,5362801,6438838.2,40.381745346268545,39.172834001498856,NaN,NaN,-93.7234879223482,-93.57344354387854,-0.03681572629005206,-0.2451791556471612,-0.20836342935710914,-4415185,2047846,3.2762728004135226,6.57657282545118,NaN,NaN,-20.249724059857996,-14.979725237494824
2004-05-04T09:30:00-04:00,23.138295,23.268194,22.902861,23.0571,8155617,6675692.7,42.3935713468898,39.47915780497654,NaN,NaN,-60.910647034764,-94.06260524803756,-0.01951685530341163,-0.23275949848637367,-0.21324264318296204,3740432,-889988.6,3.053057675909045,5.797644150594472,NaN,NaN,-19.608381090431635,-15.64096178791437
2004-05-05T09:30:00-04:00,23.138295,23.235719,23.016523,23.032752,5489550,6864263.6,41.886287150095356,39.901371773605796,NaN,NaN,-52.167407138044965,-83.63807159382398,-0.007260892303901395,-0.22231875856283878,-0.21505786625893739,-1749118,-3301606.8,2.8796195508846836,5.216196546643163,NaN,NaN,-19.210006773504563,-16.150825357284397
2004-05-06T09:30:00-04:00,22.935328,22.959684,22.66741,22.781072,5730107,7034623.55,36.96266516109679,39.51959097559693,NaN,NaN,-113.63015005626357,-85.5295567655887,-0.013299452274518508,-0.23168218160208554,-0.21838272932756703,-7479225,-3936216.4,2.8339957437148513,4.731951128282987,NaN,NaN,-20.243770373525688,-16.73553178817601
2004-05-07T09:30:00-04:00,22.54563,22.805428,22.293958,22.293958,11330757,7468560.15,29.68870818920142,38.66926999843559,NaN,NaN,-183.7906979144943,-100.84447801318301,-0.04548264924841186,-0.27523604088808185,-0.22975339163966998,-18809982,-5742615.6,2.7027301595853572,4.348422405119826,NaN,NaN,-23.632139886137125,-17.72076151645617
2004-05-10T09:30:00-04:00,22.042262,22.155924,21.774362,22.10722,13959502,7999371.8,27.45790326210839,38.13982902688939,NaN,NaN,-262.39588210673713,-134.5789568500608,-0.07309274307985919,-0.321119320489494,-0.2480265774096348,-32769484,-11413475.4,2.336803728270354,4.028499105484818,NaN,NaN,-27.188725230836823,-19.073327761367693
2004-05-11T09:30:00-04:00,22.204653,22.310188,22.115347,22.220882,4218778,7890936.85,30.863139319278545,37.861763944313324,NaN,NaN,-182.60758000092147,-158.91834344329226,-0.07705171835774627,-0.34434122535681766,-0.2672895069990714,-28550706,-17871703,2.0040330242468514,3.744946979424146,NaN,NaN,-29.019118873313772,-20.494155063074277
2004-05-12T09:30:00-04:00,22.147814,22.48068,21.944846,22.472553,10004925,7699963.95,37.82284004287094,37.39437149435303,NaN,NaN,-140.11894143962527,-176.50865030360836,-0.05699606628069959,-0.3385345898499459,-0.2815385235692463,-18545781,-21231035.6,1.8559789899683636,3.4614618710375327,NaN,NaN,-28.35100103703725,-21.616561630783274
2004-05-13T09:30:00-04:00,22.310188,22.772954,22.147814,22.513155,10670917,7562004.55,38.89160141153283,37.150079987767946,NaN,NaN,-88.83215068935549,-171.5490504302267,-0.03627988636064833,-0.3268883815200567,-0.2906084951594084,-7874864,-21310163.4,1.8525073388136661,3.2150133972434674,NaN,NaN,-27.489457482344836,-22.455546752434927
2004-05-14T09:30:00-04:00,22.488799,22.643054,22.367018,22.529392,6489465,7434816.8,39.34064725989009,36.99697571002424,NaN,NaN,-71.34962706106872,-149.06083625954162,-0.017707904947666664,-0.31274337634399174,-0.2950354713963251,-1385399,-17825246.8,9.850387104991214,3.567388837912609,NaN,NaN,-26.664010437058877,-23.05675585023835
2004-05-17T09:30:00-04:00,22.220882,22.391375,22.082864,22.237119,6919581,7534130.75,34.43538417114898,36.39324567453404,NaN,NaN,-111.04888165170175,-118.79143616853455,-0.021101467140368813,-0.3214123053217861,-0.3003108381814173,-8304980,-12932346,19.73947755474792,4.632928617191177,NaN,NaN,-27.405471404829722,-23.67800092946569
2004-05-18T09:30:00-04:00,22.488799,22.488799,22.293958,22.415731,3622993,7296001.5,39.407553517264176,36.54722748166126,NaN,NaN,-69.51975516811629,-96.17387120197351,-0.007985835245301554,-0.3102931322380442,-0.30230729699274267,-4681987,-8158602.2,28.034100021347513,6.296740479688432,NaN,NaN,-26.50394562035795,-24.08170731387887
2004-05-19T09:30:00-04:00,22.772954,22.821666,22.367018,22.431968,8270287,7269266.8,39.85409549537675,36.813272609076776,NaN,NaN,-38.17024390548799,-75.78413169514606,0.004445704742748857,-0.2967501660643066,-0.30119587080705545,3588300,-3731786,34.766675346817095,8.485231797026529,NaN,NaN,-25.64805045460797,-24.305470619697314
2004-05-20T09:30:00-04:00,22.40762,22.569986,22.40762,22.513155,2848116,7012101.25,42.149790181059224,37.25256656100585,NaN,NaN,-40.86158536425949,-66.19001863012687,0.01993161191279763,-0.2762813559160584,-0.29621296782885603,6436416,-869530,38.756175022607586,10.995843861594144,NaN,NaN,-24.27183498006217,-24.300665528320863
2004-05-21T09:30:00-04:00,22.73236,22.789199,22.54563,22.651165,3538867,6961280.35,45.92802581774786,37.648729451825794,NaN,NaN,-2.8710378954309013,-52.49430079699931,0.04010102335230542,-0.24608668863847427,-0.2861877119907797,9975283,1402606.4,41.79908658024196,13.747473417296177,NaN,NaN,-21.991206562413073,-23.970742818905464
2004-05-24T09:30:00-04:00,22.73236,22.789199,22.586232,22.683648,1588677,6969071,46.808579723697505,37.964087193026344,NaN,NaN,8.860292818142582,-28.51246590303042,0.05532276570381395,-0.21703425486101224,-0.2723570205648262,11563960,5376394.4,46.77945340748801,16.870787398123245,NaN,NaN,-19.85494778007613,-23.382772099072703
2004-05-25T09:30:00-04:00,22.618698,23.040871,22.488799,23.008396,3635680,7002210.55,54.74345576394626,38.88245637972999,NaN,NaN,56.59717871887461,-3.2890791256322345,0.0851710337784286,-0.16589322834179043,-0.25106426212021904,15199640,9352719.8,51.2727524017451,20.32743974461328,NaN,NaN,-15.425977040517852,-22.246087090707725
2004-05-26T09:30:00-04:00,22.975921,23.195134,22.951565,23.146406,5397045,6866031.2,57.63577720683608,40.35910724013994,NaN,NaN,117.15927930809532,27.776825517084422,0.11051092435870286,-0.11292560667184048,-0.22343653103054334,20596685,12754396.8,54.78934927371398,24.0385364253275,NaN,NaN,-10.783320551215315,-20.60854901363738
2004-05-27T09:30:00-04:00,23.341263,23.341263,23.0571,23.203245,6705381,6470542.75,58.80351644128576,42.438736401003105,NaN,NaN,132.52554835375264,62.45425226068685,0.12626467199049202,-0.0656056910424283,-0.19187036303292032,27302066,16927526.8,58.72479119532239,28.04011221359443,NaN,NaN,-6.6113242767914775,-18.60894547980225
2004-05-28T09:30:00-04:00,23.21949,23.260067,23.130184,23.21949,4515131,6422708.85,59.150090219632624,44.702464040826264,NaN,NaN,121.58280082865102,87.34502000550324,0.13230577648073266,-0.02648814243200448,-0.15879391891273714,31817197,21295909.6,62.4131420770316,32.33127923850595,NaN,NaN,-3.089138172710325,-16.39183015021769
2004-06-01T09:30:00-04:00,23.097701,23.195134,22.959684,23.130184,3650953,6337116.45,56.34383255755546,46.52251355784605,NaN,NaN,92.26863580999282,104.02668860387328,0.12490492987425764,-0.0026627565699151035,-0.12756768644417274,28166244,24616366.4,64.9751532744782,36.82921639923676,NaN,NaN,-0.8276352480399068,-14.168373735620865
2004-06-02T09:30:00-04:00,23.260067,23.300669,23.073345,23.243838,2102676,6034469.4,59.009143581074,48.03582095343198,NaN,NaN,112.38178367281368,115.18360959466108,0.12213464279024547,0.025100617043634088,-0.09703402574661138,30268920,27630222.4,67.16300438347707,41.49400392734452,NaN,NaN,1.884366260653653,-11.875125164724505
2004-06-03T09:30:00-04:00,23.170762,23.21949,23.0571,23.0571,2815229,5900753.35,53.25602054594345,49.06185089160416,NaN,NaN,91.8018529237978,110.11212431780159,0.1029632385069551,0.0316700223870825,-0.0712932161198726,27453691,29001623.6,68.13830196580602,46.22870354355826,NaN,NaN,2.6619734954095486,-9.798396784705355
2004-06-04T09:30:00-04:00,23.422458,23.422458,23.195134,23.251957,4608619,5844678.95,57.871610308773896,50.38549110938158,NaN,NaN,114.19111229215501,106.44523710548205,0.09863475577399727,0.05200022859762399,-0.046634527176373286,32062310,29953672.4,68.83042605783045,50.44156346876106,NaN,NaN,4.726035374515223,-7.7234779048167015
2004-06-07T09:30:00-04:00,23.463035,23.617298,23.389975,23.584824,6024118,5579347,64.34789724162482,52.52209918584414,NaN,NaN,136.77343580749485,109.48336410125084,0.11241910215426039,0.0938893505164522,-0.01852975163780819,38086428,31207518.6,69.7620427047821,54.01460383662065,NaN,NaN,8.733949510051573,-5.372416845549806
2004-06-08T09:30:00-04:00,23.568586,23.584824,23.446806,23.552341,2274132,4995078.5,63.32485051574535,54.23047754287851,NaN,NaN,122.45578432737136,115.52079380472655,0.11326161135443244,0.12304726255523235,0.009785651200799918,35812296,32736729,70.90424660738529,57.076757164194774,NaN,NaN,11.612206509456051,-2.9460420805489687
2004-06-09T09:30:00-04:00,23.471162,23.568586,23.308796,23.308796,4851761,5026727.65,56.12056503158252,55.39236822403607,NaN,NaN,89.715661487245,110.9875693676128,0.09222063212729165,0.12506144135991448,0.032840809232622836,30960535,32875052,71.01091543734903,59.665631456375635,NaN,NaN,11.84724617602853,-0.8327151867521834
2004-06-10T09:30:00-04:00,23.422458,23.430568,23.341263,23.422458,1010999,4577031.35,58.493850324574225,56.559801091429996,NaN,NaN,82.56490360767242,109.14017950438775,0.08115243597157015,0.13428135419708553,0.05312891822551538,31971534,33778620.6,71.73976043524821,62.021601842992816,NaN,NaN,12.777660590169166,1.1116242099508664
2004-06-14T09:30:00-04:00,23.235719,23.422458,23.081456,23.097701,1946863,4140828.65,50.148002348634954,56.861227986493354,NaN,NaN,41.96506270471491,94.69496958689972,0.04875136100160862,0.11406811947752615,0.06531675847591753,30024671,33371092.8,70.87425465194185,64.09839956239996,NaN,NaN,10.814436206604599,2.497740209472828
2004-06-15T09:30:00-04:00,23.300669,23.381856,23.138295,23.187007,4867158,4059713.3,52.16904782948767,57.24411856547837,NaN,NaN,44.55126045844587,76.25053451708992,0.030991187887808483,0.10405574333567813,0.07306455544786965,34891829,32732173,69.45939028453762,65.71839505361778,NaN,NaN,9.875715712442476,3.551736709897063
2004-06-16T09:30:00-04:00,23.260067,23.284423,23.154532,23.227601,2515181,3839493.3,53.099800106986294,57.126714589981226,NaN,NaN,37.25303073272896,59.209983798161446,0.020159344812010593,0.09826373646288289,0.0781043916508723,37407010,33051115.8,69.78366953835017,67.04060342051814,NaN,NaN,9.403831584891696,4.387750263467725
2004-06-17T09:30:00-04:00,23.138295,23.268194,23.081456,23.243838,3299789,3823333.1,53.489655248752705,56.830563021546695,NaN,NaN,25.983136984891054,46.46347889769065,0.012637513830531383,0.09390128393903652,0.08126377010850513,40706799,35000368.6,71.75739295167888,68.25260654037278,NaN,NaN,9.133879691097698,5.0657687531291495
2004-06-18T09:30:00-04:00,23.138295,23.341263,23.081456,23.154532,2830748,3551356.15,50.979593136593536,56.27171135692583,NaN,NaN,17.69239110426788,33.48897639700974,0.0008203299708310768,0.08228918257204398,0.08146885260121291,37876051,36181272,72.91179143045261,69.26596370002494,NaN,NaN,8.185494067961177,5.511443798105153
2004-06-21T09:30:00-04:00,23.300669,23.300669,23.048989,23.081456,4025521,3610226.4,48.95521139130685,55.54350572633113,NaN,NaN,-12.122626788855788,22.67143849829561,-0.012035730567405575,0.06642418939195593,0.07845991995936151,33850530,36946443.8,73.66297645368748,70.0695232983575,NaN,NaN,6.810557561966979,5.697031478656843
2004-06-22T09:30:00-04:00,23.081456,23.195134,22.98404,23.195134,2395826,3553074.35,52.139137007285726,55.243170329883284,NaN,NaN,-37.15347222739505,6.330491961127427,-0.01292336709117084,0.06230571109539795,0.07522907818656879,36246356,37217349.2,73.93853183904366,70.70976462439789,NaN,NaN,6.505742794787619,5.812561666675525
2004-06-23T09:30:00-04:00,23.138295,23.284423,23.040871,23.251957,4759136,3711597.3,53.6939621116181,54.863514510636435,NaN,NaN,-17.77044051031723,-4.67420228748181,-0.00986179424486855,0.0629018353804831,0.07276362962535166,41005492,37937045.6,74.69597182008333,71.24783372701262,NaN,NaN,6.6745702706508485,5.935705752957714
2004-06-24T09:30:00-04:00,23.21949,23.398102,23.21949,23.300669,2837892,3671707.9,55.04230859408558,54.991106514075156,NaN,NaN,42.2408129112245,-1.422667102215121,-0.004980574229226861,0.06653791183881808,0.07151848606804494,43843384,38564362.6,75.36797582243157,71.76423900248587,NaN,NaN,7.180353073548177,6.113512513042066
2004-06-25T09:30:00-04:00,23.260067,23.422458,23.203245,23.21949,2159089,3509810.1,52.30873649482403,54.593758384507304,NaN,NaN,20.102512531774217,-0.9406428167138536,-0.007492704674124648,0.062152605225389124,0.06964530989951377,41684295,39326011.4,76.19460361539988,72.2902516851694,NaN,NaN,6.8816159403194685,6.223241574081695
2004-06-28T09:30:00-04:00,23.454924,23.454924,23.154532,23.203245,3469767,3348029.4,51.75481861364493,53.69425276822303,NaN,NaN,10.249650485095597,3.533812638076424,-0.010346140353755279,0.056712634457319666,0.06705877481107494,38214528,40198811,77.14128989014718,72.81734076983834,NaN,NaN,6.485436942482295,6.260698055281781
2004-06-29T09:30:00-04:00,23.097701,23.203245,23.048989,23.105828,3499821,3297263.9,48.44203368818888,52.631194423397574,NaN,NaN,-89.93149942924298,-7.021792802293177,-0.01842054418967065,0.04403309457398663,0.06245363876365728,34714707,39892481.2,75.99894402640206,73.18124772833953,NaN,NaN,5.2510826714436,6.116467286162041
2004-06-30T09:30:00-04:00,23.113939,23.300669,23.040871,23.203245,8078879,3518660.2,51.76688654706391,52.320217388789096,NaN,NaN,-52.54593772284427,-13.976892244798586,-0.016868241269029215,0.04136833717737076,0.05823657844639998,42793586,40250100,76.43762178663884,73.56886961043166,NaN,NaN,5.04795544670116,5.96382273766763
2004-07-01T09:30:00-04:00,23.138295,23.268194,22.91909,23.040871,5241847,3675618.75,46.396247886817704,51.45610292894934,NaN,NaN,-115.76426423938065,-45.577907674919615,-0.025904287904747678,0.025856218565465383,0.05176050647021306,37551739,38991771,71.48656140840883,73.55078396565742,NaN,NaN,3.336351557470238,5.588469711925145
2004-07-02T09:30:00-04:00,23.097701,23.203245,23.000277,23.105828,5679606,3818837.6,48.68961365531478,51.351932307997906,NaN,NaN,-97.15979170985628,-69.03036852324571,-0.026536447970602187,0.01858994650696033,0.04512639447756252,43231345,39301181,71.96737816890551,73.62886421686912,NaN,NaN,2.5152545768613974,5.14943897834461
2004-07-06T09:30:00-04:00,22.894734,23.040871,22.862259,22.943438,1825908,3679702.05,43.66056857322195,50.74418378969322,NaN,NaN,-173.9707747754835,-105.87445357536153,-0.03631634835281768,-0.00026904096345958806,0.036047307389358095,41405437,39939362.8,72.97946707892596,73.88029827361113,NaN,NaN,0.2975922949764737,4.456318023577733
2004-07-07T09:30:00-04:00,22.813555,23.016523,22.813555,22.894734,1871358,3472064.05,42.25103135650336,49.969271736087286,NaN,NaN,-190.19583908172442,-125.92732150585782,-0.0439792493728772,-0.018926754326738404,0.025052495046138795,39534079,40903237.2,74.4782088539068,74.2156225104366,NaN,NaN,-1.962391695461105,3.5393594922864704
2004-07-08T09:30:00-04:00,22.772954,22.91909,22.724249,22.724249,1283949,3422554.9,37.666935644043846,48.83907747860808,NaN,NaN,-226.99630639964357,-160.81739524121767,-0.05758509558399039,-0.04692887443384919,0.010656221150141199,38250130,39994546,70.50766675183715,74.12635635330506,NaN,NaN,-5.3779354512267865,2.2654602146417195
2004-07-09T09:30:00-04:00,22.894734,22.894734,22.659292,22.724249,2439676,3301950.65,37.666935644043846,47.88817337199738,NaN,NaN,-201.96374385283872,-178.0572911639093,-0.06319142126883319,-0.06833305543590029,-0.005141634167067099,38250130,40134224.2,70.76566148739354,73.97306135737226,NaN,NaN,-8.142841901031101,0.7785599124027451
2004-07-12T09:30:00-04:00,22.651165,22.902861,22.634936,22.829784,3095815,3406191.45,42.1713575959787,47.40361238661681,NaN,NaN,-155.47485761827517,-189.7203043455931,-0.05661088642548315,-0.07590524219892103,-0.019294355773437886,41345945,39757144.2,69.01054194615786,73.64074460683443,NaN,NaN,-9.279122327869553,-0.6582518362075831
2004-07-13T09:30:00-04:00,22.886615,22.886615,22.764827,22.854132,3820316,3499864.1,43.191325963468906,46.764483026344166,NaN,NaN,-111.94650160052923,-177.3154497106022,-0.04778896302308755,-0.07903055955229732,-0.031241596529209773,45166261,40509309,70.5780842455675,73.40071263587186,NaN,NaN,-9.943058408496398,-1.9846527751059853
2004-07-14T09:30:00-04:00,22.73236,22.91909,22.659292,22.748597,3843965,3448704.45,39.90585082090527,45.77961793415039,NaN,NaN,-117.34631552140051,-162.74554499853744,-0.046204549413272296,-0.08899728329580014,-0.04279273388252785,41322296,40866952.4,71.32091932771353,73.15963745784543,NaN,NaN,-11.45367363545453,-3.337370040870063
2004-07-15T09:30:00-04:00,22.740471,22.813555,22.513155,22.537503,6294726,3637681.7,34.2875814339571,44.297137422712645,NaN,NaN,-150.01030589117073,-147.34834489684286,-0.055870743567721134,-0.11263116334217926,-0.05676041977445813,35027570,40222440.4,67.98950379467479,72.6326037415771,NaN,NaN,-14.57658559238062,-4.942972262514428
2004-07-16T09:30:00-04:00,22.764827,22.813555,22.496926,22.54563,4977397,3721562.1,34.668932349766095,43.03715141235136,NaN,NaN,-129.597791219515,-132.8751543701781,-0.057964370032264415,-0.12921588231478864,-0.07125151228252423,40004967,40573407.8,68.84297392344244,72.10748733500871,NaN,NaN,-16.988789490174415,-6.663803295037283
2004-07-19T09:30:00-04:00,22.488799,22.66741,22.488799,22.578105,2047495,3682399.45,36.26073054058149,41.93043083570398,NaN,NaN,-125.51344750921248,-126.88287234836557,-0.05351596141204161,-0.13814646404757625,-0.08463050263553464,42052462,40714711.2,69.19904007259434,71.54018377661207,NaN,NaN,-18.556515445510684,-8.362762173676341
2004-07-20T09:30:00-04:00,22.569986,22.716123,22.391375,22.691766,5207855,3741516.15,41.62196409256134,41.44328300744487,NaN,NaN,-106.00044870679875,-125.69366176961947,-0.03989725031556127,-0.13450206552998623,-0.09460481521442496,47260317,41133522.4,70.28304042204233,71.13190494772924,NaN,NaN,-18.40206949100723,-9.796948933295038
2004-07-21T09:30:00-04:00,22.894734,22.894734,22.448197,22.464443,4903124,3866881.05,35.238061597003394,40.26265265386912,NaN,NaN,-94.75151235168273,-121.1747011356759,-0.04291455500012609,-0.14824800896458257,-0.10533345396445648,42357193,41340501.8,70.82943148057737,70.73131992586771,NaN,NaN,-20.24682899444982,-11.289788942031436
2004-07-22T09:30:00-04:00,22.367018,22.561859,22.17217,22.488799,4183305,3838089.5,36.36425270363018,39.54608156935573,NaN,NaN,-137.22885487404534,-118.61841093225084,-0.04004144322210737,-0.1553852579920907,-0.11534381476998332,46540498,43643087.4,76.09515931049809,71.06050549030265,NaN,NaN,-21.39900777210974,-12.73396306061405
2004-07-23T09:30:00-04:00,22.448197,22.488799,22.310188,22.375137,4904726,3941431.2,33.44162412266351,38.45693945988064,NaN,NaN,-132.05474072136275,-119.10980083262038,-0.04234366956480279,-0.16827340172598682,-0.12592973216118403,41635772,43969248.4,76.73578284122667,71.40110582403987,NaN,NaN,-23.277643408256925,-14.240203110277317
2004-07-26T09:30:00-04:00,22.488799,22.488799,22.277713,22.383264,1774052,3922179.35,33.85099966695921,37.75625596657615,NaN,NaN,-125.96259432509804,-119.1996301957975,-0.03990021182259107,-0.17580499693942286,-0.1359047851168318,43409824,44240720.8,77.28150909628592,71.70839453956559,NaN,NaN,-24.68090689206919,-15.73173222196187
2004-07-27T09:30:00-04:00,22.488799,22.643054,22.40762,22.569986,3312968,3914339.4,42.5881644238619,37.78033689995891,NaN,NaN,-69.7070840781953,-111.94095727007682,-0.02312188500436907,-0.16480714137229313,-0.14168525636792406,46722792,44133215.8,76.51604193129879,71.85395404509359,NaN,NaN,-23.275261535832833,-16.80937926680058
2004-07-28T09:30:00-04:00,22.569986,22.691766,22.375137,22.643054,1932452,3835970.95,45.61535624233246,38.34808122840809,NaN,NaN,-53.27746295621418,-103.6461473909831,-0.0054387208890808725,-0.14848365747927517,-0.1430449365901943,48655244,45392826,79.12501359429302,72.46947881955472,NaN,NaN,-21.173431576168518,-17.432815310996
2004-07-29T09:30:00-04:00,22.73236,22.805428,22.643054,22.740471,1826154,3523334.7,49.44284029884761,39.189217275179786,NaN,NaN,11.083249536290143,-73.98372650891602,0.01345088927277574,-0.12623132499922463,-0.13968221427200037,50481398,46181006,80.57894777646203,73.17042784020246,NaN,NaN,-18.203908549438385,-17.54297148791634
2004-07-30T09:30:00-04:00,22.691766,22.724249,22.618698,22.708004,2407035,3381594.1,48.224696117317514,39.62159859813256,NaN,NaN,0.840111312819083,-47.40475610207966,0.02378690112080667,-0.10994858787099204,-0.1337354889917987,48074363,47468724.2,82.69910132462482,74.14818208152154,NaN,NaN,-16.115606091137643,-17.33906214551938
2004-08-02T09:30:00-04:00,22.708004,22.870378,22.553749,22.846022,4009139,3298070.75,53.472561431247584,40.35597256011675,NaN,NaN,46.20571101398341,-12.971095034263362,0.039045591692654785,-0.08492849937598024,-0.12397409106863502,52083502,49203459.8,85.06453346108356,75.1829284540584,NaN,NaN,-12.657949840415103,-16.67033181621877
2004-08-03T09:30:00-04:00,22.79731,22.829784,22.675521,22.708004,4298225,3421686.6,48.210167584390085,40.94913804322281,NaN,NaN,45.61986527178877,10.09429483573345,0.038884870695732696,-0.07536800269896915,-0.11425287339470185,47785277,49415956.8,85.32914061409757,76.18351568880011,NaN,NaN,-11.253408509340543,-15.89648562952188
2004-08-04T09:30:00-04:00,22.634936,22.837903,22.54563,22.764827,1937625,3424999.95,50.375485854843255,42.098274073286106,NaN,NaN,42.39364391347953,29.228516209672193,0.04141365746137135,-0.062485801567987664,-0.10389945902935901,49722902,49629488.4,85.60512512923943,77.44177435555473,NaN,NaN,-9.434852728130707,-14.973395215037426
2004-08-05T09:30:00-04:00,22.691766,22.764827,22.350781,22.391375,2916107,3506607.85,38.87240934748607,42.398522430266105,NaN,NaN,-76.36106010076885,11.739654282260394,0.017942077005661153,-0.08147186277228258,-0.09941393977794373,46806795,48894567.8,80.02531401132651,78.24051293326075,NaN,NaN,-11.697328200412404,-14.505385641519565
2004-08-06T09:30:00-04:00,22.253357,22.415731,22.131568,22.196526,3783610,3573804.55,34.45204703977517,42.269330751637085,NaN,NaN,-194.67946638992962,-27.364261258289343,-0.009238478293115499,-0.1109620376443381,-0.1017235593512226,43023185,47884332.2,72.98310369875767,78.5108031922724,NaN,NaN,-15.19496238956243,-14.603896605525689
2004-08-09T09:30:00-04:00,22.123457,22.269586,22.123457,22.17217,3711185,3604573.05,33.93261797997536,41.720091743595226,NaN,NaN,-188.70024669695098,-74.34545280047622,-0.026417376228197287,-0.1347452796364692,-0.10832790340827192,39312000,45330031.8,58.87557999757762,77.69598459052493,NaN,NaN,-18.050210303348717,-15.09622713378612
2004-08-10T09:30:00-04:00,22.326425,22.488799,22.24523,22.48068,4295761,3628345.3,45.20251185524046,42.43183819061216,NaN,NaN,-72.6931089903621,-98.0080476529064,-0.015123941847040981,-0.12723283071707314,-0.11210888887003216,43607761,44494528.6,55.122254236350415,76.57404335879441,NaN,NaN,-16.554230821424667,-15.304513374877342
2004-08-11T09:30:00-04:00,22.326425,22.553749,22.326425,22.529392,3566211,3614457.6,46.74715078526272,43.17347376787162,NaN,NaN,-34.57772173090574,-113.40232078178344,-0.0031218525643486594,-0.11601120457546799,-0.11288935201111933,47173972,43984742.6,52.90604466761344,74.91767802715981,NaN,NaN,-14.872264256910153,-15.24276350088203
2004-08-12T09:30:00-04:00,22.367018,22.521282,22.310188,22.310188,2021382,3400790.4,41.12879192612706,43.722557182404735,NaN,NaN,-71.40526142217611,-112.4111610460649,-0.008395419356907435,-0.12338362620725363,-0.11498820685034619,45152590,43653901.6,51.46003875578072,73.11226773534224,NaN,NaN,-15.38760559219631,-15.26345522821264
2004-08-13T09:30:00-04:00,22.488799,22.488799,22.229001,22.334536,3359281,3319884.6,41.96315983107908,44.30199719412758,NaN,NaN,-77.15277891550443,-88.90582355117986,-0.008658529089884473,-0.12581136821270178,-0.1171528391228173,48511871,44751638.8,55.778798574700836,71.57635984094331,NaN,NaN,-15.514532423993918,-15.299323399038537
2004-08-16T09:30:00-04:00,22.285831,22.691766,22.285831,22.675521,4310295,3433024.6,52.18396030965454,44.98741118596991,NaN,NaN,19.476105986364068,-47.27055301451686,0.014459379397840824,-0.09907861487551628,-0.1135379942733571,52822166,47453672,64.21799792575452,70.69792812626159,NaN,NaN,-11.985859195988935,-14.82597137003145
2004-08-17T09:30:00-04:00,22.789199,22.894734,22.764827,22.805428,6885829,3516923.3,55.40605989989754,45.686747161510276,NaN,NaN,134.05864277908844,-5.920202660626752,0.03751671748346662,-0.06664209741902383,-0.10415881490249045,59707995,50673718.8,71.25762360657717,70.1359716985676,NaN,NaN,-8.031211840829442,-13.855291437288306
2004-08-18T09:30:00-04:00,22.772954,23.081456,22.73236,23.081456,5661746,3554854.4,61.36360361632593,46.53823025561588,NaN,NaN,169.46996588503737,34.88933486256188,0.06856698011830822,-0.01845008975460516,-0.08701706987291338,65369741,54312872.6,76.81030626040499,69.86678301884925,NaN,NaN,-2.4752649740309525,-12.229573371108685
2004-08-19T09:30:00-04:00,23.016523,23.081456,22.902861,22.98404,2036532,3447515.75,58.39840223006402,47.26492354938348,NaN,NaN,151.60242681077492,79.49087250915207,0.07901074527238683,0.011746361717570153,-0.06726438355481668,63333209,57948996.4,80.80125352438885,69.73122246168954,NaN,NaN,0.8809186932608191,-10.356645933341614
2004-08-20T09:30:00-04:00,23.016523,23.235719,22.992167,23.21949,3162821,3360420.5,63.046278945530666,47.94876051468942,NaN,NaN,173.20656213539692,129.56274071933234,0.09705392660646242,0.05405302470326134,-0.04300090190320107,66496030,61545828.2,83.77574015117773,69.63916579669626,NaN,NaN,5.348350697040232,-8.113074986144207
2004-08-23T09:30:00-04:00,23.260067,23.268194,23.105828,23.138295,2006848,3372060.3,60.53460324321899,48.829077347462906,NaN,NaN,154.91686806465907,156.65089313499135,0.09848567170625905,0.08010618772962275,-0.018379483976636305,64489182,63879231.4,85.36035603581244,69.64139546967589,NaN,NaN,8.039458494687539,-5.805570203168244
2004-08-24T09:30:00-04:00,23.178889,23.268194,23.105828,23.178889,2056363,3309230.05,61.3633480788486,49.613924649177584,NaN,NaN,138.15339694002478,157.46984396717863,0.09697845663869367,0.10284358682173078,0.005865130183037113,66545545,65246741.4,86.21039040835075,69.68462870389813,NaN,NaN,10.428450966491202,-3.4864243217883235
2004-08-25T09:30:00-04:00,23.178889,23.414331,23.138295,23.381856,5775555,3501385.2,65.28825268740181,51.5007706020287,NaN,NaN,149.30839895014296,153.43753058019973,0.1038494009874076,0.1356768814172966,0.03182748042988902,72321100,66637013.2,87.03461447951776,70.18529302305465,NaN,NaN,13.756264762136025,-1.0231830240848456
2004-08-26T09:30:00-04:00,23.373729,23.463035,23.308796,23.438687,1100176,3465086.3,66.3199375480562,53.777048495477345,NaN,NaN,144.96638667507418,152.11032255305958,0.10604867517878383,0.1643883244033688,0.058339649224584976,73421276,68654626.6,88.14230052750466,71.26809279653658,NaN,NaN,16.75706754507447,1.5168527715093418
2004-08-27T09:30:00-04:00,23.503637,23.503637,23.373729,23.463035,1823937,3435931.4,66.77554531801395,56.12297187676582,NaN,NaN,131.0093601200059,143.6708821499814,0.10288985187762906,0.1869519640716213,0.08406211219399223,75245213,70404463.2,89.01856381890805,73.42116306948876,NaN,NaN,19.31363563580481,4.059250323551552
2004-08-30T09:30:00-04:00,23.463035,23.47928,23.325025,23.325025,1136512,3292300.05,61.6821251008467,57.30008710859484,NaN,NaN,102.3578373475675,133.15907600656305,0.08594245256189334,0.19149017789635892,0.10554772533446558,74108701,72328367,89.9021214124612,75.90543929635382,NaN,NaN,20.021992629249937,6.3396420815084635
2004-08-31T09:30:00-04:00,23.341263,23.487391,23.268194,23.446806,2366511,3195714.35,64.27186459274648,58.551852380557975,NaN,NaN,94.31811198847659,124.39201901625344,0.07762442607280089,0.2025782579254667,0.1249538318526658,76475212,74314300.4,90.73114663553257,78.60723229406231,NaN,NaN,21.389888043364707,8.489677218916498
2004-09-01T09:30:00-04:00,23.463035,23.519874,23.268194,23.3575,2916476,3244656.9,61.01516115703617,59.97230732562291,NaN,NaN,81.88698781535562,110.90773678929597,0.06150316701505765,0.20183279062148785,0.1403296236064302,73558736,74561827.6,90.8321758109494,81.41952779800295,NaN,NaN,21.589850069772044,10.361130483324432
2004-09-02T09:30:00-04:00,23.381856,23.649773,23.300669,23.617298,3809723,3289337.7,66.3559502531583,61.71464949862857,NaN,NaN,96.06091377905092,101.1266422100913,0.0634749195469082,0.21967327304006545,0.15619835349315725,77368459,75351264.2,91.16300543855795,83.9469711454213,NaN,NaN,23.43089370925428,12.228239515600125
2004-09-03T09:30:00-04:00,23.471162,23.755308,23.471162,23.60918,1967310,3198522.7,66.05144838786336,62.70518436135777,NaN,NaN,103.50655005336247,95.62608019676263,0.059441213296664575,0.23049987011398798,0.1710586568173234,75401149,75382451.4,91.17655172564106,85.87258213112749,NaN,NaN,24.80962816593344,14.025580751362027
2004-09-07T09:30:00-04:00,23.820266,23.950165,23.771554,23.893326,2388929,3132409.9,71.05777503468435,63.82316401384254,NaN,NaN,138.44993255246573,102.84449923774227,0.0703709825230811,0.2590223849711748,0.1886514024480937,77790078,76118726.8,91.50752912707067,87.31900395401988,NaN,NaN,27.66663513008073,15.9743028054647
2004-09-08T09:30:00-04:00,23.877097,23.893326,23.682248,23.714731,5877543,3211499,64.60864683338265,64.05495281506087,NaN,NaN,113.35064852646406,106.65100654533975,0.06041517244773681,0.2641703680077647,0.2037551955600279,71912535,75206191.4,87.14444276774454,88.05715656168698,NaN,NaN,28.024714974911596,17.695790258242827
2004-09-09T09:30:00-04:00,23.714731,23.763435,23.576697,23.690358,2030867,3134731.8,63.75819485836596,64.43779514565388,NaN,NaN,90.63957143461825,108.40152326919228,0.047594975252846394,0.2632489146260859,0.2156539393732395,69881668,74470777.8,83.68159385588264,88.26289515679368,NaN,NaN,28.050017035368185,19.17496551211788
2004-09-10T09:30:00-04:00,23.747198,23.836503,23.625425,23.804037,1419439,3104634.65,66.00579949774922,64.64918947081235,NaN,NaN,101.10151233489582,109.40964298036127,0.04235316917443352,0.2685954008412814,0.2262422316668479,71301107,73257307.4,78.16242021453363,87.86194373274768,NaN,NaN,28.74328388879756,20.541868137357834
2004-09-13T09:30:00-04:00,23.909572,23.909572,23.706604,23.739087,3669060,3120123.6,63.57968084624965,64.86669501388596,NaN,NaN,105.21514418821077,109.75136180733094,0.03063991905650071,0.26454213048747377,0.23390221143097306,67632047,71703487,71.6462297365891,86.88236328280315,NaN,NaN,28.604223641144827,21.693633209327405
2004-09-14T09:30:00-04:00,23.747198,23.820266,23.714731,23.771554,1550494,2982133.55,64.28634319196888,65.07548037910884,NaN,NaN,95.83014489715231,101.22740427626823,0.021631611896489517,0.26094172630158496,0.23931011440509545,69182541,69981979.6,65.16438217946396,85.37907698073981,NaN,NaN,28.686854797346033,22.692664864758637
2004-09-15T09:30:00-04:00,23.787791,23.787791,23.649773,23.682248,688780,2672281.1,60.792211219969175,64.75433456000651,NaN,NaN,70.76697802794052,92.71067017656353,0.0069703697306958134,0.24802307656846523,0.24105270683776941,68493761,69298224.8,62.736638165994435,83.64350724405958,NaN,NaN,27.771246992102324,23.418176597236307
2004-09-16T09:30:00-04:00,23.682248,23.852741,23.682248,23.804037,2138889,2496138.25,63.690569866213366,64.56652258273202,NaN,NaN,83.37487766831418,91.25773142330272,0.002990246820721909,0.2447905153636718,0.2418002685429499,70632650,69448421.2,63.06218065623423,81.8520701103974,NaN,NaN,27.788152579325843,24.042458880391955
2004-09-17T09:30:00-04:00,23.779664,23.79591,23.682248,23.73096,1673174,2477970.35,60.78690088084651,64.13876226579148,NaN,NaN,63.680182604539816,83.77346547723154,-0.006529221102448968,0.23363874216488867,0.24016796326733764,68959476,68980095,61.264919735606085,79.86966696159013,NaN,NaN,26.980394985931177,24.46216403832613
2004-09-20T09:30:00-04:00,23.519874,23.60918,23.430568,23.487391,2919679,2465813.25,52.23843614513954,63.46421305466955,NaN,NaN,-17.473792352985658,59.23567816899224,-0.029887136650221302,0.202809042454561,0.2326961791047823,66039797,68661645,60.01246766858332,77.73469169417027,NaN,NaN,23.60528357859753,24.339752544079186
2004-09-21T09:30:00-04:00,23.487391,23.698485,23.471162,23.682248,3184376,2524689.65,57.39984204495624,62.97335430125596,NaN,NaN,14.539270448987828,42.97750327935935,-0.03264682063677707,0.19188765330881097,0.22453447394558804,69224173,68669971.4,60.03547279505385,75.5421435627075,NaN,NaN,22.24887637881978,24.04105594904213
2004-09-22T09:30:00-04:00,23.54423,23.54423,23.211363,23.251957,3721162,2607929.6,45.6644276880983,61.876873339188975,NaN,NaN,-104.81268702321627,7.861570269127983,-0.062172341132363695,0.14681904753013342,0.2089913886624971,65503011,68071821.4,57.47727730905228,73.15965081257198,NaN,NaN,16.737185449352808,22.99764587765794
2004-09-23T09:30:00-04:00,23.260067,23.284423,23.008396,23.016523,7270378,2682670.75,40.754703745997034,60.048212874391744,NaN,NaN,-184.05004034091118,-45.6234133327171,-0.09434937097827012,0.09105467493965946,0.18540404591792958,58232633,65591818,48.2895907540319,70.09726404939155,NaN,NaN,10.374453779237253,21.1943327207407
2004-09-24T09:30:00-04:00,23.016523,23.178889,22.943438,23.105828,4494931,2852408.5,43.24732705848066,58.41934706515012,NaN,NaN,-170.34737208891627,-92.4289242714083,-0.10556241681028561,0.053451024905072586,0.1590134417153582,62727564,64345435.6,44.444458213909186,66.75925736998214,NaN,NaN,6.246291818809526,19.058898306179103
2004-09-27T09:30:00-04:00,23.105828,23.138295,22.951565,22.992167,5588823,3040652.8,40.88938187995867,56.26446183981257,NaN,NaN,-160.57662293764955,-121.04949038834107,-0.1157600550644807,0.014313372884757314,0.130073427949238,57138741,62565224.4,39.59490231148402,63.051212597440234,NaN,NaN,2.134247811750165,16.641091092689255
2004-09-28T09:30:00-04:00,23.0571,23.122058,22.91909,23.081456,4895488,3228601.6,43.49569815524241,54.75639407708827,NaN,NaN,-139.04039130561532,-151.7654227392617,-0.11157104301939558,-0.009390375825006458,0.10218066719438912,62034229,61127235.6,36.16240419620474,59.40963841375882,NaN,NaN,-0.3584993683449418,14.21257816968437
2004-09-29T09:30:00-04:00,23.21949,23.21949,22.967794,23.162651,2368359,3228694,45.83453590156632,53.47613272303114,NaN,NaN,-105.39689083717896,-151.88226350205426,-0.09884659941126292,-0.021377582069689538,0.07746901734157338,64402588,60907151,35.65297290747132,55.97902263172944,NaN,NaN,-1.6711446975803141,11.943474902932273
2004-09-30T09:30:00-04:00,23.21949,23.21949,23.016523,23.105828,1900796,3177910,44.44794042523973,51.93628564642332,NaN,NaN,-95.8182350774109,-134.2359024493542,-0.09002204394840525,-0.03505853759393318,0.05496350635447207,62501792,61760982.8,39.229709718256686,53.198114739138234,NaN,NaN,-3.156734680048516,9.786302105363589
2004-10-01T09:30:00-04:00,23.146406,23.503637,23.138295,23.495518,4091788,3192013.25,54.59309421637013,51.29438660143194,NaN,NaN,-26.89254057856076,-105.54493614728308,-0.055403865628903814,-0.014291325681657696,0.04111253994724612,66593580,62534186,42.354561654140426,51.10585273324904,NaN,NaN,-1.1838616880505783,8.219135849161566
2004-10-04T09:30:00-04:00,23.666002,23.755308,23.487391,23.527993,3423454,3264820.45,55.32530255719163,50.654312270376415,NaN,NaN,25.245128988758037,-68.38058576200157,-0.029103836483514597,0.004732744342852868,0.033836580826367466,70017034,65109844.6,51.33214903126269,50.11783607980608,NaN,NaN,0.6030066851111922,7.1311173971543695
2004-10-05T09:30:00-04:00,23.463035,23.503637,23.349373,23.398102,1901535,3240450.75,51.732055471199864,50.00715828832147,NaN,NaN,-12.404152017937593,-43.05333790446602,-0.019691638350644813,0.009222032888061449,0.02891367123870626,68115499,66326098.6,54.9036955881978,49.55834018139204,NaN,NaN,0.9949600292844323,6.254523487458664
2004-10-06T09:30:00-04:00,23.373729,23.576697,23.333152,23.568586,2880017,3090574.45,55.79057294831683,49.442872794185995,NaN,NaN,11.254461588051491,-19.723067419419937,-0.002143696507569102,0.026234050604244885,0.028377747111813987,70995516,67644684.2,58.462644245664656,49.22980186635135,NaN,NaN,2.607855579718989,5.733570929210139
2004-10-07T09:30:00-04:00,23.54423,23.584824,23.487391,23.503637,2556320,3116847.1,53.930141380627035,48.95310425845604,NaN,NaN,22.773744733565394,3.995328542775326,0.004563781641881155,0.03408247416416543,0.029518692522284277,68439196,68832165,61.41584337915704,49.24058212660499,NaN,NaN,3.3662944491941404,5.39538857492214
2004-10-08T09:30:00-04:00,23.503637,23.584824,23.349373,23.422458,1989234,3145336.85,51.61343214671111,48.90846111571115,NaN,NaN,6.982041115303427,10.770244881548162,0.003078887609396525,0.03336730203402993,0.030288414424633408,66449962,68803441.4,61.302308925161206,49.33271364493199,NaN,NaN,3.31732798321729,5.098522776107162
2004-10-11T09:30:00-04:00,23.422458,23.54423,23.381856,23.487391,2354933,3079630.5,53.34002878874156,48.61847445455295,NaN,NaN,18.375244956095017,9.396268075015549,0.005854523092817809,0.03760656829065567,0.031752045197837864,68804895,68561013.6,60.289294359395434,49.35084375667068,NaN,NaN,3.773690264878007,4.909260988788711
2004-10-12T09:30:00-04:00,23.260067,23.54423,23.203245,23.471162,5073597,3255785.65,52.83259545194906,49.13048643768516,NaN,NaN,3.8547285105228277,12.648044180707632,0.00596215966493472,0.03920474477900626,0.03324258511407154,63731298,67684173.4,56.643346316834084,49.29127725722652,NaN,NaN,4.010449275748811,4.780859315497297
2004-10-13T09:30:00-04:00,23.560467,23.625425,23.243838,23.316906,1307475,3286720.4,48.144392052090794,49.658321316691854,NaN,NaN,5.830795471041621,11.563310957305657,-0.004430245931460172,0.02770477769974633,0.0321350236312065,62423823,65969834.8,50.24557216019156,49.430990214809356,NaN,NaN,2.894285908558508,4.511348828791756
2004-10-14T09:30:00-04:00,23.260067,23.316906,22.659292,22.748597,9276241,3643588,35.607857669315734,49.1126449317515,NaN,NaN,-145.11194937040656,-22.013827863488736,-0.0472728851955288,-0.0269560828632045,0.020316802332324302,53147582,62911512,41.2865603745292,49.205426083425074,NaN,NaN,-2.640466947786393,3.4896608607091633
2004-10-15T09:30:00-04:00,22.708004,22.91909,22.537503,22.781072,11962751,4158066.85,36.62342762831515,48.80793391377696,NaN,NaN,-166.96070856905018,-56.80237780035945,-0.06976044450595675,-0.06688375330012164,0.0028766912058351135,65110333,62643586.2,40.60352693176165,49.27747069915919,NaN,NaN,-6.608928074273107,2.047005298568839
2004-10-18T09:30:00-04:00,22.651165,22.935328,22.651165,22.878488,2063754,4115270.6,39.69591105380431,48.53652054938853,NaN,NaN,-124.00449753758261,-85.27832629909499,-0.0740076179567927,-0.08963283124015575,-0.01562521328336306,67174087,62317424.6,39.741578363035,49.53312599678993,NaN,NaN,-8.886406864057316,0.48508927533653123
2004-10-19T09:30:00-04:00,22.854132,22.935328,22.48068,22.496926,12348161,4573459.85,32.95650714319217,47.6166613523618,NaN,NaN,-154.61727905347337,-116.97272781189422,-0.09699800572395062,-0.13687272043830134,-0.03987471471435072,54825926,60536350.2,35.33089258795333,49.5101202596815,NaN,NaN,-13.308324003087563,-1.4853983358669107
2004-10-20T09:30:00-04:00,22.326425,22.399493,22.082864,22.383264,11752497,4975026.6,31.25427048619835,46.674256356715986,NaN,NaN,-207.0532868587342,-159.5495442778494,-0.11321325277913012,-0.18139128068826338,-0.06817802790913326,43073429,56666271.4,28.04691586648488,48.71134927026923,NaN,NaN,-17.4223606849454,-3.7621072428781233
2004-10-21T09:30:00-04:00,22.24523,22.513155,21.92049,22.367018,11418329,5182424.15,31.007743333090488,44.989588436481725,NaN,NaN,-177.31973095777,-165.99110059532208,-0.11785704540504088,-0.21549933466543436,-0.09764228926039348,31655100,52367775,22.498705560960687,47.2930738350421,NaN,NaN,-20.722428881743067,-6.185010334144543
2004-10-22T09:30:00-04:00,22.367018,22.48068,22.220882,22.24523,3746412,5144998.2,29.1514030493408,43.12002418592095,NaN,NaN,-140.48371013787144,-160.69570090908633,-0.12147146311619283,-0.24948161815563452,-0.1280101550394417,27908688,44927446,16.43745093804077,44.80059539981197,NaN,NaN,-24.056296950147654,-8.738051279287845
2004-10-25T09:30:00-04:00,22.285831,22.285831,22.099101,22.237119,2013992,4966256.65,29.026767855185,41.49821792763417,NaN,NaN,-135.51412247520773,-162.99762589661137,-0.1167197562187246,-0.2739098503128474,-0.15719009409412282,25894696,36671567.8,12.43443810927181,41.767077008460106,NaN,NaN,-26.76904262413446,-11.313907185694504
2004-10-26T09:30:00-04:00,22.488799,22.789199,22.204653,22.73236,4687819,4955873.2,44.60109483216997,40.69896949076654,NaN,NaN,-66.9706897974266,-145.468308045402,-0.07458464017037997,-0.2504208943070978,-0.17583625413671783,30582515,31822885.6,10.774821665322833,38.36080396700713,NaN,NaN,-24.19938023163303,-13.154689049400007
2004-10-27T09:30:00-04:00,22.691766,23.073345,22.602461,23.073345,5127542,5093832.35,52.3536936356664,40.5863660804122,NaN,NaN,-12.456559793297703,-106.5489626323147,-0.020901383979475996,-0.20196298411106284,-0.18106160013158684,35710057,30350211.2,10.324106927596873,34.71139422046711,NaN,NaN,-19.17781355428831,-14.015135407241193
2004-10-28T09:30:00-04:00,22.894734,23.308796,22.894734,23.195134,4271496,5212367.35,54.78737291004335,40.81307613493593,NaN,NaN,21.07342276402768,-66.87033188795515,0.02326491957505969,-0.15198045066276222,-0.1752453702378219,39981553,32015501.8,14.670784227221148,31.380571027757107,NaN,NaN,-14.356790942930504,-14.063943340911095
2004-10-29T09:30:00-04:00,23.138295,23.29255,23.122058,23.227601,2395087,5127532.3,55.44078981897836,40.96313049423856,NaN,NaN,35.65995327370594,-31.641599205639682,0.05339756415220681,-0.10849841504756341,-0.16189597919977022,42376640,34909092.2,21.76664898118794,28.62895350074229,NaN,NaN,-10.379911828338951,-13.53765312482936
2004-11-01T09:30:00-05:00,23.300669,23.373729,23.260067,23.300669,2200105,5066364.85,56.94873745602729,41.257140637387,NaN,NaN,55.133284517814445,6.487882192964742,0.07562393725764927,-0.06736605762770864,-0.1429899948853579,44576745,38645502,29.875837444897698,26.716988581318265,NaN,NaN,-6.6820686822468875,-12.558283918746149
2004-11-02T09:30:00-05:00,23.381856,23.584824,23.300669,23.398102,9547465,5448661.35,58.9439513666332,42.028537731282896,NaN,NaN,74.02041079863197,34.68610231217646,0.09311222449779262,-0.026599714263117136,-0.11971193876090976,54124210,43353841,38.523391174382375,25.87968993947475,NaN,NaN,-3.002310783261076,-11.19314489939114
2004-11-03T09:30:00-05:00,24.088183,24.088183,23.47928,23.536119,5679355,5588628.25,61.65491952696635,43.88904214968652,NaN,NaN,114.1348567816976,60.00438562717552,0.10909176086846785,0.016652762324675052,-0.0924389985437928,59803565,48172542.6,45.87929464632684,26.207742387460293,NaN,NaN,0.9523616846511941,-9.458072530242235
2004-11-04T09:30:00-05:00,23.584824,23.942054,23.495518,23.933928,5619251,5741774.8,68.17736067218823,46.14289450996317,NaN,NaN,122.38641928977395,80.26698493232479,0.1396186440505444,0.0820843065193877,-0.0575343375311567,65422816,53260795.2,52.361299318820706,27.047583272250225,NaN,NaN,6.8328815681417705,-7.130793373330235
2004-11-05T09:30:00-05:00,23.820266,24.153132,23.755308,23.885215,6229200,5953773.1,66.6816021128308,48.070443871322205,NaN,NaN,133.05515385527252,99.7460250486381,0.14884904271044763,0.12852696585690282,-0.0203220768535448,59193616,56624190.4,56.10383850928033,28.216316139839176,NaN,NaN,11.041992473589344,-4.5346811094845805
2004-11-08T09:30:00-05:00,23.852741,23.933928,23.812147,23.852741,5475630,6109807.95,65.6476132839189,50.40552288137411,NaN,NaN,115.62130722267176,111.84362958960955,0.1449444226683928,0.16085845148194622,0.01591402881355341,53717986,58452438.6,58.03379740582852,29.83795219825884,NaN,NaN,14.127275930748587,-1.8686872465941278
2004-11-09T09:30:00-05:00,23.86897,23.990759,23.812147,23.828393,1864461,5949351.15,64.83583557193093,52.80420610178358,NaN,NaN,108.45575042445034,118.73069751477324,0.13319993868390823,0.1824139521684387,0.049214013484530465,51853525,57998301.6,57.359174899443985,31.931684986327344,NaN,NaN,16.419535300070827,0.7439159743580084
2004-11-10T09:30:00-05:00,23.909572,23.998877,23.812147,23.893326,1788094,5973382.1,66.04184077358988,55.30664163324782,NaN,NaN,103.09251000251052,116.52222815893583,0.12255136036048633,0.20240321393513838,0.07985185357465205,53641619,56765912.4,55.47457358562887,34.2871041309465,NaN,NaN,18.6890888168014,3.3075120947070644
2004-11-11T09:30:00-05:00,23.950165,24.145022,23.942054,24.120666,2936184,5656379.25,69.93026428589693,58.21941743585898,NaN,NaN,109.61685526916874,113.96831535481479,0.12323300653363305,0.23389311174169336,0.11066010520806031,56577803,54996909.8,52.79318516277266,36.883942289855916,NaN,NaN,21.895690125613136,5.962966099122218
2004-11-12T09:30:00-05:00,24.193726,24.266794,23.998877,24.218082,3730030,5244743.2,71.4394249878415,61.24889294533445,NaN,NaN,107.54223920001044,108.86573242376237,0.12240816579633668,0.26367031245348116,0.14126214665714448,60307833,55219753.2,53.10071549868606,39.7886763890998,NaN,NaN,25.04955809144652,8.689622098025689
2004-11-15T09:30:00-05:00,24.266794,24.339863,24.193726,24.29115,3446241,5313867.55,72.55216962116214,63.245398287405315,NaN,NaN,107.52874359863604,107.24721969895522,0.1188495023143957,0.2898240245501391,0.17097452223574341,63754074,57226970.8,55.88822986018184,43.01106268873258,NaN,NaN,28.021955890174755,11.451384068332699
2004-11-16T09:30:00-05:00,24.307388,24.307388,24.063827,24.088183,4070602,4899989.6,64.97889385070661,64.14719830276533,NaN,NaN,85.77209870878164,102.71048935582148,0.09587709183073112,0.2908208870241573,0.1949437951934262,59683472,58792960.2,57.98630399691959,46.415505336541344,NaN,NaN,28.44661318438209,13.879273942054041
2004-11-17T09:30:00-05:00,24.153132,24.3561,24.096293,24.145022,5508886,4587809.05,66.04772219457456,64.95150896594613,NaN,NaN,84.21757971901434,98.93550329912225,0.07830246123041454,0.29282187173144436,0.21451941050102982,65192358,61103108,60.937904107546075,49.72029961370742,NaN,NaN,29.10250954222096,16.05402188493503
2004-11-18T09:30:00-05:00,24.193726,24.218082,24.063827,24.088183,2840848,4158935,63.9459959745171,65.55902369134175,NaN,NaN,70.39682534251932,91.09149731379236,0.057599214129808674,0.28651842816329065,0.22891921403348198,62351510,62257849.4,62.361316388858306,52.61991871425529,NaN,NaN,29.061832145251387,17.912280493551652
2004-11-19T09:30:00-05:00,24.209972,24.209972,23.722841,23.779664,11342207,4538724.75,53.91686895710881,65.34246165570472,NaN,NaN,38.12544854058576,77.20813918190743,0.019827399351947828,0.25370346322341675,0.23387606387146892,51009303,60398143.4,58.65434210025566,54.675526189638006,NaN,NaN,25.91001364280656,19.054813800588068
2004-11-22T09:30:00-05:00,23.666002,23.966402,23.666002,23.917698,1875177,4531784,57.154614207704626,65.21465185863839,NaN,NaN,23.260081762005168,60.35440681458125,0.0017901765496855793,0.2361137845585759,0.23432360800889032,52884480,58224224.6,54.57070121379477,55.82176262102461,NaN,NaN,24.21702912150811,19.792273132148075
2004-11-23T09:30:00-05:00,23.86897,24.039471,23.844622,23.974521,1856208,4390203.45,58.44883007891375,64.98564546949179,NaN,NaN,36.36732750602324,50.473452574029565,-0.008119021771225587,0.22417483079485834,0.23229385256608392,54740688,57235667.8,52.771459649012,56.31406012121641,NaN,NaN,23.20791280961336,20.28022165750026
2004-11-24T09:30:00-05:00,24.145022,24.145022,24.039471,24.071937,2209836,4244318.15,60.643695006122584,64.44752649334423,NaN,NaN,63.75141998828636,46.38022062788397,-0.009805219942796928,0.22003732763758777,0.2298425475803847,56950524,55587301,49.821707905763915,56.132660734569484,NaN,NaN,22.992309015418627,20.667662708631454
2004-11-26T09:30:00-05:00,24.120666,24.153132,24.071937,24.088183,697648,4065625.75,61.013556399690394,64.04266608526277,NaN,NaN,65.83222622530033,45.46730080444017,-0.011406739324720055,0.21558412342448463,0.22699086274920469,57648172,54646633.4,48.16706768099606,55.565748532549186,NaN,NaN,22.91855107433583,20.989218189446365
2004-11-29T09:30:00-05:00,24.071937,24.145022,23.836503,23.974521,6654761,4278609.45,56.979023907102714,63.4234811297759,NaN,NaN,19.47703354615746,41.73761780555451,-0.021135656194366276,0.20057129250624683,0.2217069487006131,50993411,54643455,48.16124745640064,54.86056639330434,NaN,NaN,21.71059902537663,21.09227259457926
2004-11-30T09:30:00-05:00,23.974521,23.990759,23.836503,23.950165,6284012,4482804.8,56.122617028977764,62.80110837670781,NaN,NaN,-17.332097671648505,33.61918191882376,-0.029701189736211636,0.18458046153034857,0.2142816512665602,44709399,53008438.8,45.139589300191396,53.98773885050058,NaN,NaN,20.47042363369778,21.00343702873905
2004-12-01T09:30:00-05:00,24.071937,24.42105,24.055708,24.42105,6026701,4306766.6,66.58077302597887,62.83960353759274,NaN,NaN,138.79740878941678,54.10519817550248,-0.005415699058468559,0.20751202744347452,0.21292772650194308,50736100,52207521.2,43.693436228085424,53.14622903924747,NaN,NaN,22.58662236009752,21.22960636179026
2004-12-02T09:30:00-05:00,24.3561,24.502228,24.323633,24.380456,5331147,4289356.2,65.13935636844496,62.49739582920331,NaN,NaN,165.88521308695977,74.53195679523716,0.005558040220656257,0.21987527677776342,0.21431723655710716,45404953,49898407,39.740397029427754,52.21388702972284,NaN,NaN,23.827504958160716,21.600734732700325
2004-12-03T09:30:00-05:00,24.437295,24.445406,24.242438,24.372337,5134442,4265115.75,64.83702087687942,62.025795535563155,NaN,NaN,130.15313729291248,87.39613900875959,0.009672780802893355,0.22640821256072385,0.2167354317578305,40270511,46422874.8,34.657893684077706,50.896542614393674,NaN,NaN,24.733090928670997,22.048214189267565
2004-12-06T09:30:00-05:00,24.193726,24.412939,24.193726,24.3561,1971005,4052206,64.19531365446218,61.42887725222745,NaN,NaN,103.30741098515074,104.16221449655825,0.0087326143632728,0.2276511997119215,0.2189185853486487,38299506,43884093.8,31.489760467373273,49.15379480062163,NaN,NaN,25.296506079515545,22.51225588787442
2004-12-07T09:30:00-05:00,24.477872,24.477872,24.136895,24.153132,3785088,3967678.9,56.64780795539799,60.833799688276834,NaN,NaN,67.4150615725264,121.11164634539323,-0.007263224366402171,0.20983955489064599,0.21710277925704816,34514418,41845097.6,29.18248523279557,47.09637917461277,NaN,NaN,23.573302215281167,22.663833934646814
2004-12-08T09:30:00-05:00,24.193726,24.274905,24.153132,24.218082,4394915,4094201.6,58.33590848994999,60.28295585223223,NaN,NaN,43.1670191522597,101.98556841796182,-0.014742683300333181,0.1986744251316317,0.21341710843196487,38909333,39479744.2,26.735235112200755,44.65333138923096,NaN,NaN,22.614338676326245,22.65676318345816
2004-12-09T09:30:00-05:00,24.088183,24.615907,24.080064,24.347989,1575252,4083559.5,61.56000921936616,60.1125282268643,NaN,NaN,98.73574943131631,88.55567568683313,-0.012313149225462505,0.19802567190013676,0.21033882112559926,40484585,38495670.6,25.767095953008734,42.03945850095598,NaN,NaN,22.719500413190204,22.665725644848454
2004-12-10T09:30:00-05:00,24.153132,24.461643,24.153132,24.388567,2436227,4058561.65,62.535250959838464,60.728126941344996,NaN,NaN,83.15211229264146,79.15547068677891,-0.00947291442598125,0.1984976780931227,0.20797059251910394,42920812,39025730.8,27.294325733056596,39.799457331870336,NaN,NaN,23.083028293132312,22.725340308889006
2004-12-13T09:30:00-05:00,24.437295,24.705196,24.396693,24.550957,3189919,4031556.1,66.22791814159942,61.37622007948033,NaN,NaN,158.40376827646816,90.1747421450424,0.0012711977827419008,0.2095595897475313,0.2082883919647894,46110731,40587975.8,31.751018909138224,38.16948002439487,NaN,NaN,24.4951422888197,22.978169163164818
2004-12-14T09:30:00-05:00,24.550957,24.664611,24.477872,24.632136,1870742,3952781.15,67.92964630812534,62.05342123870973,NaN,NaN,154.82759198411208,107.65724822735953,0.011220489499066594,0.22231400383862265,0.21109351433955606,47981473,43281386.8,38.72478595382917,37.16614618902467,NaN,NaN,26.187559914513976,23.436653556214697
2004-12-15T09:30:00-05:00,24.599661,24.770146,24.599661,24.762035,2499045,3874203.3,70.49189059214856,62.75686378056873,NaN,NaN,169.21545476603816,132.86693535011523,0.023233667632746147,0.24013559888048874,0.2169019312477426,50480518,45595623.8,44.01788980886375,36.751587753531794,NaN,NaN,28.424131569390294,24.14915041523978
2004-12-16T09:30:00-05:00,24.68084,24.688967,24.510355,24.591534,4050402,3801279.1,63.33881930975433,62.922953988430436,NaN,NaN,113.55169866621897,135.83012519709578,0.016686918701050046,0.23776057962405517,0.22107366092300512,46430116,46784730,46.571732620855464,36.63763524923604,NaN,NaN,28.211900527261342,24.729543288385717
2004-12-17T09:30:00-05:00,24.396693,24.461643,24.315506,24.364211,3848276,3851650.5,55.284029431766974,62.80188295447788,NaN,NaN,39.76474212644005,127.1526511638555,-0.00481392170928055,0.21505625878640444,0.219870180495685,42581840,46716935.6,46.441652651602205,36.514807048893296,NaN,NaN,25.40909774831077,24.826622496946438
2004-12-20T09:30:00-05:00,24.364211,24.534711,24.315506,24.323633,3574463,3463263.3,53.96478092035778,62.647751803862164,NaN,NaN,38.34478871944613,103.14085525245109,-0.022631985835797258,0.1915801982009384,0.21421218403673567,39007377,45296264.8,43.687848777566025,36.411111297277195,NaN,NaN,22.74882485257663,24.529794262036464
2004-12-21T09:30:00-05:00,24.071937,24.640263,24.071937,24.640263,2869671,3512988,61.654160204144766,62.295850888016865,NaN,NaN,54.83986547952638,83.14330995153395,-0.014359941839711399,0.1962622567370964,0.2106221985768078,41877048,44075379.8,41.41510689959239,36.24837348809912,NaN,NaN,22.854538607483992,24.290472025671825
2004-12-22T09:30:00-05:00,24.68084,24.835103,24.583424,24.778272,2561124,3548233.8,64.44206317396599,62.24604423126839,NaN,NaN,154.42100996489722,80.18442099130576,-0.0015352034535429104,0.20870319425987915,0.21023839771342206,44438172,42866910.6,39.239129739325044,36.212568681663214,NaN,NaN,23.8689928582881,24.230260716045578
2004-12-23T09:30:00-05:00,24.84323,24.900053,24.794502,24.826985,1588185,3517151.25,65.39832897552242,62.28613766688575,NaN,NaN,170.69926554423708,91.61393436690938,0.007775618528847561,0.21995792087448152,0.21218230234563396,46026357,42786158.8,39.09132876811483,36.52924261623729,NaN,NaN,24.979879280158183,24.33734908234738
2004-12-27T09:30:00-05:00,24.883807,24.883807,24.656492,24.697085,970229,3530780.3,60.709667446846076,62.03716293777031,NaN,NaN,117.0374590850999,107.06847775864135,0.0029795105165655866,0.21590669049134092,0.21292717997477534,45056128,43281016.4,40.568687484013026,37.17773740314014,NaN,NaN,24.440252593627456,24.35204958395882
2004-12-28T09:30:00-05:00,24.737679,24.84323,24.697085,24.810747,879943,3242039.4,63.19604752825741,62.5048943358317,NaN,NaN,115.46072606961322,122.49166522867476,0.0051296389150662924,0.21933922861860822,0.21420958970354192,45936071,44666755.2,44.61956413421765,38.28038589609885,NaN,NaN,24.7607054410447,24.410428992113946
2004-12-29T09:30:00-05:00,24.810747,24.842499,24.713323,24.753924,2948132,3075245.4,61.11388208821995,62.70332102142241,NaN,NaN,99.20992691465594,131.36567751570067,0.0006291745406553084,0.21499605787936105,0.21436688333870574,42987939,44888933.4,45.263753366659905,39.60385148570308,NaN,NaN,24.39733125406439,24.408557886678295
2004-12-30T09:30:00-05:00,24.762035,24.875697,24.762035,24.786391,1164472,2832133.95,61.886573346255624,62.72664703048594,NaN,NaN,101.11515661080134,120.70450684488151,-0.002106985575023007,0.211733151369927,0.21384013694495,44152411,44831781.2,45.118366007869476,40.986085061050275,NaN,NaN,24.32147651327374,24.396117690477645
2004-12-31T09:30:00-05:00,24.84323,24.932536,24.762035,24.786391,701836,2600668.4,61.88657334625562,62.680312915230026,NaN,NaN,96.90135448183104,105.94492463240029,-0.005661045771865603,0.20676382973011798,0.21242487550198358,44152411,44456992,44.117613035552175,42.187748439799954,NaN,NaN,24.259492053179248,24.37659974229216
2005-01-03T09:30:00-05:00,24.965002,24.997469,24.664611,24.697085,5014595,2594676.05,58.19744973347836,62.10670802893566,NaN,NaN,75.20010264160493,97.5774533437013,-0.015227837802378963,0.1933900782490099,0.20861791605138885,39137816,43273329.6,41.02286708471523,42.85002330948402,NaN,NaN,23.19043522219397,24.20714766799242
2005-01-04T09:30:00-05:00,24.802628,24.84323,24.412939,24.461643,7431118,2867681.7,49.773546965340145,60.80984379016529,NaN,NaN,-4.550382373521191,73.57523165507442,-0.03735313741067975,0.16192649428803918,0.19927963169871893,31706698,40427455,34.71720933253587,42.5637678365345,NaN,NaN,19.64938193794724,23.556038277985966
2005-01-05T09:30:00-05:00,24.437295,24.624017,24.412939,24.42105,2945052,2825679.9,48.47085432420341,59.2369126281692,NaN,NaN,-44.77194497357852,44.778857277427534,-0.05367007817109201,0.1321920339848539,0.18586211215594592,28761646,37582196.4,29.787424070442242,41.54730599807583,NaN,NaN,16.348655774173853,22.526412206012807
2005-01-06T09:30:00-05:00,24.485999,24.615907,24.461643,24.54283,3213815,2766624.9,52.4883292618102,58.461877624744616,NaN,NaN,-32.260445335087326,18.103736888249802,-0.05500650064357787,0.11710398635147357,0.17211048699505144,31975461,35146806.4,26.33974931800084,40.1021643335862,NaN,NaN,14.64261080598,21.400154863150977
2005-01-07T09:30:00-05:00,24.640263,24.640263,24.412939,24.412939,1520563,2763890.45,48.17411460918788,57.954026565988976,NaN,NaN,-60.94697146254861,-13.465928300626132,-0.06281905132873011,0.0935866728341388,0.1564057241628689,30454898,32407303.8,23.100773248829796,38.434958661959605,NaN,NaN,11.864706737921562,20.037947988118205
2005-01-10T09:30:00-05:00,24.3561,24.550957,24.315506,24.437295,3744318,2829295,49.020266155778614,57.6008469399476,NaN,NaN,-91.4052352500656,-46.78699587896025,-0.0642943063817393,0.07603784118569479,0.1403321475674341,34199216,31419583.8,22.048052574961957,36.88925893320218,NaN,NaN,9.830540667834754,18.579746942363425
2005-01-11T09:30:00-05:00,24.3561,24.453524,24.283032,24.331744,7435548,3041576.45,45.54949441093581,56.45051366900411,NaN,NaN,-117.09122228222323,-69.29516386070065,-0.06986395352263301,0.05300220566414282,0.12286615918677583,26763668,30430977.8,21.01575318294367,35.432162239155836,NaN,NaN,7.056611218257995,16.93358469606265
2005-01-12T09:30:00-05:00,24.396693,24.396693,24.120666,24.299261,4751130,3185595.85,44.50516086927634,55.026449218669136,NaN,NaN,-134.70294077419248,-87.28136302082345,-0.0728856530541932,0.03175909286903433,0.10464474592322753,22012538,29081156.2,19.662112415606998,34.03380385889026,NaN,NaN,4.45502933943918,15.150933930830725
2005-01-13T09:30:00-05:00,24.323633,24.323633,24.03136,24.063827,8485838,3484935.5,37.74954272047136,53.05153591473692,NaN,NaN,-162.9350713496885,-113.41628822374369,-0.08693768344650432,-0.004027358384902868,0.08291032506160145,13526700,25391404,16.52818373798364,32.422150642452316,NaN,NaN,-0.07134584586424146,12.976322534160015
2005-01-14T09:30:00-05:00,24.071937,24.193726,24.047589,24.145022,6412972,3603064,41.07172338973475,51.64882562494325,NaN,NaN,-143.2242115083088,-129.87173623289573,-0.08676200923308156,-0.025542186479750484,0.061219822753331064,19939672,23288358.8,15.055250663256857,30.59976229811259,NaN,NaN,-2.8666806807623075,10.713036360599684
2005-01-18T09:30:00-05:00,24.047589,24.54283,24.047589,24.526601,7200660,3770683.2,53.603344126243286,50.96363252479939,NaN,NaN,-59.512346270814476,-123.49315843704548,-0.05831034124439142,-0.011668103802158214,0.046642237442233205,27140332,21876582,14.144011059086793,28.422937078460386,NaN,NaN,-1.23254644602594,9.006524531081737
2005-01-19T09:30:00-05:00,24.559067,24.559067,24.274905,24.283032,4416101,3812765.1,46.76670706484679,49.93883430884416,NaN,NaN,-58.93231189370902,-111.86137635934264,-0.05338989544213029,-0.02009513186042966,0.03329476358170063,22724231,21068694.6,13.635404338768453,26.163769290753855,NaN,NaN,-2.2687046602796643,7.3957775037443945
2005-01-20T09:30:00-05:00,24.03136,24.234328,24.03136,24.10442,4999938,3919278.45,42.48730467259495,48.55317226072554,NaN,NaN,-127.79500294785082,-110.47978879407432,-0.05920921137041825,-0.040716750631322185,0.018492460739096064,17724293,20211045.6,13.096980688152073,23.876527482202615,NaN,NaN,-4.6352040997562165,5.67706584610145
2005-01-21T09:30:00-05:00,24.153132,24.193726,23.958276,23.982632,5056102,4044027.35,39.812198388125154,46.97643119228764,NaN,NaN,-134.93136314710338,-104.87904715355731,-0.06769361903245051,-0.06612456305146708,0.0015690559809834366,12668191,20039343.8,12.986421321550466,21.652870931202493,NaN,NaN,-7.45038118059029,3.8017162708597727
2005-01-24T09:30:00-05:00,24.136895,24.185599,23.990759,23.990759,6613743,4295305.25,40.08330502821513,45.68256371334028,NaN,NaN,-118.21095398964901,-99.87639564982534,-0.06895852864666388,-0.08462910482734642,-0.015670576180682537,19281934,19907796.2,12.896597348644832,19.64385166434032,NaN,NaN,-9.534825614884785,1.8964960014676933
2005-01-25T09:30:00-05:00,24.10442,24.412939,23.998877,24.007004,3231428,4408365.2,40.658695810298205,45.03150291655157,NaN,NaN,-84.73858882675181,-104.92164416101282,-0.06495684586674833,-0.09686663351411795,-0.03190978764736962,22513362,18982402.2,12.25446357850683,18.03936982476682,NaN,NaN,-11.019883165297435,0.05129897764410374
2005-01-26T09:30:00-05:00,24.071937,24.145022,23.998877,24.120666,2404448,4484590.45,44.66286124046058,44.759503410569934,NaN,NaN,-91.53758579242269,-111.44269894075555,-0.05149896468155833,-0.09628349349931753,-0.0447845288177592,24917810,19421118,14.42974023552884,16.94239240798729,NaN,NaN,-11.076941893608637,-1.5384497182491448
2005-01-27T09:30:00-05:00,24.071937,24.153132,23.925809,23.998877,1783413,4426354.5,41.436483097050655,43.97008582737283,NaN,NaN,-100.99044317520998,-106.08178698622737,-0.04772816210862779,-0.10444473145354394,-0.056716569344916146,23134397,20503138.8,19.716079774134045,16.469273154853944,NaN,NaN,-12.092683481308567,-3.046197398686205
2005-01-28T09:30:00-05:00,23.950165,24.071937,23.852741,23.966402,3088425,4522552.15,40.594389209490146,43.42867687025156,NaN,NaN,-108.82223403971967,-100.85996116475063,-0.04441811147971868,-0.1122392086945645,-0.06782109721484582,20045972,21978695,26.394127212242523,16.704512723669133,NaN,NaN,-13.166066925989133,-4.491893045443766
2005-01-31T09:30:00-05:00,23.990759,24.266794,23.990759,24.250557,4744109,4724665.8,50.142158675211725,43.50881205021107,NaN,NaN,-37.986222669853206,-84.81501490079147,-0.02126254481112863,-0.0943992782287566,-0.07313673341762797,24790081,23080324.4,31.008184160873213,17.344522122662795,NaN,NaN,-11.125324865456049,-5.439526162588378
2005-02-01T09:30:00-05:00,24.3561,24.60778,24.274905,24.510355,4154113,4681641.7,56.954107274767594,44.32342725477048,NaN,NaN,77.55126617647143,-52.35704390014682,0.011612008575054594,-0.05862172269880972,-0.07023373127386431,28944194,24366490.8,36.04860535602913,18.418297277883187,NaN,NaN,-6.994218709239927,-5.661625097824314
2005-02-02T09:30:00-05:00,24.559067,24.559067,24.412939,24.510355,10033010,4811736.3,56.95410727476759,45.21263771230557,NaN,NaN,92.54858207707763,-15.539810326246762,0.032248728595727784,-0.029922820529204586,-0.06217154912493237,28944194,25171767.6,39.05100508766938,19.8032181830305,NaN,NaN,-3.7892104989004354,-5.3941372979780455
2005-02-03T09:30:00-05:00,24.477872,24.477872,24.331744,24.396693,6482810,4988624.2,53.26176222097452,46.32065339091294,NaN,NaN,59.59589789504566,16.57745788780436,0.036806056104520465,-0.01616397899428179,-0.05297003509880226,22461384,25037165,38.723748178111855,21.388615643039657,NaN,NaN,-2.226145604113798,-4.941567055997439
2005-02-04T09:30:00-05:00,24.477872,24.737679,24.461643,24.688967,5070393,5081453.1,60.375538137100584,47.69949730143907,NaN,NaN,145.24727273236186,67.39135924222067,0.05686822799035268,0.018115249889138596,-0.038752978101214086,27531777,26534326,44.31366077500051,23.478502079592776,NaN,NaN,1.5838631236442418,-4.009362744620056
2005-02-07T09:30:00-05:00,24.826985,24.826985,24.599661,24.713323,3952849,5203067.4,60.90948701999504,48.22136465099277,NaN,NaN,162.94118455108477,107.57684068640829,0.06836932870198723,0.04670868277626994,-0.02166064592571728,31484626,27873235,48.81101011456563,25.954716297841262,NaN,NaN,4.749961902313808,-2.758030652200932
2005-02-08T09:30:00-05:00,24.68084,24.729568,24.615907,24.615907,4566617,5244182.35,57.568096866095935,48.99289249393913,NaN,NaN,128.70847101406522,117.80828165392704,0.06597457706496936,0.06080757540549442,-0.005167001659474937,26918009,27467998,47.55906868777197,28.377835179912942,NaN,NaN,6.364009919054663,-1.4548819991644184
2005-02-09T09:30:00-05:00,24.68084,24.713323,24.534711,24.550957,2700801,5007445,55.38647480430146,49.91426178906103,NaN,NaN,98.99062580289814,119.09669039909113,0.05691724608824594,0.06597955595083249,0.009062309862586548,24217208,26522600.8,44.679892521898026,30.633757453751937,NaN,NaN,7.047011779429361,-0.2403257450795926
2005-02-10T09:30:00-05:00,24.721441,24.721441,24.559067,24.624017,8900439,5214910.45,57.344670714221564,51.166581240925055,NaN,NaN,96.9436419695415,126.56623921399031,0.05283648957980547,0.07510792183734338,0.022271432257537915,33117647,28653853.4,51.76864280412863,33.40391613107895,NaN,NaN,8.191256261680158,0.9641859701718003
2005-02-11T09:30:00-05:00,24.559067,24.859459,24.559067,24.818874,2652518,4923244.45,62.12016865647432,52.74064292865786,NaN,NaN,115.78928965278682,120.6746425980753,0.05974124848764166,0.09694799286709,0.037206744379448334,35770165,30301531,56.41822153444486,36.512603572921805,NaN,NaN,10.677343502581623,2.3517799033732034
2005-02-14T09:30:00-05:00,24.84323,24.883807,24.713323,24.778272,6360994,4920645.55,60.59780517962686,54.164865026467055,NaN,NaN,116.62784362487626,111.41197441283359,0.058006951067518596,0.10971543321384658,0.051708482146327985,29409171,29886440,54.98026191500952,39.56444631124343,NaN,NaN,12.2645463365663,3.7678893938293596
2005-02-15T09:30:00-05:00,24.818874,24.883807,24.753924,24.835103,7012947,4911259.9,62.00150635934072,55.403339677815644,NaN,NaN,110.09433692917368,107.68914759585527,0.057034512107580204,0.12300162228080325,0.06596711017322304,36422118,31787261.8,60.00708014940542,42.819970590806044,NaN,NaN,13.994061292213903,5.22877109359858
2005-02-16T09:30:00-05:00,24.68084,24.770146,24.624017,24.664611,3656004,4873255.05,55.60197911931299,56.415160822262955,NaN,NaN,67.59139571527943,101.40930157833154,0.041953352145986195,0.11840880035570578,0.07645544820971958,32766114,33497043,63.91057813326046,45.976720473600786,NaN,NaN,13.634317225307587,6.429563398128438
2005-02-17T09:30:00-05:00,24.559067,24.688967,24.445406,24.445406,2259351,4736225.7,48.64928326876006,56.99051039792509,NaN,NaN,24.34059778901525,86.8886927422263,0.015615328484137797,0.09597460881489184,0.08035928033075404,30506763,32974866.2,61.92273240531525,48.51447798739169,NaN,NaN,11.11142731379372,7.098401100366335
2005-02-18T09:30:00-05:00,24.518474,24.518474,24.185599,24.185599,10981683,5032504.75,41.953302336077684,56.40559208798694,NaN,NaN,-40.95090335306415,55.540654141056095,-0.01902431182005862,0.05657889055568077,0.07560320237573939,19525080,29725849.2,51.24293484720123,49.95981732212941,NaN,NaN,6.601063522017242,7.027352874887893
2005-02-22T09:30:00-05:00,24.03136,24.161243,23.812147,23.828393,8724428,5138039,34.85091263801412,54.826792471075976,NaN,NaN,-135.0548679224903,5.2041118315827815,-0.06322379380591558,-0.0034265398816550885,0.059797253924260496,10800652,26004145.4,42.253197658883224,50.40300248661898,NaN,NaN,-0.06178777567310712,6.014618496236322
2005-02-23T09:30:00-05:00,23.828393,24.088183,23.828393,24.047589,10597755,5506355.35,41.40615708436026,53.7162246003326,NaN,NaN,-114.39053345715651,-39.69286224568326,-0.07416946059628175,-0.0329145718210917,0.041254888775190054,21398407,22999403.2,36.661168835272356,50.23229989716206,NaN,NaN,-3.18472195462974,4.700427003255456
2005-02-24T09:30:00-05:00,24.03136,24.136895,23.958276,24.077629,19081627,6340214.3,42.26355530777215,52.930638392246706,NaN,NaN,-95.38336399338849,-72.28781418741684,-0.07560093712901426,-0.05324628263607778,0.022354654492936485,40480034,24542187.2,40.98023529544588,50.3934775484002,NaN,NaN,-5.284714373310774,3.2739782351745657
2005-02-25T09:30:00-05:00,24.047589,24.3561,24.047589,24.323633,13529875,6927537.4,48.86280314319361,52.10830017839621,NaN,NaN,-53.49047283074345,-87.85402831136858,-0.05703943538657671,-0.0489446397402844,0.008094795646292306,54009909,29242816.4,51.77123202939436,50.92616120942834,NaN,NaN,-4.817180317265686,2.118098441968815
2005-02-28T09:30:00-05:00,24.274905,24.274905,24.039471,24.088183,9935578,7269895.05,43.71294063989491,50.879975436960486,NaN,NaN,-88.63135981074917,-97.39011960290559,-0.05751501188691647,-0.06379896921235328,-0.006283957325436814,44074331,34152666.6,59.99821172483508,51.72524703873329,NaN,NaN,-6.20861430604732,0.9285680493950816
2005-03-01T09:30:00-05:00,24.234328,24.412939,24.153132,24.323633,6162316,7340805.4,49.450400480749245,50.300139980864294,NaN,NaN,-46.25349758613717,-79.62984553563497,-0.039714903476416666,-0.05592758667095765,-0.016212683194540983,50236647,42039865.6,69.11304279369972,53.26481661772813,NaN,NaN,-5.358707205217241,0.030385870164749806
2005-03-02T09:30:00-05:00,24.323633,24.445406,24.185599,24.250557,7734983,7519848.9,47.82113544383353,49.75975859797372,NaN,NaN,-42.96996644000296,-65.34573213220425,-0.030991951167301104,-0.05495262215366736,-0.02396067098636626,42501664,46260517,72.69815375641619,55.26612099162229,NaN,NaN,-5.230030621374701,-0.7211022000551718
2005-03-03T09:30:00-05:00,24.274905,24.396693,24.088183,24.209972,6596870,7348041.9,46.89698575588661,49.01349538666409,NaN,NaN,-54.784249446404225,-57.2259092228074,-0.02627151938200389,-0.05680007021387112,-0.030528550831867233,35904794,45345469,70.7799841182331,56.62407394262975,NaN,NaN,-5.4163753471442915,-1.3918555067821887
2005-03-04T09:30:00-05:00,24.364211,24.575305,24.347989,24.518474,9140871,7480944.95,54.1502936493351,48.44421860043986,NaN,NaN,11.489812714430709,-44.22985211377257,-0.0019694478376808683,-0.03299036062896832,-0.03102091279128745,45045665,43552620.2,67.04723358494641,57.38328908909415,NaN,NaN,-3.1761808469061505,-1.6467591267998976
2005-03-07T09:30:00-05:00,24.518474,24.672729,24.518474,24.518474,3546503,7404750.45,54.150293649335104,47.983682062561876,NaN,NaN,36.81937279376575,-19.139705592869586,0.013648673247493338,-0.013960071231920779,-0.027608744479414117,45045665,43746887,67.24878484996427,58.25961215587663,NaN,NaN,-1.4309291523799312,-1.6159262733113309
2005-03-08T09:30:00-05:00,24.599661,24.599661,24.396693,24.477872,14757533,7944984.65,53.04439519385191,47.3438884078841,NaN,NaN,19.199887982883638,-6.0490284790654245,0.02038290183244425,-0.0021301171888588044,-0.022513019021303055,30288132,39757184,59.23563342822933,58.204508818649764,NaN,NaN,-0.3360586571828987,-1.4330880424358405
2005-03-09T09:30:00-05:00,24.559067,24.559067,24.177489,24.177489,9136069,8173457.25,45.62115786259544,46.63097260383285,NaN,NaN,-29.704573716196585,-3.395949934304146,0.004570786037117594,-0.016799536474906063,-0.021370322512023657,21152063,35487263.8,52.08281454589642,57.359668562409475,NaN,NaN,-1.66689249216779,-1.4664886781118334
2005-03-10T09:30:00-05:00,24.218082,24.380456,24.16937,24.315506,11296759,8603255.15,49.1428226310953,46.66622541542823,NaN,NaN,-30.612861597829294,1.4383276354108403,0.0034232016894948925,-0.01709132040015504,-0.020514522089649934,32448822,34796069.4,51.00905604829851,56.58012025119399,NaN,NaN,-1.6836064215342037,-1.4975054986007434
2005-03-11T09:30:00-05:00,24.274905,24.347989,24.007004,24.10442,15428704,8929668.4,44.40615651964924,46.84142928568333,NaN,NaN,-65.31969549405636,-13.923574006286572,-0.010759520238930655,-0.03396392238831325,-0.023204402149382596,17020118,29190960,43.22637015920745,56.00750848776586,NaN,NaN,-3.2056222330324755,-1.7415221749481338
2005-03-14T09:30:00-05:00,24.03136,24.250557,24.03136,24.234328,10308916,9312488.3,47.74431802343852,47.76238681321365,NaN,NaN,-55.27746310918586,-32.3429411868769,-0.010582968572202384,-0.036433112864635575,-0.02585014429243319,27329034,25647633.8,39.15889958076584,55.786487196471754,NaN,NaN,-3.4257548504495414,-1.9821268428769063
2005-03-15T09:30:00-05:00,24.29115,24.3561,24.047589,24.071937,11010012,9544939.2,44.17361045242317,47.96006205378957,NaN,NaN,-56.70884084684035,-47.52468695282169,-0.020045276121650406,-0.050906739444496196,-0.03086146332284579,16319022,22853811.8,36.261590781780754,55.75794590693665,NaN,NaN,-4.729881581379286,-2.374663234091532
2005-03-16T09:30:00-05:00,24.03136,24.063827,23.79591,23.828393,11046719,9746627.8,39.412906113011836,47.75644425416384,NaN,NaN,-148.57930013402856,-71.29963223638808,-0.04018631172736837,-0.08109435298205625,-0.04090804125468788,5272303,19677859.8,33.249873606802,55.20577721489065,NaN,NaN,-7.405627165938113,-3.093372367212472
2005-03-17T09:30:00-05:00,23.828393,23.877097,23.698485,23.763435,9461245,10036889.85,38.22946559478739,46.99692014356339,NaN,NaN,-174.757884647432,-100.12863684630864,-0.05447620678565719,-0.10900329973675937,-0.05452709295110218,-4188942,12350307,27.562023513119286,53.476548035156725,NaN,NaN,-9.92909949522414,-4.069904814071282
2005-03-18T09:30:00-05:00,23.747198,23.747198,23.406212,23.519874,14995011,10673672.85,34.095517247432596,46.30996132981608,NaN,NaN,-220.71400923945967,-131.2074995953893,-0.07562348430851597,-0.14905644833674714,-0.07343296402823117,-19183953,5109492.8,23.317298951218177,50.856482837041234,NaN,NaN,-13.462743704037711,-5.411738941209343
2005-03-21T09:30:00-05:00,23.463035,23.495518,23.268194,23.308796,23394385,11294307.95,30.96996058291934,44.98992990854252,NaN,NaN,-224.22872104997938,-164.99775118354802,-0.0977149106870405,-0.19557660238703178,-0.09786169169999129,-42578338,-8871981.6,17.661280128442257,47.181356932379984,NaN,NaN,-17.492867333882742,-7.137614425876971
2005-03-22T09:30:00-05:00,23.422458,23.438687,22.878488,22.878488,24760988,12096135.95,25.781292272661773,43.41565539631597,NaN,NaN,-238.1107431657365,-201.27813164732723,-0.13300807659357347,-0.26412178744195813,-0.13111371084838466,-67339326,-25603651.2,13.45508037806762,42.949708833926515,NaN,NaN,-22.99393023639935,-9.402802398808738
2005-03-23T09:30:00-05:00,22.781072,23.065227,22.781072,22.927217,17043494,12418422.9,27.267355866340907,42.01353897563413,NaN,NaN,-205.90108166073927,-212.74248795266936,-0.14385153646651144,-0.310928131431524,-0.16707659496501254,-50295832,-36717278.2,11.496526284194019,38.71517613149515,NaN,NaN,-26.7739955692866,-11.884401423162718
2005-03-24T09:30:00-05:00,22.894734,23.081456,22.813555,22.813555,5776661,11753174.6,25.961582958378344,40.00005964056579,NaN,NaN,-165.76889507407492,-210.94469003799796,-0.14883750967783665,-0.35312348206230837,-0.20428597238447171,-56072493,-47093988.4,10.028676977569319,34.642422088111076,NaN,NaN,-30.263847210213147,-14.510036535598493
2005-03-28T09:30:00-05:00,22.902861,23.097701,22.894734,22.975921,4504538,11301907.75,31.041721105421047,38.34944731600051,NaN,NaN,-128.23594462874695,-192.4490771158554,-0.13193605787381588,-0.36920604472674157,-0.2372699868529257,-51567955,-53570788.8,9.236020131295007,30.498653179634697,NaN,NaN,-31.582554651096917,-16.94896769495541
2005-03-29T09:30:00-05:00,22.943438,23.178889,22.870378,22.894734,6741227,11142190.2,29.93564968448105,36.69882263675972,NaN,NaN,-110.70052459716628,-169.7434378252928,-0.11744426864392232,-0.3840753226578286,-0.2666310540139063,-58309182,-56716957.6,8.869298089921301,26.901057798326985,NaN,NaN,-32.992619903433194,-19.240918010452237
2005-03-30T09:30:00-05:00,22.894734,23.178889,22.870378,23.178889,6684322,11168290.5,38.23144978051855,36.170986345182804,NaN,NaN,-87.05783414397,-139.53285602093948,-0.08163954059130296,-0.368680479753035,-0.287040939161732,-51624860,-53574064.4,12.602516157005624,24.081036484834787,NaN,NaN,-31.597613949682135,-21.00616028748508
2005-03-31T09:30:00-05:00,23.21949,23.268194,23.048989,23.048989,9887295,11275906.1,36.1256577656928,35.24118885479691,NaN,NaN,-72.44864343918101,-112.84236837662782,-0.06059116815890109,-0.36277989936035837,-0.3021887312014573,-61512155,-55817329,12.21779416659858,21.310232064713368,NaN,NaN,-31.09179134439433,-22.4469647241864
2005-04-01T09:30:00-05:00,23.21949,23.349373,22.66741,22.73236,16896668,11790896,31.562253605895847,34.323767218100244,NaN,NaN,-86.89010138761243,-97.06660963933533,-0.06167369303327097,-0.379280847493046,-0.31760715445977505,-78408823,-60284595,11.46705733133274,19.041709719865175,NaN,NaN,-32.12187170905909,-23.829094293453927
2005-04-04T09:30:00-04:00,22.73236,22.992167,22.496926,22.894734,14892652,12078485.05,36.02530490571698,33.4866948525487,NaN,NaN,-92.28443076714,-89.87630686701394,-0.04586126860671158,-0.3749337402181645,-0.3290724716114529,-63516171,-62674238.2,11.07503050797959,17.035719071809012,NaN,NaN,-31.53200691113095,-24.9295103816935
2005-04-05T09:30:00-04:00,22.943438,23.113939,22.91909,22.959684,10596894,12431004.6,37.77337864772715,33.02953543792756,NaN,NaN,-62.35892590867168,-80.20798712931501,-0.026401175656958098,-0.36207394118265057,-0.3356727655256925,-52919277,-61596257.2,12.527799561584985,15.340448270366457,NaN,NaN,-30.517437318801267,-25.72778565842318
2005-04-06T09:30:00-04:00,23.097701,23.21949,23.0571,23.113939,8940715,12140163.7,41.83813594675473,33.202766140337765,NaN,NaN,-40.71536004435589,-70.9394923093922,0.00008448511431363714,-0.33556715913280044,-0.3356516442471141,-43978562,-60066997.6,14.657856412802886,14.01244704222366,NaN,NaN,-28.411992122000125,-26.111243724648457
2005-04-07T09:30:00-04:00,23.113939,23.316906,23.065227,23.203245,13225394,12344629.95,44.114207361252376,33.62310483794241,NaN,NaN,-26.968861077062652,-61.84353583696851,0.025440127579178795,-0.3038514847731406,-0.3292916123523194,-30753168,-53915200.2,22.801783933228492,13.672429929374315,NaN,NaN,-25.9891918249793,-26.093807738981436
2005-04-08T09:30:00-04:00,23.211363,23.276313,22.992167,22.992167,6169091,12088246.55,40.11811847235406,34.05329063972251,NaN,NaN,-38.777733793484636,-52.22106231814297,0.029530523460489566,-0.2923784580267075,-0.32190898148719704,-36922259,-45617887.4,32.199519990505664,14.30687428932342,NaN,NaN,-25.076041922023766,-25.948412622273196
2005-04-11T09:30:00-04:00,23.138295,23.170762,22.975921,23.040871,7846825,11709152.6,41.43634835423545,34.80088976624509,NaN,NaN,-38.71423313331179,-41.50702279137733,0.03658922375386392,-0.27617245179486716,-0.3127616755487311,-29075434,-38729740,38.854270277834495,15.820659299994293,NaN,NaN,-23.944647372954698,-25.662160443799124
2005-04-12T09:30:00-04:00,23.0571,23.422458,22.902861,23.3575,14585833,11922998.45,49.25699460887386,36.4777256474031,NaN,NaN,4.061367632824819,-28.22296408307803,0.062153324349952244,-0.23507002011129075,-0.297223344461243,-14489601,-31043804.8,45.3052224946993,18.095669451182275,NaN,NaN,-20.467441792941337,-24.92005777939087
2005-04-13T09:30:00-04:00,23.3575,23.365619,22.967794,23.016523,5138508,11629423.25,42.65146654849049,37.576590696128065,NaN,NaN,-13.70841335026682,-22.82157474426021,0.05586760031968552,-0.22738884406163606,-0.2832564443813216,-19628109,-26173714.2,48.97835941299826,20.772943246096865,NaN,NaN,-19.515644006169595,-24.147998668930686
2005-04-14T09:30:00-04:00,22.975921,23.016523,22.740471,22.756716,5229656,11338570.1,38.42336443208864,38.46671794425023,NaN,NaN,-109.16505628943538,-39.26081378673476,0.035001277497689554,-0.23950484750920964,-0.2745061250068992,-24857765,-24994633.6,49.856366843482824,23.617778236519257,NaN,NaN,-20.11714720751482,-23.572162745871278
2005-04-15T09:30:00-04:00,22.813555,22.910971,22.456324,22.513155,13645412,11547778.45,34.927748764270504,38.744291348453764,NaN,NaN,-191.9198494060077,-69.88923690923937,0.007046971723401518,-0.26569741035264727,-0.2727443820760488,-38503177,-25310817.2,49.60982423303653,26.501621386643652,NaN,NaN,-21.7967079307683,-23.31852634371371
2005-04-18T09:30:00-04:00,22.610588,22.764827,22.537503,22.699893,10246588,11310357.3,39.474257707142314,39.42562049292957,NaN,NaN,-160.19477660992507,-94.18534560456203,0.003560081901719303,-0.26829427969889963,-0.27185436160061893,-28256589,-25147048.2,49.74843532737449,29.42155976074745,NaN,NaN,-21.679613534010926,-23.0843959423276
2005-04-19T09:30:00-04:00,22.935328,22.935328,22.708004,22.73236,8717528,10576514.45,40.255834860483645,39.57021942721279,NaN,NaN,-91.22691707361942,-113.24300254585087,0.005738353951180275,-0.26468141916164356,-0.27041977311282384,-19539061,-26156940.2,48.85595723559441,32.011091266360935,NaN,NaN,-21.344811096152636,-22.835883821445464
2005-04-20T09:30:00-04:00,22.813555,22.813555,22.415731,22.448197,13424808,10009705.45,35.88777737635293,39.55322797083137,NaN,NaN,-170.2743913669485,-144.5561981491872,-0.008866414675199608,-0.28150279145682333,-0.2726363767816237,-32963869,-28824092.2,46.484143969836545,34.45868768087793,NaN,NaN,-22.44981523862671,-22.78073116675707
2005-04-21T09:30:00-04:00,22.569986,22.643054,22.237119,22.578105,14303769,9872719.2,39.13903506230672,40.0944266462893,NaN,NaN,-166.34862920756294,-155.99291273281273,-0.006779609723855162,-0.28111088893644265,-0.2743312792125875,-18660100,-27584559.2,47.75359054070696,37.050582910118955,NaN,NaN,-22.34434388973767,-22.71839012718287
2005-04-22T09:30:00-04:00,22.651165,22.691766,22.350781,22.521282,15879515,10377861.9,38.225887258686186,40.25161110007281,NaN,NaN,-130.03203869109439,-143.61535058983003,-0.006241527667746882,-0.2821331887972711,-0.27589166112952423,-34539615,-26791846.8,48.59342342285834,39.73046811832457,NaN,NaN,-22.531119845729393,-22.691637229832374
2005-04-25T09:30:00-04:00,22.724249,22.829784,22.610588,22.805428,3605872,10332928.6,45.12096972164111,40.7764390339238,NaN,NaN,-48.549335089370146,-121.28626228571906,0.015071708449190258,-0.2570520255680364,-0.27212373401722667,-30933743,-27327277.6,48.0318096421399,42.26646883836421,NaN,NaN,-20.551423685453802,-22.385892437778292
2005-04-26T09:30:00-04:00,22.772954,22.910971,22.651165,22.675521,12289403,10610337.4,42.77050869763293,40.84303708755796,NaN,NaN,-44.85193548341619,-112.01126596767843,0.02183088696519242,-0.24483512531073615,-0.26666601227592857,-43223146,-32064094.6,43.26759859538522,44.31002185140581,NaN,NaN,-19.61879100305835,-21.9905922328183
2005-04-27T09:30:00-04:00,22.488799,23.040871,22.488799,22.992167,7127743,10632508.45,49.65479437943931,41.23879330314274,NaN,NaN,-11.098973189426896,-80.1761823321741,0.04756174905249538,-0.20721382596030935,-0.25477557501280473,-36095403,-32690401.4,42.665012476623055,45.7288238902197,NaN,NaN,-16.585688529774323,-21.218463132383448
2005-04-28T09:30:00-04:00,22.975921,23.016523,22.740471,22.740471,9891607,10632724.05,45.01902256101476,41.58885788090422,NaN,NaN,-9.610771725845309,-48.828610835830574,0.04745617901455207,-0.19545535124461466,-0.24291153025916673,-45987010,-38155783.4,37.7272563900897,46.12366220447571,NaN,NaN,-15.489896600131194,-20.40009648491884
2005-04-29T09:30:00-04:00,22.862259,23.113939,22.634936,23.089583,14007658,10488273.55,51.74800349255736,42.32540467649864,NaN,NaN,30.33340320310169,-16.75552245699135,0.06939636874279748,-0.1561660693306699,-0.22556243807346738,-31979352,-37643730.8,38.44603071662209,46.09450223581768,NaN,NaN,-12.26622344434075,-19.238114621979115
2005-05-02T09:30:00-04:00,23.29255,23.300669,22.975921,23.146406,9584172,10222849.55,52.76139662181055,42.57571910599412,NaN,NaN,87.59831772438119,10.474008105758895,0.08519290309374133,-0.11907130920629072,-0.20426421230003206,-22395180,-35936018.2,40.89619328157728,45.779571577737535,NaN,NaN,-9.402259439502021,-17.832992453053816
2005-05-03T09:30:00-04:00,23.178889,23.341263,23.0571,23.170762,17966420,10591325.85,53.2149581190874,43.33025421817962,NaN,NaN,95.5789786539658,38.5601909332353,0.0940444928932948,-0.08670859618341353,-0.18075308907670834,-4428760,-28177141,50.530958037851526,45.89047147951277,NaN,NaN,-6.983200365508731,-16.28302215483309
2005-05-04T09:30:00-04:00,23.178889,23.649773,23.154532,23.617298,15144420,10901511.1,60.670695372726534,44.91934928536803,NaN,NaN,165.24196253072137,73.82837807726494,0.12480730591811268,-0.02474395667906748,-0.14955126259718016,10715660,-18814928.4,59.17827402202188,46.55632199226556,NaN,NaN,-2.2995483573710396,-14.285383040909942
2005-05-05T09:30:00-04:00,23.706604,23.706604,23.325025,23.511763,13858620,10933172.4,58.30575751026389,46.58920705293899,NaN,NaN,160.14209307674773,107.77895103778356,0.13217466910009673,0.015667073777940743,-0.11650759532215597,-3142960,-10246118.4,65.17796255343185,47.66833187229379,NaN,NaN,0.7494867492379845,-12.137544499460239
2005-05-06T09:30:00-04:00,23.706604,23.706604,23.333152,23.341263,13136584,11281547.05,54.602644300993305,47.66980609535692,NaN,NaN,129.72109464886233,127.65648932693568,0.12004484087681074,0.033548455773857455,-0.08649638510295328,-16279544,-7106156.8,67.0869122182595,48.90679450735701,NaN,NaN,2.151865920743532,-10.096200153716843
2005-05-09T09:30:00-04:00,23.446806,23.568586,23.333152,23.54423,4852624,11131837,58.020680617557964,48.93872364943365,NaN,NaN,118.99507759796603,133.93584130165266,0.11989060142117781,0.06336686667351898,-0.05652373474765883,-11426920,-4912504.8,68.39063181282211,50.302128405730414,NaN,NaN,4.402517659344009,-8.024954751851007
2005-05-10T09:30:00-04:00,23.316906,23.422458,23.187007,23.235719,15594861,11182288.4,51.65443179566466,50.064913250813056,NaN,NaN,71.8827705556676,129.196599681993,0.09433592850038953,0.061396175877828085,-0.03293975262256145,-27021781,-9431109,62.86659275585664,51.47230331901757,NaN,NaN,4.32005557978451,-6.261381847331648
2005-05-11T09:30:00-04:00,23.300669,23.422458,23.122058,23.341263,11018515,11476288.75,53.53285880103535,51.093043517865105,NaN,NaN,70.3682889471057,110.22186496526987,0.08040938628218798,0.06757198023017352,-0.012837406052014454,-16003266,-14774894.2,57.0027133779593,52.132954950249875,NaN,NaN,4.832205472111239,-4.676583658839807
2005-05-12T09:30:00-04:00,23.463035,23.503637,23.105828,23.122058,16630496,12046330.75,49.25261471728381,51.88066690776493,NaN,NaN,53.20320426949249,88.83408720381883,0.053593191706033855,0.05415408358052787,0.000560891874494011,-32633762,-20673054.6,51.31353785275059,52.32724883809932,NaN,NaN,3.927116462746074,-3.447483641470395
2005-05-13T09:30:00-04:00,23.122058,23.187007,22.764827,22.91909,12179164,11973018.35,45.61576883175962,51.916009701344834,NaN,NaN,-11.540466166540606,60.58177504073825,0.021017819660044103,0.02683316644954914,0.005815346789505037,-44812926,-26379731,46.47993799790527,52.21640086351114,NaN,NaN,2.01808021103722,-2.666688805397879
2005-05-16T09:30:00-04:00,22.975921,23.325025,22.935328,23.325025,10461775,11983777.7,53.078252503387326,52.65227711604158,NaN,NaN,36.43362479715435,44.06948448057591,0.025351224669758726,0.037504377626703445,0.012153152956944718,-34351151,-30964577.2,42.97723423786047,52.19566055225937,NaN,NaN,2.7590530337994568,-1.891582828369688
2005-05-17T09:30:00-04:00,23.276313,23.503637,23.146406,23.471162,10532845,12074543.55,55.448331112605345,53.066101168410576,NaN,NaN,70.0811812518893,43.70916661982026,0.03595368985139073,0.05709526527118314,0.021141575419792405,-23818306,-30323882.2,43.616674243760684,52.26363639276919,NaN,NaN,4.120596633122326,-1.0327000481565434
2005-05-18T09:30:00-04:00,23.682248,23.804037,23.584824,23.747198,25652875,12685946.9,59.59945779762548,54.107560828168495,NaN,NaN,135.6991236656084,56.77533356352078,0.058137586732727745,0.09381355883570208,0.03567597210297434,1834569,-26756315.2,47.16925338030965,52.93806474921348,NaN,NaN,6.629819184819986,0.06194555655438938
2005-05-19T09:30:00-04:00,23.771554,23.79591,23.625425,23.771554,4382598,12189888.35,59.95401467792373,54.69370448426609,NaN,NaN,132.93860731711763,72.7224141730458,0.07022344715233625,0.12345528104339465,0.0532318338910584,6217167,-18986129.4,53.97165651672771,54.047038020649595,NaN,NaN,8.720711084189109,1.2989120605022062
2005-05-20T09:30:00-04:00,23.706604,23.771554,23.625425,23.747198,5945407,11693182.95,59.3926870973717,55.167368089663306,NaN,NaN,120.73565514275901,99.17763843490573,0.07207775369438374,0.14332902600903807,0.07125127231465433,271760,-9969192.2,60.35155921883891,55.43670701616828,NaN,NaN,10.24739198669339,2.5772663356723755
2005-05-23T09:30:00-04:00,23.625425,23.843648,23.625425,23.779664,5494596,11787619.15,59.9312193771245,55.64710103666596,NaN,NaN,118.32409638065566,115.555732751606,0.07088388218403754,0.15985612504470126,0.08897224286066371,5766356,-1945690.8,65.00036872331785,56.47023635084445,NaN,NaN,11.654694798010137,3.8740418302920556
2005-05-24T09:30:00-04:00,23.828393,23.828393,23.584824,23.698485,11306613,11738479.65,57.864785872594965,55.44667892951371,NaN,NaN,96.66845194196786,120.8731868896217,0.06042793933042631,0.1645071670236966,0.1040792276932703,-5540257,1709919,66.9043685009218,57.02210024219443,NaN,NaN,12.288842985314767,5.0761562810095855
2005-05-25T09:30:00-04:00,23.747198,23.747198,23.536119,23.617298,4681168,11616150.9,55.79285902738775,55.26718618073683,NaN,NaN,71.18693597163886,107.9707493508278,0.044576589358651636,0.15979996439158484,0.1152233750329332,-10221425,-701279.8,64.4152256239129,56.967619032943084,NaN,NaN,12.2747186308824,6.104522330991416
2005-05-26T09:30:00-04:00,23.698485,23.852741,23.625425,23.771554,7322110,11487676.05,58.81062478658757,55.567756215422136,NaN,NaN,96.68657889436223,100.72034366627672,0.04109827984840975,0.16659622484344538,0.12549794499503564,-2899315,-2524576.2,62.52100635993556,56.64148290020565,NaN,NaN,13.078933733708906,7.100866817093914
2005-05-27T09:30:00-04:00,23.771554,23.852741,23.763435,23.812147,4884649,11031525.6,59.59234353484436,55.68001785237117,NaN,NaN,107.6829454652956,98.10980173078403,0.03821011271038274,0.17326058588301407,0.13505047317263133,1985334,-2181861.4,62.74278127250509,56.23806500446873,NaN,NaN,13.963402256753316,8.081229022759542
2005-05-31T09:30:00-04:00,23.860859,23.860859,23.714731,23.771554,4033650,10753999.5,58.39875780915822,56.16175542476357,NaN,NaN,89.9014146186523,92.42526537838337,0.030575048441467412,0.1732692837244656,0.14269423528299818,-2048316,-3744795.8,60.970879949568015,56.10265694687668,NaN,NaN,14.40789780282468,8.985038848483134
2005-06-01T09:30:00-04:00,23.787791,24.120666,23.73096,23.958365,18695111,10790434.05,62.15542532894235,56.77765303389979,NaN,NaN,124.55980881051784,98.00353675209337,0.0348076690016092,0.1862038215350097,0.1513961525334005,16646795,692614.6,64.07307659852763,56.60768289120299,NaN,NaN,15.82003092548098,9.961466288054254
2005-06-02T09:30:00-04:00,23.86897,23.942054,23.820266,23.893326,4247601,10245593.1,60.119925870885474,57.55388954487133,NaN,NaN,96.5351255643184,103.07317467062929,0.030105031182504183,0.18902744151153072,0.15892241032902654,12399194,5216738.4,66.95679162699453,57.72505816079184,NaN,NaN,16.48911752028423,10.893987892658537
2005-06-03T09:30:00-04:00,23.917698,23.933928,23.698485,23.771554,4207077,9763015.95,56.396020187502046,58.32390749885293,NaN,NaN,65.32297467562124,96.80045382688108,0.01635928358417385,0.17937151480924385,0.16301223122507,8192117,7435024.8,68.30034424069706,59.283658606705536,NaN,NaN,16.074679599488313,11.634086707919932
2005-06-06T09:30:00-04:00,23.722841,23.844622,23.657892,23.828393,3997930,9306083.25,57.712681445087796,58.65493813754582,NaN,NaN,53.815843587092395,86.02703345124044,0.00902731540895546,0.1742963754862643,0.16526906007730885,12190047,9475967.4,69.52798554555083,61.18014084296914,NaN,NaN,16.06504049079402,12.267080105473374
2005-06-07T09:30:00-04:00,23.909572,24.03136,23.787791,23.812147,5205511,9323727.6,57.181202681352474,58.778714678170616,NaN,NaN,76.72072432672641,83.39089539285524,0.0014150447698667856,0.16703786603964232,0.16562282126977554,6984536,11282537.8,70.61286859553351,63.10844043952434,NaN,NaN,15.92034870663332,12.788975619924795
2005-06-08T09:30:00-04:00,23.79591,23.958276,23.79591,23.828393,6174878,8852728.45,57.601685196840435,58.636016635257405,NaN,NaN,69.01905416560415,72.2827444638725,-0.003903527858134359,0.16074341144710758,0.16464693930524193,13159414,10585061.6,69.5828544601304,64.70941194522582,NaN,NaN,15.900494123064963,13.233478263230532
2005-06-09T09:30:00-04:00,23.779664,23.966402,23.755308,23.901453,4128862,8508245.8,59.52655581148096,58.605483859082916,NaN,NaN,70.81341577382607,67.13840250577405,-0.0038710129616895406,0.15980817310313,0.16367918606481954,17288276,11562878,70.23828975144797,65.87131431913441,NaN,NaN,16.36127921271682,13.680306970300002
2005-06-10T09:30:00-04:00,23.860859,23.942054,23.73096,23.828393,8847965,8119119.25,56.7518456735688,58.41685232881128,NaN,NaN,55.49135809991196,65.17207919063219,-0.009802458772782685,0.1514261125988412,0.16122857137162389,8440311,11612516.8,70.27330898007324,66.58001073065115,NaN,NaN,16.0681261127556,14.021423990650801
2005-06-13T09:30:00-04:00,23.787791,23.982632,23.747198,23.828393,6446719,7832497,56.7518456735688,58.18975420712873,NaN,NaN,64.62254844159096,67.3334201615319,-0.014476203118681974,0.1431333174732714,0.15760952059195338,8440311,10862569.6,68.95323749279532,66.86235849989954,NaN,NaN,15.81863859332169,14.2781689338895
2005-06-14T09:30:00-04:00,23.787791,23.958276,23.787791,23.893326,3299912,7474403.85,58.73450933344253,58.251877311474985,NaN,NaN,80.92462921271775,68.17420113873018,-0.013939772590500554,0.14018480485382767,0.15412457744432823,11740223,11813707,69.72987527028724,67.06418041199707,NaN,NaN,16.0801328471585,14.535592350070786
2005-06-15T09:30:00-04:00,24.015115,24.03136,23.836503,23.950165,7577442,7326633.7,60.44397263021662,58.58409971167704,NaN,NaN,128.269315776711,80.02425346095154,-0.010650594573283406,0.14081133422772396,0.15146192880100737,19317665,13045357.2,70.75023515765062,67.51668109297835,NaN,NaN,16.732992077650046,14.849506596867823
2005-06-16T09:30:00-04:00,23.86897,24.088183,23.86897,24.071937,6170813,6352530.6,63.894836134134955,58.94725766507329,NaN,NaN,168.86692615468888,99.63495553712411,-0.0016403246821925788,0.14941152294826665,0.15105184763045923,25488478,14685397.6,72.09892459900033,68.20081811005439,NaN,NaN,18.227693095372867,15.33210466808283
2005-06-17T09:30:00-04:00,24.047589,24.071937,23.942054,24.055708,7553549,6511078.15,63.10469299113874,59.19813976909432,NaN,NaN,158.72550817178873,120.28178555149948,0.0016803187302711353,0.15315224604329813,0.151471927313027,17934929,16584321.2,73.61587011937864,68.9774673134025,NaN,NaN,19.3051604411141,15.899684064230154
2005-06-20T09:30:00-04:00,24.03136,24.080064,23.86897,23.998877,4680429,6447829.25,60.29289341055759,59.33343516919427,NaN,NaN,113.18343059802923,129.9939619827871,-0.0013342136950753036,0.14980416019418286,0.15113837388925816,13254500,17547159,74.37657558121853,69.93501700137755,NaN,NaN,19.543497914629512,16.42022890000149
2005-06-21T09:30:00-04:00,24.039471,24.120666,23.933928,24.088183,3189057,6332552.3,63.07708255665315,59.39926782831647,NaN,NaN,149.07165381531115,143.6233669033058,0.00116767804842266,0.15259797144978648,0.15143029340136382,16443557,18487825.8,75.13097253824385,70.72486671135728,NaN,NaN,20.48091390326265,17.000326757610228
2005-06-22T09:30:00-04:00,24.177489,24.209972,24.047589,24.055708,3713648,5952904.05,61.391341655239124,59.49008324148459,NaN,NaN,170.73475474427963,152.11645469681952,-0.0007784360011660607,0.15045724839990626,0.15123568440107232,12729909,17170274.6,71.93629384688296,71.0805454413493,NaN,NaN,20.855881854762455,17.551120342917688
2005-06-23T09:30:00-04:00,24.063827,24.112539,23.804037,23.836503,5432890,5990490.15,51.40492011151275,59.13357609319964,NaN,NaN,17.392560930099293,121.8215816519016,-0.017325353546954025,0.1295789924673798,0.14690434601433383,7297019,13531982.8,63.86099562920283,70.76344911195686,NaN,NaN,18.323900656832993,17.661517530619875
2005-06-24T09:30:00-04:00,23.86897,23.885215,23.755308,23.79591,4697796,5859274.45,49.78971461849092,58.567649891299865,NaN,NaN,-77.56584588226437,74.563310841091,-0.030718266544263212,0.10850651283400481,0.13922477937826802,2599223,10464841.6,57.954639314663495,69.93678152403633,NaN,NaN,15.73208457043354,17.385884250593257
2005-06-27T09:30:00-04:00,23.828393,23.828393,23.706604,23.787791,2756845,5752884.25,49.455004060183704,58.01577856121638,NaN,NaN,-107.33164181349699,30.46029635878576,-0.03928980400581056,0.09011252437100481,0.12940232837681537,-157622,7782417.2,53.31079627839133,68.70091921566903,NaN,NaN,13.487772411188297,16.829011130678264
2005-06-28T09:30:00-04:00,23.844622,23.998877,23.820266,23.966402,5378449,5820124.2,56.399098078477415,57.929879481333316,NaN,NaN,20.452213962569797,4.736408388237492,-0.03238384075407272,0.08892252743422446,0.12130636818829718,5220827,5537871.2,49.720652459296375,67.28219050132374,NaN,NaN,13.396484129380735,16.3386501304929
2005-06-29T09:30:00-04:00,24.03136,24.128776,24.007004,24.080064,3539113,5062324.3,60.15096171946633,57.97447990333227,NaN,NaN,130.93207733908721,-3.2241270928009897,-0.020209986033120825,0.09604388564689614,0.11625387168001697,8759940,4743877.4,48.47698139404839,65.72781133293806,NaN,NaN,14.4440622479696,16.067994718703858
2005-06-30T09:30:00-04:00,24.234328,24.234328,23.901453,23.925809,4860384,5092963.45,53.4311825832308,57.73728968259384,NaN,NaN,79.0118583382741,9.099732388833981,-0.022424266966900655,0.08822353797139115,0.11064780493829181,3899556,4064384.8,47.38463948645592,64.09290636910825,NaN,NaN,13.269418760213266,15.668198153205202
2005-07-01T09:30:00-04:00,24.080064,24.080064,23.901453,23.950165,4953502,5130284.7,54.29931609563713,57.56210899845586,NaN,NaN,39.69255484770818,32.551412534828486,-0.02209103012656867,0.08303401728008097,0.10512504740664964,8853058,5315151.8,49.63438569390663,62.71298838347335,NaN,NaN,12.576503953711764,15.226527553277569
2005-07-05T09:30:00-04:00,23.990759,24.16937,23.877097,24.145022,3201005,5090438.45,60.6237341589218,57.697053628847236,NaN,NaN,98.83263995872346,73.78426888927258,-0.009247201900070418,0.09356604503156163,0.10281324693163205,12054063,7757488.8,53.78943440747062,61.57438546470073,NaN,NaN,13.96818120804707,15.046763789673212
2005-07-06T09:30:00-04:00,24.112539,24.16937,23.966402,23.966402,5531183,5106722.05,53.33711385910453,57.18942085948209,NaN,NaN,67.10037760130786,83.11390161702019,-0.01304862544819245,0.08650246512139148,0.09955109056958393,6522880,8017899.4,54.22307146308574,60.39387377223181,NaN,NaN,12.760492023362326,14.720153537343085
2005-07-07T09:30:00-04:00,23.86897,24.03136,23.682248,24.015115,7791642,5187560.25,54.928179264735896,56.54894536881073,NaN,NaN,-35.79231217697363,49.76902371380802,-0.012546092007059556,0.08386847556075949,0.09641456756781905,14314522,9128815.8,56.115016207758885,59.252166030000275,NaN,NaN,12.297947236551396,14.374124065801416
2005-07-08T09:30:00-04:00,23.966402,24.274905,23.958276,24.258676,2800325,5121133.4,61.91960074750594,56.464295922836946,NaN,NaN,152.71082436611013,64.5088169193752,0.003091073901095351,0.10027840994418824,0.09718733604309289,17114847,11771874,60.31719208285611,58.30226045596295,NaN,NaN,14.281634198104179,14.360911227558953
2005-07-11T09:30:00-04:00,24.3561,24.477872,24.201845,24.364211,3588875,4858178.9,64.4899112425222,56.764082910834425,NaN,NaN,247.33292078342998,106.03689010651956,0.018579066108150438,0.12041116867828094,0.1018321025701305,20703722,14142006.8,63.676123317610035,57.53794243713378,NaN,NaN,16.77031918769662,14.705112364721478
2005-07-12T09:30:00-04:00,24.396693,24.469762,24.283032,24.364211,6685309,4870108.4,64.4899112425222,56.86499924553936,NaN,NaN,222.3053786715424,130.73143784908336,0.026384310384325385,0.13481249055053723,0.10842818016621185,20703722,15871938.6,65.94211043233261,56.8815951438544,NaN,NaN,18.704319790446764,15.276427711253662
2005-07-13T09:30:00-04:00,24.372337,24.510355,24.3561,24.469762,2754628,4842844.2,67.06821770212878,57.27049039174576,NaN,NaN,214.21322105984694,160.15400654079116,0.035640876347729625,0.15297927560087388,0.11733839925314425,23458350,19259032.6,69.90121650252038,56.736232476399934,NaN,NaN,21.151025153171137,16.115655917241874
2005-07-14T09:30:00-04:00,24.640263,24.68084,24.526601,24.591534,3674479,4647696.05,69.79316307298146,58.583936317564955,NaN,NaN,223.11418225761457,211.9353054277088,0.046275811702547465,0.1751831638813286,0.12890735217878113,27132829,21822694,72.50634955688106,57.35375775694837,NaN,NaN,24.104738509606044,17.256953430436756
2005-07-15T09:30:00-04:00,24.664611,24.672729,24.485999,24.656492,11400840,4909197.4,71.16388452481824,60.11066273944549,NaN,NaN,176.10387297001435,216.61391514848964,0.05348597271610983,0.19576481807391843,0.1422788453578086,38533669,26106458.4,76.2114392786957,58.657814897236385,NaN,NaN,26.96515327259815,18.643839122174096
2005-07-18T09:30:00-04:00,24.567178,24.624017,24.388567,24.396693,6640841,4863562,59.52900040600476,60.83023390700413,NaN,NaN,108.26662024838495,188.80065504148064,0.037324444567567505,0.188934401067268,0.1516099564997005,31892828,28344279.6,77.88785486011659,60.41331908164533,NaN,NaN,25.715129118822706,19.65402340740961
2005-07-19T09:30:00-04:00,24.461643,24.510355,24.380456,24.388567,4623892,4860735.15,59.202961166396896,61.03050984185552,NaN,NaN,82.61366849835173,160.86231300684253,0.023337321395141636,0.18078160824362755,0.1574442868484859,27268936,29657322.4,78.83052924196423,62.49259599469303,NaN,NaN,24.63608996226836,20.36574720096086
2005-07-20T09:30:00-04:00,24.3561,24.550957,24.299261,24.477872,10020202,5202292.4,61.686531115629506,61.140193370152886,NaN,NaN,77.29169304789562,133.47800740445228,0.01761092957315097,0.1794579488149246,0.16184701924177364,37289138,32423480,80.69745921471063,64.7940586961689,NaN,NaN,24.49291160121458,20.95534211528282
2005-07-21T09:30:00-04:00,24.437295,24.510355,24.307388,24.347989,7331713,5383195.65,56.31686316113464,61.34631341143173,NaN,NaN,55.53787620096024,99.96274619312139,0.0033341860786852973,0.16601475184013026,0.16268056576144496,29957425,32988399.2,81.06472771428538,67.19977928387101,NaN,NaN,22.68242679049214,21.20206849745558
2005-07-22T09:30:00-04:00,24.396693,24.494118,24.307388,24.477872,5561851,5389643.7,60.060899419856085,61.75785507744738,NaN,NaN,59.40192554040276,76.62235670719907,0.0010167182636790228,0.16395146359104373,0.1629347453273647,35519276,32385520.6,79.32998610167841,69.32089359871186,NaN,NaN,22.310043606759606,21.360350655927586
2005-07-25T09:30:00-04:00,24.437295,24.559067,24.372337,24.380456,2832103,5296359.05,56.172150153862766,61.43988479137173,NaN,NaN,56.548905793726824,66.27881381626744,-0.00819143022748861,0.15269545754300395,0.16088688777049256,32687173,32544389.6,79.45475552234916,71.15413082120317,NaN,NaN,20.776633489117984,21.2769624892405
2005-07-26T09:30:00-04:00,24.380456,24.461643,24.3561,24.412939,5915230,5454278.3,57.16800700588135,61.71352001614151,NaN,NaN,43.364562355314746,58.42899258766005,-0.012927296873463445,0.14472776667866327,0.15765506355212672,38602403,34811083,81.198556384714,73.08095117274806,NaN,NaN,19.830137351522577,21.070273183852226
2005-07-27T09:30:00-04:00,24.469762,24.469762,24.339863,24.445406,5185188,5444615.25,58.19057376453264,61.94654819469842,NaN,NaN,41.63400829208008,51.297455636496935,-0.014583319104260861,0.13942591467180065,0.15400923377606152,43787591,36110773.6,82.13487470751195,74.93951249415899,NaN,NaN,19.34416258118421,20.823685954899652
2005-07-28T09:30:00-04:00,24.469762,24.567178,24.42105,24.518474,10146699,5774994.55,60.47742723426328,61.843535800895374,NaN,NaN,67.50242684821309,53.69036576594751,-0.011597843797536866,0.13951192902914045,0.1511097728266773,53934290,40906146.6,85.08603355558583,76.70871545649683,NaN,NaN,19.582524148355855,20.646377125393396
2005-07-29T09:30:00-04:00,24.477872,24.559067,24.29115,24.299261,5602623,5812106.5,51.39487839106351,60.908176311505464,NaN,NaN,17.954647336537224,45.400910125174406,-0.024485928070161866,0.12050236273897497,0.14498829080913683,48331667,43468624.8,86.38071601666255,78.33047207785772,NaN,NaN,16.966736358294643,20.120714158665002
2005-08-01T09:30:00-04:00,24.453524,24.453524,24.266794,24.299261,5214014,5825132.1,51.39487839106351,59.972816822115554,NaN,NaN,-10.017566372996903,32.087615691829654,-0.03260216736952262,0.10423558159723356,0.13683774896675618,48331667,46597523.6,87.77610628239005,79.89004321000469,NaN,NaN,14.883094599075362,19.37248279300934
2005-08-02T09:30:00-04:00,24.283032,24.477872,24.283032,24.477872,2316380,5780900.85,57.43539770778915,59.2847582510913,NaN,NaN,22.032704424901155,27.82124410574694,-0.02582919632380734,0.10455125356199702,0.13038044988580436,50648047,49006652.4,88.73328271333548,81.23519079649147,NaN,NaN,14.861863438680679,18.728108599533815
2005-08-03T09:30:00-04:00,24.477872,24.518474,24.347989,24.510355,4251542,5716918.8,58.44681227165104,58.47430462242483,NaN,NaN,46.08582009994994,28.711606467320912,-0.019345684634975074,0.1061983440920855,0.12554402872706058,54899589,51229052,89.54647284015202,82.45234245958225,NaN,NaN,15.145442243264432,18.21629912006676
2005-08-04T09:30:00-04:00,24.3561,24.429168,24.307388,24.339863,6748491,5664761.25,51.5262452899325,57.07161610564729,NaN,NaN,-67.5533955142392,1.70044199483045,-0.026292774444375208,0.09267806067159157,0.11897083511596677,48151098,50072413.6,86.06485821738778,83.15615809806026,NaN,NaN,13.24264184490723,17.505776652186828
2005-08-05T09:30:00-04:00,24.283032,24.283032,24.039471,24.063827,6720658,5860777.9,42.70876893669955,55.870171000696914,NaN,NaN,-308.5658115088141,-63.603649774239805,-0.047969372110083106,0.05900911997836289,0.106978492088446,41430440,48692168.2,81.96917675738027,83.44768109072196,NaN,NaN,8.450964414750292,16.21223204683875
2005-08-08T09:30:00-04:00,24.063827,24.161243,23.933928,23.966402,6639484,6013308.35,40.10048535020416,54.50570844239742,NaN,NaN,-308.7203882663767,-123.34421415291577,-0.06623394821923635,0.02418605681440056,0.09042000503363691,34790956,45984026,74.47991003845885,83.13692257618585,NaN,NaN,3.6878003956714207,14.423027525243418
2005-08-09T09:30:00-04:00,24.03136,24.161243,23.990759,24.120666,7220612,6040073.5,45.75006144963397,53.367389180540606,NaN,NaN,-196.74071544679,-167.09889812725402,-0.06518931150381589,0.008933365653867043,0.07412267715768293,42011568,44256730.2,70.08172551293443,82.37865588320184,NaN,NaN,1.5667356241104977,12.586414396510143
2005-08-10T09:30:00-04:00,24.145022,24.372337,24.023233,24.096293,5168560,6160770.1,45.02745956811719,52.56100320961078,NaN,NaN,-122.69167402315087,-200.85439695187415,-0.06334841223840691,-0.0050628381403257094,0.0582855740980812,36843008,40645414,61.85724695906202,81.00669297211445,NaN,NaN,-0.32853826205101627,10.741421159572836
2005-08-11T09:30:00-04:00,24.16937,24.218082,23.974521,24.185599,4692623,6211677.3,48.25262546764457,51.71755507016711,NaN,NaN,-121.35226682326744,-211.6141712136798,-0.05370582196358277,-0.008846703356397256,0.044859118607185514,41535631,39322320.6,59.11979698949698,79.56310803553006,NaN,NaN,-0.9027802666520651,9.077963812969278
2005-08-12T09:30:00-04:00,24.145022,24.193726,23.998877,24.120666,3935235,5838397.05,46.13333438333861,51.000496800843955,NaN,NaN,-111.79346483456456,-172.2597018788299,-0.04939952964151103,-0.016890293444703275,0.032509236196807755,37600396,38556311.8,57.53236271697242,77.997222835146,NaN,NaN,-2.016557089650799,7.493032255452125
2005-08-15T09:30:00-04:00,24.096293,24.283032,24.015115,24.234328,5820142,5797362.1,50.25220374841905,50.50651085388237,NaN,NaN,-65.19695750525779,-123.55501572660614,-0.03715356126421533,-0.013932715383461414,0.023220845880753918,43420538,40282228.2,60.13000687935985,76.49232644190643,NaN,NaN,-1.7121557599686161,6.178005396106305
2005-08-16T09:30:00-04:00,24.234328,24.339863,24.071937,24.071937,15218569,6327095.95,44.962408766623774,49.5616419254603,NaN,NaN,-64.59269113476384,-97.12541086420089,-0.03810548871877854,-0.02441101501771925,0.013694473701059284,28201969,37520308.4,54.3959246747675,74.51097286813896,NaN,NaN,-3.1021131018348984,4.852274182114704
2005-08-17T09:30:00-04:00,24.096293,24.218082,24.03136,24.128776,11870617,6419616.7,47.06286351407759,48.60345880258989,NaN,NaN,-72.2589706052925,-87.03887018062923,-0.0332021034293841,-0.027808155585670846,0.005393947843713257,40072586,38166224,55.465517461068295,72.39522171853056,NaN,NaN,-3.5993463592686856,3.644899819059934
2005-08-18T09:30:00-04:00,24.063827,24.177489,23.998877,24.112539,13098030,6707932.55,46.51671967653851,48.25501889440953,NaN,NaN,-77.17665014618736,-78.2037468452132,-0.029473630398992673,-0.031448090155027586,-0.0019744597560349113,26974556,35254009,49.794880438090274,69.78194774863255,NaN,NaN,-4.159541837724444,2.529979582376452
2005-08-19T09:30:00-04:00,24.120666,24.234328,24.120666,24.153132,6889649,6774322.45,48.13709481751491,48.022320067727485,NaN,NaN,-39.53902036937952,-63.752857952176214,-0.02298308812763408,-0.03070331991557751,-0.007720231787943431,33864205,34506770.8,48.42679009351517,66.97128230657005,NaN,NaN,-4.170498066596935,1.5727684896659682
2005-08-22T09:30:00-04:00,24.153132,24.323633,24.112539,24.218082,6526536,6959044.1,50.710254856343006,47.541952721195614,NaN,NaN,-12.61160735613359,-53.23578792235137,-0.013494789372736467,-0.024588718503864015,-0.011093929131127549,40390741,33900811.4,47.292073044209815,64.0111959016325,NaN,NaN,-3.457004555228437,0.8542294832524817
2005-08-23T09:30:00-04:00,24.218082,24.218082,24.03136,24.063827,8106719,7068618.55,44.9998628160283,46.58145633150828,NaN,NaN,-64.53324889748694,-53.22389947489601,-0.01658334087200673,-0.03182310522113596,-0.015239764349129232,32284022,34717222,49.02511062376516,61.116812886176305,NaN,NaN,-4.481146782117668,0.09203287391388892
2005-08-24T09:30:00-04:00,23.990759,24.145022,23.787791,23.787791,13044576,7461587.95,36.975730923830255,45.54213387678669,NaN,NaN,-156.88328631814818,-70.14876261746714,-0.03512689361239996,-0.05914838136462919,-0.024021487752229224,19239446,30550594,41.521564882202824,57.93514907652023,NaN,NaN,-8.090088649046859,-1.0768416293662177
2005-08-25T09:30:00-04:00,23.787791,23.950165,23.747198,23.909572,8262161,7367361.05,41.89811591787695,45.48423008972794,NaN,NaN,-174.50845378265555,-89.61512334476079,-0.03691744517824409,-0.07016829422503434,-0.03325084904679025,27501607,30656004.2,41.764404235417985,55.06337961066578,NaN,NaN,-9.494683514798638,-2.2793904701422774
2005-08-26T09:30:00-04:00,23.909572,23.909572,23.657892,23.657892,16329584,7903709.1,35.693550555566205,45.16944903296808,NaN,NaN,-218.45061776933292,-125.39744282475147,-0.051862942717435134,-0.09807952744358417,-0.046216584726149035,11172023,26117567.8,35.0212477257048,52.24490373118335,NaN,NaN,-12.902128514429645,-3.796924476469044
2005-08-29T09:30:00-04:00,23.657892,23.877097,23.527993,23.844622,11125424,8199279.6,42.49739624952662,44.93711580438899,NaN,NaN,-184.36819282135167,-159.7487599177951,-0.046173729730250954,-0.10393374688896273,-0.05776001715871178,22297447,22498909,30.757133134476547,49.43600427557921,NaN,NaN,-13.35940440043642,-5.162993037035812
2005-08-30T09:30:00-04:00,23.706604,23.787791,23.560467,23.633536,20835473,9125234.25,37.64815650794367,44.4100227286623,NaN,NaN,-184.99568908500987,-183.84124795529968,-0.05313176637091746,-0.12417472512235861,-0.07104295875144115,1461974,16334499.4,25.141307153093024,46.81343714658142,NaN,NaN,-15.471613624047919,-6.635653120894684
2005-08-31T09:30:00-04:00,23.300669,23.901453,23.300669,23.901453,14223826,9623848.45,46.06094870646448,44.25347438857801,NaN,NaN,-139.7463748112492,-180.41386565391988,-0.036962151817405725,-0.1172456485231983,-0.08028349670579257,15685800,15623770.2,24.58397104716036,44.346592436414525,NaN,NaN,-14.148722056791085,-7.708948683165598
2005-09-01T09:30:00-04:00,23.982632,24.047589,23.714731,23.958276,19862540,10279550.9,47.67352731352679,44.36348816930575,NaN,NaN,-45.099773471957356,-154.53212959178023,-0.020531493171617426,-0.10594786317031435,-0.08541636999869692,35548340,17233116.8,28.451723018771375,42.26940388654303,NaN,NaN,-12.574059041996009,-8.4039644487128
2005-09-02T09:30:00-04:00,23.990759,24.071937,23.893326,23.942054,7390220,10313029,47.23933088233346,44.14828296458534,NaN,NaN,-14.953354792255178,-113.8326769963647,-0.00941330525017181,-0.09718300156141169,-0.08776969631123988,28158120,20630336.2,35.92239885638132,40.540289027758845,NaN,NaN,-11.495855755564358,-8.845663206834452
2005-09-06T09:30:00-04:00,24.03136,24.234328,24.015115,24.234328,10435168,10502813.2,55.162839495023576,44.876885159471044,NaN,NaN,63.853647763546014,-64.18830887938515,0.017501244002012847,-0.06589314130872381,-0.08339438531073666,38593288,23889504.4,42.16180564413786,39.66642338271388,NaN,NaN,-7.792722236782692,-8.695243068255628
2005-09-07T09:30:00-04:00,24.258676,24.274905,24.10442,24.177489,10591967,10671380.95,53.48076292192923,45.33530654574616,NaN,NaN,70.4533077458898,-13.098509513205219,0.030586276420354108,-0.045161539785294025,-0.07574781620564813,28001321,29197373.8,50.5985500086725,39.318782850399884,NaN,NaN,-5.416331182761669,-8.226827084613634
2005-09-08T09:30:00-04:00,24.071937,24.161243,24.039471,24.039471,7685098,10797207.85,49.531175184084574,45.550624796285156,NaN,NaN,29.21234123597212,20.69323369623904,0.029066930146162975,-0.03941415352294442,-0.06848108366910739,20316223,30123458.4,51.916418543904506,39.470321286529476,NaN,NaN,-4.70347015211385,-7.723490379970808
2005-09-09T09:30:00-04:00,24.071937,24.29115,24.063827,24.250557,8131843,10969168.85,55.00427995320109,46.04113802026274,NaN,NaN,77.4823547541839,45.209659341467294,0.04068624117958134,-0.01762328219463072,-0.05830952337421206,28448066,28703403.6,49.725865040639015,39.56311235418117,NaN,NaN,-2.271715651802825,-6.944665418803953
2005-09-12T09:30:00-04:00,24.315506,24.323633,24.234328,24.323633,8273982,11186106.2,56.75279213940653,46.47274782619585,NaN,NaN,106.6219272506989,69.52471575005812,0.05103129663383979,0.005479597418087678,-0.04555169921575211,36722048,30416189.2,52.33804774500622,39.92353911852377,NaN,NaN,0.24261877078702926,-5.91791053457667
2005-09-13T09:30:00-04:00,24.274905,24.283032,24.120666,24.120666,5417494,11165973.8,50.84310034808505,46.89012193562848,NaN,NaN,59.6590532772378,68.68579685279647,0.04230263845538966,0.007326598853484967,-0.03497603960190469,31304554,28958442.4,49.958825875736174,39.990233065093136,NaN,NaN,0.4951813911639117,-5.001754545185158
2005-09-14T09:30:00-04:00,24.120666,24.250557,24.071937,24.096293,8386194,10824355.05,50.16753310404116,47.832393519929255,NaN,NaN,46.409889781939384,63.877113260006396,0.03337755235820653,0.00674590084585347,-0.026631651512353062,22918360,27941850.2,48.30952624251157,40.47508744797233,NaN,NaN,0.48801358702526665,-4.217501954869383
2005-09-15T09:30:00-04:00,24.193726,24.193726,24.015115,24.112539,5714459,10516547.15,50.63834605992521,48.4566956729327,NaN,NaN,34.035154921148816,64.84167599704173,0.02731335230142203,0.007510038864424473,-0.019803313436997556,28632819,29605169.4,51.151079628666665,41.1455642617758,NaN,NaN,0.6186787456845947,-3.526618997647386
2005-09-16T09:30:00-04:00,24.120666,24.323633,24.03136,24.315506,12799337,10501612.5,56.20534109080039,49.92182356830658,NaN,NaN,75.65379608926057,64.47596426405707,0.035214040928655405,0.024214237723821697,-0.010999803204833706,41432156,32201987.4,55.28401578805584,42.592904837658025,NaN,NaN,2.4274475250114236,-2.6760380658389846
2005-09-19T09:30:00-04:00,24.3561,24.3561,24.055708,24.096293,6958010,10505030.55,49.68749913569688,50.43540234589016,NaN,NaN,54.680122106746325,54.08760323526654,0.024430682852185345,0.019538550360397977,-0.004892132491787369,34474146,31752407,54.42548363607226,44.28350130205772,NaN,NaN,1.9665362066337817,-2.0128131697714466
2005-09-20T09:30:00-04:00,24.015115,24.339863,23.958276,23.966402,23292142,11343310.85,46.26402471574584,51.05082150359032,NaN,NaN,26.542084486754323,47.46420947716985,0.008146446620478665,0.0052909257838109625,-0.002855520836667703,11182004,27727897,47.338494761023036,45.86901470262415,NaN,NaN,0.4994491782282343,-1.6539185486286352
2005-09-21T09:30:00-04:00,23.974521,23.974521,23.560467,23.568586,17685838,11822266.8,37.697247724294606,50.45341429057818,NaN,NaN,-110.77847344972628,16.026536830836722,-0.027848901875575406,-0.037666648181136964,-0.009817746305561556,-6503834,21843458.2,39.283791055341865,46.919001846065676,NaN,NaN,-3.88129377577138,-1.9721150096490274
2005-09-22T09:30:00-04:00,23.560467,23.747198,23.381856,23.747198,15660142,11953045.1,42.81705528153712,50.10652343115034,NaN,NaN,-123.00025357687556,-15.380544868768155,-0.03746209642384864,-0.05664536683537236,-0.019183270411523717,9156308,17948156,35.03419144973137,47.38917816256282,NaN,NaN,-5.705286488533515,-2.50542522091824
2005-09-23T09:30:00-04:00,23.706604,23.852741,23.60918,23.828393,4368433,11758358.7,45.028555026530746,49.948610870021575,NaN,NaN,-72.18812823022866,-44.948929732666,-0.036167070102209625,-0.06439210803928574,-0.02822503793707612,13524741,12366673,30.0225960979773,46.967763679819676,NaN,NaN,-6.422553841324127,-3.0650150238333667
2005-09-26T09:30:00-04:00,23.86897,24.071937,23.674129,23.698485,7962110,11339985,42.21546732200873,49.02379857194909,NaN,NaN,-57.57589515963531,-67.40013318594232,-0.041492537902664474,-0.08009071031540671,-0.038598172412742236,5562631,6584370,25.890583313198277,45.805533513324,NaN,NaN,-7.921110761630197,-3.758742986375771
2005-09-27T09:30:00-04:00,23.625425,23.877097,23.617298,23.779664,7327282,11150077.9,44.546852068903384,48.38566208244725,NaN,NaN,-77.01686177014349,-88.11192243732188,-0.03712278424730896,-0.08500165272187843,-0.04787886847456947,12889913,6925951.8,26.53383266504116,44.08662513163604,NaN,NaN,-8.413030769510238,-4.423641241109266
2005-09-28T09:30:00-04:00,23.779664,23.844622,23.584824,23.584824,7656523,10491130.4,40.3399990721456,47.72914950302304,NaN,NaN,-106.73768314870745,-87.30376437711811,-0.044435600733214634,-0.10342336939108776,-0.05898776865787313,5233390,9273396.6,30.96828484120556,42.59032986715755,NaN,NaN,-10.171332116317595,-5.244739937567599
2005-09-29T09:30:00-04:00,23.625425,24.03136,23.576697,24.023233,8622931,10211085.65,51.45003079465793,47.475274563127094,NaN,NaN,-42.18426182590499,-71.140566026924,-0.018173726413279495,-0.08170492667447249,-0.063531200261193,13856321,10213399.2,32.719581132709706,41.375595302305456,NaN,NaN,-7.90097989080234,-5.624202788029705
2005-09-30T09:30:00-04:00,24.071937,24.22612,23.893326,23.966402,6621749,9549046.1,50.14637743389713,47.00338779844786,NaN,NaN,9.782030457646758,-54.746534289348915,-0.0038082154240319105,-0.06829146954123289,-0.06448325411720097,7234572,8955365.4,31.56540966919053,39.89183543974719,NaN,NaN,-6.564830075942961,-5.758578114874456
2005-10-03T09:30:00-04:00,24.071937,24.372337,23.828393,23.909572,4221488,9390609.5,48.814386208637956,46.85847964563021,NaN,NaN,11.572442055325133,-40.91686684635683,0.0023565651873964782,-0.06153754763295538,-0.06389411282035186,3013084,8445456,31.086753828151785,38.54383029349117,NaN,NaN,-5.917688217177982,-5.781308129489245
2005-10-04T09:30:00-04:00,24.315506,24.315506,23.60918,23.60918,11317082,9434705.2,42.40297648528353,46.30386845857608,NaN,NaN,-51.89796913464818,-35.89308831925777,-0.01249081003741262,-0.07950762536711764,-0.06701681532970502,-8303998,4206673.8,27.371087152099363,37.04822750131887,NaN,NaN,-7.460047782849591,-6.021128079969294
2005-10-05T09:30:00-04:00,23.706604,23.79591,23.511763,23.511763,12960448,9553129.25,40.543224393658875,45.58278833955706,NaN,NaN,-119.11942666519509,-38.369437022555296,-0.02674801412776999,-0.10045183298941751,-0.07370381886164752,-21264446,-1092893.4,23.576799830358112,35.078636087153974,NaN,NaN,-9.30088738273563,-6.489665123221628
2005-10-06T09:30:00-04:00,23.625425,23.771554,23.454924,23.576697,12226836,9780216.15,42.35798748114224,44.593691653152916,NaN,NaN,-106.4443213948997,-51.22144893635425,-0.029466098514007957,-0.11053644200415746,-0.08107034349014951,-9037610,-5671679.6,20.88321766741342,32.6214362213938,NaN,NaN,-10.237198947303341,-7.025027098090444
2005-10-07T09:30:00-04:00,23.576697,23.763435,23.568586,23.657892,6122040,9679726,44.6336421174496,44.23270186613525,NaN,NaN,-79.0063278116084,-68.97912059020527,-0.023704301514426013,-0.11070072038318202,-0.086996418868756,-2915570,-7701708,19.802996428026532,30.14840142081911,NaN,NaN,-10.335918083045211,-7.498011524512553
2005-10-10T09:30:00-04:00,23.747198,23.747198,23.406212,23.406212,5317598,9531906.8,39.43644617415748,43.74501768459322,NaN,NaN,-116.46384677241257,-94.58637835575283,-0.034118800009714595,-0.12964491888089924,-0.09552611887118465,-8233168,-9950958.4,18.651782549480785,28.099350548566093,NaN,NaN,-12.039461798074608,-8.14679013502142
2005-10-11T09:30:00-04:00,23.511763,23.576697,23.300669,23.333152,10026480,9762356.1,38.051311380539964,43.7703079457536,NaN,NaN,-141.10172857331483,-112.42713024348613,-0.04264946715614412,-0.1488379528163648,-0.10618848566022068,-18259648,-11942088.4,17.67236843695332,26.555677504395483,NaN,NaN,-13.852640248670722,-8.961911579828463
2005-10-12T09:30:00-04:00,23.381856,23.495518,23.122058,23.227601,12450269,9965559.85,36.07968606927134,43.28906728773462,NaN,NaN,-162.16074659546575,-121.03539422954027,-0.051528486593262965,-0.1705990939017994,-0.11907060730853643,-30709917,-13831182.6,16.7724931614179,25.25127048380167,NaN,NaN,-15.962340361787305,-9.961972834394011
2005-10-13T09:30:00-04:00,23.260067,23.3575,23.081456,23.341263,21816675,10770670.65,39.70285930292751,42.90866045033439,NaN,NaN,-152.0082053107451,-130.14817101270938,-0.04605328824415278,-0.17663721761372742,-0.13058392936957464,-8893242,-13802309,16.842191528312668,24.30981301453991,NaN,NaN,-16.688927598156532,-10.922966372074372
2005-10-14T09:30:00-04:00,23.398102,23.60918,23.398102,23.601069,11222730,10691840.3,47.08597336503412,43.25655373912191,NaN,NaN,-59.77092010561747,-126.30108947151118,-0.022436629798343766,-0.15862971661750436,-0.1361930868191606,2329488,-12753297.4,19.480472076649193,23.85194792621497,NaN,NaN,-15.050077146751716,-11.512553625599708
2005-10-17T09:30:00-04:00,23.625425,23.73096,23.471162,23.625425,9417148,10814797.2,47.732102556016024,43.48407163105854,NaN,NaN,-28.67993242413376,-108.74430660185541,-0.003662011210913141,-0.14077060083280202,-0.13710858962188888,11746636,-8757336.6,28.753226409993587,24.01047605085443,NaN,NaN,-13.53952075335744,-11.802120358136527
2005-10-18T09:30:00-04:00,23.601069,23.739087,23.438687,23.438687,6499809,9975180.55,43.360375803942986,43.69981282618693,NaN,NaN,-49.63001098810136,-90.44996308481272,-0.0023696653923762356,-0.14007067136235918,-0.13770100596998294,5246827,-4056041.6,37.82522044057462,24.500257165095075,NaN,NaN,-13.524882048787632,-12.048229171086685
2005-10-19T09:30:00-04:00,23.487391,23.966402,23.365619,23.909572,19484646,10065120.95,54.64182418787539,43.9277980685596,NaN,NaN,36.32889203654213,-50.752035358411156,0.029870748118738827,-0.10036257082155942,-0.13023331894029824,24731473,7032236.4,53.019668167985344,25.950263381900488,NaN,NaN,-9.643096569736848,-11.70463879946528
2005-10-20T09:30:00-04:00,23.990759,24.039471,23.601069,23.698485,16391541,10101690.9,49.84858957101929,43.906527506925464,NaN,NaN,45.46638587064203,-11.25711712213373,0.036228773838595546,-0.0849473516420538,-0.12117612548064935,8339932,10478871.2,56.572323726321265,27.736471528838397,NaN,NaN,-8.049476025327083,-11.18247268887411
2005-10-21T09:30:00-04:00,24.071937,24.071937,23.706604,23.836503,8714449,10318991.7,52.76612411672143,44.188794500360004,NaN,NaN,77.8345149260273,16.263969884195223,0.04822741492485336,-0.060891856824582646,-0.109119271749436,17054381,13423849.8,59.39759613363691,29.758674550658764,NaN,NaN,-5.78994362171021,-10.412111393564981
2005-10-24T09:30:00-04:00,23.950165,24.307388,23.893326,24.307388,9295697,10385671.05,61.08419605993533,45.523167327120845,NaN,NaN,168.03244579300582,55.606445527623166,0.08426537012131304,-0.0037875590977947127,-0.08805292921910775,26350078,16344538.2,62.03550126195744,32.23470412993434,NaN,NaN,-0.716566501042173,-9.02703355177601
2005-10-25T09:30:00-04:00,24.274905,24.307388,24.03136,24.16937,12161429,10627378.4,57.867504642552895,46.76061591632756,NaN,NaN,143.7168113340683,94.2758099920571,0.09443070774664021,0.029985455464192512,-0.0644452522824477,14188649,18132902.6,63.59513397598346,35.09315656890758,NaN,NaN,2.1713937634202,-7.427258221033694
2005-10-26T09:30:00-04:00,24.193726,24.42105,24.088183,24.331744,18007438,11144924.15,60.50270325834807,48.05666704327083,NaN,NaN,150.22771059205866,117.05557370316042,0.10680179510372714,0.06905699159721124,-0.03774480350651591,32196087,19625825.4,64.89177442147235,38.23662490848322,NaN,NaN,5.39304075004054,-5.59578693945166
2005-10-27T09:30:00-04:00,24.234328,24.388567,24.193726,24.193726,17865544,11607054.8,57.226311317560224,48.956143414707306,NaN,NaN,127.96920299487314,133.55613712800664,0.1004931522543582,0.08787163681143184,-0.012621515442926362,14330543,20823947.6,65.94023058838367,41.53214163422302,NaN,NaN,6.934107355836453,-3.805802040124787
2005-10-28T09:30:00-04:00,24.3561,24.60778,24.250557,24.60778,20494415,12300688.1,63.59547458198307,50.68178830098056,NaN,NaN,164.8330457939611,150.9558433015934,0.11781002695827818,0.13464101825492136,0.016830991296643186,34824958,24378063,68.90659670234412,45.12177121657039,NaN,NaN,10.518209953841696,-1.7595146124152894
2005-10-31T09:30:00-05:00,24.615907,24.794502,24.615907,24.697085,11661224,12672674.9,64.81249435108174,52.59330137030498,NaN,NaN,181.58913851158388,153.66718184530902,0.12803390378643117,0.17687337102968215,0.04883946724325098,46486182,28405283.8,71.8936694348696,48.99472128785013,NaN,NaN,13.73936211100536,0.4546106337876603
2005-11-01T09:30:00-05:00,24.705196,24.705196,24.518474,24.60778,10151500,12614395.8,62.56020038377508,54.484766678483815,NaN,NaN,135.7051030915759,152.0648401968105,0.12158578634296782,0.20082170017196077,0.07923591382899295,36334682,32834490.4,74.76501681711562,53.13704440611425,NaN,NaN,15.61658947199768,2.6206076106748055
2005-11-02T09:30:00-05:00,24.559067,24.883807,24.550957,24.810747,12956878,12614217.3,65.49502651222348,56.327064336290675,NaN,NaN,134.9665125121448,149.01260058082775,0.12340100448961852,0.2334871694410161,0.11008616495139759,49291560,36253585,76.74040980845824,57.41548856898179,NaN,NaN,18.129885338455924,4.836218714643536
2005-11-03T09:30:00-05:00,25.046198,25.046198,24.721441,24.826985,10990305,12552390.75,65.72649886192843,57.658530443211696,NaN,NaN,131.33633869729601,149.68602772131234,0.11810250016429202,0.2577142901567626,0.1396117899924706,60281865,45443849.4,81.03728370864138,61.81240368555266,NaN,NaN,20.199643458174446,7.030993678005094
2005-11-04T09:30:00-05:00,24.924409,24.924409,24.737679,24.867578,8040570,12648317.25,66.33450191702715,58.98727325471249,NaN,NaN,112.50360585991469,139.22013973450308,0.10990810847605514,0.2769969255875395,0.16708881711148438,68322435,52143344.8,83.43906845651156,65.71853526030394,NaN,NaN,22.06905271507713,9.179287826158243
2005-11-07T09:30:00-05:00,25.005596,25.094902,24.91629,25.078664,9380196,12851447.15,69.37673030397474,60.84558429042904,NaN,NaN,123.70748682517909,127.6438093972221,0.11095815639021928,0.3057865125992585,0.1948283562090392,77702631,58386634.6,85.30676778252973,69.11007435615788,NaN,NaN,24.610120818516407,11.383692539352266
2005-11-08T09:30:00-05:00,24.875697,25.16797,24.875697,25.005596,7573872,12728816.75,67.11581591625398,61.736583699598945,NaN,NaN,111.47639524168697,122.79806782724431,0.09936045417844439,0.3190289239320947,0.21966846975365031,70128759,65145450,87.01416251583487,71.53825252386142,NaN,NaN,26.08616756356393,13.484046114239646
2005-11-09T09:30:00-05:00,25.046198,25.184207,24.948765,25.070546,10033626,12607984.6,68.11065426372174,63.04101689193483,NaN,NaN,108.20099725225559,117.44496477526647,0.08902488168076797,0.33094957185461027,0.2419246901738423,80162385,71319615,88.34636526804616,73.80782691969891,NaN,NaN,27.60010423753876,15.500625846139519
2005-11-10T09:30:00-05:00,25.16797,25.598261,25.086775,25.573905,18640789,12449190.3,74.53929596758273,64.59624345271064,NaN,NaN,139.95754496078214,119.16920602796372,0.10779752788882341,0.37667160003487155,0.26887407214604814,98803174,79023876.8,89.75828650264842,75.9764476603426,NaN,NaN,31.144965051181618,17.735531446859817
2005-11-11T09:30:00-05:00,25.598261,25.720033,25.533311,25.663211,10656388,12420873.2,75.48361245672783,65.62477319533868,NaN,NaN,152.36529443615538,127.14154374321186,0.11716096099922557,0.4153252733950801,0.2981643123958545,109459562,87251302.2,91.01081341877443,78.04611281440096,NaN,NaN,34.32024620392917,20.104776412155438
2005-11-14T09:30:00-05:00,25.687567,25.711923,25.573905,25.679448,6892974,12294664.5,75.66036717810482,66.89569194787809,NaN,NaN,139.89047146962585,130.3781406721012,0.11520590858394286,0.44217169812578305,0.3269657895418402,116352536,94981283.2,92.00065973669574,80.07507894016611,NaN,NaN,36.923479762235154,22.50744831930968
2005-11-15T09:30:00-05:00,25.695677,25.898645,25.346581,25.444006,16983756,12818861.85,68.00417299476139,67.43151121476477,NaN,NaN,118.15016174454415,131.71289397267265,0.08993499241345909,0.43938453005866407,0.349449537645205,99368780,100829287.4,92.65923112713261,82.05846870485614,NaN,NaN,36.91888417068644,24.56622486950636
2005-11-16T09:30:00-05:00,25.435887,25.565794,25.241038,25.305988,21744978,12931878.45,63.92076359124168,67.90968637717059,NaN,NaN,84.26552601208071,126.92579972463766,0.057387279768503885,0.42118363735583486,0.363796357587331,77623802,100321570.8,91.9514392218409,83.91641217867449,NaN,NaN,35.684019505633536,26.15448124609596
2005-11-17T09:30:00-05:00,25.379048,25.6551,25.305988,25.606372,11015800,12663091.4,68.37203755970995,68.25086944700823,NaN,NaN,97.39587780427331,118.41346629333589,0.04983181118186486,0.4260861215646621,0.3762543103827972,88639602,98288856.4,89.0195864621873,85.35305430437758,NaN,NaN,35.95979503971068,27.55524035946949
2005-11-18T09:30:00-05:00,25.776872,26.46697,25.557668,25.736279,9422200,12698478.95,70.09063672358796,68.62787961647295,NaN,NaN,140.15763328549622,115.97193406320405,0.04734404648661783,0.43543436849106953,0.3880903220044517,98061802,96009304.4,85.71879926084766,86.34056357766174,NaN,NaN,36.71532675550695,28.863824130331984
2005-11-21T09:30:00-05:00,25.776872,25.923001,25.695677,25.858068,7279735,12597680.85,71.64615642228105,69.27687647636624,NaN,NaN,114.03141214772134,110.80012219882315,0.04753705469538538,0.4475116403736834,0.399974585678298,105341537,93807104.6,82.53488472312651,86.8955541423768,NaN,NaN,37.813685006661515,30.142375684093345
2005-11-22T09:30:00-05:00,25.898645,26.134095,25.752516,26.085383,15696604,12774439.6,74.32967400483325,69.90792272583836,NaN,NaN,122.13154695564883,111.59639924104408,0.056026277844571204,0.47000743298401204,0.41398115513944084,121038141,98140976.8,83.80941982159989,87.40048342902978,NaN,NaN,39.59798496023394,31.493177009256286
2005-11-23T09:30:00-05:00,26.101612,26.426368,26.04479,26.288351,11818268,12464981.1,76.47098801217592,70.67538623657033,NaN,NaN,141.83482980369195,123.11025999936632,0.06758892480763001,0.49846731114897835,0.43087838634134834,132856409,109187498.2,86.51139575820596,87.7914914325701,NaN,NaN,41.79219381631037,32.964465124549726
2005-11-25T09:30:00-05:00,26.345182,26.393886,26.272113,26.345182,2177934,11680600.6,77.04829438015688,71.44065712679388,NaN,NaN,140.3758554712496,131.7062555327616,0.07099163044614992,0.5196179243990358,0.44862629395288584,135034343,118466446.4,88.28061545430324,88.13731621812666,NaN,NaN,43.743459782188474,34.504321504212406
2005-11-28T09:30:00-05:00,26.426368,26.426368,26.174697,26.223401,19181887,11614974.2,72.91948195556971,71.69371081619352,NaN,NaN,120.6363222489152,127.8019933254454,0.057541062638786555,0.520552622251369,0.46301155961258245,115852456,122024577.2,88.88278475314495,88.39274600174203,NaN,NaN,44.16271159533359,35.88409151722972
2005-11-29T09:30:00-05:00,26.30458,26.361419,25.533311,26.207164,18634756,11963650.8,72.36269659953717,72.0684880078566,NaN,NaN,78.81280620419798,120.75827213674071,0.040836714317037615,0.5140574525088795,0.47322073819184185,97217700,120399809.8,86.69226031846596,88.36975298764425,NaN,NaN,44.3467538721491,37.093043282218204
2005-11-30T09:30:00-05:00,26.223401,26.223401,25.809339,25.874297,26006863,12756418.95,61.92386442420843,71.62657444789137,NaN,NaN,63.37888494291248,109.00773973419345,0.002668966919796012,0.4765569468415869,0.4738879799217909,71210837,110434349,74.55554247402694,87.38469421664287,NaN,NaN,41.309990328879195,37.69546428888406
2005-12-01T09:30:00-05:00,26.020433,26.150341,25.97984,26.012307,12607313,12738940.7,64.22798436374987,70.89005219047473,NaN,NaN,69.35839944507126,94.51245366246931,-0.01690661984506764,0.45275470511545635,0.469661324960524,83818150,100626697.2,64.92240292341306,85.61070253241178,NaN,NaN,39.436412665426154,37.94417119981865
2005-12-02T09:30:00-05:00,26.077264,26.093502,25.971729,26.069146,7868744,12582862.65,65.16298878007129,70.15286478499925,NaN,NaN,62.2814968208103,78.89358193238144,-0.028944425893485948,0.43348079259366656,0.4624252184871525,91686894,91957207.4,57.81163719836265,83.23933280238236,NaN,NaN,38.16688697711169,37.975987739431936
2005-12-05T09:30:00-05:00,25.97984,26.036679,25.784983,26.020433,15700418,12965855.05,63.62801225632786,69.29341086201518,NaN,NaN,39.014759667591726,62.56926941611674,-0.04229676718513892,0.4095542595057289,0.4518510266908678,75986476,83984011.4,52.1540247203464,80.39314458692884,NaN,NaN,36.678746697145385,37.79066759053386
2005-12-06T09:30:00-05:00,26.142214,26.207164,25.923001,25.939246,8586840,12926187.25,61.046992573761884,68.79646940337237,NaN,NaN,48.6033386610206,56.52737590748128,-0.05774909383291066,0.3796646593997295,0.43741375323264015,67399636,78020398.6,48.343232287454484,77.2277160983804,NaN,NaN,34.69205828565617,37.34800911840847
2005-12-07T09:30:00-05:00,25.91489,25.987951,25.614499,25.72816,9694776,13032232.45,54.820498737518996,68.1464504852493,NaN,NaN,-14.31009088128764,40.98958074264125,-0.08186584296775268,0.33508144952294927,0.41694729249070195,57704860,75319203.2,46.679494588650996,73.99400576743827,NaN,NaN,31.08187825249582,36.45284756613523
2005-12-08T09:30:00-05:00,25.736279,25.882416,25.614499,25.711923,9379951,12999548.7,54.36119568347296,67.14567606551809,NaN,NaN,-38.06125696616708,19.505649460393577,-0.0975276476259535,0.2950377329582601,0.3925653805842136,48324909,68220555,42.53649222222088,70.67378475029781,NaN,NaN,27.989094203525255,35.243739942905236
2005-12-09T09:30:00-05:00,26.142214,26.142214,25.687567,25.898645,9127202,12523869.35,58.65152143606027,66.32859640212327,NaN,NaN,5.684137850510177,8.186177666333554,-0.09389438473807937,0.2751973996616144,0.36909178439969376,57452111,61373598.4,38.945965859428135,67.33286807876785,NaN,NaN,26.43721425064149,33.985664844010415
2005-12-12T09:30:00-05:00,25.906772,25.963603,25.695677,25.784983,6238067,12302953.3,55.246903089282306,65.15722116405193,NaN,NaN,-29.55271908332548,-5.527318083849883,-0.09731360979666948,0.24744977215385688,0.34476338195052636,51214044,56419112,36.54227933388686,64.04768197953645,NaN,NaN,24.1254820830742,32.57706730673381
2005-12-13T09:30:00-05:00,25.776872,26.190918,25.744406,26.117858,19225242,12919566.7,62.17236724870959,64.28884211004309,NaN,NaN,35.94299238051895,-8.059387339950213,-0.07625521069374602,0.24944436858334385,0.32569957927708987,70439286,57027042,37.05562733789994,60.70812537355787,NaN,NaN,24.122451698834983,31.369265077033976
2005-12-14T09:30:00-05:00,26.093502,26.264003,26.04479,26.215274,11674527,12654105.25,63.93145773393604,63.3931613758831,NaN,NaN,87.1844354039559,12.2395179170985,-0.05581126930992275,0.2559354926396864,0.31174676194960915,82113813,61908832.6,41.17117679357676,57.469538304655785,NaN,NaN,24.6603719399052,30.410851771729867
2005-12-15T09:30:00-05:00,26.23152,26.23152,26.036679,26.069146,11073446,12120528.65,59.46437778674202,62.13716733349633,NaN,NaN,57.56852530593355,31.365474371518623,-0.052239367254354796,0.24644755288166564,0.29868692013602044,71040367,66451924.2,44.789048616097915,54.36299781621255,NaN,NaN,23.75373339258054,29.45983486042282
2005-12-16T09:30:00-05:00,26.061035,26.101612,25.91489,25.963603,7616241,11950550.7,56.39915267425534,60.957143813402446,NaN,NaN,-9.18631718643862,28.391383364128863,-0.056720673621106,0.2277860781096379,0.2845067517307439,63424126,67646327.2,45.73392608428214,51.280936482722346,NaN,NaN,22.07199458263532,28.404429106453176
2005-12-19T09:30:00-05:00,25.91489,25.97984,25.720033,25.736279,7944866,11876684,50.375927623111274,59.38666031508631,NaN,NaN,-100.99292586728481,14.103342007337,-0.07365715855442412,0.19243530353771376,0.2660924620921379,55479260,68499370.4,46.43895050959779,48.405700067803195,NaN,NaN,18.703023234180698,27.018513981842823
2005-12-20T09:30:00-05:00,25.744406,25.906772,25.736279,25.849941,5433877,11784391.1,53.074417958036335,58.754556996074015,NaN,NaN,-91.39884122646994,-11.365024714060779,-0.07558366011175685,0.1716128869524418,0.24719654706419866,60913137,66594140.6,45.03175117558682,46.29685783220033,NaN,NaN,16.719564707117733,25.54723551402495
2005-12-21T09:30:00-05:00,25.890534,26.085383,25.849941,25.923001,7318164,11365469.1,54.77673118503173,58.07946748330843,NaN,NaN,-26.0510882045499,-34.012129435761935,-0.07042005882162214,0.15917147353717098,0.22959153235879312,68231301,63817638.2,42.98742573216707,44.73007374711134,NaN,NaN,15.588436127299532,24.124549887349893
2005-12-22T09:30:00-05:00,25.97984,26.101612,25.898645,26.101612,6723737,11110742.55,58.71938944448267,57.61921038790924,NaN,NaN,23.62246085211078,-40.801342326526495,-0.05418668314470129,0.1618581784279165,0.2160448615726178,74955038,64600572.4,43.76272145542882,43.726579765473204,NaN,NaN,15.802325500458917,22.935660689222612
2005-12-23T09:30:00-05:00,26.125968,26.16657,26.061035,26.134095,3942010,11198946.35,59.41242089834812,57.31809671948212,NaN,NaN,85.7622256209992,-21.811633765038927,-0.04106801288329648,0.1647098454684972,0.20577785835179369,78897048,67695156.8,46.8398436177725,43.346995401003646,NaN,NaN,16.178749804435522,21.9703877056816
2005-12-27T09:30:00-05:00,26.272113,26.272113,25.906772,25.931128,8317708,10655737.4,53.38189977208255,56.77059009079074,NaN,NaN,45.97433083500683,7.5818175754194,-0.04552154864444674,0.14887592254623527,0.19439747119068201,70579340,70715172.8,49.73062672558067,43.44609500372694,NaN,NaN,14.707061549107179,20.932769683313825
2005-12-28T09:30:00-05:00,25.923001,26.028552,25.858068,25.874297,5015334,9974766.3,51.79655750137457,56.554594288208996,NaN,NaN,-29.764956545958547,19.908594511521677,-0.05132573006953192,0.13024030860376712,0.18156603867329904,65564006,71645346.6,50.62127991869901,43.72765109873037,NaN,NaN,13.029815564497444,19.803776237768627
2005-12-29T09:30:00-05:00,25.947373,25.971729,25.809339,25.849941,4119748,8880410.55,51.09619493600211,56.32137994910393,NaN,NaN,-54.02686760085791,14.313438632260079,-0.05548274489572666,0.11221260755364071,0.16769535244936737,61444258,70287938,49.24994945239279,44.207183758028364,NaN,NaN,11.452437440365868,18.61072783813966
2005-12-30T09:30:00-05:00,25.711923,25.817466,25.638855,25.711923,6319116,8566000.7,47.201344001565346,55.50351013235429,NaN,NaN,-135.19375636741938,-17.449804811645958,-0.06551661692854774,0.0857995812886827,0.15131619821723044,55125142,66321958.8,45.38170156033127,44.66687916523573,NaN,NaN,8.956891238681814,17.231608323931397
2006-01-03T09:30:00-05:00,25.711923,26.190918,25.630744,26.142214,17730426,9059084.8,57.96035865549375,55.69732838708369,NaN,NaN,30.12572055397466,-28.577105825050864,-0.042290518723507226,0.09845304981284642,0.14074356853635364,72855568,65113662.8,44.24159134401205,45.21683002310181,NaN,NaN,10.016073818926712,16.2008176803593
2006-01-04T09:30:00-05:00,26.142214,26.239647,26.020433,26.117858,19269710,9237549.4,57.24923082758756,55.345675785574976,NaN,NaN,103.46659657871692,-17.07865267630885,-0.028353386728334595,0.10530183512593538,0.13365522185426998,53585858,61714966.4,41.11286538730836,45.5066327409167,NaN,NaN,10.6369437689855,15.405978550163043
2006-01-05T09:30:00-05:00,26.134095,26.223401,25.980246,26.207164,6365796,9126497.2,59.224712467214445,55.00947969509486,NaN,NaN,101.80458484436988,9.23525560175684,-0.013650739877036827,0.11659179700797395,0.13024253688501078,59951654,60592496,40.10413943126684,45.430415786465986,NaN,NaN,11.752438522687738,14.884044260523714
2006-01-06T09:30:00-05:00,26.23152,26.385775,26.150341,26.361419,9408400,9112178.4,62.45214718964731,55.222891795302374,NaN,NaN,169.70312566840852,53.98125425561013,0.004936986057409831,0.13641376945677308,0.13147678339936325,69360054,62175655.2,42.25610777779202,45.24949144087272,NaN,NaN,13.704379847303189,14.715520772920781
2006-01-09T09:30:00-05:00,26.369538,26.475081,26.328936,26.434487,8244175,9055389.6,63.90937513011119,55.75933625643494,NaN,NaN,200.3928714983751,121.09857982876902,0.01979298792420328,0.15621801830461735,0.13642503038041406,77604229,66671472.6,47.97272256125817,45.40940547494244,NaN,NaN,15.759679945569168,14.864686369013407
2006-01-10T09:30:00-05:00,26.499437,26.507547,26.272113,26.458843,8349984,9016528.7,64.40527213870126,56.76143229326279,NaN,NaN,168.36208117573526,148.74585195312116,0.02837744301158812,0.1718968341448992,0.14351939113331108,85954213,69291201.6,51.01585460233121,45.73632719585197,NaN,NaN,17.58593668450721,15.25343641408395
2006-01-11T09:30:00-05:00,26.288351,26.613099,26.288351,26.60498,9200490,9164649.85,67.30782297305335,57.778104080049715,NaN,NaN,175.02517550673295,163.05756773872434,0.04028810374145658,0.19387952081013182,0.15359141706867524,95154703,77604970.6,59.17652654242251,46.74666829348309,NaN,NaN,20.041858365016292,15.93749669278857
2006-01-12T09:30:00-05:00,26.499437,26.54003,26.377664,26.418242,7187972,8562786.35,60.516910893839295,58.18811691639312,NaN,NaN,130.4486499030648,168.78638075046334,0.03232405963065613,0.1939964916069954,0.16167243197633926,87966731,83207986,63.58021247537479,48.21758163228363,NaN,NaN,20.19715308183993,16.54601903408162
2006-01-13T09:30:00-05:00,26.742998,26.742998,26.328936,26.402012,7532980,8355709,59.950765734157024,58.276072365655565,NaN,NaN,130.17264766252757,160.88028514928715,0.02312817306682516,0.1905826483098707,0.16745447524304555,80433751,85422725.4,65.17914914306921,49.74732646711511,NaN,NaN,20.161812463247003,17.06256095253382
2006-01-17T09:30:00-05:00,26.247757,26.247757,26.077264,26.125968,7339845,8169028.95,51.18071903664689,57.68809366124833,NaN,NaN,12.576840653979998,123.31707898040813,-0.0029911812045422814,0.16371549873736768,0.16670667994190996,73093906,84520660.8,63.94769445291796,50.96931581248264,NaN,NaN,17.40683431637104,17.111742861653422
2006-01-18T09:30:00-05:00,25.97984,26.264003,25.955484,26.052908,10857278,8331080.8,49.13211207397928,57.38453739709809,NaN,NaN,-9.511207758890349,87.74242119348301,-0.025387835282466797,0.13497188583882647,0.16035972112129326,62236628,79777143.8,57.76700264071325,51.543342663563536,NaN,NaN,14.511446544101847,16.740271959146053
2006-01-19T09:30:00-05:00,26.158451,26.158451,25.931128,25.971729,7730427,8320358.85,46.886430651180824,57.033814050655685,NaN,NaN,-39.550364179562756,44.82731325622388,-0.04473737498484329,0.10443800239023915,0.14917537737508244,54506201,71647443.4,49.02196511636361,51.42910589196815,NaN,NaN,11.419481929913255,15.980159097827082
2006-01-20T09:30:00-05:00,25.963603,25.963603,25.411531,25.427777,26995711,9398450.55,35.25758032854186,55.902484435837096,NaN,NaN,-178.5531858457568,-16.97305389354047,-0.09059383379510463,0.035933085131201636,0.12652691892630627,27510490,59556195.2,39.455159934249345,50.72947806924362,NaN,NaN,4.117214357197903,14.285452706308629
2006-01-23T09:30:00-05:00,25.330344,25.663211,25.297869,25.49271,13657604,9715422.55,37.25807331535972,55.19225081539384,NaN,NaN,-187.89108301018797,-80.58580002808358,-0.11159634472670665,-0.012968511982077047,0.0986278327446296,41168094,51703063.8,34.716375030739655,49.967669031415646,NaN,NaN,-0.9183861047465507,12.113475733300746
2006-01-24T09:30:00-05:00,25.573905,25.736279,25.565794,25.606372,16969710,10227721.2,40.711521321849865,53.96019100584785,NaN,NaN,-122.73611461897234,-107.64839108267407,-0.11255577471748408,-0.042066885652225494,0.07048888906525859,58137804,48711843.4,33.086321357167165,49.17086403235529,NaN,NaN,-3.895386539755656,9.826495408578403
2006-01-25T09:30:00-05:00,25.6551,25.72816,25.557668,25.6551,8822470,10471744.2,42.18083612539528,52.8838770985484,NaN,NaN,-104.69021746259132,-126.68419302341427,-0.10478969377212387,-0.06049822814989625,0.04429146562222762,66960274,49656572.6,34.13815017685704,48.67267008875164,NaN,NaN,-5.82534833913438,7.590517730333719
2006-01-26T09:30:00-05:00,25.890534,26.182808,25.817466,26.093502,14635102,10787613.9,53.37604668903409,52.466115257249804,NaN,NaN,-4.811201887246749,-119.73636056495107,-0.06685482116985594,-0.039277060840092304,0.027577760329763633,81595376,55074407.6,39.966271644246625,48.66282238967875,NaN,NaN,-3.747970743956392,5.970733662577989
2006-01-27T09:30:00-05:00,26.061035,26.355086,25.971729,26.117858,12411714,11157432.9,53.90997813020346,51.85596032443239,NaN,NaN,22.817042369422193,-79.46231492191527,-0.038270415902139435,-0.020260259547910664,0.01801015635422877,94007090,68373727.6,51.34747959306464,49.312206090769656,NaN,NaN,-1.9664336791592123,4.8368526137583885
2006-01-30T09:30:00-05:00,26.093502,26.117858,26.036679,26.036679,7288357,11315863.35,51.78147999226532,50.989682100300534,NaN,NaN,-1.8571738441145293,-42.25553308870058,-0.023692915300537198,-0.011605987771442727,0.01208692752909447,86718733,77483855.4,57.31685837042905,49.979644362853286,NaN,NaN,-1.1785134666344799,3.977514602273693
2006-01-31T09:30:00-05:00,26.052908,26.109739,25.906772,25.939246,16152216,11807518.35,49.267225220484974,49.90839303471366,NaN,NaN,-28.578778749551066,-23.42406591481633,-0.01964213921566583,-0.012465746490487817,0.0071763927251780124,70566517,79969598,58.802159841353166,50.535809022783425,NaN,NaN,-1.2880279634998342,3.2252942357346175
2006-02-01T09:30:00-05:00,25.898645,26.04479,25.801229,25.923001,13482454,11595119.75,48.84140984417917,48.58936352550837,NaN,NaN,-45.011877621440455,-11.488397946586169,-0.017175661598798804,-0.014293184273320492,0.0028824773254783114,57084063,77994355.8,57.10173887602338,50.38760990375492,NaN,NaN,-1.4990079879603582,2.550393918063907
2006-02-02T09:30:00-05:00,25.906772,25.939246,25.703804,25.744406,17757769,11519522.7,44.30748232107232,47.43154719888215,NaN,NaN,-72.92341927735707,-25.110841424608235,-0.026153139314791934,-0.029808946818011606,-0.003655807503219672,39326294,69540539.4,50.386049215845695,49.44516967093141,NaN,NaN,-3.0290508828303424,1.7533303750790141
2006-02-03T09:30:00-05:00,25.817466,25.833712,25.476481,25.638855,15279049,11965185.35,41.83569495060419,46.137613571485524,NaN,NaN,-99.152551856324,-49.50476026975747,-0.03711174658008247,-0.05004549072832276,-0.012933744148240292,24047245,55548570.4,41.654124182381906,47.76481074516803,NaN,NaN,-5.053620880061704,0.7809087672017687
2006-02-06T09:30:00-05:00,25.614499,25.72816,25.614499,25.711923,9132003,11951365.5,44.1581298123459,45.63600005546402,NaN,NaN,-80.82597357205209,-65.29852021534498,-0.03725398669408401,-0.0595012275158453,-0.022247240821761292,33179248,44840673.4,36.448326152472006,45.80057015227903,NaN,NaN,-6.081247470753989,-0.1993992667919109
2006-02-07T09:30:00-05:00,25.671329,25.768762,25.533311,25.541438,9072510,11992782.25,40.13171634783535,44.99311464645374,NaN,NaN,-88.0416338338552,-77.19109123220582,-0.04606735506810192,-0.07983143465688869,-0.03376407958878677,24106738,35548717.6,32.63659876038021,44.00554130368381,NaN,NaN,-8.17931694958845,-1.3393875071914165
2006-02-08T09:30:00-05:00,25.508955,25.736279,25.508955,25.703804,11283084,12139437.25,45.251736256768304,44.87635076113856,NaN,NaN,-71.48490971056212,-82.48569765003015,-0.038506837274216846,-0.08189762618155783,-0.04339078890734098,35389822,31209869.4,31.00601825047501,42.71868795612034,NaN,NaN,-8.457915027788157,-2.3563200101338078
2006-02-09T09:30:00-05:00,25.711923,25.955484,25.703804,25.768762,7928364,12075830.95,47.19733346155465,45.72919027063948,NaN,NaN,-24.216414977887666,-72.74429679013626,-0.027208405806971446,-0.07740129616605529,-0.05019289035908384,43318186,32008247.8,31.682395498692102,42.16349049643768,NaN,NaN,-8.11538800729352,-3.1790440097280523
2006-02-10T09:30:00-05:00,25.736279,25.931128,25.614499,25.91489,6554495,12044157.1,51.382925387933625,46.73810827582332,NaN,NaN,-14.047095916745755,-55.72320560222062,-0.00891731167935849,-0.06133952995828196,-0.05242221827892347,49872681,37173335,36.05026912648729,42.258768646133944,NaN,NaN,-6.564345785032614,-3.6626585490572756
2006-02-13T09:30:00-05:00,25.858068,25.890534,25.703804,25.817466,18038357,12569425.95,48.61599997301946,47.30271389376401,NaN,NaN,-10.00564916782019,-41.559140721374234,-0.0027247967464037737,-0.055828214211928184,-0.05310341746552441,31834324,36904350.2,35.921466045154276,42.461278980990166,NaN,NaN,-6.060931263496039,-4.005268936834242
2006-02-14T09:30:00-05:00,25.858068,26.23152,25.833712,26.125968,18680330,13136450.2,56.58796649449244,48.331794634413804,NaN,NaN,92.23441374724328,-5.503931205154544,0.0214714006361411,-0.026264166670348033,-0.04773556730648913,50514654,42185933.4,40.42258477188417,42.91016716634925,NaN,NaN,-3.019291424259999,-3.8644150064664933
2006-02-15T09:30:00-05:00,26.158451,26.30458,26.061035,26.280232,16654144,13426293.5,59.93524135322599,48.80030853899894,NaN,NaN,142.4576825758994,37.28458725213777,0.04579150624251151,0.009503815496650247,-0.03628769074586126,67168798,48541728.6,45.393566496704345,43.29783108438194,NaN,NaN,0.6247836220251662,-3.2231009166819704
2006-02-16T09:30:00-05:00,26.272113,26.434487,26.23152,26.434487,9682459,13523895.1,63.006824030115716,49.45008324613553,NaN,NaN,172.40096045924994,76.6080623395653,0.06880943253574624,0.04972409992382154,-0.0190853326119247,76851257,55248342.8,50.12269983591826,43.210346816014344,NaN,NaN,4.685438230970513,-2.093309609874473
2006-02-17T09:30:00-05:00,26.426368,26.483199,26.239647,26.328936,9478734,12648046.25,59.6376166505171,50.01123586458208,NaN,NaN,142.81135777151783,107.97975307721799,0.07306749775002751,0.07224903957560969,-0.0008184581744178215,67372523,58748311.2,52.43767484411134,42.86183370699165,NaN,NaN,6.988062629498259,-0.7959707185355112
2006-02-21T09:30:00-05:00,26.280232,26.402012,26.215274,26.247757,14562305,12693281.3,57.10828766322088,50.57131175334894,NaN,NaN,111.05638369116718,132.19215964901548,0.06673285915942956,0.08259761577486913,0.015864756615439568,52810218,62943490,55.12615998372721,42.5992622885898,NaN,NaN,8.117380559571387,0.47736517833690284
2006-02-22T09:30:00-05:00,26.54003,26.775473,26.312707,26.742998,22408139,12965202.75,66.45519423726276,51.82943920999776,NaN,NaN,178.96878881576617,149.53903466272004,0.09072467135420062,0.12927059580819034,0.03854592445398972,75218357,67884230.6,58.12804505962119,42.672569873132495,NaN,NaN,12.512648799777832,2.1966914099713213
2006-02-23T09:30:00-05:00,26.751117,26.824177,26.523793,26.645582,9131262,12980642.35,63.52279885581444,53.201961819622205,NaN,NaN,167.77873406570754,154.60324496068168,0.09443805987750561,0.15659349930087174,0.06215543942336613,66087095,67667890,57.945256346587186,43.21251323961403,NaN,NaN,15.008055062990763,4.026886217545528
2006-02-24T09:30:00-05:00,26.653692,26.783599,26.580632,26.702404,9344350,12716104.75,64.50661053916949,54.82131293309116,NaN,NaN,146.5193627199315,149.42692541281798,0.09487452873000117,0.1807486003358676,0.08587407160586642,75431445,67383927.6,57.68882986142184,44.357849359545455,NaN,NaN,17.301347401409203,5.923237815240338
2006-02-27T09:30:00-05:00,26.710515,26.824177,26.710515,26.751117,11741411,12682589.6,65.36893239198764,56.33637026020842,NaN,NaN,138.8973569278223,148.6441252440789,0.09250047172082118,0.2014996612568929,0.10899918953607171,87172856,71343994.2,60.325653641079434,46.06337275158884,NaN,NaN,19.412662029445993,7.850298417269717
2006-02-28T09:30:00-05:00,26.669938,26.694286,26.418242,26.491318,17547018,13195522.65,57.3643079921816,57.56726966337601,NaN,NaN,81.15269651887921,142.6633878096213,0.06858994115615596,0.19473661598126668,0.12614667482511072,69625838,74707118.2,62.4650301162738,48.193974991295526,NaN,NaN,18.740759094488865,9.40607851401531
2006-03-01T09:30:00-05:00,26.572505,26.629336,26.499437,26.629336,6732234,12724523.55,60.1556872361718,58.631837590476266,NaN,NaN,81.2439100179294,123.11841205005393,0.057665616936950714,0.1982286959962991,0.1405630790593484,76358072,74935061.2,62.61218530498447,50.451558352331915,NaN,NaN,19.0551034517135,10.784510647972194
2006-03-02T09:30:00-05:00,26.515674,26.515674,26.353308,26.46697,17976274,12949214.55,55.54824483363038,59.22833125991025,NaN,NaN,50.37944314307991,99.63855386552842,0.03615222966386061,0.18575336613917415,0.14960113647531353,58381798,73394001.8,60.87457161828508,52.5367137894457,NaN,NaN,17.861473703652383,11.79550537021222
2006-03-03T09:30:00-05:00,26.393886,26.556276,26.320825,26.402012,13554019,12739027.05,53.77374587344085,59.399104151732196,NaN,NaN,42.56450818342712,78.84758295822755,0.015263542875784575,0.16868056507004425,0.15341702219425968,44827779,67273268.6,54.41529201002046,53.848501138269505,NaN,NaN,16.348280570074476,12.4459018273354
2006-03-06T09:30:00-05:00,26.402012,26.475081,26.239647,26.320825,17053713,12827760.25,51.556923310345034,59.609170104398295,NaN,NaN,22.421859101625408,55.552483392988165,-0.005209059840210084,0.14690569739399706,0.15211475723420714,27774066,55393510.6,44.53744503451626,54.46392820893821,NaN,NaN,14.430574266963742,12.72942646156802
2006-03-07T09:30:00-05:00,26.30458,26.426368,26.215274,26.410131,26696392,13705979.7,53.8125313360235,59.410924735936234,NaN,NaN,18.492789012508638,43.020501891714055,-0.013455323998637553,0.1352956022359102,0.14875092623454775,54470458,52362434.6,42.42151445953325,54.60670890091315,NaN,NaN,13.468179332487457,12.834962585985082
2006-03-08T09:30:00-05:00,26.434487,26.483199,26.255876,26.426368,10373336,13771021,54.22980836750232,59.00339380838454,NaN,NaN,21.24776012431934,31.021271912992027,-0.018238498691598687,0.1259528028700494,0.14419130156164808,64843794,50059579,40.834228996886125,54.28104193664042,NaN,NaN,12.794243977640804,12.829145641935899
2006-03-09T09:30:00-05:00,26.426368,26.507547,26.247757,26.264003,7944866,13604110.1,49.42154803705722,58.03301695173751,NaN,NaN,-1.050793161405029,20.735224652095045,-0.03195672724294829,0.10424539250796272,0.136202119750911,56898928,49763005,40.62341649283472,53.602521697848736,NaN,NaN,10.812744189578385,12.541088291599111
2006-03-10T09:30:00-05:00,26.345182,26.548149,26.264003,26.499437,9611144,13688249.1,55.57275991064795,57.742670041746855,NaN,NaN,23.259040533715932,16.874131122152857,-0.025096703548446897,0.1048312403153524,0.1299279438637993,66510072,54099463.6,45.08747838593624,53.077507665121935,NaN,NaN,10.867158354576798,12.301955443453066
2006-03-13T09:30:00-05:00,26.572505,26.637455,26.434487,26.507547,12923867,14006717.7,55.772298034264516,57.647242211107105,NaN,NaN,49.130415056532314,22.21584231313424,-0.020148329936714976,0.10474253144290557,0.12489086137962055,79433939,64431438.2,53.967471719100104,52.99474421764858,NaN,NaN,10.968241702366978,12.111424909012197
2006-03-14T09:30:00-05:00,26.523793,26.816066,26.515674,26.816066,17449838,13977291.75,62.645581741845746,57.375127032863034,NaN,NaN,120.13508455229508,42.54430142109153,0.002559779205741214,0.12809058538679707,0.12553080618105586,96883777,72914102,59.72586221115733,53.108874014186874,NaN,NaN,13.221462212245537,12.27000166661696
2006-03-15T09:30:00-05:00,26.767354,26.897253,26.669938,26.848549,23891884,14237869.45,63.292403683447105,57.3586702348368,NaN,NaN,142.61300951654195,66.81735129953606,0.017587143006811135,0.1475147349395698,0.12992759193275866,120775661,84100475.4,65.8014193080601,53.67002851143494,NaN,NaN,15.232090443751344,12.693157206207585
2006-03-16T09:30:00-05:00,26.929728,27.051517,26.913482,26.937838,14018128,14106068.65,65.08224915977914,57.39978727916606,NaN,NaN,186.4073064063922,104.30897121309549,0.030597746741068882,0.16817477535909475,0.13757702861802587,134793789,99679447.6,72.11131364692703,54.70020592468531,NaN,NaN,17.452418533500904,13.373051681535202
2006-03-17T09:30:00-05:00,26.816066,26.872905,26.775473,26.872905,8747831,14059337.25,62.68838838214643,57.20831984989169,NaN,NaN,115.31202400052928,122.71956790645818,0.03175042078643717,0.17726505460107234,0.14551463381463517,126045958,111586624.8,75.78831446823094,55.80468169805328,NaN,NaN,18.626842338625664,14.123593203976696
2006-03-20T09:30:00-05:00,26.840422,26.929728,26.742998,26.889134,9059702,14038385.65,63.05416237929986,57.61473802040013,NaN,NaN,107.4804001406079,134.3895649232733,0.030517552750262467,0.18366157475246325,0.15314402200220079,135105660,122720969,78.62615988272046,56.95904810994232,NaN,NaN,19.696011008942108,14.919652890400327
2006-03-21T09:30:00-05:00,26.864778,26.881016,26.588743,26.621209,10618820,13841211.4,53.69551663738179,57.1532972633437,NaN,NaN,40.37903476525812,118.4383549658659,0.009650502012454876,0.16520714951776938,0.1555566475053145,124486840,128241581.6,79.88505588191637,58.19282457972317,NaN,NaN,17.89373334492589,15.344521526761122
2006-03-22T09:30:00-05:00,26.580632,26.85666,26.572505,26.832303,8932464,13167427.65,58.87464039718846,57.390896946454994,NaN,NaN,58.31299916973916,101.57835289650534,0.008118889273529467,0.16570525909722633,0.15758636982369686,133419304,130770310.2,80.45297640817043,59.59128206471498,NaN,NaN,17.90364957936296,15.710111248561384
2006-03-23T09:30:00-05:00,26.751117,26.767354,26.621209,26.702404,10018971,13211813.1,54.81186836754068,57.465048553176416,NaN,NaN,34.843632152583986,71.2656180457437,-0.0029932370758498916,0.1538448234788845,0.1568380605547344,123400333,128491619,78.3074216742651,61.29786275501817,NaN,NaN,16.643033056347196,15.843385792530785
2006-03-24T09:30:00-05:00,26.645582,26.783599,26.572505,26.694286,12093559,13349273.55,54.55848133702975,57.67944555508246,NaN,NaN,29.695544148422602,54.14232207532236,-0.011749126615573341,0.14215165228526772,0.15390077890084106,111306774,125543782.2,75.50224641409149,63.5096342821307,NaN,NaN,15.55986165423741,15.80288234420316
2006-03-27T09:30:00-05:00,26.678048,26.72676,26.596853,26.678048,8247380,13174572,54.02053760542211,57.69430314575379,NaN,NaN,25.90032892448974,37.82630783209873,-0.019060595166843247,0.130075034942287,0.14913563010913025,103059394,119134529,69.65938746003197,65.45519663930918,NaN,NaN,14.521377836259164,15.619810271639732
2006-03-28T09:30:00-05:00,26.678048,26.759243,26.410131,26.458843,13895571,12991999.65,47.24787472168306,57.19559359962385,NaN,NaN,-24.595307122955177,24.831439454456074,-0.03799288618267965,0.1016445223807807,0.13963740856346035,89163823,112069925.6,63.79877616725744,67.09552143719284,NaN,NaN,11.53631245088153,15.036453440102846
2006-03-29T09:30:00-05:00,26.60498,26.637455,26.402012,26.580632,6554620,12983118.95,50.92889875593432,57.30326150811506,NaN,NaN,-24.418526694184962,8.285134281671244,-0.04136838767876258,0.08792692396500712,0.1292953116437697,95718443,104529753.4,58.17323102774961,68.34907961825819,NaN,NaN,10.074004879167273,14.32753221711205
2006-03-30T09:30:00-05:00,26.483199,26.653692,26.369538,26.418242,10014163,12585013.4,46.290612773942755,56.6402509983504,NaN,NaN,-49.414241171676245,-8.566440383180797,-0.05285759848534351,0.06322331353709032,0.11608091202243383,85704280,96990542.8,53.12880659209731,68.92346020441255,NaN,NaN,7.373042193801509,13.334033642353402
2006-03-31T09:30:00-05:00,26.434487,26.548149,26.385775,26.426368,9105647,12362594.8,46.55292552049593,55.98172439022408,NaN,NaN,-61.38193561958195,-26.781936336781712,-0.05782763576109537,0.04379636732106462,0.10162400308215999,94809927,93691173.4,51.042813848591706,68.71455607080482,NaN,NaN,5.274921108641583,12.182731851823142
2006-04-03T09:30:00-04:00,26.426368,26.678048,26.402012,26.46697,17772059,12398512.1,47.92154458278945,54.930007450291484,NaN,NaN,-41.694726479111125,-40.30094741750188,-0.05624670046914167,0.03131562749573291,0.08756232796487458,112581986,95595691.8,52.20926185464044,68.17765604533932,NaN,NaN,3.908093466995795,11.000640653990665
2006-04-04T09:30:00-04:00,26.46697,26.79171,26.402012,26.751117,5493000,11338342.5,56.346344488324696,54.4338603649256,NaN,NaN,9.621330550704213,-33.457619882770004,-0.03497194718317444,0.043847393985906535,0.07881934116908097,118074986,101377924.4,55.66315421150167,67.453494252728,NaN,NaN,5.220862123975946,10.174958006845705
2006-04-05T09:30:00-04:00,26.767354,26.872905,26.702404,26.799821,10007389,11320045.15,57.61209946981986,53.90027824421422,NaN,NaN,71.17978601878652,-14.337957340175706,-0.017414462113823442,0.05705126352680168,0.07446572564062512,128082375,107850710.8,59.21644342302029,66.53243209387752,NaN,NaN,6.674852771912495,9.674942973283818
2006-04-06T09:30:00-04:00,26.994677,26.994677,26.596853,26.702404,14081933,11626898.5,54.22532706669268,53.29577386453895,NaN,NaN,52.61020284318514,6.066931462796572,-0.012392690899861392,0.05897486201579838,0.07136755291565977,114000442,113509943.2,62.07803429436369,65.55312636717272,NaN,NaN,6.910618579780051,9.280039488497565
2006-04-07T09:30:00-04:00,26.807947,26.832303,26.410131,26.450725,15017056,11897194.1,46.603067620534404,52.12069566748428,NaN,NaN,-64.9345499404762,5.356408598617722,-0.025307706824934953,0.03973291938449108,0.06504062620942604,98983386,114344635,62.4960120764401,64.40097295243841,NaN,NaN,4.7041262330095766,8.626337594856423
2006-04-10T09:30:00-04:00,26.515674,26.637455,26.434487,26.499437,8594846,11680743.05,48.12301971429525,51.7226601729781,NaN,NaN,-88.46769425858807,-3.998184957277664,-0.029560193724670614,0.02809038405358777,0.05765057777825838,107578232,113343884.2,61.61908778006788,63.09626094516351,NaN,NaN,3.3787779972012744,7.876686223762831
2006-04-11T09:30:00-04:00,26.613099,26.613099,26.223401,26.272113,11986154,11407558.85,42.10029827813924,50.524492878760306,NaN,NaN,-149.80370039697263,-35.88319114681303,-0.045708851850878716,0.0005145129646599855,0.0462233648155387,95592078,108847302.6,57.701336286748756,61.47114379363338,NaN,NaN,0.25749745974038785,6.788230686045339
2006-04-12T09:30:00-04:00,26.280232,26.410131,26.264003,26.328936,8631062,10644517.75,43.987374271545626,49.75131472904637,NaN,NaN,-144.37335376579833,-78.99381910372999,-0.05022948285121888,-0.0165634887484849,0.03366599410273398,104223140,104075455.6,53.79262936477803,59.72008720009859,NaN,NaN,-1.6918838599461374,5.576785750903699
2006-04-13T09:30:00-04:00,26.296469,26.402012,26.247757,26.369538,6874869,10287354.8,45.357780569300736,49.09412181706573,NaN,NaN,-128.449299919124,-115.20571965619183,-0.04814561594734564,-0.026516025831448076,0.021629590115897566,111098009,103494969,53.31945272921342,58.13560193689302,NaN,NaN,-2.8777111523199936,4.3690004790146
2006-04-17T09:30:00-04:00,26.418242,26.475081,26.272113,26.345182,7462646,10223095.55,44.65203542860004,48.42494309014985,NaN,NaN,-106.7476180531117,-123.56833327871894,-0.046067151662695385,-0.03595434946247167,0.010112802200223718,103635363,104425364.4,54.01760815258433,57.01833198636104,NaN,NaN,-4.050872498599116,3.166161482212641
2006-04-18T09:30:00-04:00,26.450725,26.85666,26.393886,26.832303,16313817,10585801.3,58.54484816046771,49.231869764348765,NaN,NaN,65.29391045470382,-92.81601233606054,-0.011354766573874832,-0.004080656017119821,0.0072741105567550104,119949180,106899554,55.90622377047304,56.454578243733586,NaN,NaN,-0.48562314201444756,2.6444779644659144
2006-04-19T09:30:00-04:00,26.889134,26.929728,26.759243,26.864778,11339995,10621860.05,59.27869794980718,49.82828399248255,NaN,NaN,135.38068644211478,-35.779134968243085,0.013003681490848313,0.0235287124203154,0.010525030929467088,131289175,114038973.4,60.897087644005744,56.649139430609026,NaN,NaN,2.5400939952450305,2.629565968862931
2006-04-20T09:30:00-04:00,26.872905,27.04339,26.807947,26.921609,5376721,10444072.9,60.59337395919053,50.84990979142882,NaN,NaN,156.52672431768883,24.400880648454347,0.031120277319431913,0.04942537757875698,0.018305100259325066,136665896,120527524.6,64.79694166123024,57.48257764983281,NaN,NaN,5.398919238359869,3.0251878645053507
2006-04-21T09:30:00-04:00,27.083983,27.083983,26.564386,26.889134,6028303,10244539.5,59.41298004061782,51.76848511429467,NaN,NaN,110.29819682734724,72.1503799977486,0.038604669509692977,0.06656093714644129,0.027956267636748314,130637593,124435441.4,66.9357884373063,58.61779012045529,NaN,NaN,7.374391323253716,3.646502644326546
2006-04-24T09:30:00-04:00,27.148933,27.148933,26.580632,26.897253,6814640,9980593.55,59.62474551988444,52.60442803837288,NaN,NaN,111.39986374442559,115.77987635725606,0.04153528462775967,0.0798753734214479,0.038340088793688235,137452233,131198815.4,70.29913175924851,59.909923685070154,NaN,NaN,9.043402746884503,4.417488373263397
2006-04-25T09:30:00-04:00,26.897253,26.897253,26.653692,26.734871,8730461,10004747.6,53.60107101840993,52.4083370762361,NaN,NaN,60.781429325126666,114.87738013134063,0.030482409997228274,0.07644310129022358,0.04596069129299531,128721772,132953333.8,71.11984558201218,61.01397306867805,NaN,NaN,8.791528304901872,5.042351220640322
2006-04-26T09:30:00-04:00,26.637455,26.897253,26.637455,26.889134,6679885,9643963.3,57.94752502919025,52.432296044762566,NaN,NaN,71.02137237133151,102.00551731718397,0.03138243343083643,0.08518873308154085,0.053806299650704416,135401657,133775830.2,71.51718917113429,61.8925977649719,NaN,NaN,9.87262680183245,5.732390589382055
2006-04-27T09:30:00-04:00,26.816066,27.360019,26.775473,27.311307,21788335,10405649.05,67.04567216038285,53.348034980026156,NaN,NaN,170.74335074131014,104.84884260190825,0.05675298448891054,0.1247475302618426,0.06799454577293206,157189992,137880649.4,73.4783446984211,62.706905650976005,NaN,NaN,14.101494456617235,6.927976856129938
2006-04-28T09:30:00-04:00,27.197645,27.676648,27.197645,27.571113,16502151,10730048.45,71.178284157315,55.10340758979619,NaN,NaN,233.51656256238098,129.492515748915,0.08563998782710859,0.1750445305568178,0.0894045427297092,173692143,146491559.4,77.04844918587503,63.74636544450707,NaN,NaN,19.201684910377004,8.681363721022375
2006-05-01T09:30:00-04:00,27.595469,27.627936,27.075873,27.140806,16769555,11113243.85,58.16742610204573,55.820865188921225,NaN,NaN,152.60391085668343,137.73332517136654,0.07098014059534209,0.1781297184738868,0.10714957787854472,156922588,150385630.4,78.46051553692831,64.9493245699971,NaN,NaN,18.708060257052747,10.113748940455284
2006-05-02T09:30:00-04:00,27.27884,27.327544,27.189534,27.311307,4899306,10469606.2,61.19425358434262,57.184719139364326,NaN,NaN,133.77355006270528,152.3317493188823,0.06797484934988632,0.19211813956590262,0.1241432902160163,161821894,157005654.8,80.6410604661783,66.5878762970992,NaN,NaN,19.447428359978115,11.447131714672832
2006-05-03T09:30:00-04:00,27.319417,27.360019,27.181408,27.286951,5729491,10481430.75,60.52059478427044,58.36566346170181,NaN,NaN,116.88184066610474,161.50384297783694,0.05984170339339584,0.19894541945776112,0.13910371606436528,156092403,161143804,81.87618458828723,68.59384452734987,NaN,NaN,19.77234437202596,12.63644780858042
2006-05-04T09:30:00-04:00,27.295069,27.449325,27.295069,27.343773,10435413,10502831.95,61.58313767662376,59.524617540796314,NaN,NaN,119.61326452172005,151.27782573391892,0.05396506936412515,0.20656005276952172,0.15259498340539657,166527816,163011368.8,82.42127754158011,70.67254629966178,NaN,NaN,20.37094310803296,13.741375708502211
2006-05-05T09:30:00-04:00,27.449325,27.765954,27.449325,27.733479,14817643,10539617.45,67.95347062873175,61.18900576937715,NaN,NaN,153.76633799201446,135.3277808198456,0.07093171805462095,0.24125963097367276,0.1703279129190518,181345459,164542032,82.87586579051583,72.73385041665686,NaN,NaN,23.144505953061337,15.084680029153514
2006-05-08T09:30:00-04:00,27.774081,27.782191,27.587343,27.619817,10287235,10303126.4,64.5894053731528,61.62075985599751,NaN,NaN,133.3532342479558,131.4776454981001,0.06904123651149591,0.2566294585584217,0.18758822204692577,171058224,167369159.2,83.71360024492421,74.72009159340338,NaN,NaN,24.21682095780077,16.389271590388837
2006-05-09T09:30:00-04:00,27.579224,27.701004,27.579224,27.66853,12733936,10510080.9,65.38042768507049,62.056597694230604,NaN,NaN,114.07990797573365,127.53891708070576,0.06563560744639915,0.2696327313549247,0.20399712390852556,183792160,171763212.4,84.94626942765503,76.43789029223548,NaN,NaN,25.313355104605495,17.66414066384836
2006-05-10T09:30:00-04:00,27.644173,27.733479,27.489918,27.684775,10468053,10434175.85,65.65595614612475,62.41821070758304,NaN,NaN,100.49713458212555,124.2619758639099,0.05923721323601955,0.27804364045355,0.21880642721753046,194260213,179396774.4,86.81349867284014,78.01050150735047,NaN,NaN,26.2677927788874,18.893233823139653
2006-05-11T09:30:00-04:00,27.66853,27.66853,27.140806,27.230112,10604285,10532837,52.95335102506368,61.95680863504346,NaN,NaN,44.164994693042445,109.17232189817439,0.021111164184960562,0.24519538244873118,0.22408421826377062,183655928,182822396.8,87.55925480475483,79.48360624788252,NaN,NaN,22.889100513441242,19.464071921754165
2006-05-12T09:30:00-04:00,26.79171,27.230112,26.79171,26.954084,10412752,10709731.15,47.007256836764626,61.05555944339205,NaN,NaN,-31.940867545867203,72.03088079059805,-0.023550581999314757,0.19464599076462719,0.21819657276394194,173243176,181201940.2,85.10727695259675,80.54133090455024,NaN,NaN,17.94412493090953,19.24693663734779
2006-05-15T09:30:00-04:00,26.905372,27.165178,26.905372,27.140806,6757610,10674479.35,51.014390993443016,60.870796584465836,NaN,NaN,-25.798169332987406,40.200600074409394,-0.040382233522383654,0.16771878086096237,0.20810101438334602,180000786,182990452.6,85.58701873387129,81.57470041539732,NaN,NaN,15.250610409411285,18.67603289049972
2006-05-16T09:30:00-04:00,27.165178,27.238238,26.994677,27.108339,9567173,10337147.15,50.30213638872942,60.3246973958615,NaN,NaN,-22.176331877933766,12.949352103675926,-0.0527842685203615,0.14212067873289413,0.19490494725325563,170433613,180318743.2,81.37023851942509,82.27848965456094,NaN,NaN,12.920267515290758,17.853780694041298
2006-05-17T09:30:00-04:00,26.929728,26.970321,26.483199,26.564386,13430476,10441671.2,40.180294045204285,58.40574181620588,NaN,NaN,-127.96394732849365,-32.74286427844792,-0.09428130609868438,0.07705331462990017,0.17133462072858455,157003137,172867328,70.88114369864735,82.09297529743425,NaN,NaN,7.076964929043518,16.3142355847559
2006-05-18T09:30:00-04:00,26.588743,26.686167,26.320825,26.328936,8365381,10591104.2,36.734645387189076,55.94548190405403,NaN,NaN,-163.60332557657767,-74.29652833237193,-0.13193635744155305,0.00641417392664323,0.13835053136819628,148637756,165863693.6,62.700077827262454,81.06809162896192,NaN,NaN,1.097894532164984,14.14047257724291
2006-05-19T09:30:00-04:00,26.483199,26.588743,26.30458,26.46697,12229790,10901178.55,39.98399914727033,54.646665692998646,NaN,NaN,-147.46186934476088,-97.40072869215068,-0.14107380023039562,-0.037991718919798245,0.10308208131059737,160867546,163388567.6,60.06170969925545,79.75389121198529,NaN,NaN,-2.5481633485130257,11.756381730706348
2006-05-22T09:30:00-04:00,26.410131,26.523793,26.182808,26.402012,12680111,11194452.1,38.96964694727542,53.05919379035099,NaN,NaN,-146.88161576574828,-121.61741797870286,-0.14449089809221888,-0.07753154130467621,0.06695935678754265,148187435,157025897.4,53.79504612545177,77.83631875907625,NaN,NaN,-5.747913114720274,9.255768181359688
2006-05-23T09:30:00-04:00,26.499437,26.596853,26.255876,26.272113,9390295,11227443.8,36.95088444105019,51.375643051549545,NaN,NaN,-133.35833931625274,-143.85381946636664,-0.14795852358061004,-0.1179887976882199,0.029969725892390137,138797140,150698602.8,48.38822829878796,75.44432188125487,NaN,NaN,-9.010931475937817,6.646239658888616
2006-05-24T09:30:00-04:00,26.223401,26.46697,26.061035,26.288351,13330951,11559997.1,37.3875319577736,49.6473855002031,NaN,NaN,-135.33033086920673,-145.32709617450925,-0.14161269080687264,-0.14704613761620067,-0.005433446809328023,152128091,149723593.6,47.59439267634639,72.9566872480239,NaN,NaN,-11.489213120085461,4.0554606904637485
2006-05-25T09:30:00-04:00,26.426368,26.54003,26.345182,26.523793,6985108,10819835.75,43.49771336598272,47.90054569572103,NaN,NaN,-89.00648532446847,-130.40772812408744,-0.11513678040556614,-0.1493544223162857,-0.03421764191071956,159113199,151818682.2,49.51113968179812,70.57349252597263,NaN,NaN,-11.816992535345461,1.7879673724910043
2006-05-26T09:30:00-04:00,26.661811,26.751117,26.556276,26.742998,4872578,10238357.1,48.53351897561029,46.75369666732513,NaN,NaN,-49.6071442876682,-110.83678311266888,-0.078205425699402,-0.13197442403497206,-0.05376899833557006,163985777,152442328.4,50.096254035082545,68.17225351098394,NaN,NaN,-10.537953946927326,0.02712146971695706
2006-05-30T09:30:00-04:00,26.775473,26.775473,26.337063,26.345182,9418995,9870829.1,41.33367016940116,45.036071130491614,NaN,NaN,-71.63675524029239,-95.7878110075777,-0.07585539646037237,-0.14858824391103553,-0.07273284745066316,154566782,153718197.8,51.33871117496228,65.7717136357916,NaN,NaN,-11.743002486083478,-1.6543248096831051
2006-05-31T09:30:00-04:00,26.434487,26.564386,26.280232,26.531903,6486875,9950207.55,45.42593297778409,43.59106947561014,NaN,NaN,-68.09866171233938,-82.73587548679502,-0.05782678894099971,-0.1450163336269128,-0.08718954468591308,161053657,158169501.2,55.501280170091746,63.535126599880996,NaN,NaN,-11.396442249121382,-3.046055872460002
2006-06-01T09:30:00-04:00,26.515674,26.881016,26.515674,26.840422,4520674,9889766.7,51.45181999292376,43.48381725902872,NaN,NaN,-22.62407768280892,-60.194624849515456,-0.02301157893025707,-0.11595401834873442,-0.09294243941847735,165574331,160858749.2,57.847299476293585,61.41284407641947,NaN,NaN,-9.067295881321154,-3.9062330165830237
2006-06-02T09:30:00-04:00,26.710515,27.051517,26.710515,26.994677,12651285,10000560.3,54.176200587515744,43.995884669796645,NaN,NaN,7.233523130189942,-40.94662315858378,0.010707757425355083,-0.0795577426367835,-0.09026550006213858,178225616,164681232.6,60.99506960022354,59.69054355124995,NaN,NaN,-6.279404891788706,-4.245257570183836
2006-06-05T09:30:00-04:00,26.864778,26.945965,26.531903,26.556276,8066562,9663006.25,46.23505477410805,43.65450351127272,NaN,NaN,-25.84607441270484,-36.19440918359112,0.004126271561555012,-0.08510766061019481,-0.08923393217174982,170159054,165915888,61.982587544817115,58.00451275203179,NaN,NaN,-6.530710714150198,-4.571750876464745
2006-06-06T09:30:00-04:00,26.629336,26.694286,26.23152,26.491318,23214061,10309347.55,45.17835686080543,43.288519259278154,NaN,NaN,-57.99659767077231,-33.4663776696871,-0.003547121326816588,-0.09366783383027055,-0.09012071250345396,146944993,164391530.2,59.96402547037863,56.475497534242756,NaN,NaN,-7.070219207731124,-4.928674923788513
2006-06-07T09:30:00-04:00,26.458843,26.807947,26.442614,26.580632,10932414,10219271.45,46.97288011844775,43.77370397879555,NaN,NaN,-24.29804217800912,-24.706253762821046,-0.001649285210057111,-0.09218231901602536,-0.09053303380596825,157877407,163756280.2,59.10024353535898,55.63400466543643,NaN,NaN,-6.945114383422653,-5.216737703736247
2006-06-08T09:30:00-04:00,26.507547,26.710515,26.255876,26.629336,28726155,11132176.55,47.97300799960184,44.57644416539647,NaN,NaN,-36.684288802048044,-27.518295986668875,0.0035602478433075513,-0.08608272400183381,-0.08964297184514136,186603562,167962126.4,62.90973233868394,55.64897998768082,NaN,NaN,-6.546899132658397,-5.40676076501084
2006-06-09T09:30:00-04:00,26.588743,26.742998,26.499437,26.54003,11780701,11190997.35,46.25044887444984,45.02404771733785,NaN,NaN,-9.259249561255094,-30.816850524957886,0.001756805738830719,-0.08744696467160296,-0.08920377041043367,174822861,167281575.4,61.9049697238119,55.780641418006276,NaN,NaN,-6.71077557671329,-5.593048595254047
2006-06-12T09:30:00-04:00,26.548149,26.60498,26.239647,26.247757,9566802,11148699.85,41.05486289499991,45.17299171360389,NaN,NaN,-84.14119631576625,-42.475874905570166,-0.01730457780324024,-0.11083449266448397,-0.09352991486124373,165256059,166300976.4,60.4078569636784,56.25298504930818,NaN,NaN,-8.427380894313838,-5.997953209405446
2006-06-13T09:30:00-04:00,26.182808,26.345182,25.663211,25.736279,24372138,12029426.25,33.88175414382688,44.95376812094508,NaN,NaN,-232.85018903394013,-77.44659317820373,-0.060133385837769365,-0.16869664715845545,-0.10856326132068608,140883921,165088762,58.52363120182354,56.97694239952501,NaN,NaN,-12.444180628509303,-6.918842840705997
2006-06-14T09:30:00-04:00,25.776872,25.866178,25.314098,25.582016,20194609,12560798.05,32.06223709829115,44.57338991669633,NaN,NaN,-311.0706451739015,-134.80111377738223,-0.09268031527354031,-0.2244136554126115,-0.13173334013907118,120689312,157651143,48.5230207640224,57.04327297721615,NaN,NaN,-16.299562010592073,-8.25894557926115
2006-06-15T09:30:00-04:00,25.817466,26.207164,25.711923,26.150341,15694876,12674018.05,43.994902668213335,44.60890343828423,NaN,NaN,-129.76435889733975,-153.41712779644052,-0.07075148332593534,-0.22017269429649033,-0.149421210970555,136384188,147607268.2,38.86468242401668,56.282811744517474,NaN,NaN,-15.599571448585811,-9.307606417736102
2006-06-16T09:30:00-04:00,26.020433,26.020433,25.752516,25.833712,10180446,12764771.3,39.8006463795714,43.98512682428145,NaN,NaN,-147.30402705943118,-181.02608329607577,-0.07214228504452369,-0.2395990672762096,-0.16745678223168592,126203742,137883444.4,32.185346985447055,55.00346124097208,NaN,NaN,-16.503049446254224,-10.335526850381548
2006-06-19T09:30:00-04:00,25.833712,25.996077,25.598261,25.6551,7103228,12508443.2,37.62175167600283,43.71998978903871,NaN,NaN,-148.3677421774508,-193.87139246841267,-0.07910412387679971,-0.2663369370776856,-0.18723281320088586,119100514,128652335.4,27.37540191258715,53.29179629365957,NaN,NaN,-17.9627140322488,-11.425125019219728
2006-06-20T09:30:00-04:00,25.671329,25.906772,25.663211,25.72816,22591419,13004008.6,39.090623794975166,43.26746770455237,NaN,NaN,-120.28905293903148,-171.35916524943096,-0.07295141635977714,-0.2784220836506073,-0.20547066729083013,141691933,128813937.8,27.579445231650624,51.29737951234235,NaN,NaN,-18.63725129663137,-12.455428773135676
2006-06-21T09:30:00-04:00,25.776872,26.036679,25.72816,25.939246,15116707,13290329.2,43.248687762860044,42.681529688119234,NaN,NaN,-80.17400178005464,-125.17983657066156,-0.049926532456369854,-0.26787883286129244,-0.21795230040492258,156808640,136037803.4,36.20753326493903,49.751681925817024,NaN,NaN,-17.874545262492116,-13.229588271615167
2006-06-22T09:30:00-04:00,25.849941,25.931128,25.760635,25.841822,4028846,12825223.95,41.82937028467272,41.79961323791617,NaN,NaN,-81.02314993638788,-115.43159477847121,-0.03710809252120417,-0.2643374160564278,-0.22722932353522363,152779794,139316924.6,39.71836670302633,48.23191743316007,NaN,NaN,-17.686723780939904,-13.866321915804415
2006-06-23T09:30:00-04:00,25.736279,25.833712,25.606372,25.671329,5012255,12726581.3,39.392959543206075,41.310892149994594,NaN,NaN,-93.82446420505795,-104.73568220759657,-0.03593733376496805,-0.2721509907414337,-0.23621365697646562,147767539,143629684,44.07759035731066,46.9529890626239,NaN,NaN,-18.26151889211743,-14.494207198134845
2006-06-26T09:30:00-04:00,25.711923,25.898645,25.6551,25.898645,5161540,12741029.4,44.070506950233856,41.231760013525204,NaN,NaN,-66.7141423550469,-88.40496224311578,-0.0166593395485235,-0.25703783141212,-0.2403784918635965,152929079,150395397,50.16586317529956,46.253120327261115,NaN,NaN,-17.32970655776301,-14.899278535224584
2006-06-27T09:30:00-04:00,25.858068,25.931128,25.630744,25.646973,4802862,12510222.75,40.356848618479646,40.75918633495605,NaN,NaN,-73.28108400118461,-79.00336845554641,-0.01757259040529266,-0.26234422987021233,-0.24477163946491967,148126217,151682253.8,51.25293449929328,45.69259825325643,NaN,NaN,-17.6656680704013,-15.294477040249829
2006-06-28T09:30:00-04:00,25.776872,25.79311,25.614499,25.784983,5789349,12475346.45,43.18422218823172,40.41713020557246,NaN,NaN,-68.03477524025348,-76.57552314758618,-0.006184802025648112,-0.2525026419969798,-0.2463178399713317,153915566,151103639,50.717223493137894,44.821704764288846,NaN,NaN,-17.09163417422403,-15.551213773674714
2006-06-29T09:30:00-04:00,25.91489,26.353308,25.858068,26.328936,11575374,12828081.45,52.70136749294337,40.87791010689343,NaN,NaN,15.084955852592865,-57.35390198979003,0.038236503070370076,-0.1985222111333691,-0.23675871420373917,165490940,153645868.2,53.039706187059515,44.188471654520825,NaN,NaN,-13.394243769590918,-15.243075201662743
2006-06-30T09:30:00-04:00,26.410131,26.450725,26.207164,26.255876,7773902,12584212.3,51.454657585298946,41.620752584771935,NaN,NaN,49.33117930533595,-28.72277328771125,0.06157046133271066,-0.15979563753785087,-0.22136609887056152,157717038,155635768,54.83390693487931,43.79033236674946,NaN,NaN,-10.844710163106166,-14.614737339011803
2006-07-03T09:30:00-04:00,26.288351,26.572505,26.288351,26.564386,4079594,12384863.9,56.16976496099315,43.21275335742667,NaN,NaN,90.62492660541241,2.745040504380614,0.09467464892695171,-0.1030227877118719,-0.1976974366388236,161796632,157409278.6,56.43162041417194,43.64090302477434,NaN,NaN,-7.128904919521088,-13.545332707655987
2006-07-05T09:30:00-04:00,26.345182,26.402012,26.207164,26.312707,5992213,11523771.5,51.7535839500375,44.61927813255141,NaN,NaN,57.75769784431362,28.952796873480253,0.09620151481789851,-0.07744554311645047,-0.17364705793434898,155804419,158944919,57.822866198847414,44.30517769869042,NaN,NaN,-5.403682094155923,-12.382239762870263
2006-07-06T09:30:00-04:00,26.288351,26.475081,26.288351,26.393886,4243906,11189346.1,53.03617763412515,45.265083487259396,NaN,NaN,81.65810942270913,58.891373806072785,0.09887924361774997,-0.050048003412161535,-0.1489272470299115,160048325,160171470.8,58.95038196278541,45.73987052288818,NaN,NaN,-3.6205477460352458,-11.130569474750976
2006-07-07T09:30:00-04:00,26.264003,26.499437,26.239647,26.264003,3651816,9935629.15,50.71323414565229,46.04455404197946,NaN,NaN,75.01112962494405,70.87660856054302,0.08844309046645676,-0.038373383946840534,-0.1268164744132973,156396509,158352584.6,56.53669847142059,47.479252771886294,NaN,NaN,-2.8309481198516324,-9.944909281193926
2006-07-10T09:30:00-04:00,26.320825,26.483199,26.320825,26.442614,3760946,9534641.4,53.71545736008498,47.19410444798534,NaN,NaN,101.08577522341135,81.2275277441581,0.08982027724781108,-0.014541127853533453,-0.10436140510134453,160157455,158840668,57.04495280453698,49.59850640702557,NaN,NaN,-1.27033048499598,-8.705683738879934
2006-07-11T09:30:00-04:00,26.328936,26.475081,26.16657,26.450725,5807950,9346698.8,53.85292728570564,48.248554697323236,NaN,NaN,87.92583892673514,80.68771020842264,0.08744401196821994,0.004943609858930387,-0.08250040210928955,165965405,159674422.6,57.949555458458434,51.767799994654695,NaN,NaN,0.033477129681645505,-7.457232186228279
2006-07-12T09:30:00-04:00,26.531903,26.531903,26.134095,26.190918,6623471,8459265.45,48.84818955655252,48.64851911115841,NaN,NaN,60.85964222893367,81.30809908534664,0.06554251995974036,-0.000572252159614095,-0.06611477211935446,159341934,160381925.6,58.743536944905394,53.37751454322372,NaN,NaN,-0.25670678724919316,-6.428585700659839
2006-07-13T09:30:00-04:00,26.061035,26.101612,25.768762,25.776872,11406873,8019878.65,42.128750553459646,48.66990341607176,NaN,NaN,-44.5102656834085,56.07442406412313,0.022558549195231946,-0.037916585625314525,-0.06047513482054647,147935061,157959272.8,54.919567044114224,54.46331456758714,NaN,NaN,-2.625382926300616,-5.885271018608521
2006-07-14T09:30:00-04:00,25.752516,25.849941,25.565794,25.671329,9373547,7703812.2,40.59578970790481,48.75581985640738,NaN,NaN,-83.92261820173125,24.287674498788082,-0.01174969479895338,-0.0751622533192382,-0.06341255852028482,138561514,154392273.8,49.781295405849804,54.87072207105422,NaN,NaN,-5.035230260452591,-5.763836624586245
2006-07-17T09:30:00-04:00,25.598261,25.776872,25.525193,25.720033,6110213,7500300.55,41.65092067803461,48.58299226553601,NaN,NaN,-84.13063377972517,-12.755607301839216,-0.02895120336634341,-0.09960156272821408,-0.07065035936187067,144671727,151295128.2,45.77653796021495,54.55719884140532,NaN,NaN,-6.701797415733,-5.897831023321496
2006-07-18T09:30:00-04:00,25.825585,25.858068,25.565794,25.776872,8535478,7571913.05,42.9250145715191,48.76643269075311,NaN,NaN,-69.59310646830696,-44.25939638084763,-0.033943667733657826,-0.11307994402894295,-0.07913627629528512,153207205,148743488.2,42.72686338914374,53.94819376210893,NaN,NaN,-7.734429487791754,-6.160202232531533
2006-07-19T09:30:00-04:00,25.849941,26.475081,25.841822,26.458843,40063438,8445514,55.48474806314839,49.64504168181859,NaN,NaN,49.37067084252543,-46.55719065812927,0.008949801809459978,-0.06794902403346015,-0.07689882584292013,193270643,155529230,51.90355511548201,54.03293173513351,NaN,NaN,-4.675235893986444,-5.948064184167949
2006-07-20T09:30:00-04:00,26.46697,26.548149,26.328936,26.353308,15561233,8467740.3,53.52192291483115,49.703652783382,NaN,NaN,77.26820866134946,-22.201495789177688,0.029331508900312248,-0.040234439717529824,-0.06956594861784207,177709410,161484099.8,58.22872923238579,54.403576238371095,NaN,NaN,-2.821255783633069,-5.501377269805824
2006-07-21T09:30:00-04:00,26.353308,26.434487,26.117858,26.207164,21469703,9339783.15,50.83978644341034,49.65973341610424,NaN,NaN,37.01198244530379,1.9854243402293208,0.0318764126946115,-0.029720432749577697,-0.0615968454441892,156239707,165019738.4,61.468785049333285,54.87749610368923,NaN,NaN,-2.106978383890889,-5.016463143246547
2006-07-24T09:30:00-04:00,26.320825,26.572505,26.247757,26.548149,11423136,9660327.2,56.33766440025277,49.67172623319421,NaN,NaN,80.02419959180222,34.8163910145348,0.05412292764214906,0.006056814108497122,-0.048066113533651936,167662843,169617961.6,65.24454713477846,55.506990869446845,NaN,NaN,0.27505416216772177,-4.260532099615937
2006-07-25T09:30:00-04:00,26.548149,26.686167,26.410131,26.613099,8849693,9844734.85,57.31685296015545,50.069102591059774,NaN,NaN,102.49695995907159,69.23440430001051,0.06981256577078462,0.03919959367982884,-0.03061297209095578,176512536,174279027.8,68.60314474735976,56.27701076576915,NaN,NaN,2.491007820610106,-3.2960263967265027
2006-07-26T09:30:00-04:00,26.613099,26.686167,26.483199,26.580632,5506913,9879937.4,56.63313395563167,50.32602804259596,NaN,NaN,102.59381223229376,79.87903257796418,0.07419396146539652,0.06212947974078986,-0.012064481724606651,171005623,169826023.8,62.39921791651787,56.52335619103575,NaN,NaN,4.09179738877372,-2.2406229987978996
2006-07-27T09:30:00-04:00,26.710515,26.759243,26.418242,26.426368,9571113,10069025.6,53.37520237207119,50.516168630197306,NaN,NaN,88.19128670356213,82.06364818640671,0.06331598683112472,0.06708050181429925,0.0037645149831745314,161434510,166571043.8,58.25238732175821,56.6459053946313,NaN,NaN,4.526676483371879,-1.2738659299165027
2006-07-28T09:30:00-04:00,26.629336,26.994677,26.621209,26.897253,14391837,10209848.75,60.790055365301875,51.021497059141375,NaN,NaN,164.0603895565559,107.47332960865712,0.08319521467961702,0.1077585333326958,0.024563318653078786,175826347,170488371.8,61.563031956245524,56.96862533403904,NaN,NaN,7.272345990399478,-0.05297851272850562
2006-07-31T09:30:00-04:00,26.954084,26.962211,26.79171,26.85666,8954145,10268860.9,59.90560388790027,51.45383110215527,NaN,NaN,151.29045741487062,121.7265811732708,0.08847940942854457,0.1351625804387595,0.046683171010214936,166872202,170330243.6,61.351531939653526,57.21162365412441,NaN,NaN,9.2114620213414,1.2705129921386238
2006-08-01T09:30:00-04:00,26.751117,26.848549,26.621209,26.775473,7723036,10451033,58.08536566871434,52.11362939588111,NaN,NaN,109.38911974931445,123.10501313131938,0.08154643724634007,0.14861621756814003,0.06706978032179996,159149166,166857569.6,56.741238311653014,57.068602323177814,NaN,NaN,10.289258192202395,2.5589051635763056
2006-08-02T09:30:00-04:00,26.816066,26.889134,26.694286,26.824177,7264219,10514633.3,58.8923156427356,53.31102690225797,NaN,NaN,109.70699356128031,124.52764939711669,0.07542289872084934,0.16134840372286163,0.08592550500201229,166413385,165939122,55.552243849381334,57.11379352355403,NaN,NaN,11.40679829747667,3.8228898969906435
2006-08-03T09:30:00-04:00,26.710515,26.994677,26.710515,26.937838,7384802,10671678.1,60.789522087474666,54.75343635794153,NaN,NaN,113.92796170516064,129.6749843974364,0.07410120348415954,0.17855200935721172,0.10445080587305218,173798187,168411857.4,58.09803823638949,57.7078465828783,NaN,NaN,12.888375983709178,5.117959337950434
2006-08-04T09:30:00-04:00,27.213882,27.441206,26.897253,26.994677,20001600,11489167.3,61.74045743409141,56.18840326908844,NaN,NaN,143.81250404541123,125.62540729520745,0.07206335711671098,0.1945300022689409,0.12246664515222992,193799787,172006545.4,61.546151572745046,58.834247555201884,NaN,NaN,14.394389487819263,6.443163645074552
2006-08-07T09:30:00-04:00,26.994677,27.010915,26.85666,26.937838,4078978,11505068.9,60.16898691699011,57.42011557947923,NaN,NaN,95.05804251515222,114.37892431526377,0.06226455701336964,0.20029734141894195,0.13803278440557232,189720809,176576266.8,65.43963798970012,60.45658859809877,NaN,NaN,15.262351658054785,7.703047646928871
2006-08-08T09:30:00-04:00,27.019034,27.083983,26.702404,26.742998,10959511,11762646.95,55.0009787830051,57.38556063089756,NaN,NaN,70.08236412944308,106.51757319128949,0.03916619581143416,0.18699052916986503,0.14782433335843087,178761298,180498693.2,68.39745109637015,61.634724025305054,NaN,NaN,14.629709486651892,8.692570766889302
2006-08-09T09:30:00-04:00,26.929728,26.994677,26.402012,26.426368,10117628,11937354.8,47.8137435305208,56.97783353201826,NaN,NaN,23.402177061405638,89.25660989131457,0.001081160671539072,0.1491757841978547,0.14809462352631564,168643670,180944750.2,68.72524927953806,62.384475457244505,NaN,NaN,11.909594651403212,9.152145607534147
2006-08-10T09:30:00-04:00,26.393886,26.613099,26.312707,26.556276,12122504,11973136.35,50.662386988921575,56.96516214241192,NaN,NaN,-4.44571664066656,65.58187422214911,-0.01590620309603158,0.12821186965627618,0.14411807275230776,180766174,182338347.6,69.77990780259958,62.97812708247782,NaN,NaN,10.419219907587324,9.333156221827458
2006-08-11T09:30:00-04:00,26.491318,26.54003,26.361419,26.475081,6340545,11821486.25,48.866929704147616,56.43153823554726,NaN,NaN,-23.241469334405668,32.17107954618574,-0.03221529632881315,0.10384895234129132,0.13606424867010447,174425629,178463516,63.380043955482996,62.84494828395672,NaN,NaN,8.65358906813189,9.236075199870948
2006-08-14T09:30:00-04:00,26.613099,26.751117,26.458843,26.507547,6752928,11853622,49.63552534884419,55.88287197759645,NaN,NaN,-7.5642755396881105,11.646615935217678,-0.03991730844991129,0.08616761310771537,0.12608492155762666,181178557,176755065.6,60.735112573037455,62.28294598579083,NaN,NaN,7.396053490492435,8.973214955674017
2006-08-15T09:30:00-04:00,26.832303,27.286951,26.783599,26.954084,10767243,11965210.25,58.806890312224475,56.03814028878166,NaN,NaN,110.96788739292096,19.82372058791325,-0.015304793179677326,0.10695393008303,0.12225872326270733,191945800,179391966,63.28203935503649,62.34600465997074,NaN,NaN,9.004487196958834,8.977682418714705
2006-08-16T09:30:00-04:00,27.11645,27.148933,26.97844,27.100221,5891582,10256617.45,61.29120571744105,56.60356909916522,NaN,NaN,119.23954327672593,38.99119383097731,0.009135669610966818,0.13367831027641586,0.12454264066544904,197837382,185230708.4,68.20063208282235,63.05659357147532,NaN,NaN,11.120935687455603,9.283861457106262
2006-08-17T09:30:00-04:00,27.075873,27.213882,27.010915,27.189534,6559673,9806539.45,62.769039427087314,56.74492510357847,NaN,NaN,125.39171974734776,64.95868110858018,0.028539886827406158,0.16021749919970674,0.13167761237230058,204397055,189956884.6,71.52563229644242,63.76820788148938,NaN,NaN,13.313975698097288,9.859592062962124
2006-08-18T09:30:00-04:00,27.213882,27.230112,27.100221,27.230112,7484201,9107264.35,63.45176007193049,56.99822197386634,NaN,NaN,130.65216215884263,95.73740740722982,0.040595079734532385,0.18242146204046605,0.14182638230593367,211881256,197448010,75.83810217923484,64.80296289860233,NaN,NaN,15.310527662077632,10.638297148550054
2006-08-21T09:30:00-04:00,27.197645,27.197645,27.059627,27.124577,4730313,8772623.2,60.35204791934693,57.16012784891153,NaN,NaN,102.55059558800541,117.76038163276853,0.037994978734743445,0.18932010572436297,0.15132512698961953,207150943,202642487.2,78.29309056056209,66.34238091638154,NaN,NaN,16.13590239676343,11.42366932686625
2006-08-22T09:30:00-04:00,27.11645,27.189534,27.019034,27.11645,6329340,8646605.55,60.108529271818796,57.2470002509889,NaN,NaN,88.26632289501747,113.22006873318784,0.032475277780212586,0.19191922421488528,0.1594439464346727,200821603,204417647.8,79.07553455014157,68.02261596643585,NaN,NaN,16.750395008784665,12.184630138568881
2006-08-23T09:30:00-04:00,27.100221,27.148933,26.97844,27.035271,4748913,8608705.55,57.60805966517135,57.01975293511009,NaN,NaN,63.752837942281914,102.12272766629903,0.020678954276671158,0.18529263928051165,0.1646136850038405,196072690,204064709.4,78.469908764307,69.47774957557282,NaN,NaN,16.607601200567505,12.816483147425828
2006-08-24T09:30:00-04:00,27.124577,27.173289,27.067746,27.124577,4824294,8371364.6,59.5991790143178,56.86680447655483,NaN,NaN,79.17281231778877,92.87894618038725,0.016399771024582982,0.18511339878456923,0.16871362775998625,200896984,203364695.2,77.20688685745257,70.5963735244805,NaN,NaN,17.01400388023128,13.416128966398036
2006-08-25T09:30:00-04:00,27.04339,27.067746,26.954084,26.97844,4466355,7875090.5,55.04319816076401,56.500676708252975,NaN,NaN,32.793270603959,73.3071678694105,0.0019937068902708688,0.17120576137282484,0.16921205448255397,196430629,200274569.8,71.71910858370762,71.04490713833817,NaN,NaN,16.120151583160762,13.802417911649854
2006-08-28T09:30:00-04:00,26.954084,27.230112,26.945965,27.173289,11603703,8007568.4,59.48980400424799,56.821307081198896,NaN,NaN,67.36032134996341,66.26911302180211,0.0037518855493199887,0.17390191141920397,0.17015002586988398,208034332,200451247.6,71.8423417510005,71.29097075652605,NaN,NaN,16.580145870368863,14.199236191466856
2006-08-29T09:30:00-04:00,27.11645,27.11645,26.905372,27.059627,17304368,8486635,56.00965439462987,57.40672928577812,NaN,NaN,33.294141816951566,55.27467680618893,-0.0041476707808814905,0.1649654373937821,0.1691131081746636,190729964,198432919.8,68.18697990484219,71.25252294404778,NaN,NaN,15.975030120355719,14.45292103845098
2006-08-30T09:30:00-04:00,27.108339,27.213882,27.100221,27.140806,4859275,8366387.8,57.90379163857963,57.923972475039406,NaN,NaN,71.75091017669764,56.87429125307208,-0.005242649688102813,0.16255979606453508,0.1678024457526379,195589239,198336229.6,68.00845933244531,71.12599091046533,NaN,NaN,15.99401545505784,14.67307738368053
2006-08-31T09:30:00-04:00,27.140806,27.189534,27.092102,27.173289,4165075,8205401.45,58.670640648579045,58.62423754249879,NaN,NaN,66.51382461825094,54.342493713164515,-0.0051109665876335475,0.16141373751809596,0.1665247041057295,199754314,198107695.6,67.5582461288528,71.42443392284888,NaN,NaN,16.218815973528812,14.893897182230285
2006-09-01T09:30:00-04:00,27.270713,27.270713,27.124577,27.213882,3035954,7357119.15,59.65961853651931,59.3402441987613,NaN,NaN,81.9470762357856,64.17325483952983,-0.0036881283706068635,0.16191454364247093,0.1656026720130778,202790268,199379623.4,68.79634980667375,72.00023658239434,NaN,NaN,16.672586040412074,15.147995590541969
2006-09-05T09:30:00-04:00,27.238238,27.400612,27.197645,27.311307,9711285,7638734.5,62.00930082681714,59.568987806946495,NaN,NaN,107.30148044782983,72.16148665910312,0.002104684789857536,0.1682335280003997,0.16612884321054217,212501553,200273067.6,69.67191273925981,72.45665610983886,NaN,NaN,17.703441682238967,15.513059317927254
2006-09-06T09:30:00-04:00,27.197645,27.522385,27.157052,27.222001,6862922,7433905.05,58.63766457621409,59.37944915400171,NaN,NaN,100.68514676528557,85.63968764876992,-0.0015886884383592703,0.16414298266259308,0.16573167110095235,205638631,203254801,72.45025421352575,72.76020054774624,NaN,NaN,17.692001531081644,15.82433677694931
2006-09-07T09:30:00-04:00,27.11645,27.181408,26.986567,27.010915,8964615,7376254.4,51.50867854146084,58.575137662171244,NaN,NaN,10.857069672501344,73.46091954793066,-0.018802300946807293,0.14222879491744322,0.16103109586425052,196674016,203471756.4,72.64660748250608,72.84027020389365,NaN,NaN,15.609981063374786,15.79371453215295
2006-09-08T09:30:00-04:00,27.019034,27.189534,26.881016,27.165178,6836440,7111951.2,55.74332277167779,58.024534997867484,NaN,NaN,8.70195155111686,61.89854493450383,-0.020229197588410353,0.13574459887873758,0.15597379646714793,203510456,204222984.8,73.35475934937139,72.66288857318912,NaN,NaN,15.02393934166111,15.683746647796973
2006-09-11T09:30:00-04:00,27.11645,27.222001,27.083983,27.181408,4259548,7007901.35,56.176930618210925,57.72631233350062,NaN,NaN,48.061999303785655,55.12152954810385,-0.020449323440891648,0.13041214216603336,0.150861465606925,207770004,205218932,74.30453427690138,72.37799169578479,NaN,NaN,14.666897570181964,15.538482493851971
2006-09-12T09:30:00-04:00,27.213882,27.571113,27.197645,27.530512,8002267,7070368.3,64.28306045440428,58.02449313225673,NaN,NaN,253.6989242185454,84.40101830224697,0.0013883197893771737,0.15259686534364647,0.1512085455542693,215772271,205873075.6,74.93645843309078,72.08234340170972,NaN,NaN,16.91161975919597,15.734644960329685
2006-09-13T09:30:00-04:00,27.571113,27.79031,27.441206,27.733479,8547060,6959359.15,67.99027711752112,58.766080093138854,NaN,NaN,307.6141463023648,125.78681820966281,0.026577293808639657,0.18443016281506885,0.1578528690064292,224319331,209609215.6,78.22959473014384,72.06517811355522,NaN,NaN,20.07431647703534,16.35459803414478
2006-09-14T09:30:00-04:00,27.636047,27.798437,27.611691,27.798437,3827706,6856165.35,69.09583783616964,59.444412866128275,NaN,NaN,252.74110273072964,174.16362482130847,0.04367838240504257,0.21245084701273242,0.16877246460768985,228147037,215903819.8,82.42046813490471,72.43757677623037,NaN,NaN,22.97651172202277,17.300585703841634
2006-09-15T09:30:00-04:00,28.407339,28.41545,27.692886,27.725352,7387266,6897545,66.32042081035495,60.249928769670476,NaN,NaN,245.59799228427337,221.54283296793975,0.0459045401492332,0.22615313979423135,0.18024859964499815,220759771,219353682.8,84.21407096120247,73.33007408890857,NaN,NaN,24.51673825995885,18.331464640429807
2006-09-18T09:30:00-04:00,27.660419,27.782191,27.595469,27.692886,9319100,6989289.95,65.07003900853323,60.64851698426229,NaN,NaN,129.06518506525734,237.7434701202341,0.0411782644971333,0.23172143026641479,0.1905431657692815,211440671,220087816.2,84.57474034244176,74.23953113115438,NaN,NaN,25.40806257993726,19.342407203216585
2006-09-19T09:30:00-04:00,28.050108,28.050108,27.587343,27.741598,7718355,7138692.05,66.10268746171127,61.36944791762524,NaN,NaN,134.30031794752097,213.8637488660292,0.03742883418183235,0.2373292084965719,0.19990037431473956,219159026,220765167.2,84.91715000908493,75.43454328145744,NaN,NaN,26.444249772038088,20.356956141619655
2006-09-20T09:30:00-04:00,27.839014,27.977048,27.798437,27.92832,9696378,7307043.95,69.78954137332242,62.21843004153544,NaN,NaN,135.34556425178837,179.41003245591392,0.043210390831064455,0.25391336285357013,0.21070297202250568,228855404,221672381.8,85.38509047433499,76.67573122016384,NaN,NaN,28.473270773352503,21.516429660438632
2006-09-21T09:30:00-04:00,27.92832,28.001404,27.684775,27.733479,6464830,7392839.8,62.188543828572946,62.46970884010643,NaN,NaN,97.46102942291026,148.35401779435006,0.030213762230116598,0.24847017481015143,0.21825641258003484,222390574,220521089.2,81.91200775070385,77.70099990743893,NaN,NaN,27.919692629796018,22.431181513203974
2006-09-22T09:30:00-04:00,27.733479,27.830904,27.66853,27.782191,7965931,7549921.65,63.265732859733895,62.727288434621755,NaN,NaN,77.15085095422673,114.66458952834073,0.021602755855475275,0.24525985739937894,0.22365710154390367,230356505,222440436,83.14302767378368,78.72576261223249,NaN,NaN,27.785312962040642,23.196057434466354
2006-09-25T09:30:00-04:00,27.936447,28.131287,27.806547,28.066354,7122816,7682744.7,68.84211732347411,63.21534675581154,NaN,NaN,115.0739989818056,111.86635231165037,0.031168671424984196,0.2626179408251339,0.2314492694001497,237479321,227648166,85.93920271908276,79.88771189650556,NaN,NaN,29.454120389317808,24.090066428016563
2006-09-26T09:30:00-04:00,28.082583,28.220593,27.968922,28.220593,7663662,7485742.65,71.38156121592641,64.12562508721956,NaN,NaN,126.50584407956052,110.30745753805829,0.04326358256171409,0.2855287476022923,0.2422651650405782,245142983,232844957.4,88.0664831313668,81.00315681920848,NaN,NaN,31.683961584200137,25.174908593185645
2006-09-27T09:30:00-04:00,28.139414,28.212482,28.017626,28.09071,6003669,6920707.7,66.46874037608006,65.1942009325495,NaN,NaN,109.52747622651842,105.1438399330043,0.03807897516232689,0.28986388399348684,0.25178490883115995,239139314,234901739.4,88.78938898238583,82.15621264062847,NaN,NaN,31.964268850690896,26.14481720140068
2006-09-28T09:30:00-04:00,28.017626,28.220593,28.017626,28.188126,3999162,6877702.05,68.23462196089724,66.08643658892233,NaN,NaN,107.29430682809993,107.11049541404222,0.036754587472551115,0.2977281431718488,0.2609735556992977,243138476,239051319.8,90.0932865996788,83.35182172993613,NaN,NaN,32.746026910217694,27.08784715980311
2006-09-29T09:30:00-04:00,27.863387,28.374857,27.863387,28.106939,6333897,6986143.15,65.15498012947148,66.72772583972666,NaN,NaN,95.34143237148236,110.74861169749333,0.026437339952656458,0.2940202306401183,0.2675828906874618,236804579,240340934.6,90.46447905519926,84.50610349981456,NaN,NaN,32.44791998748936,27.853571849472576
2006-10-02T09:30:00-04:00,28.066354,28.147533,27.936447,28.041982,4539150,7061302.95,62.71605590365617,66.61579694324465,NaN,NaN,74.4933481771922,102.63248153657067,0.011999893913607229,0.28258275807947086,0.27058286416586363,232265429,239298156.2,87.60609509778435,85.41107754729266,NaN,NaN,31.473907670767698,28.370762681086166
2006-10-03T09:30:00-04:00,28.058227,28.382983,28.033871,28.318026,8255632,6988520.3,68.16907465509792,66.6285681959287,NaN,NaN,111.4097025764488,99.6132532359483,0.017471359036309586,0.2924220629612506,0.27495070392494103,240521061,238373771.8,85.04092757889681,85.8976013222036,NaN,NaN,32.310446201729505,28.933574612606645
2006-10-04T09:30:00-04:00,28.60218,28.659011,28.244949,28.659011,14706172,7380682.8,73.35346339397128,66.93268430720025,NaN,NaN,157.04385315165953,109.11652862097654,0.039239082877241316,0.3239995575214927,0.28476047464425136,255227233,241591355.6,86.5204413883025,86.19045655458915,NaN,NaN,34.86791212655694,29.781337114599545
2006-10-05T09:30:00-04:00,28.715842,28.935047,28.537222,28.642774,10693830,7467143.55,72.74587167502605,67.39164508324818,NaN,NaN,180.72652228288177,123.80297171193293,0.04719337860715883,0.3437521979031999,0.29655881929604105,244533403,241870341,86.64378989426814,86.36400790695099,NaN,NaN,36.64761246490785,30.76223359321502
2006-10-06T09:30:00-04:00,28.553468,28.585951,28.472289,28.545349,6340545,7442348.8,69.05010235422098,67.67593532222587,NaN,NaN,132.44360232512253,131.22340570266095,0.04078391613554461,0.3475387144654718,0.3067547983299272,238192858,242147996.8,86.7735116248463,86.52106299855132,NaN,NaN,36.94717089186991,31.64579606445143
2006-10-09T09:30:00-04:00,28.537222,28.66713,28.439806,28.626528,4488033,7453773.05,70.39954032219647,67.9828533836891,NaN,NaN,132.07805779071595,142.7403476253657,0.037012658143222466,0.35302062100895526,0.3160079628657328,242680891,244231089.2,87.73590261769768,86.72240247059507,NaN,NaN,37.60373747851391,32.49693055217464
2006-10-10T09:30:00-04:00,28.675257,28.715842,28.545349,28.626528,6825725,7394945.95,70.39954032219647,68.02642473718011,NaN,NaN,130.55116269329292,146.56863964873452,0.029827657717820033,0.35329253501300784,0.3234648772951878,242680891,244663055.2,87.93199831792117,86.90432445942267,NaN,NaN,38.13026710281441,33.30169291655175
2006-10-11T09:30:00-04:00,28.220593,28.626528,28.220593,28.553468,7392564,7337221.15,67.33517162661435,68.39404100846878,NaN,NaN,80.61828183273427,131.28352538494948,0.01614913748151936,0.34365129914708703,0.32750216166556767,235288327,240675274,75.87120434664962,86.47283850199021,NaN,NaN,37.70734257828737,33.93107143965684
2006-10-12T09:30:00-04:00,28.610307,28.756435,28.610307,28.699613,6479856,7469828.65,70.1355380721074,68.88474138078116,NaN,NaN,116.78852287110888,118.4959255025949,0.01306999930779923,0.3438396608003167,0.33076966149251746,241768183,240122230,74.34816110482946,85.8446337470649,NaN,NaN,38.139794518938686,34.53231759383996
2006-10-13T09:30:00-04:00,28.626528,28.813274,28.626528,28.813274,4956335,7348282.1,72.13625723187572,69.12003708852414,NaN,NaN,114.002462634274,114.80769756442518,0.014692919814186411,0.3491358112602505,0.3344428914460641,246724518,241828562,75.9521454534868,85.13127251380806,NaN,NaN,39.09369615256697,35.183943102229534
2006-10-16T09:30:00-04:00,28.715842,28.74019,28.618417,28.659011,6323917,7198522.95,65.70272066285045,68.7144056204473,NaN,NaN,86.45349065749828,105.68278413778167,0.0020461515355454374,0.3370005808654959,0.33495442932995045,240400601,241372504,74.60933103816215,84.17004736429342,NaN,NaN,38.00416843243378,35.58683243511585
2006-10-17T09:30:00-04:00,28.634655,28.732079,28.512874,28.659011,6895808,7157395.6,65.70272066285045,68.65968992664519,NaN,NaN,70.38230270520991,93.64901214016507,-0.009041576052521427,0.32365245926429864,0.33269403531682007,240400601,240916446,73.21533138873332,83.05761467903254,NaN,NaN,37.12401396250873,35.806429796171976
2006-10-18T09:30:00-04:00,28.780792,28.894453,28.569705,28.74019,7022305,7023691.95,67.47319202107226,68.60530207380053,NaN,NaN,84.84466288369315,94.49428835035685,-0.013369628425803914,0.3159819997845652,0.3293516282103691,247422906,243343361.8,75.80591726817228,82.03708829821065,NaN,NaN,36.8608646076931,35.95706334067499
2006-10-19T09:30:00-04:00,28.691486,28.691486,28.423561,28.553468,10123667,7206633.8,59.823600279912945,68.2244892274035,NaN,NaN,38.87607148579955,78.91179807329499,-0.030300307540790883,0.29147624378438053,0.3217765513251714,237299239,242449573,73.00544142836364,80.7900141820081,NaN,NaN,34.34974344776722,35.727446213116735
2006-10-20T09:30:00-04:00,28.553468,28.564842,28.399213,28.520993,8723812,7244527.85,58.57968055947847,67.92903384567651,NaN,NaN,16.753123043266545,59.4619301550935,-0.04432979104730583,0.2663643125160391,0.3106941035633449,228575427,238819754.8,62.850606964882026,79.02176502965791,NaN,NaN,31.9222980743039,35.18385362185776
2006-10-23T09:30:00-04:00,28.431687,28.748317,28.41545,28.707723,4844617,7130617.9,63.304471285953845,67.58156217645195,NaN,NaN,50.9126138554371,52.353754794681265,-0.04171522508595349,0.2585500722059031,0.3002652972918566,233420044,237423643.4,59.426721179955216,77.19217885830494,NaN,NaN,31.12979506789344,34.60470239986285
2006-10-24T09:30:00-04:00,28.650884,28.707723,28.561578,28.699613,3736558,6934262.7,62.968514035397064,66.83978007941093,NaN,NaN,58.1002454675728,49.897343347153836,-0.041144707417164805,0.24883441302040055,0.28997912043756535,229683486,235280220.4,54.516404575179514,74.90617622879617,NaN,NaN,30.39151568599385,34.002818583595854
2006-10-25T09:30:00-04:00,28.732079,28.821385,28.610307,28.821385,5792309,6923694.7,65.89520175522013,66.35044651371051,NaN,NaN,89.75564862708939,50.87954049583307,-0.03350272417440642,0.24810071521955734,0.28160343939396376,235475795,232890798.2,49.59658484447168,72.25994729666785,NaN,NaN,30.589285534534387,33.5151710051585
2006-10-26T09:30:00-04:00,28.870097,29.032463,28.74019,29.024352,11996253,7323549.25,70.1323099912224,66.4277470592106,NaN,NaN,156.51822634614484,74.40797146790212,-0.016571053997323504,0.26088962189730935,0.27746067589463286,247472048,234925360,53.448840996576294,69.87961368036284,NaN,NaN,32.0734890449417,33.30921643941324
2006-10-27T09:30:00-04:00,28.983759,28.98384,28.723961,28.805148,5315261,7272617.45,61.277792312793885,65.77619362996757,NaN,NaN,113.14803857893436,93.68695457503568,-0.02160857231742075,0.25044996049785695,0.2720585328152777,242156787,237641632,58.05771021119463,67.75974279418406,NaN,NaN,30.537985211509106,32.913326263998364
2006-10-30T09:30:00-05:00,28.764546,28.90258,28.715842,28.813274,9939644,7542642.15,61.47198658163382,65.13851121992738,NaN,NaN,100.09685002961109,103.52380180987049,-0.025594957516249017,0.2400648359199664,0.26565979343621543,252096431,241376909.4,63.420986407825524,66.00895622917723,NaN,NaN,29.38287793130499,32.40897650218503
2006-10-31T09:30:00-05:00,28.894453,28.967513,28.764546,28.764546,9733946,7616557.85,59.54358392203973,64.58196924102919,NaN,NaN,106.66282383918305,113.23631748419254,-0.032283493312372735,0.2253054267957495,0.25758892010812223,242362485,243912709.2,66.54831036190927,65.3430352302672,NaN,NaN,27.862500732447256,31.75947996365106
2006-11-01T09:30:00-05:00,28.894453,28.943157,28.529112,28.585951,11326446,7447571.55,52.9831355424262,63.35679763176625,NaN,NaN,5.136417573149692,96.31247127340461,-0.048529288590281494,0.19692730937027036,0.24545659796055186,231036039,243024758,64.46978224636828,64.63743674037713,NaN,NaN,24.488369843740916,30.72074994652104
2006-11-02T09:30:00-05:00,28.561578,28.610307,28.41545,28.504756,4531020,7139431.05,50.27130004476717,61.79501497554421,NaN,NaN,-105.2870253439993,43.951420935375765,-0.06358730900211124,0.1659724617079128,0.22955977071002404,226505019,238831352.2,55.63265456763293,63.186044534244715,NaN,NaN,20.84400894981146,29.3097869469911
2006-11-03T09:30:00-05:00,28.594061,28.659011,28.366738,28.504756,4711961,7058001.85,50.27130004476716,60.69277064568113,NaN,NaN,-103.23204524174245,0.6754041712404103,-0.07178488527343788,0.1398286641182267,0.21161354939166457,226505019,235700998.6,50.1106569818601,61.43613924450886,NaN,NaN,17.905649482049654,27.680624451999464
2006-11-06T09:30:00-05:00,28.577824,28.878224,28.520993,28.837622,9466291,7306914.75,60.00433214902894,60.285742894693875,NaN,NaN,45.895030763585446,-10.164959681964715,-0.053846394813933884,0.1443055558742472,0.1981519506881811,235971310,232475974.4,45.139603528416444,59.430730111629074,NaN,NaN,18.176701760509122,26.322921210357986
2006-11-07T09:30:00-05:00,28.861978,29.008115,28.845741,28.90258,4725017,7201879.35,61.58447277530423,59.86512009142473,NaN,NaN,138.55359103812904,-3.7868062421755213,-0.03744122523141252,0.15135041914891545,0.18879164438032797,240696327,232142742.8,44.64676324384053,57.205076252748235,NaN,NaN,18.894452877948552,25.26171144858521
2006-11-08T09:30:00-05:00,28.780792,29.073065,28.780792,29.024352,3912818,7027892.05,64.42214375986669,60.19358748284999,NaN,NaN,145.28535427423202,24.24298109804095,-0.019146024688974028,0.16485911351911042,0.18400513820808445,244609145,234857364,49.485299333228525,55.52506610309572,NaN,NaN,20.396794842155902,24.56672336195245
2006-11-09T09:30:00-05:00,29.024352,29.024352,28.780792,28.829496,4962001,6951999.3,57.14762221978691,60.09129760144345,NaN,NaN,86.76725233997767,62.65383663483634,-0.02078807559681653,0.1580200437120638,0.17880811930888033,239647144,237485789,53.70495052417296,54.87180492875935,NaN,NaN,19.365352473966762,23.823670377954496
2006-11-10T09:30:00-05:00,28.910691,29.064946,28.861978,29.064946,6406198,7024492.45,62.63763345649504,60.04366632791068,NaN,NaN,134.26713397557518,110.15367247829985,-0.007331826566991967,0.16964333610014037,0.17697516266713234,246053342,241395453.6,59.16858675675822,54.853366755673854,NaN,NaN,20.324049658802302,23.323724560932753
2006-11-13T09:30:00-05:00,28.935047,29.154252,28.935047,29.032463,4203012,6918447.2,61.467630653618045,59.93646037206933,NaN,NaN,135.04391024381613,127.98344837434601,-0.002199801852295402,0.1742254103517631,0.1764252122040585,241850330,242571257.6,60.67183605627283,55.293040432894806,NaN,NaN,20.705453853306963,22.949685888414784
2006-11-14T09:30:00-05:00,28.967513,29.235431,28.853852,29.202964,7790781,6963195.85,65.14756575292775,59.883057800477005,NaN,NaN,140.01139914011915,128.27500999474404,0.010404709578651528,0.18943109917737289,0.17902638959872136,249641111,244360214.4,62.90927660908197,56.24394698750983,NaN,NaN,22.23000540459487,22.846874390726224
2006-11-15T09:30:00-05:00,29.154252,29.235431,29.105548,29.16237,4038577,6814009.45,63.59043234378708,59.4157808256602,NaN,NaN,146.80945473623763,128.57983008714513,0.013536777418664991,0.1959473613720526,0.1824105839533876,245602534,244558892.2,63.15994654942831,56.937597384142116,NaN,NaN,22.973749766471197,22.864999444404077
2006-11-16T09:30:00-05:00,29.357219,29.446525,29.243557,29.446525,11176791,6866665.65,69.14913142119315,59.978019333403,NaN,NaN,199.31360464135972,151.08910054742154,0.03126138240911888,0.22148731196478622,0.19022592955566733,256779325,247985328.4,67.26843201773994,57.59550608460969,NaN,NaN,25.510459596394114,23.242922323259798
2006-11-17T09:30:00-05:00,29.381575,29.381575,29.22732,29.22732,12762140,7068582.05,61.36582614809521,59.9704364452931,NaN,NaN,143.81498178537242,152.998670109381,0.025008643625624383,0.2214867340876978,0.19647809046207343,244017185,247578097,66.32175721235745,57.80270399921911,NaN,NaN,25.037124156137047,23.49923687081369
2006-11-20T09:30:00-05:00,29.308515,29.470881,29.276032,29.41405,13281557,7490429.05,64.98175620723435,60.358877322807004,NaN,NaN,158.4261908800378,157.67512623662532,0.029903972786424676,0.23385805644510427,0.2039540836586796,257298742,250667779.4,69.79493169435139,58.03460552296498,NaN,NaN,25.878986693722954,23.8392011312293
2006-11-21T09:30:00-05:00,29.430288,29.430288,29.300388,29.365338,4278147,7517508.5,63.31690801977236,61.09700392833172,NaN,NaN,131.4988360572087,155.97261362004326,0.026436558109497743,0.23699978129555177,0.21056322318605403,253020595,251343676.2,70.51137678192231,58.46614798979027,NaN,NaN,26.00383928127429,24.148435152664298
2006-11-22T09:30:00-05:00,29.365338,29.470881,29.284159,29.397821,2485496,7352167.85,63.97963725571751,62.07617087197104,NaN,NaN,119.41464194995378,150.49365106278648,0.023030726165526344,0.23935163089296196,0.21632090472743562,255506091,253324387.6,72.56505622427844,59.67560525097924,NaN,NaN,26.306214965045736,24.456689411575933
2006-11-24T09:30:00-05:00,29.22732,29.349092,29.186727,29.251676,2505819,6877646.15,58.82994637778856,62.68750275290113,NaN,NaN,74.0734622242652,125.4456225793676,0.008389919087898157,0.2268083035873083,0.21841838449941015,253000272,252568577,70.54609671371668,61.13527951754042,NaN,NaN,24.97660518890678,24.530963094051767
2006-11-27T09:30:00-05:00,29.259787,29.259787,28.788918,28.797029,9620382,7092902.2,46.335244522390916,61.711139350998415,NaN,NaN,-17.28787274232495,93.22505167382812,-0.032232256691854616,0.17812806363459188,0.2103603203264465,243379890,252441118,70.19142516976436,62.92469534906527,NaN,NaN,19.25854623152042,23.777760685118718
2006-11-28T09:30:00-05:00,28.853852,28.90258,28.659011,28.845741,8993560,7045598,47.61889969914101,60.71359841698676,NaN,NaN,-59.60448383035823,49.618916731748904,-0.05481291017749659,0.14184418260457576,0.19665709278207236,252373450,251456059.6,67.37232164389313,64.5479495204976,NaN,NaN,15.243749854307273,22.558616280717082
2006-11-29T09:30:00-05:00,28.943157,29.113658,28.861978,29.024352,5154150,6816608.2,52.13947401514259,59.83626486379218,NaN,NaN,-4.797508718088912,22.359647776689393,-0.0564869914210224,0.12604835350579435,0.18253534492681675,257527600,252357460.6,68.61453521320003,65.91432351192414,NaN,NaN,13.374787212142959,21.246640699492207
2006-11-30T09:30:00-05:00,28.935047,29.113658,28.829496,28.967513,4430881,6471829.95,50.641686967266786,59.37155520289788,NaN,NaN,-19.113459915784944,-5.345972596458347,-0.05986660377200309,0.10770209021181287,0.16756869398381596,253096719,251875586.2,67.14286510611356,66.87417455349133,NaN,NaN,11.41165913040973,19.841643332480423
2006-12-01T09:30:00-05:00,28.951284,29.04059,28.60218,28.797029,10393534,6764955.65,46.34160823106807,58.20755340108167,NaN,NaN,-78.95938749407493,-35.95254254012639,-0.07125415542032171,0.07850099970841384,0.14975515512873555,242703185,249816168.8,61.11027538262761,67.01286659819628,NaN,NaN,8.37187464232551,18.20310494817258
2006-12-04T09:30:00-05:00,28.90258,29.251676,28.886335,29.202964,8238387,6941276.95,55.935859743654525,57.81242690751284,NaN,NaN,14.486207128844299,-29.597726565892525,-0.050115857412653536,0.08711033336291862,0.13722619077557216,250941572,251328505.2,63.69025253351128,67.22846777514188,NaN,NaN,8.916454898674274,16.876440655387107
2006-12-05T09:30:00-05:00,29.22732,29.357219,29.121777,29.340982,10043850,6970154.9,58.643442522900706,57.34784667679663,NaN,NaN,67.44913857053763,-4.187002085713357,-0.02668270434257411,0.10387281034735452,0.13055551468992863,260985422,253050899.6,66.42237317802835,67.47940324435234,NaN,NaN,10.2792749380263,15.93398841004985
2006-12-06T09:30:00-05:00,29.324744,29.422177,29.308515,29.381575,3269488,6897378.45,59.43297447407937,57.050885400388935,NaN,NaN,93.91280923816316,15.55506150553706,-0.009196205800371227,0.11906025743946458,0.1282564632398358,264254910,254396361.6,68.42128922815687,67.85521343569009,NaN,NaN,11.601713580117146,15.31509200577375
2006-12-07T09:30:00-05:00,29.438398,29.560187,29.259787,29.308515,5471690,6975322.05,57.31224179807361,56.20539328445182,NaN,NaN,85.90094813665749,36.55794311602555,-0.0035857351916970814,0.12377429425021447,0.12736002944191155,258783220,255533661.8,70.04462259359727,68.05351276253705,NaN,NaN,12.027470409893764,14.845431777790894
2006-12-08T09:30:00-05:00,29.243557,29.462754,29.202964,29.397821,6417157,7048079.85,59.22743313568499,56.05265092642252,NaN,NaN,71.02093201560365,66.55400701796125,0.0046569524642037785,0.13318122002216626,0.12852426755796248,265200377,260033100.2,75.42664653567265,68.70386199991671,NaN,NaN,12.95744479355144,14.575719351470973
2006-12-11T09:30:00-05:00,29.462754,29.617018,29.446525,29.560187,10907289,7273134.4,62.51981139822391,55.87679772577892,NaN,NaN,126.82485057864974,89.02173570792236,0.018769271845318902,0.15198585736461112,0.13321658551929222,276107666,265066319,79.79900511540046,69.41843867284878,NaN,NaN,14.764295052031256,14.6026587372653
2006-12-12T09:30:00-05:00,29.470881,29.633255,29.430288,29.584543,7819727,7453970.15,63.00243699052904,55.85433550940439,NaN,NaN,117.36429731570927,99.00476745695667,0.02697051682602908,0.16692973155182855,0.13995921472579947,283927393,269654713.2,82.8030261546648,70.29641362804468,NaN,NaN,16.37021642722546,14.85516697868818
2006-12-13T09:30:00-05:00,29.633255,29.738798,29.568305,29.617018,4948575,7311859.85,63.674102140717736,55.83251157261869,NaN,NaN,135.76733426442993,107.37567246221003,0.031493556424419145,0.17932616025632342,0.14783260383190427,288875968,274578924.8,85.32514079269403,71.20784824007436,NaN,NaN,17.887411338189317,15.2883447443312
2006-12-14T09:30:00-05:00,29.625144,29.868689,29.576416,29.868689,7149788,7467420.4,68.45375224322072,56.51992627729242,NaN,NaN,160.07270770163984,122.21002437520652,0.04739085939072854,0.20707117807031494,0.1596803186795864,296025756,282027432,88.15500129716986,72.46562713889246,NaN,NaN,20.727035081737597,16.065300506817827
2006-12-15T09:30:00-05:00,29.819985,29.836222,29.657611,29.71445,8297636,7323462.65,62.9841385897542,57.70913299638979,NaN,NaN,132.435867245375,134.4930114211608,0.043571726114442655,0.21414497632263974,0.17057325020819708,287728120,286532980.6,89.47689925855182,73.84316100237727,NaN,NaN,21.535111227062348,16.84670203828133
2006-12-18T09:30:00-05:00,29.803756,29.925528,29.763154,29.860579,6475174,7009114.35,65.7743552372133,59.00595124910925,NaN,NaN,144.37950547818625,138.00394240106806,0.04666439311742132,0.22890374160497373,0.1822393484875524,294203294,290152106.2,90.40335174714254,75.48823458118079,NaN,NaN,23.07665658216548,17.736695544550493
2006-12-19T09:30:00-05:00,29.763154,29.909291,29.690094,29.836222,13323316,7011202.3,64.89625964159808,59.917150222427495,NaN,NaN,119.68969345089656,138.4690216281055,0.042940744092160976,0.23591527860275363,0.19297453451059265,280879978,289542623.2,88.98257120882994,76.94309429515435,NaN,NaN,24.074304148231413,18.642068202219196
2006-12-20T09:30:00-05:00,29.868689,29.941766,29.746917,29.933647,5204160,7057502.95,66.80517588227723,61.071685144928246,NaN,NaN,118.93533271859714,135.10262131893896,0.04281393216257143,0.24649194971380695,0.20367801755123552,286084138,288984257.2,87.62392240930527,78.40602695966807,NaN,NaN,25.474816775462845,19.618175141254003
2006-12-21T09:30:00-05:00,29.957995,29.990478,29.779383,29.803756,9409141,7403685.2,61.96694184872098,62.18778040333201,NaN,NaN,100.3262563144128,123.15333104149356,0.03034383805298374,0.2416078151174652,0.21126397706448147,276674997,285114105.4,78.65903961599571,79.65951011919435,NaN,NaN,25.287280915244615,20.428047394681233
2006-12-22T09:30:00-05:00,29.795629,29.803756,29.576416,29.657611,4099547,7483371.6,56.9677964740283,62.26149016978729,NaN,NaN,55.65122685276989,107.79640296297255,0.00968446468862258,0.2233695579252597,0.21368509323663712,272575450,282083571.4,72.41154905814015,80.28245987095355,NaN,NaN,23.642521529449002,20.887257985362343
2006-12-26T09:30:00-05:00,29.71445,29.925528,29.698205,29.925528,5113503,7258027.65,62.87994465849448,62.56409746518684,NaN,NaN,83.91512753688613,95.70352737471251,0.011377604891507687,0.2279070993510217,0.21652949445951403,277688953,278780703.2,66.23688108416192,80.26921043567738,NaN,NaN,23.998959673300053,21.331786797924874
2006-12-27T09:30:00-05:00,30.014834,30.152852,29.998596,30.136614,5214504,7069074.85,66.75535159152061,63.087124402146934,NaN,NaN,129.14214290406923,97.59401726534703,0.023339356835555713,0.24570369050395868,0.22236433366840297,282903457,279185399,66.61255504463946,80.14001513685471,NaN,NaN,25.565596842816685,21.93661680433799
2006-12-28T09:30:00-05:00,30.071657,30.152852,29.949884,29.998596,8435338,7233134.25,62.183963628110405,63.43510453286385,NaN,NaN,106.90421771593945,95.1877942648155,0.0187780240554353,0.2458368637376971,0.2270588396822618,274468119,276862195.2,62.32532874269281,79.58863700464725,NaN,NaN,25.40156822704884,22.431609864725257
2006-12-29T09:30:00-05:00,29.966122,30.03919,29.811866,29.828112,4285784,7225879.4,56.99225387061898,63.27544887107342,NaN,NaN,68.84429779296896,88.89140256052671,0.001984751288397868,0.2295397787927591,0.22755502750436124,270182335,275563662.8,60.000838125622025,78.4867935467865,NaN,NaN,23.585273376553484,22.596418937843573
2007-01-03T09:30:00-05:00,30.006723,30.193445,29.746917,29.97424,9370587,7174732.05,60.069559313490814,63.10043086502105,NaN,NaN,86.08126981534015,94.97741115304076,-0.001394018855386786,0.22581250393512775,0.22720652279051454,279552922,276959157.2,61.65592749006453,77.19085943069106,NaN,NaN,23.04705815366016,22.660795968674513
2007-01-04T09:30:00-05:00,29.957995,29.97424,29.738798,29.876816,6650205,7095322.95,57.1343542719767,62.681282099410176,NaN,NaN,48.54054119726156,87.90249388511585,-0.011727460330096195,0.2125471973778943,0.2242746577079905,272902717,276001910,59.82719619667501,75.54972871940608,NaN,NaN,21.68817614014569,22.52185027888468
2007-01-05T09:30:00-05:00,29.795629,29.860579,29.584543,29.625144,7982063,6992233.6,50.29711607509201,61.72578309472262,NaN,NaN,-19.491733116868303,58.17571868092834,-0.035695276737581494,0.1796555617860136,0.2153508385235951,264920654,272405349.4,53.41658889897683,73.27054644128341,NaN,NaN,18.257990894161864,21.912727509638565
2007-01-08T09:30:00-05:00,29.649492,29.795629,29.454644,29.771273,4429896,7050254,53.757400676677385,60.67604369711239,NaN,NaN,-34.996478504157984,29.79557943690886,-0.04148433542975219,0.16349541923640487,0.20497975466615706,269350550,271381835.6,51.7182083831897,70.66791837599912,NaN,NaN,16.512132446265944,21.141213929156763
2007-01-09T09:30:00-05:00,29.771273,29.893062,29.560187,29.722561,6000835,7076711.25,52.446614293954866,59.92336339026958,NaN,NaN,-23.318763629683584,11.362967152378355,-0.04791557518844497,0.14508528568060086,0.19300086086904583,263349715,270015311.6,49.45722765741068,67.80937040448904,NaN,NaN,14.706731984459987,20.222002222771508
2007-01-10T09:30:00-05:00,29.576416,29.844333,29.55206,29.819985,3616588,6936682.8,54.819409424064,59.14086726075892,NaN,NaN,-30.34778234583467,-11.922843279856608,-0.04497691797541345,0.136779713399779,0.18175663137519246,266966303,267497987.8,45.51021284026248,64.60271762542618,NaN,NaN,13.912185098191635,19.320599776402954
2007-01-11T09:30:00-05:00,29.828112,30.006723,29.803756,30.006723,4678088,6625222.75,59.03838754478455,58.72244782527224,NaN,NaN,76.46273476943513,-6.338404565421883,-0.030517117812412897,0.14361023410967633,0.17412735192208922,271644391,267246322.6,45.12250820919047,61.46985598259479,NaN,NaN,14.519045680932742,18.634663477050065
2007-01-12T09:30:00-05:00,29.893062,30.071657,29.893062,30.03919,8133201,6640896.45,59.74226785523079,58.217954394768924,NaN,NaN,106.07951904413862,18.775845866779502,-0.01936975519857148,0.1499151579238749,0.16928491312244637,279777592,270217710.2,50.48592576907051,58.817141936863734,NaN,NaN,15.21845914539425,18.14663428681352
2007-01-16T09:30:00-05:00,30.03919,30.120385,29.998596,30.120385,5318956,6659415.5,61.522985053361786,58.18624319510041,NaN,NaN,142.68564444137704,54.312270455886505,-0.00772907272362322,0.15962357221791734,0.16735264494154056,285096548,273366909.8,55.45496293487744,57.15970788821244,NaN,NaN,16.323239765738943,17.88614935523144
2007-01-17T09:30:00-05:00,30.079783,30.169089,29.957995,30.03919,4930592,6548455.7,58.72556591877039,58.31179815543913,NaN,NaN,111.25809528806842,81.2276422394369,-0.006735145034761025,0.15893371364808928,0.1656688586828503,280165956,276730158,60.0643935281675,56.2777682075001,NaN,NaN,16.467712397495294,17.683515504126277
2007-01-18T09:30:00-05:00,30.096029,30.120385,29.901172,29.917418,5031963,6385172.05,54.70790687869029,57.728081171167396,NaN,NaN,58.41849893383215,98.98089849537027,-0.01504067890255456,0.1468680100546571,0.16190868895721167,275133993,278363696,62.114945935240094,55.98334426829141,NaN,NaN,15.44220011438378,17.36332759130592
2007-01-19T09:30:00-05:00,29.957995,30.031079,29.893062,30.006723,4205353,6271681,57.02971902816357,57.03339313092761,NaN,NaN,51.518497335174224,93.99205100851809,-0.015234823528680858,0.1428651595463606,0.15809998307504144,279339346,279902687,63.99086788561042,55.79608089978933,NaN,NaN,15.226340007834652,17.058043650810028
2007-01-22T09:30:00-05:00,30.03919,30.071657,29.901172,29.982351,5731954,5892112.9,56.18324894063604,56.60477065325087,NaN,NaN,50.94828703229446,82.96580460614926,-0.017554606465035927,0.13615672499374654,0.15371133145878246,273607392,278668647,61.36689789211042,55.72762155331917,NaN,NaN,14.815623776586332,16.737697954492358
2007-01-23T09:30:00-05:00,29.884935,30.022953,29.836222,29.966122,7709236,6017366.7,55.59154508031749,56.504720025372194,NaN,NaN,23.43955731245653,59.11658718036516,-0.020525413723466723,0.12805456430444906,0.14857997802791578,265898156,274828968.6,53.953597946475064,55.29567582623724,NaN,NaN,14.315927066965752,16.3917306848457
2007-01-24T09:30:00-05:00,29.957995,30.274624,29.925528,30.274624,5151931,5804506.2,63.46786747318632,56.7474563224933,NaN,NaN,132.11629130065282,63.28822638288203,-0.0029781804301119708,0.1448572524902758,0.14783543292038778,271050087,273005794.8,50.81464911016905,54.52129879910184,NaN,NaN,16.181580727709523,16.361709262397675
2007-01-25T09:30:00-05:00,30.282751,30.298997,29.795629,29.836222,15356767,6367367.2,49.918510978132744,56.23203894436159,NaN,NaN,27.903345851531736,57.185195766421955,-0.021149372284508833,0.12139871756475173,0.14254808984926057,255693320,269117660.2,44.82523545674958,53.449730174821454,NaN,NaN,13.348145261741934,15.931200119446855
2007-01-26T09:30:00-05:00,29.85246,29.97424,29.673848,29.893062,11199698,6671676.95,51.36812377524241,56.30853949437233,NaN,NaN,-51.6509360009391,36.55130909919929,-0.02910222597525125,0.1061703073801965,0.13527253335544775,266893018,266628394.6,41.456243646532904,52.59541979964689,NaN,NaN,11.589282790045468,15.310926215246656
2007-01-29T09:30:00-05:00,29.876816,29.933647,29.706323,29.746917,13651445,7093524,47.556587635456914,55.865624277142295,NaN,NaN,-72.91200580464391,11.779250531811616,-0.043121220165437804,0.0813710081486505,0.12449222831408831,253241573,262555230.8,36.607859396857016,51.51610915776598,NaN,NaN,8.882683168406764,14.392605779983814
2007-01-30T09:30:00-05:00,29.763154,29.909291,29.730679,29.860579,7692243,7056369.25,50.625104692638764,55.735516448476865,NaN,NaN,-44.269354359662664,-1.762531802612223,-0.04352889709250768,0.07008110694845371,0.11361000404096139,260933816,261562362.8,35.51744123628151,50.52041012768533,NaN,NaN,7.623129612864471,13.425537756109621
2007-01-31T09:30:00-05:00,29.860579,30.177208,29.771273,30.10414,15298141,7606987.1,56.49885434529753,55.85547679999354,NaN,NaN,61.7925852970089,-15.827273003341006,-0.026994831082209153,0.07986646518819995,0.1068612962704091,276231957,262598736.8,37.60657964638608,49.955864899551294,NaN,NaN,8.463620544060289,12.716692440102573
2007-02-01T09:30:00-05:00,30.185318,30.315226,30.160962,30.298997,18414894,8059202.45,60.54299547589961,55.962948795073196,NaN,NaN,177.14999025133693,14.022055876620033,-0.0037554006944217067,0.10216704540238197,0.10592244609680368,294646851,270389443,50.57096860943659,50.34504064242602,NaN,NaN,10.528502290064088,12.404093847239933
2007-02-02T09:30:00-05:00,30.307107,30.396413,30.274624,30.355819,7708991,8112141.75,61.66227143007369,56.100091907561975,NaN,NaN,190.14630608026005,62.38150429285986,0.01366806093116528,0.12300752226076028,0.109339461329595,302355842,277482007.8,58.93628969190837,50.948638065485866,NaN,NaN,12.530555070899663,12.42215973633418
2007-02-05T09:30:00-05:00,30.380175,30.404532,30.22592,30.347701,5312797,7978678.45,61.394318531241126,56.090901441696204,NaN,NaN,165.8516444790669,110.134234349602,0.022357347997378194,0.13728614632631775,0.11492879832893955,297043045,286242302.2,66.48169588645436,51.73626184774135,NaN,NaN,14.042490604617258,12.653635574660335
2007-02-06T09:30:00-05:00,30.380175,30.510075,30.339582,30.485718,9900599,8252213.6,64.23950468333666,56.4847542105938,NaN,NaN,186.30609961545753,156.24932514462606,0.03439175425596107,0.1579184911488909,0.12352673689292983,306943644,295444267.8,72.24984454422862,52.60665120603144,NaN,NaN,16.200223150475182,13.160290942633884
2007-02-07T09:30:00-05:00,30.510075,30.648092,30.485718,30.59938,5619742,8233158.95,66.43348681912404,57.3222956349105,NaN,NaN,196.79818371157234,183.25044482753873,0.046259287989639825,0.1813508468799796,0.13509155889033977,312563386,302710553.6,75.79244296692514,53.583615279723226,NaN,NaN,18.69126849632861,13.950430593161702
2007-02-08T09:30:00-05:00,30.518193,30.534431,30.339582,30.501964,6933250,8398992.05,62.87312379002232,57.739681689328975,NaN,NaN,128.0803309827761,173.43651297382658,0.04382417441115194,0.1898717769042797,0.14604760249312776,305630136,304907210.6,76.75839823726147,54.495581733412585,NaN,NaN,19.751770425674824,14.779193426377862
2007-02-09T09:30:00-05:00,30.453236,30.607499,29.998596,30.177208,21992683,9264721.8,52.72794598382823,57.492874335271274,NaN,NaN,50.93519099809043,145.59428995739265,0.017943899412829645,0.1684774767591648,0.15053357734633516,283637453,301163532.8,71.52049509232364,55.22083867628496,NaN,NaN,17.46691089731059,15.163153065082538
2007-02-12T09:30:00-05:00,30.22592,30.258395,30.022953,30.10414,11943376,9455230.55,50.74398153868201,57.14661979658303,NaN,NaN,2.2360850803079435,112.87117807764086,-0.005253419380146118,0.1439668031211525,0.14922022250129863,271694077,296093739.2,65.04704735896686,56.01322792003437,NaN,NaN,14.991653042444177,15.138653061848487
2007-02-13T09:30:00-05:00,30.144733,30.388286,30.120385,30.323353,12944839,9836524.7,56.08286893943534,56.61911990131511,NaN,NaN,50.529602413979624,85.7158786373453,-0.006888407214517944,0.1406097134831512,0.14749812069766916,284638916,291632793.6,59.90877735331214,56.6628085088303,NaN,NaN,14.534244156918483,15.052308932572773
2007-02-14T09:30:00-05:00,30.380175,30.696805,30.36393,30.615626,12219936,10200991.9,61.997300148945456,57.48189055637316,NaN,NaN,128.02628900864977,71.96149969676078,0.009755383620105945,0.1596923502228016,0.14993696660269565,296858852,288491886.8,56.523228389186656,57.49837943257581,NaN,NaN,16.130595041878966,15.2063498053308
2007-02-15T09:30:00-05:00,30.648092,30.713042,30.566897,30.66433,12013993,10550093.4,62.894073955694004,58.305172712119706,NaN,NaN,135.7421770800767,73.49386891622089,0.021417224736569096,0.176708497523407,0.1552912727868379,308872845,289140428.6,57.0627888069554,58.613132658320275,NaN,NaN,17.677766321748276,15.559409307676153
2007-02-16T09:30:00-05:00,30.575024,30.66433,30.534431,30.656203,6768815,10678266.5,62.628496770672456,59.38173765034939,NaN,NaN,113.60429051745189,86.02768882009318,0.025669507464634977,0.18737815711763162,0.16170864965299664,302104030,292833744,60.099634829989796,60.29111661782976,NaN,NaN,18.824190297490546,16.025806591935353
2007-02-20T09:30:00-05:00,30.607499,30.842949,29.933647,30.818593,6512497,10717293.65,65.7413916748414,60.46147243479243,NaN,NaN,81.55171176114285,101.89081415626016,0.03587820143596088,0.20655640144794774,0.17067820001198686,308616527,300218234,65.3730500850554,62.42366010702789,NaN,NaN,20.764939108309584,16.70282552284596
2007-02-21T09:30:00-05:00,30.688686,30.769865,30.623736,30.688686,5234338,10593548.75,61.33966334856481,60.807244506454374,NaN,NaN,116.59806448543338,115.10450657055091,0.030549616613257946,0.2088652207785593,0.17831560416530134,303382189,303966888.6,67.70635637753318,64.57364415925268,NaN,NaN,21.081307681913238,17.328322974141283
2007-02-22T09:30:00-05:00,30.761754,30.810467,30.542549,30.566897,11649403,10918422.35,57.45567878443365,60.586721885635384,NaN,NaN,90.74695963508947,107.64864069583886,0.016210342710105158,0.19857853255293278,0.18236818984282763,291732786,302941675.4,66.38878045340077,65.70348786239298,NaN,NaN,20.17670649824983,17.73523490615679
2007-02-23T09:30:00-05:00,30.583143,30.59938,30.201564,30.282751,20246468,11162907.4,49.56946565291224,59.722950044409565,NaN,NaN,9.003002184249015,82.30080571667332,-0.013423159204584756,0.1655892408370967,0.17901240004168145,271486318,295464370,57.58672322187871,65.60709025739087,NaN,NaN,16.80959371381031,17.603000450107295
2007-02-26T09:30:00-05:00,30.420769,30.461362,29.941766,30.063546,21972542,11701549.6,44.49552400272107,58.51589329237242,NaN,NaN,-61.52172208491299,47.27560319620035,-0.046914372800031634,0.12036943404164191,0.16728380684167354,249513776,284946319.2,47.95510662494077,64.28376245299704,NaN,NaN,12.235797936509003,16.836257233878968
2007-02-27T09:30:00-05:00,29.698205,29.868689,28.3505,28.659011,40894606,13063707.65,26.076979441428207,55.789998632236106,NaN,NaN,-352.2544470205998,-39.485628560148186,-0.1566059246899753,-0.028473599020795604,0.1281323256691797,208619170,264946847.8,35.7210817760928,61.674565112415905,NaN,NaN,-1.9264197827306082,14.155874802934743
2007-02-28T09:30:00-05:00,28.991886,29.373448,28.853852,29.186727,26696884,14013939.7,36.68214717652574,53.664902943479085,NaN,NaN,-254.00513088919365,-113.60626763507359,-0.18463947866044222,-0.10266702265637306,0.08197245600406915,235316054,251333620.8,30.093362053102894,58.41034504714289,NaN,NaN,-7.727821358523474,11.029632494154999
2007-03-01T09:30:00-05:00,28.821385,29.267913,28.577824,29.154252,32222873,14860176.3,36.33667222054826,51.769442117088076,NaN,NaN,-218.83727978601684,-175.52311551929486,-0.19535106648198913,-0.1622163770984173,0.03313468938357185,203093181,233605699.8,24.647546202587066,54.688141330380425,NaN,NaN,-11.818833580156674,7.765565912110475
2007-03-02T09:30:00-05:00,29.121777,29.219209,28.821385,28.821385,15167578,14697810.5,32.91483198067776,50.35421968829161,NaN,NaN,-174.29793263131663,-212.183302482408,-0.21336913344352612,-0.2335767274208358,-0.02020759397730968,187925603,216893556.8,20.822146959782884,51.06683074948466,NaN,NaN,-16.34073659962941,4.3218084104333485
2007-03-05T09:30:00-05:00,28.553468,28.894453,28.033871,28.366738,21421045,15383413.2,28.910270187147304,48.7946688774677,NaN,NaN,-186.69756443929853,-237.21847095328513,-0.24230762682087564,-0.3230921275034042,-0.08078450068252858,166504558,200291713.2,17.85715098953071,47.6961238659535,NaN,NaN,-21.56016951724781,0.6243829921931829
2007-03-06T09:30:00-05:00,28.66713,29.048709,28.594061,28.959403,23829687,16309257.7,39.28096495836127,47.59453287881956,NaN,NaN,-113.58564416081182,-189.4847103813275,-0.20918455504688407,-0.3422651944911337,-0.1330806394442496,190334245,196634728.2,17.2736595355088,44.65075830753898,NaN,NaN,-21.646243995769357,-2.557135148944323
2007-03-07T09:30:00-05:00,28.935047,29.048709,28.756435,28.788918,14018499,16515152.7,37.582531279596324,45.850620816723186,NaN,NaN,-97.40699529842348,-158.16508326317347,-0.18712453895183395,-0.36698631313404206,-0.1798617741822081,176315746,184834666.6,15.512313519493574,41.72140724541805,NaN,NaN,-22.345071845499493,-5.383983248452204
2007-03-08T09:30:00-05:00,29.373448,29.373448,28.967513,29.048709,24361161,17452223.65,41.717988996389636,44.33804331963002,NaN,NaN,-64.06415534254779,-127.21045837447964,-0.14526935053300946,-0.36144846234846995,-0.21617911181546048,200676907,184351411.8,15.442864714343528,38.748555524517194,NaN,NaN,-21.39110527831158,-7.670714967003544
2007-03-09T09:30:00-05:00,29.235431,29.276032,28.983759,29.121777,11768264,17693974.35,42.86458550917224,42.926335372379995,NaN,NaN,-57.4090501050796,-103.83268186923223,-0.10478617714338428,-0.34716183324469085,-0.24237565610130657,212445171,189255325.4,19.386937679730224,35.84050572807008,NaN,NaN,-20.274236030980877,-9.471217976143162
2007-03-12T09:30:00-04:00,29.024352,29.22732,28.918809,29.121777,17753087,17481994.55,42.86458550917224,41.29227778911792,NaN,NaN,-54.87228325034805,-77.46762563144215,-0.07170935120412525,-0.33201234510646316,-0.2603029939023379,212445171,198443448,26.321281894758854,33.05109371447747,NaN,NaN,-19.410486518204344,-10.891113482151901
2007-03-13T09:30:00-04:00,28.886335,28.918809,28.09071,28.253076,55864116,19678031.55,33.71814307643015,39.31931205539401,NaN,NaN,-101.8033743587945,-75.11117167103869,-0.10028365049392507,-0.38565755701974425,-0.2853739065258192,156581055,191692810,24.64397165346861,29.975209091330004,NaN,NaN,-21.809993533383352,-12.45095348947068
2007-03-14T09:30:00-04:00,28.253076,28.447917,27.749708,28.318026,49924997,21527039.45,34.837693205435556,37.703741656894145,NaN,NaN,-111.30911687285955,-77.8915959859259,-0.10618977634516436,-0.4181111269572746,-0.31192135061211024,206506052,197730871.2,29.001998115121268,27.30472463859575,NaN,NaN,-23.282027938661308,-13.998249839355054
2007-03-15T09:30:00-04:00,28.3505,28.797029,28.334255,28.659011,38843795,22858232.4,40.518041191064114,37.05721133819071,NaN,NaN,-71.19299636291618,-79.31736418999957,-0.07972038455189623,-0.4115718313019805,-0.33185144675008427,245349847,206665459.2,34.99292716742001,25.690882063277275,NaN,NaN,-22.63036362138411,-15.23140895107349
2007-03-16T09:30:00-04:00,28.626528,28.66713,28.236839,28.431687,23636927,23439379.1,38.13156130892381,36.60264257434805,NaN,NaN,-80.71227746463354,-83.97800966191036,-0.07043266859783881,-0.41989228249738275,-0.34945961389954394,221712920,208519009,36.19577828784246,24.850930039198825,NaN,NaN,-22.865089024840128,-16.321934675897296
2007-03-19T09:30:00-04:00,28.618417,28.74019,28.447917,28.618417,19659826,24083929.65,41.195455193923785,37.6825336995263,NaN,NaN,-63.841564523062246,-85.77186591645321,-0.0458164823397994,-0.4067302168242932,-0.3609137344844938,241372746,214304524,39.93187241361292,25.151700799021693,NaN,NaN,-22.092102133104323,-17.14624431264116
2007-03-20T09:30:00-04:00,28.634655,28.926928,28.610307,28.878224,21942724,24855441,45.257551505566695,38.29506258017209,NaN,NaN,-39.301649138054614,-73.27152087230522,-0.008115100567233136,-0.3710576101935352,-0.3629425096263021,263315470,235651407,51.2700125918624,26.66431869464737,NaN,NaN,-20.17056780092872,-17.578290525253667
2007-03-21T09:30:00-04:00,28.90258,29.698205,28.853852,29.535831,41203838,26653916,53.93195078266842,39.5518681917521,NaN,NaN,44.86025328758105,-42.03764684021711,0.06121662214275553,-0.2864217319478577,-0.3476383540906132,304519308,255254058.2,58.935344094704824,29.11344711551293,NaN,NaN,-15.4704464747253,-17.277169946606758
2007-03-22T09:30:00-04:00,29.600788,29.633255,29.300388,29.357219,20910401,27116965.9,51.542965462629574,40.88244915474866,NaN,NaN,75.5909382636126,-12.680859914911348,0.09323407821643215,-0.23109575632007306,-0.3243298345365052,283608907,262905870.2,61.48234249226282,32.01774679640435,NaN,NaN,-12.471708550018676,-16.590675461379888
2007-03-23T09:30:00-04:00,29.308515,29.503356,29.276032,29.389694,15024698,26855877.4,51.959639859704986,42.5288327027885,NaN,NaN,88.9308721342779,21.24777000487094,0.11344384678493419,-0.1825250260553375,-0.2959688728402717,298633605,278290007.2,66.04259146523424,35.45956397324032,NaN,NaN,-9.97727931471807,-15.645904583285343
2007-03-26T09:30:00-04:00,29.349092,29.470881,29.032463,29.243557,20603297,26787415.15,49.88103862031945,43.2859808214998,NaN,NaN,79.54342556177737,49.92476802183887,0.11353619407073434,-0.15404863025185378,-0.2675848243225881,278030308,285621519.6,67.98772889636419,39.081997499015706,NaN,NaN,-8.523563715666885,-14.628427316482707
2007-03-27T09:30:00-04:00,29.202964,29.219209,29.024352,29.064946,7704561,25127912.9,47.38594255674789,43.986224484153475,NaN,NaN,43.458574720696916,66.47681279358918,0.09868330367132633,-0.1442306947334302,-0.24291399840475653,270325747,287023575,68.36097486826777,42.856901881071,NaN,NaN,-8.024109513336091,-13.684953344604619
2007-03-28T09:30:00-04:00,28.90258,29.048709,28.60218,28.699613,21512429,24868690.15,42.682976295961744,44.05515214840863,NaN,NaN,-24.567189577912718,52.59132422049042,0.06310055985216018,-0.16403829858955632,-0.2271388584417165,248813318,275882377,62.15894725794003,46.19376491989932,NaN,NaN,-8.999879102295228,-13.015657024274706
2007-03-29T09:30:00-04:00,28.910691,29.064946,28.691486,28.845741,17227184,24118905.7,45.03290323077895,44.210031985666255,NaN,NaN,-3.9866805187732215,36.67580046401326,0.04888647895619766,-0.16603075974646941,-0.21491723870266707,266040502,272368696,60.30086842595759,49.11618854462985,NaN,NaN,-9.122942021733035,-12.459554881054467
2007-03-30T09:30:00-04:00,28.951284,29.073065,28.594061,28.926928,14564826,24088768.1,46.3489954550563,44.45891841037225,NaN,NaN,-3.621038243543648,18.16541838844895,0.0445551825286819,-0.15922326054181468,-0.20377844307049658,280605328,268763040.6,58.37256301922694,51.405565767806145,NaN,NaN,-8.852188593607657,-11.944216839990638
2007-04-02T09:30:00-04:00,28.90258,28.90258,28.512874,28.659011,14569614,23746196.55,42.714398331490024,45.10150807144795,NaN,NaN,-49.12570034834896,-7.568406793576327,0.024264725677527854,-0.17344753597358675,-0.1977122616511146,266035714,266364121.8,57.06507223336683,53.7213586663703,NaN,NaN,-9.663852371304987,-11.61845048732126
2007-04-03T09:30:00-04:00,28.910691,29.105548,28.853852,29.016242,16621940,23385809.2,48.512085824228784,46.07825040136176,NaN,NaN,22.205691777114193,-11.818983382292876,0.03487521621189446,-0.15411824138624652,-0.18899345759814098,282657654,268830503.2,58.10410844380051,55.80008083270453,NaN,NaN,-8.65443828028385,-11.195020172030201
2007-04-04T09:30:00-04:00,29.008115,29.121777,28.926928,29.016242,14408094,23405288.95,48.512085824228784,46.649253589444946,NaN,NaN,27.038087049651025,-1.4979280567801325,0.04142046693433227,-0.13721787393022566,-0.17863834086455793,282657654,275599370.4,60.900701965658506,57.65063617543586,NaN,NaN,-7.840629454688237,-10.715821498124207
2007-04-05T09:30:00-04:00,29.008115,29.097421,28.910691,29.032463,6653774,22519919.6,48.78504892149864,47.41021699034315,NaN,NaN,27.051101305013137,4.709628307977139,0.04601537194319766,-0.12111912593556085,-0.1671344978787585,289311428,280253555.6,62.74226549165223,59.54681383285084,NaN,NaN,-7.095800722969988,-10.198675673102176
2007-04-09T09:30:00-04:00,29.105548,29.113658,28.959403,29.024352,7641761,22313594.45,48.646172417871256,47.94241107776797,NaN,NaN,33.3332863053455,12.10049321775497,0.04748927579336093,-0.10777290313705734,-0.15526217893041827,281669667,280466423.4,62.82849955104709,61.182287199810425,NaN,NaN,-6.509884782132036,-9.671705545820728
2007-04-10T09:30:00-04:00,29.024352,29.16237,29.024352,29.154252,12001416,22026010.9,51.04952966516321,48.356123803453436,NaN,NaN,52.718514995172065,32.469336286459175,0.05562903404126923,-0.08572588637883172,-0.14135492042010095,293671083,285993497.2,65.08797390194331,62.16928443624477,NaN,NaN,-5.374554649780858,-9.057826846386462
2007-04-11T09:30:00-04:00,29.146125,29.146125,28.821385,28.910691,13691418,19917376,46.64190065275135,47.835405937030785,NaN,NaN,9.256634398312123,29.879524810698758,0.04355992274077081,-0.08690501699413744,-0.13046493973490825,279979665,285457899.4,64.67769417626627,62.57945229921346,NaN,NaN,-5.527156758160617,-8.553445405211342
2007-04-12T09:30:00-04:00,28.861978,28.926928,28.683367,28.861978,12347651,18038508.7,45.79035274076767,47.42450502832637,NaN,NaN,-41.60079872537896,16.151747655692773,0.031792428560176056,-0.09072440403468818,-0.12251683259486423,267632014,282452771.4,62.30463518143563,62.638187491297224,NaN,NaN,-5.879473299723792,-8.171449390141692
2007-04-13T09:30:00-04:00,28.90258,29.073065,28.878224,28.983759,19045541,17048596,48.330096166776435,47.1652519074029,NaN,NaN,0.6501901220831211,10.87156541910677,0.031638921036144296,-0.08296818129968386,-0.11460710233582816,286677555,281925996.8,61.876063748510326,62.34057836867409,NaN,NaN,-5.524955836906744,-7.793378882536699
2007-04-16T09:30:00-04:00,29.243557,29.698205,29.243557,29.690094,39942512,17863875.25,60.02752011650058,47.89000058570156,NaN,NaN,173.15891236846073,38.836690631729816,0.07600564162054298,-0.01960005031014944,-0.09560569193069242,326620067,290916076.8,66.1548686042411,62.209659776379574,NaN,NaN,-1.4962905195715661,-6.893794830684538
2007-04-17T09:30:00-04:00,29.690094,29.828112,29.584543,29.681967,15470505,17654409.2,59.859604674186826,48.78097645123291,NaN,NaN,185.4001802816382,65.37302368902304,0.10018247391948251,0.029622400468660715,-0.0705600734508218,311149562,294411772.6,67.6741207264077,62.160598766246714,NaN,NaN,1.669412447835685,-5.670479505181649
2007-04-18T09:30:00-04:00,29.795629,30.128496,29.722561,30.022953,31130777,18113811.85,64.36384953563567,50.329610254066736,NaN,NaN,206.78063448858444,104.87782370707751,0.1324885258302835,0.09505058383703258,-0.03743794199325092,342280339,306871907.4,72.4254569401278,62.89392088640299,NaN,NaN,5.894970103486738,-4.018272418229023
2007-04-19T09:30:00-04:00,29.917418,30.055427,29.755027,29.982351,17758909,16941565.4,63.45084420542183,51.64517746654123,NaN,NaN,168.91758315051544,146.9815000822564,0.14354225562936218,0.14198987754345183,-0.0015523780859103692,324521430,318249790.6,75.90775612269653,64.0086985790272,NaN,NaN,9.05158790649541,-2.151149514696961
2007-04-20T09:30:00-04:00,30.160962,30.234047,30.022953,30.136614,21008841,16946487.4,65.45580292028609,53.009949428343354,NaN,NaN,178.53842878936334,182.55914781571244,0.15280465409685962,0.18945343953516414,0.036648785438304535,345530271,330020333.8,78.87932180235674,65.47346706353646,NaN,NaN,12.324421905128515,-0.08321074043617882
2007-04-23T09:30:00-04:00,30.136614,30.258395,30.022953,30.055427,11679633,16779234.15,63.482069193180685,54.49335448989269,NaN,NaN,147.77741108499728,177.48284755901972,0.14508458889476517,0.21800452155676098,0.07291993266199583,333850638,331466448,79.21845990101832,67.05585189694014,NaN,NaN,14.503527916012644,2.0006090676279387
2007-04-24T09:30:00-04:00,30.079783,30.10414,29.763154,29.966122,15716200,16534879.3,61.292679935204724,55.406254069248114,NaN,NaN,101.60534338485012,160.7238801796621,0.126276194123702,0.23076517531662333,0.10448898119292133,318134438,332863423.2,79.55990618862758,68.58840887871351,NaN,NaN,15.7407346373721,3.963484149019962
2007-04-25T09:30:00-04:00,30.055427,30.388286,30.006723,30.372057,20039803,17151641.4,66.88356863260462,56.71850284127496,NaN,NaN,125.45672080172194,144.45909744228962,0.13282106716835443,0.27051531515336436,0.13769424798500993,338174241,332042203.6,78.74087545656381,69.86270698520674,NaN,NaN,18.578621196290822,6.051360870058656
2007-04-26T09:30:00-04:00,30.323353,30.388286,30.152852,30.323353,9489877,16550513.8,65.65819232072131,57.92372736979087,NaN,NaN,113.24840703472903,133.32526221913233,0.12559705930617054,0.2946905721177231,0.16909351281155255,328684364,332874790.4,78.97716909581514,71.02234295693265,NaN,NaN,20.546578132969824,8.12210619333168
2007-04-27T09:30:00-04:00,30.209691,30.315226,30.096029,30.282751,11870276,16282668.4,64.59571123547573,59.062980142476896,NaN,NaN,94.57233092864143,116.53204264698795,0.11035246767679677,0.3070340974075485,0.19668162973075173,316814088,327131553.8,72.9534545033573,71.74555402495481,NaN,NaN,21.88050561109039,10.087591824440066
2007-04-30T09:30:00-04:00,30.274624,30.36393,30.014834,30.047301,18625571,16485705.65,58.66697744136527,59.60708355506277,NaN,NaN,75.87926181160184,102.15241279230887,0.07819361645498984,0.294423650299489,0.21623003384449918,298188517,319999129.6,66.20056476331669,71.8250248007672,NaN,NaN,21.36113088045611,11.698097403870928
2007-05-01T09:30:00-04:00,30.03919,30.201564,29.85246,30.10414,14064983,16460474.1,59.63024470280482,60.53482241578087,NaN,NaN,58.61382468030258,93.55410905139938,0.05559403719609643,0.2857225803396197,0.2301285431435233,312253500,318822942,65.12991257879298,71.85732611523339,NaN,NaN,21.1923947510677,13.05442559632761
2007-05-02T09:30:00-04:00,30.160962,30.339582,30.047301,30.234047,10992576,16179005.9,61.820289862791256,61.67981792449684,NaN,NaN,72.96285109129239,83.05533510931346,0.044707050702011725,0.28601235652103796,0.24130530581902623,323246076,315837309,62.37236245006955,71.86216377727867,NaN,NaN,21.648817913292078,14.282195927322533
2007-05-03T09:30:00-04:00,30.412658,30.518193,30.274624,30.518193,12612500,16089226.2,66.14638159853068,62.95240974105071,NaN,NaN,96.86951617905554,79.77955693817877,0.05147328050190614,0.3056469064464089,0.25417362594450277,335858576,317272151.4,63.17920454828248,71.95524526297667,NaN,NaN,23.32522674453288,15.574057472638296
2007-05-04T09:30:00-04:00,30.583143,30.648092,30.493837,30.623736,10921429,16302608.95,67.61425810372154,63.49431959728078,NaN,NaN,111.16678037224372,83.09844682689922,0.05743416309939875,0.3259663298187512,0.2685321667193524,346780005,323265334.8,66.41829033398898,71.97406110081582,NaN,NaN,25.160094094806475,16.94349127580518
2007-05-07T09:30:00-04:00,30.648092,30.737398,30.583143,30.66433,5845811,16212811.45,68.18563772002966,64.08903624341242,NaN,NaN,117.62872898409984,91.44834026139884,0.05830199283420623,0.3414096577621102,0.28310766492790396,352625816,334152794.6,71.34912900023465,72.23656169180346,NaN,NaN,26.840268396721235,18.35731657879319
2007-05-08T09:30:00-04:00,30.591253,30.623736,30.461362,30.59938,7472871,15986384.2,66.17395279522398,64.21832933338301,NaN,NaN,98.55309001575426,99.43619332848917,0.04906364908987382,0.3444372262902462,0.2953735772003724,345152945,340732683.6,73.84829280113394,72.33819282473247,NaN,NaN,27.715307081620594,19.69417236491139
2007-05-09T09:30:00-04:00,30.623736,30.794221,30.52632,30.761754,14581397,16030883.15,68.6630709182388,64.59063124144136,NaN,NaN,118.1694756598069,108.47751824219206,0.048370701471503796,0.35583695403975213,0.30746625256824833,359734342,348030336.8,76.31583355368389,72.36734121266014,NaN,NaN,29.175171804436435,21.04860085627211
2007-05-10T09:30:00-04:00,30.615626,30.729288,30.323353,30.323353,15895820,16208291.6,56.561198051981776,63.95530232227677,NaN,NaN,71.26188484747522,103.35599197587598,0.014619864459151088,0.3257410831421872,0.3111212186830361,343838522,349626326,76.83071626282444,72.22101224555068,NaN,NaN,26.791316352408472,21.86898878429159
2007-05-11T09:30:00-04:00,30.453236,30.648092,30.453236,30.648092,16821981,16097113.6,61.91574168143708,63.843421785723656,NaN,NaN,95.0223431100922,100.1271045234457,0.010586747796610063,0.32435465342879866,0.3137679056321886,360660503,352402425.6,77.7373198408576,72.11521652696779,NaN,NaN,26.406460496985556,22.517199028962157
2007-05-14T09:30:00-04:00,30.672449,30.688686,30.339582,30.501964,37236897,15961832.85,58.42568780534537,63.63863663359085,NaN,NaN,67.97100789326012,90.19556030527777,-0.004682216087262492,0.30791513552311045,0.31259735161037294,323423606,346561983.6,71.40679500820887,71.53285144265216,NaN,NaN,24.966145922602408,22.86704858519648
2007-05-15T09:30:00-04:00,30.534431,30.696805,30.36393,30.428888,20253242,16200969.7,56.70432179882997,62.91154757403552,NaN,NaN,56.33374367826307,81.75169103777952,-0.021520487322591375,0.2856967424571337,0.3072172297797251,303170364,338165467.4,63.41179777899675,70.43791732282595,NaN,NaN,23.267527835258573,22.92425990663392
2007-05-16T09:30:00-04:00,30.575024,30.777992,30.477592,30.777992,19647051,15626783.4,62.40315028078676,62.67904457118305,NaN,NaN,100.49429494727127,78.21665489527238,-0.011468089146897509,0.2928821183461032,0.30435020749300074,322817415,330782082,57.332913445506456,68.8918990620896,NaN,NaN,23.5757423860139,23.017328832259633
2007-05-17T09:30:00-04:00,30.672449,30.696805,30.558787,30.623736,7518324,15114754.15,58.72494804258681,62.259704343119544,NaN,NaN,77.93448075586053,79.55117407694945,-0.01718522483072238,0.2828686764545978,0.30005390128532017,315299091,325074195.8,53.095363201076644,67.47346396906956,NaN,NaN,22.65480015824615,22.96553902168628
2007-05-18T09:30:00-04:00,30.769865,30.769865,30.623736,30.704932,12369240,14682774.1,60.059453474045974,62.35916691688245,NaN,NaN,93.32808419884581,79.21232229470017,-0.017421531946587188,0.2782769863520862,0.2956985182986734,327668331,318475761.4,48.621436016737825,66.2178119157425,NaN,NaN,22.31248650331102,22.872245804775527
2007-05-21T09:30:00-04:00,30.721161,30.802348,30.623736,30.737398,16405966,14919090.75,60.60788305363088,62.42899822765573,NaN,NaN,94.19476855466523,84.4570744269812,-0.017280301850373048,0.27409814098570706,0.2913784428360801,344074297,322605899.6,51.38284191404981,65.23587829683228,NaN,NaN,22.193911886046095,22.77534095924275
2007-05-22T09:30:00-04:00,30.769865,30.85106,30.639982,30.761754,15248092,14895685.35,61.04008501377953,62.373269309869194,NaN,NaN,100.36503006613272,93.26333170455514,-0.017388018208952916,0.26964342007488895,0.28703143828384187,359322389,333836304.6,57.9939683025341,64.9231358577226,NaN,NaN,22.216295786042345,22.695477363071266
2007-05-23T09:30:00-04:00,30.713042,30.932255,30.696805,30.737398,20119148,14899652.6,60.327271737280974,61.95761860549421,NaN,NaN,106.20156044457686,94.40478480401626,-0.020715177942149388,0.26113746585615516,0.28185264379830455,339203241,337113469.8,59.715486485215166,64.67572742464635,NaN,NaN,22.043553599331627,22.602345396822745
2007-05-24T09:30:00-04:00,30.794221,30.85106,30.355819,30.461362,24819855,15666151.5,52.801495263427356,60.89956411690177,NaN,NaN,13.728594240291358,81.5636075009024,-0.04190022274933536,0.22947736536163532,0.2713775881109707,314383386,336930328.8,59.568563745750225,64.18646123977217,NaN,NaN,19.710742773518415,22.18925930777927
2007-05-25T09:30:00-04:00,30.445125,30.558787,30.372057,30.518193,11262482,15635761.8,54.07183812175178,59.89143557416764,NaN,NaN,-23.161573070375802,58.26567604705809,-0.05182939551556692,0.20659084371651204,0.25842023923207896,325645868,336525836.2,59.2219907441106,63.32023707862045,NaN,NaN,18.111084316405897,21.60666288044022
2007-05-29T09:30:00-04:00,30.583143,30.66433,30.485718,30.648092,9935752,15201270.85,56.925596350562216,59.23083868526322,NaN,NaN,22.040717266739474,43.83486578947294,-0.0494019433692062,0.1966678100205712,0.2460697533897774,335581620,334827300.8,57.70378508592243,62.16705795610534,NaN,NaN,17.51756601635524,21.022506185570936
2007-05-30T09:30:00-04:00,30.461362,30.859171,30.461362,30.859171,16642520,15330147.7,61.14989147662838,58.69418301086248,NaN,NaN,87.283855133161,41.21863080287858,-0.03406353419728264,0.2034903356431741,0.23755386984045673,352224140,333407651,56.40231016912102,60.744663428636564,NaN,NaN,18.218349162534604,20.621912325137174
2007-05-31T09:30:00-04:00,30.940366,30.972832,30.688686,30.769865,13729390,15466988.4,58.53432428543932,58.83512059896658,NaN,NaN,133.713494494198,46.721017612802804,-0.03052908330393725,0.19939251571053518,0.22992159901447243,338494750,333265952.8,56.26590068477236,59.27574803020428,NaN,NaN,18.05899138590605,20.255780762389872
2007-06-01T09:30:00-04:00,30.818593,30.924128,30.753636,30.867297,8896522,15281189.5,60.518453749817525,58.735314318136616,NaN,NaN,143.50383724707254,72.67606621415904,-0.022591641672935953,0.2016820469233025,0.22427368859623845,347391272,339867530,60.99847380826173,58.08011617073315,NaN,NaN,18.486955998488824,20.00309151040401
2007-06-04T09:30:00-04:00,30.769865,30.826704,30.729288,30.826704,12320072,15351121.65,59.246480349063965,58.79394235697366,NaN,NaN,94.8269006054482,96.27376094932383,-0.021067526681213533,0.19793928024472152,0.21900680692593505,335071200,341752596.4,62.254520327871184,57.426382264994736,NaN,NaN,18.494812102998896,19.78762302363185
2007-06-05T09:30:00-04:00,30.672449,30.753636,30.558787,30.639982,17926477,15955154.95,53.65963155232317,58.57646448222317,NaN,NaN,-0.7247420158045909,91.72066909281503,-0.032920651447735455,0.17785599261626572,0.21077664406400118,317144723,338065217,58.29936279119631,57.0612083372947,NaN,NaN,16.90287162562755,19.375515681059806
2007-06-06T09:30:00-04:00,30.52632,30.528585,30.307107,30.380175,18763226,16519672.7,47.01620718827388,57.47739711847225,NaN,NaN,-147.66804802972734,44.73028846023736,-0.057126091684207736,0.13936902945874152,0.19649512114294926,298381497,327296688.4,48.59051632659641,56.436751400229696,NaN,NaN,13.420560363491512,18.52480777855005
2007-06-07T09:30:00-04:00,30.266514,30.412658,29.78751,29.868689,31747447,17377975.2,37.24087060177872,55.94282015841453,NaN,NaN,-283.95151983748417,-38.80271440609907,-0.10373619867193376,0.06682487280303206,0.17056107147496583,266634050,312924548.4,39.20610071942765,55.44466122296905,NaN,NaN,6.612332846151908,16.823025645350313
2007-06-08T09:30:00-04:00,29.901172,30.22592,29.811866,30.217801,22678133,17717090.85,45.56066592021476,54.90719247599801,NaN,NaN,-212.10478217041728,-109.92443828959703,-0.10678794827437213,0.03707613613200067,0.1438640844063728,289312183,301308730.6,33.56398184304375,54.36912878199091,NaN,NaN,3.7493582900328772,14.955358880304965
2007-06-11T09:30:00-04:00,30.201564,30.428888,30.047301,30.355819,24488669,18100425.25,48.46909917905054,54.04013648495656,NaN,NaN,-112.32284966532022,-151.3543883437507,-0.09560632016721693,0.024356184197351638,0.11996250436456857,313800852,297054661,31.761271524188857,52.96758803985798,NaN,NaN,2.494551087358671,13.175243481312638
2007-06-12T09:30:00-04:00,30.152852,30.404532,29.876816,29.941766,25860337,17531597.25,41.33457990571069,52.63260040580878,NaN,NaN,-157.0948035623345,-182.62840065305673,-0.11110362141882861,-0.0189170224089672,0.09218659900986141,287940515,291213819.4,29.42449587161417,50.92691143764942,NaN,NaN,-1.195115498474281,11.122335055628792
2007-06-13T09:30:00-04:00,30.047301,30.52632,30.047301,30.510075,15422294,17290049.85,51.817898549304445,52.024788035239034,NaN,NaN,-58.54942337495191,-164.80467572210162,-0.07956508910566619,-0.007269762372221322,0.07229532673344487,303362809,292210081.8,30.365574968563564,48.83048918646002,NaN,NaN,-0.333248681206586,9.485823093223738
2007-06-14T09:30:00-04:00,30.428888,30.623736,30.404532,30.461362,23031135,17459254.05,50.97701467070741,51.89446799290189,NaN,NaN,-13.421870863752742,-110.69874592735535,-0.05939426716010036,-0.0019475072166805774,0.05744675994341978,280331674,294949606.6,33.01080284459502,46.93350626494894,NaN,NaN,0.0050495257376894295,8.13142686929716
2007-06-15T09:30:00-04:00,30.615626,30.615626,30.380175,30.404532,11829725,17674824.1,49.95846369893815,51.600655534129494,NaN,NaN,-20.315776397297004,-72.34094477273128,-0.047788530089012876,-0.0022889026678463154,0.04549962742116656,268501949,290787559.8,31.07916860213676,44.92330468337938,NaN,NaN,-0.07366498163666904,6.959270890592327
2007-06-18T09:30:00-04:00,30.493837,30.575024,30.323353,30.396413,9996611,17556192.65,49.805357069577084,51.092067014059126,NaN,NaN,-27.66717358226252,-55.40980955611974,-0.03894207224989936,-0.003177962891207642,0.03576410935869172,258505338,279728457,26.62157761637988,42.70314700698348,NaN,NaN,-0.18237689165989396,5.939035493127724
2007-06-19T09:30:00-04:00,30.282751,30.52632,30.242157,30.52632,10076852,17239736.95,52.32307929907785,50.46158042994838,NaN,NaN,-23.850478732464374,-28.760944590145705,-0.023391569389343957,0.00652464762201177,0.029916217011355727,268582190,275856792,25.255876006036445,40.4784017096203,NaN,NaN,0.49609624083258475,5.161472742799847
2007-06-20T09:30:00-04:00,30.518193,30.591253,29.876816,29.990478,25602995,17757482.1,42.78913099443916,49.33692376630551,NaN,NaN,-105.58527223802244,-38.16811436275982,-0.046887515794899415,-0.028693177732268538,0.018194338062630874,242979195,263780069.2,21.543337060988733,37.99821859363575,NaN,NaN,-2.079676519281173,4.1270228482168445
2007-06-21T09:30:00-04:00,29.957995,30.079783,29.633255,30.03919,47183967,19110723.05,43.79181242670957,48.142163671797796,NaN,NaN,-159.54805431556196,-67.39335105312166,-0.05621358702109895,-0.052072645713742816,0.004140941307356134,290163162,265746366.8,23.514721253198232,35.3208076968455,NaN,NaN,-3.7811324949379395,2.9972863706233044
2007-06-22T09:30:00-04:00,29.949884,29.949884,29.470881,29.657611,47424912,20240975.9,38.15120499122404,46.635358289094945,NaN,NaN,-184.42896996145961,-100.21598976595416,-0.08350141118280663,-0.10023582267115216,-0.01673441148834553,242738250,260593627,21.95767525701548,32.44246162035581,NaN,NaN,-7.165250811077663,1.5454953446660233
2007-06-25T09:30:00-04:00,29.503356,29.795629,29.219209,29.422177,40586517,21707177.65,35.143422617091616,45.31277193657839,NaN,NaN,-191.26191556495343,-132.93493816249236,-0.11109989218864316,-0.15560927672414948,-0.04450938453550632,202151733,249322906,18.99491133125757,29.635000801788753,NaN,NaN,-10.97481669758616,-0.24312066137000277
2007-06-26T09:30:00-04:00,29.446525,29.584543,29.146125,29.146125,36638989,23042339.5,31.961619336799387,44.237444232901645,NaN,NaN,-189.0931043238063,-165.98346328076076,-0.13978525564875705,-0.2192409540964526,-0.07945569844769558,165512744,228709016.8,15.006622737448666,27.236151259706777,NaN,NaN,-15.241059304937767,-2.385683324736826
2007-06-27T09:30:00-04:00,29.146125,29.584543,29.064946,29.584543,36702132,24045320.1,41.08466381589734,44.512000891052985,NaN,NaN,-142.33418688434608,-173.3332462100255,-0.12173371668082489,-0.2316228442987267,-0.10988912761790182,202214876,220556153,13.774744478779525,25.419625813946197,NaN,NaN,-15.789293378914016,-4.300484761047853
2007-06-28T09:30:00-04:00,29.584543,29.746917,29.357219,29.535831,32578989,24987800.05,40.43590207937194,44.14594633099278,NaN,NaN,-105.67493171681907,-162.55862169027688,-0.10614472702769087,-0.2425700364025154,-0.13642530937482453,169635887,196450698,10.920364482045912,23.802224573874923,NaN,NaN,-16.423822628581984,-6.032390170695586
2007-06-29T09:30:00-04:00,29.568305,29.71445,29.064946,29.373448,37331986,26409573.25,38.26662544471118,43.41719820711139,NaN,NaN,-119.97997870887075,-149.66882343975914,-0.09992870853481642,-0.26133619504334504,-0.16140748650852862,132303901,174363828.2,9.066523245940274,22.181171125428595,NaN,NaN,-17.627883724566477,-7.688889249819999
2007-07-02T09:30:00-04:00,29.78751,29.811866,29.381575,29.625144,18325743,26709856.8,43.34051341166753,43.56047917182259,NaN,NaN,-71.76987152026996,-125.77041463082244,-0.07326002858524244,-0.25298252224008166,-0.17972249365483922,150629644,164059410.4,8.353992729959515,20.676135186738982,NaN,NaN,-17.02848297563674,-9.023116924936676
2007-07-03T09:30:00-04:00,29.730679,29.909291,29.730679,29.884935,18109517,26719008.8,48.08356841874656,43.293741305354175,NaN,NaN,-23.90520675678337,-92.73283511741786,-0.0344864545266407,-0.2228305618131401,-0.1883441072864994,168739161,164704693.8,8.837154185236514,19.138390845072763,NaN,NaN,-14.993389806600202,-9.87601305088861
2007-07-05T09:30:00-04:00,29.633255,29.836222,29.568305,29.633255,24885895,27025142.25,44.221431954376996,42.811199682759145,NaN,NaN,-48.59823322476791,-73.98564438550223,-0.02272062489843532,-0.21674488840954353,-0.1940242635111082,143853266,153032371.8,8.014105995278726,17.352912498693026,NaN,NaN,-14.503715119252805,-10.537113346369209
2007-07-06T09:30:00-04:00,29.633255,29.78751,29.511483,29.779383,16092588,26242399.3,46.88882054399587,42.59193945740612,NaN,NaN,-42.113396386080375,-61.273337319354496,-0.0030605483754403418,-0.19784994898040864,-0.1947894006049683,159945854,151094365.2,7.882832275019851,15.696031332470394,NaN,NaN,-13.267499709272371,-10.92716854106966
2007-07-09T09:30:00-04:00,29.755027,29.795629,29.600788,29.657611,19674818,26092233.55,44.95935220988953,42.24579625314273,NaN,NaN,-39.74211375246399,-45.22576432807315,0.00342709893824375,-0.1905055269321636,-0.19393262587040735,140271036,152687792.2,9.19978800738042,14.451617788970436,NaN,NaN,-12.829876276629323,-11.198983931863898
2007-07-10T09:30:00-04:00,29.454644,29.487127,28.90258,29.032463,52157828,27475691.5,36.62665352742608,41.12462298373903,NaN,NaN,-128.58987069928108,-56.58976416387539,-0.03081366177021244,-0.23244970308317292,-0.20163604131296048,88113208,140184505,8.208151142013037,13.233923155825906,NaN,NaN,-15.222382858755209,-11.773755207134085
2007-07-11T09:30:00-04:00,28.918809,29.235431,28.853852,29.129896,55055375,28935443.4,38.538601126228436,40.82101370743827,NaN,NaN,-126.07288661671569,-77.02330013586185,-0.04260358042288198,-0.25489051684156294,-0.21228693641868096,143168583,135070389.4,7.83609739223462,12.254834608057752,NaN,NaN,-16.505671098103775,-12.449743191558326
2007-07-12T09:30:00-04:00,29.267913,29.771273,29.243557,29.665722,40834951,30206076.25,47.85566129466637,41.11128862657803,NaN,NaN,-36.03377607288656,-74.51040870548557,-0.011629379930764877,-0.22682366133213705,-0.21519428140137217,184003534,143100443,14.39725709327152,11.603587168062987,NaN,NaN,-14.454502978845587,-12.736137446885078
2007-07-13T09:30:00-04:00,29.755027,29.876816,29.617018,29.779383,26318873,30370463.15,49.600965165725775,41.929128639042446,NaN,NaN,10.083567338010058,-64.07101596066748,0.01760974485406902,-0.1931821003337859,-0.21079184518785493,210322407,153175753.6,21.909074218650304,11.600115665322619,NaN,NaN,-12.260901324865943,-12.668246572310915
2007-07-16T09:30:00-04:00,29.706323,29.982351,29.641366,29.673848,29989274,31278440.6,47.99466545270595,42.84707455587204,NaN,NaN,22.757457467579474,-51.57110171665877,0.0301998817542104,-0.17304199299509193,-0.20324187474930233,180333133,161188173,27.36762652041824,12.198166750262667,NaN,NaN,-10.995057141129982,-12.429219510713638
2007-07-17T09:30:00-04:00,29.673848,29.917418,29.673848,29.771273,34975806,32527400.35,49.616777968396406,44.10815731527183,NaN,NaN,41.15500993169093,-17.62212559046437,0.044578361221308954,-0.14751892322266613,-0.19209728444397509,215308939,186627319.2,41.378295883606974,14.081857689273972,NaN,NaN,-9.47354097159143,-12.006979719410465
2007-07-18T09:30:00-04:00,29.470881,30.031079,29.04059,29.389694,62446943,35145904.9,43.84802605726762,44.305540332512564,NaN,NaN,-36.768545753977925,0.2387425820831865,0.02865347616863162,-0.15628043923318558,-0.1849339154018172,152861996,188566001.8,42.291892214899924,16.118796813282575,NaN,NaN,-9.92357078770077,-11.709349872023365
2007-07-19T09:30:00-04:00,29.479,29.633255,29.170481,29.29227,40456979,35888604.1,42.489702694144604,44.4522403764249,NaN,NaN,-69.72848338912257,-6.50019888116401,0.012638639291691123,-0.1691356162872033,-0.18177425557889443,112405017,174246298.4,37.62732604684003,18.02643692505358,NaN,NaN,-10.700144132107328,-11.565177623463931
2007-07-20T09:30:00-04:00,29.324744,29.357219,28.642774,28.780792,86494300,37854120.75,36.15697396357814,44.3015509849154,NaN,NaN,-192.1357172972705,-46.94405580822012,-0.029045818423525882,-0.21808152860830177,-0.18903571018477588,25910717,137363960.4,28.812648549086532,19.436874446706884,NaN,NaN,-13.476541547322455,-11.838229612586577
2007-07-23T09:30:00-04:00,28.74019,29.048709,28.642774,28.764546,44616009,37713675.6,35.973575802884255,43.77534115571659,NaN,NaN,-186.7181092467696,-88.83916915108993,-0.05296357843994853,-0.25524018323471154,-0.202276604794763,-18705292,97556275.4,22.646239518039508,20.45774921728403,NaN,NaN,-15.718383044263584,-12.392537245683293
2007-07-24T09:30:00-04:00,28.334255,28.553468,27.830904,28.041982,94863483,40427523.9,28.94208688237181,42.40809247454696,NaN,NaN,-275.24716479609117,-152.11960409664636,-0.10944655799827818,-0.33908480229261073,-0.22963824429433255,-113568775,31780732.6,16.40045240400427,20.997984804338866,NaN,NaN,-20.28624045928754,-13.520209133341043
2007-07-25T09:30:00-04:00,28.204372,28.399213,27.806547,28.171889,91859080,43188528.45,31.533190007227944,41.50178947832204,NaN,NaN,-212.31453284896975,-187.22880151564473,-0.12872769661344086,-0.3905478650611336,-0.26182016844769274,-21709695,-3133605.6,14.166927454552692,21.43747205142986,NaN,NaN,-23.061320210716868,-14.883225001537589
2007-07-26T09:30:00-04:00,27.684775,27.85526,27.067746,27.506156,105550849,46630964.3,26.250429950090833,40.02761872161453,NaN,NaN,-235.6495150209524,-220.41300784201067,-0.17416318247844248,-0.4795241465457458,-0.30536096406730334,-127260544,-51066717.8,11.792507025008902,21.716734533571934,NaN,NaN,-27.453863636261396,-16.679030520783847
2007-07-27T09:30:00-04:00,27.424969,27.774081,27.067746,27.075873,95862027,49795116.2,23.50906350279172,38.49545524253612,NaN,NaN,-201.16400472814303,-222.2186653281852,-0.21818708118978897,-0.5780948155545396,-0.3599077343647506,-223122571,-100873375.4,9.930109298180923,21.768900340057687,NaN,NaN,-32.08153182716765,-18.879387850267246
2007-07-30T09:30:00-04:00,27.368146,27.619817,26.79171,27.587343,103199398,53088486.8,32.5289083971287,38.202759161800586,NaN,NaN,-159.86379430999344,-216.84780234082996,-0.19842065005769843,-0.6079335469368736,-0.4095128968791752,-119923173,-121116951.6,9.288049701284876,21.84603595143425,NaN,NaN,-32.68893683392793,-20.852180562218773
2007-07-31T09:30:00-04:00,27.839014,30.242157,26.710515,26.710515,121943325,58269365.9,26.713295540406037,37.35809447709899,NaN,NaN,-93.46421201173337,-180.4912117839584,-0.22785355923110695,-0.6943298459180589,-0.46647628668695196,-241866498,-146776496.2,8.534764801865961,21.89594076640791,NaN,NaN,-35.476958118374014,-22.941434498812377
2007-08-01T09:30:00-04:00,26.864778,27.181408,26.393886,27.010915,123161570,63521968.55,31.248318839752514,36.17185573031943,NaN,NaN,-152.8906053758548,-168.60642628933542,-0.2109334749316727,-0.7301431303515429,-0.5192096554198702,-118704928,-166175542.8,8.006109740089101,21.439430241180595,NaN,NaN,-35.936845560771395,-24.797921793377952
2007-08-02T09:30:00-04:00,27.319417,27.522385,26.945965,27.189534,81056996,66330523.6,33.86875415020097,35.04812637206766,NaN,NaN,-107.3544476441025,-142.94741281396543,-0.1731382299688201,-0.7356324428808954,-0.5624942129120752,-37647932,-148253020.4,13.346469653520401,20.827815629385604,NaN,NaN,-35.37346603893835,-26.30871382845801
2007-08-03T09:30:00-04:00,26.954084,27.205756,25.996077,26.028552,165968758,73824332.1,26.73584682802536,33.52963932744762,NaN,NaN,-142.66718914132449,-131.24804969660173,-0.20933571713527743,-0.824163859331172,-0.6148281421958945,-203616690,-144351844.2,14.509815687076113,19.909400569861166,NaN,NaN,-37.61523550653234,-27.92393121104006
2007-08-06T09:30:00-04:00,26.134095,27.400612,25.947373,27.360019,141456913,79913436.85,41.85892013721272,32.97550662522021,NaN,NaN,-97.56189156045345,-118.78766914669373,-0.1304734924238934,-0.7779200077257613,-0.6474465153018679,-62159777,-132799165,18.01978668229016,18.240935626909966,NaN,NaN,-33.15558846028135,-28.67131081807453
2007-08-07T09:30:00-04:00,27.222001,27.936447,27.092102,27.554868,144205589,84515824.9,43.69073198104085,32.96427133406116,NaN,NaN,-50.79299867474048,-110.25342647929514,-0.055867087449338326,-0.7172803746135408,-0.6614132871642024,82045812,-68016703,34.30757110067047,17.670626975893576,NaN,NaN,-29.222818594562515,-28.7500976432871
2007-08-08T09:30:00-04:00,27.757835,28.569705,27.619817,28.212482,135140867,88520099.5,49.47635337450824,33.46331781122999,NaN,NaN,-7.385975862856543,-81.15250057669549,0.04182077472272938,-0.6091373187607907,-0.6509580934835201,217186679,-838381.6,46.23639736100745,18.28556064119125,NaN,NaN,-23.860893383343264,-28.05163989186655
2007-08-09T09:30:00-04:00,27.400612,27.960803,26.905372,27.197645,124440868,92700395.35,42.26011701534539,33.899256600641934,NaN,NaN,-57.278279175979065,-71.1372668830708,0.0420274542728829,-0.5984237756424164,-0.6404512299152993,92745811,25240367,50.02985538810357,19.801075415406753,NaN,NaN,-22.21155416039337,-27.217341930227523
2007-08-10T09:30:00-04:00,26.759243,27.522385,26.669938,27.075873,95010521,96134977.75,41.47836232182956,34.29245563770945,NaN,NaN,-70.38362839205041,-56.68055473321597,0.03802151546417143,-0.5929243355850851,-0.6309458510492565,-2264710,65510763,55.277417960498774,22.131873875582414,NaN,NaN,-21.275150324176078,-26.368457415077316
2007-08-13T09:30:00-04:00,27.709123,27.709123,26.54003,26.832303,71000155,98185521.8,39.88889061922272,35.07437019034166,NaN,NaN,-69.83659021096696,-51.135494463318686,0.023725664469584684,-0.6012887704622756,-0.6250144349318603,-73264865,63289745.4,54.93477238196144,24.884325302579356,NaN,NaN,-21.08725549277729,-25.613999997605884
2007-08-14T09:30:00-04:00,27.010915,27.035271,26.239647,26.361419,87651353,100819299.15,36.941607790004106,35.46068574625424,NaN,NaN,-105.01171554547952,-61.979237837466485,-0.010831016024053008,-0.6385532049619265,-0.6277221889378735,-160916218,14697339.4,47.9340536749406,27.296262889749922,NaN,NaN,-21.921050937801247,-25.086435846205223
2007-08-15T09:30:00-04:00,26.142214,26.881016,25.947373,26.125968,100526557,102723279.85,35.52805329392197,36.12337312795646,NaN,NaN,-122.7212984236152,-85.04630234961822,-0.04122580351453009,-0.6792544433310361,-0.638028639816506,-261442775,-81028551.4,37.73268015699005,29.149132399177144,NaN,NaN,-23.041276138308024,-24.79427017364848
2007-08-16T09:30:00-04:00,25.931128,29.917418,25.582016,26.913482,201654984,110783180.1,43.337731639314605,37.53970656627953,NaN,NaN,3.2709031740508094,-72.93646587961226,-0.002041453702063989,-0.640580456944086,-0.6385390032420221,-59787791,-111535271.8,35.164256180796244,30.9515714622211,NaN,NaN,-21.424048075398154,-24.312809873898434
2007-08-17T09:30:00-04:00,28.723961,28.732079,27.303188,28.009515,218091802,117363055.2,52.04439525844699,38.933669913516546,NaN,NaN,81.99085354940989,-42.46156949132019,0.09839325774304841,-0.5155474310632115,-0.61394068880626,158304011,-79421527.6,39.80898967091743,33.13163860290914,NaN,NaN,-16.896146572441268,-23.25328654511884
2007-08-20T09:30:00-04:00,28.09071,28.115058,27.262595,27.636047,108981506,120581330.05,49.26645094343911,40.544609585161766,NaN,NaN,50.08698354950895,-18.476854739225008,0.13794917677334162,-0.44150421783958294,-0.5794533946129246,49322505,-54904053.6,43.157043438705806,35.604658505540556,NaN,NaN,-14.247222720463565,-21.966705998739513
2007-08-21T09:30:00-04:00,27.465562,28.066354,27.465562,27.830904,58700038,118773157.8,50.743716291484944,41.93713797457122,NaN,NaN,73.21188997166611,17.16786636420412,0.17322862120866067,-0.36291761810209877,-0.5361462393107594,108022543,-1116301.4,49.75952077874861,38.587045008301956,NaN,NaN,-11.680933321538076,-20.497309901996452
2007-08-22T09:30:00-04:00,28.001404,28.244949,27.652292,27.903972,86261810,118493294.3,51.31617458850011,43.18338229159259,NaN,NaN,99.80488327493518,61.673102703914196,0.19581113491613794,-0.291382320665587,-0.48719345558172494,194284353,90029124.2,58.54630019281477,41.81560433253726,NaN,NaN,-9.472701508633001,-18.922365845801675
2007-08-23T09:30:00-04:00,28.212482,28.253076,27.76515,27.944565,63157067,116373605.2,51.652350191087294,44.9631325318113,NaN,NaN,98.72837934534945,80.76459793817392,0.20673287392197903,-0.22877736317925113,-0.43551023710123016,257441420,153474966.4,63.351242513539844,45.304277677284674,NaN,NaN,-7.5962616324093055,-17.304350958174194
2007-08-24T09:30:00-04:00,27.879616,28.180016,27.684775,28.041982,43548844,113757946.05,52.500051627500845,45.72321335254616,NaN,NaN,85.32663569922406,81.43175436813677,0.21292851853692135,-0.16934958893007845,-0.3822781074669998,300990264,182012217,65.29953357771923,48.68140245552961,NaN,NaN,-5.809090280754897,-15.662170861400009
2007-08-27T09:30:00-04:00,27.977048,28.001404,27.676648,27.717242,24230460,109809499.15,49.39118079170361,46.1303882675935,NaN,NaN,55.5856582871171,82.53148931565839,0.18841077214974694,-0.14676464227981612,-0.33517541442956306,276759804,227499676.8,68.20133512711305,51.102385600275504,NaN,NaN,-5.116753269078651,-14.15568263392553
2007-08-28T09:30:00-04:00,27.441206,27.465562,26.799821,26.889134,76739497,107549307.75,42.48258531677788,45.63083340632704,NaN,NaN,-42.35108983383665,59.41889335455784,0.11337453201710085,-0.19345724940818698,-0.30683178142528783,200020307,245899229.6,69.31897658769157,52.75114125932437,NaN,NaN,-6.54600482950166,-13.068585804722119
2007-08-29T09:30:00-04:00,27.035271,27.360019,26.678048,27.213882,61876034,104485030.95,45.6907618215355,45.87587946391205,NaN,NaN,-40.30214590140057,31.39748751929069,0.08392197555631353,-0.20192931197989594,-0.2858512875362095,261896341,259421627.2,70.14935947419461,54.188248694045164,NaN,NaN,-6.806851339798374,-12.174052309733012
2007-08-30T09:30:00-04:00,26.885083,27.270713,26.864778,27.04339,58470523,103355707.3,44.29392627283544,46.07699117469819,NaN,NaN,-41.930819664670686,3.2656477172866616,0.05278800560903846,-0.21986628052491142,-0.2726542861339499,203425818,248618506.8,68.55305561448463,55.13650852647272,NaN,NaN,-7.425735207189583,-11.495721295083952
2007-08-31T09:30:00-04:00,27.595469,27.60358,27.140806,27.400612,68206978,98467618.3,47.88866983235033,46.64840397563587,NaN,NaN,-3.7423628072928206,-14.548151984016716,0.055789412515082626,-0.2029175204900966,-0.2587069330051792,271632796,242747013.2,67.65198985293517,56.04488120297084,NaN,NaN,-6.927827915704683,-10.84316509802977
2007-09-04T09:30:00-04:00,27.473681,27.92832,27.327544,27.611691,45038737,93646709.5,49.94414285381881,47.57715648019407,NaN,NaN,29.717780112415983,-19.72172761895695,0.07057521341157572,-0.17048791624070958,-0.2410631296522853,316671533,250729359,68.262742965416,57.4969304380048,NaN,NaN,-5.928264069549207,-10.141036379675404
2007-09-05T09:30:00-04:00,27.562987,27.579224,27.11645,27.27884,55608291,89216844.6,46.8087214257752,48.38291848961216,NaN,NaN,-17.411769015295548,-14.733863455248734,0.05709895097665438,-0.16968944093146732,-0.2267883919081217,261063242,262937946,69.21995236324882,59.746021309880426,NaN,NaN,-5.95278343563006,-9.54271453052607
2007-09-06T09:30:00-04:00,27.270713,27.53863,26.905372,27.075873,39250638,84422333.15,44.95538882125433,48.498465431179284,NaN,NaN,-36.77760122302486,-14.028954519573592,0.034773776106148596,-0.18332117177543594,-0.21809494788158454,221812604,254921198.6,67.77444269628509,62.07532034670106,NaN,NaN,-6.491949377984861,-9.106890937305897
2007-09-07T09:30:00-04:00,26.79171,27.067746,26.637455,26.799821,92869942,82843786.85,42.491190617981786,47.81609367114605,NaN,NaN,-85.66465109091793,-22.77572080482304,0.0033292264803854443,-0.21393341478110273,-0.21726264126148817,128942662,240024567.4,65.05581116053541,63.878664738816624,NaN,NaN,-7.646973420288543,-8.898331292017703
2007-09-10T09:30:00-04:00,26.864778,27.027964,26.426368,26.710515,73798770,81783199.3,41.69493663143674,47.27527122028874,NaN,NaN,-96.86433275024181,-41.40011479341284,-0.020272689852578213,-0.24260350357721094,-0.22233081372463273,55143892,196726786.6,57.798685968570936,64.92449634809272,NaN,NaN,-8.830405928570933,-8.888627668668164
2007-09-11T09:30:00-04:00,26.848549,27.189534,26.824177,26.986567,62391013,81352742.2,45.11846486432437,46.87346754692013,NaN,NaN,-52.78598773580247,-57.90086836305653,-0.014359244542165472,-0.24027986940233959,-0.2259206248601741,117534905,156899461,52.04724751947839,65.08790540100198,NaN,NaN,-8.940451291836684,-8.896031043406524
2007-09-12T09:30:00-04:00,27.035271,27.189534,26.85666,27.04339,40105928,78975470.95,45.82363746392527,46.48114346659336,NaN,NaN,-55.04642574309526,-65.42779970861648,-0.0042140899341337745,-0.23118823727784132,-0.22697414734370755,157640833,136214979.2,49.30325880288915,64.42768815886444,NaN,NaN,-8.848157994660081,-8.889192036442745
2007-09-13T09:30:00-04:00,27.213882,27.522385,27.189534,27.489918,67155421,77306914.15,51.13687947877398,46.44432412999954,NaN,NaN,-2.901766187631103,-58.65263270153772,0.03293125975263275,-0.1858100726529166,-0.21874133240554935,224796254,136811709.2,49.38616208689258,63.43018241410392,NaN,NaN,-7.301957362291697,-8.662444225849738
2007-09-14T09:30:00-04:00,27.189534,27.587343,27.157052,27.587343,37355891,69091959.5,52.23751387506604,46.42557143339706,NaN,NaN,5.596278742981801,-40.40044673475778,0.06269859312966408,-0.14036809099346925,-0.20306668412313333,262152145,163453605.8,53.07561703037434,62.557045517865,NaN,NaN,-5.701168920900286,-8.239404896571244
2007-09-17T09:30:00-04:00,27.360019,27.360019,27.092102,27.327544,50534573,60714098.05,49.063751698500255,46.402183641025395,NaN,NaN,-24.14283450304748,-25.856147085318913,0.06334097209990572,-0.12389046899825118,-0.1872314410981569,211617572,194748341.8,57.03726347336786,61.759611828311776,NaN,NaN,-5.1507557489341105,-7.798169304051654
2007-09-18T09:30:00-04:00,27.506156,28.496645,27.238238,28.358611,170993129,63814679.2,59.56389625732521,47.622277279635924,NaN,NaN,123.99960032117266,9.500970526076111,0.1279304048586774,-0.027318435024810128,-0.15524883988348753,382610701,247763501,62.77139176696228,61.29192719825967,NaN,NaN,-1.2882130257573716,-6.868175550009614
2007-09-19T09:30:00-04:00,28.675257,28.959403,28.456043,28.537222,92118590,65485606.8,61.061355967549865,48.720176861494096,NaN,NaN,205.57233276980773,61.62472222865671,0.1745213975799232,0.06290290709141644,-0.11161849048850674,474729291,311181192.6,68.23328084454535,61.15506443899902,NaN,NaN,2.3346917897044346,-5.55348021576475
2007-09-20T09:30:00-04:00,28.618417,28.650884,28.050108,28.188126,79724113,65158721.95,56.645898854989255,49.60246061736222,NaN,NaN,134.55498904277937,89.1160732747388,0.17331414245959992,0.10502418758599319,-0.06828995487360674,395005178,345222977.4,70.71681934921052,61.30961899147944,NaN,NaN,4.081590474493801,-4.177041545727814
2007-09-21T09:30:00-04:00,28.285551,28.285551,27.774081,28.09071,66623671,65332052.15,55.441109169965316,50.14192057004901,NaN,NaN,93.70626134838547,106.73806979581954,0.15787776954754296,0.12905725706082194,-0.028820512486721003,328381507,358468849.8,71.64572169671203,61.59488555174921,NaN,NaN,5.155123824452957,-2.8438750642734183
2007-09-24T09:30:00-04:00,28.131287,28.131287,27.587343,27.701004,61015305,66205375.2,50.78748842224047,50.202159539221974,NaN,NaN,57.81956344594162,123.13054938561736,0.11531896111344214,0.11532818890508167,0.000009227791639535715,267366202,369618575.8,72.43827152256321,61.89313759154544,NaN,NaN,4.700056171578514,-1.7661706020088566
2007-09-25T09:30:00-04:00,27.554868,27.660419,27.343773,27.644173,44206900,67204197.2,50.12670201940708,50.43915815305284,NaN,NaN,18.740565757129726,102.07874247280878,0.07897180821052578,0.09872398805479676,0.019752179844270985,223159302,337728296,66.69596518754028,61.71285279328055,NaN,NaN,4.138730135658843,-0.9226133537706138
2007-09-26T09:30:00-04:00,27.717242,27.895853,27.498037,27.652292,65173429,66625893.8,50.22633563787349,50.81565435423992,NaN,NaN,35.96408210253054,68.15709233935334,0.052388343010477845,0.08523760860736829,0.03284926559689044,288332731,300448984,60.643950096199454,61.20353189327444,NaN,NaN,3.704210762640158,-0.26163847999764644
2007-09-27T09:30:00-04:00,27.774081,27.993278,27.692886,27.977048,44098015,65736992.85,54.170226194188544,51.649871181111834,NaN,NaN,63.15480821110571,53.8770561730186,0.05340574726884344,0.09960644968294474,0.046200702414101305,332430746,287934097.6,58.71769781307854,60.75080951131323,NaN,NaN,4.407748582156902,0.40541681459586043
2007-09-28T09:30:00-04:00,27.782191,28.041982,27.733479,27.863387,37899663,64708449.85,52.59934075807832,52.42875719015766,NaN,NaN,55.47507636969114,46.23081917727974,0.043569036554793814,0.10066199810759358,0.05709296155279976,294531083,281164012.8,57.65089628647296,60.74025310544909,NaN,NaN,4.575346981326101,1.0011211241287519
2007-10-01T09:30:00-04:00,27.709123,28.456043,27.684775,28.391094,61748979,64385549.9,58.601826177448515,53.39185442680938,NaN,NaN,93.64597162732925,53.39610081355725,0.06827613824519661,0.14243813435929553,0.07416199611409892,356280062,298946784.8,59.720960192947786,61.28837543926834,NaN,NaN,6.476769461211805,1.7833566008549022
2007-10-02T09:30:00-04:00,28.537222,28.764546,28.456043,28.715842,36324455,63949835.8,61.80711732485123,54.53353155973266,NaN,NaN,142.77095182177806,78.20217802648692,0.10023146086802581,0.1994513221991312,0.09921986133110539,392604517,332835827.8,63.39331366103564,62.29480792913595,NaN,NaN,9.080736570247165,2.8258394536252256
2007-10-03T09:30:00-04:00,28.553468,28.821385,28.512874,28.650884,52117210,63775281.75,60.793177946383565,55.223267164561925,NaN,NaN,127.1230442956952,96.43397046511984,0.10995610286457974,0.23666498991183005,0.1267088870472503,340487307,343266743,64.46716225492688,63.37202222685265,NaN,NaN,10.93419345397841,3.984175739389966
2007-10-04T09:30:00-04:00,28.748317,28.861978,28.626528,28.821385,37435806,63684540.15,62.53069129990015,55.958494123478644,NaN,NaN,126.29724924319427,109.06245867153757,0.12001303422635509,0.2767251798301942,0.1567121456038391,377923113,352365216.4,65.42004157108937,64.25376683690372,NaN,NaN,13.001689710186657,5.272392020932351
2007-10-05T09:30:00-04:00,28.90258,29.202964,28.861978,29.138014,48811913,61481638.7,65.58118973065214,57.1383111257752,NaN,NaN,148.33154464466014,127.63375232653136,0.1388030507616647,0.33021595905591994,0.19141290829425525,426735026,378806005,68.09750310276314,65.0437839532891,NaN,NaN,15.704572743419323,6.762703552716204
2007-10-08T09:30:00-04:00,29.097421,29.097421,28.618417,28.74019,25853774,59084388.9,59.07368945954499,57.10329635450518,NaN,NaN,105.99629917346121,130.10381783575775,0.11617071058278033,0.3366262965227307,0.22045558593995035,400881252,387726243,68.97039750115535,65.48657007716004,NaN,NaN,16.17431291526214,8.10721917593705
2007-10-09T09:30:00-04:00,28.878224,29.089302,28.675257,28.983759,39644514,57947063.95,61.58690600091861,57.14083564260295,NaN,NaN,106.66586606714779,122.88280068483171,0.10942949067085536,0.35724244927851956,0.2478129586076642,440525766,397310492.8,69.92263054459758,65.60723791287805,NaN,NaN,17.31586527577135,9.42274004734195
2007-10-10T09:30:00-04:00,28.926928,29.016242,28.66713,28.821385,40219443,57952739.7,58.98639710273738,57.30801408887068,NaN,NaN,86.86180259237403,114.83055234416747,0.08684615711953814,0.35637065500708687,0.26952449788754873,400306323,409274296,71.11427350002475,65.63562749507908,NaN,NaN,17.514369765373587,10.578687149917897
2007-10-11T09:30:00-04:00,29.146125,29.146125,28.585951,28.66713,77531013,58471519.3,56.54374308970241,57.386773654566184,NaN,NaN,74.03705578917727,104.37851365336408,0.055837344967034075,0.3393211790963413,0.2834838341293072,322775310,398244735.4,68.42285564528163,65.40542277711975,NaN,NaN,16.9795775247556,11.493100060608997
2007-10-12T09:30:00-04:00,28.561578,28.861978,28.561578,28.853852,41238740,58665661.75,58.76946052091926,57.95691451875752,NaN,NaN,61.89584033897273,87.0913727922266,0.042806230180257754,0.3369916218546294,0.29418539167437163,364014050,385700540.2,65.39164651865471,64.90209241969771,NaN,NaN,17.148047325570893,12.300949669889269
2007-10-15T09:30:00-04:00,28.74019,28.748317,27.968922,28.269322,94926921,60885279.15,50.115995012030865,57.95614973251636,NaN,NaN,-8.390303264043826,64.21405230472558,-0.007590764525627847,0.2846969360173368,0.29228770054296466,269087129,359341715.6,59.43346568721297,64.38334245538861,NaN,NaN,14.615323169994134,12.631574455618535
2007-10-16T09:30:00-04:00,28.082583,28.115058,27.60358,27.741598,83536999,56512472.65,43.83986041162042,57.49997293064114,NaN,NaN,-86.83132113019462,25.51461486525712,-0.07512354802921994,0.1983832655064397,0.27350681353565964,185550130,308346588.4,49.95096995973537,63.619558159926896,NaN,NaN,10.295497495694509,12.29784917562939
2007-10-17T09:30:00-04:00,27.968922,28.074465,27.222001,27.725352,91606725,56486879.4,43.65859708151695,56.74914227973603,NaN,NaN,-98.31532016718357,-11.520809686654397,-0.11704397905590308,0.1272018397157808,0.2442458187716839,93943405,247074004.8,41.40328353024151,62.382814282581386,NaN,NaN,6.830431586961382,11.51678952010539
2007-10-18T09:30:00-04:00,27.157052,27.457452,27.11645,27.376256,88920640,56946705.75,39.846098401467266,55.83819639712095,NaN,NaN,-130.5603262450225,-52.440286093494365,-0.1616884879770192,0.042135208800409885,0.2038236967774291,5022765,183523495.8,34.75949709051669,60.74771434001308,NaN,NaN,2.6379896051832863,10.248389532259374
2007-10-19T09:30:00-04:00,27.230112,27.384375,26.426368,26.46697,110448638,59137954.1,32.00614314113986,53.93850475167033,NaN,NaN,-174.78960788947063,-99.77737573918303,-0.24108155354270383,-0.09752824515095071,0.14355330839175312,-105425873,89635511.2,27.69011694570092,58.45979696520974,NaN,NaN,-4.125624397103748,8.194958970921785
2007-10-22T09:30:00-04:00,26.199045,26.954084,26.199045,26.79171,80657031,60120040.4,36.789542900814915,52.15153514995345,NaN,NaN,-163.26448812964657,-130.75221271230356,-0.2587902954974576,-0.17993456098006888,0.07885573451738871,-24768842,30864317,24.351458366348083,55.67109301558919,NaN,NaN,-7.994489823328918,5.882180571743113
2007-10-23T09:30:00-04:00,27.092102,27.092102,26.637455,26.937838,60839829,60951686.85,38.873454030850525,50.585840584558234,NaN,NaN,-126.0220669896502,-138.5903618841947,-0.24771694205970693,-0.23079044305724494,0.01692649900246198,36070987,968488.4,22.842681337404073,52.69791580719471,NaN,NaN,-10.386826252367229,3.5580367397273505
2007-10-24T09:30:00-04:00,26.872905,26.905372,26.061035,26.734871,128791949,64132612.85,37.046554109116514,48.765545070930834,NaN,NaN,-140.1257952338035,-146.9524568975187,-0.24089784264831998,-0.284195804307938,-0.043297961659618016,-92720962,-36364385,21.08575053117866,49.53118073291537,NaN,NaN,-12.917009067274455,1.2044587672985214
2007-10-25T09:30:00-04:00,26.767354,26.970321,26.125968,26.710515,96872809,66771352.55,36.82291640527408,46.71138269054668,NaN,NaN,-118.96473593496408,-144.633338835507,-0.22515510403708316,-0.324741841705972,-0.09958673766888881,-189593771,-75287692.2,19.409549754872444,46.0534697794946,NaN,NaN,-15.001792268226172,-1.1107199520621491
2007-10-26T09:30:00-04:00,27.213882,27.360019,26.596853,27.360019,97517385,69752238.65,46.1572805858413,45.78878205671071,NaN,NaN,-68.96563933739402,-123.46854512509167,-0.16112711666017193,-0.30099563349410374,-0.1398685168339318,-92076386,-72617794.8,19.88003633351596,42.54701541037751,NaN,NaN,-13.924790476252772,-2.9413014555179524
2007-10-29T09:30:00-04:00,27.368146,27.441206,27.108339,27.441206,47012334,69015406.4,47.207278804495914,44.761665828394804,NaN,NaN,-46.221147145020815,-100.05987692816652,-0.10609274565351554,-0.27248444890082624,-0.1663917032473107,-45064052,-76676836.8,19.691817483873237,38.95910019175433,NaN,NaN,-12.739074592745208,-4.340983332264703
2007-10-30T09:30:00-04:00,27.311307,27.311307,26.994677,27.019034,35145784,68956472.85,42.55949751735428,43.58831585801029,NaN,NaN,-57.933141280557784,-86.44209178634804,-0.09146178043448525,-0.28071892879041727,-0.18925714835593202,-80209836,-99933001.4,18.6049568971778,35.20843472012241,NaN,NaN,-13.144738579118245,-5.598662653243781
2007-10-31T09:30:00-04:00,27.124577,27.514274,26.872905,27.384375,104633894,71582307.05,47.38700964242564,42.93426346891909,NaN,NaN,-41.59762194737604,-66.73645712906254,-0.05245616680793111,-0.2548273568658459,-0.2023711900579148,24424058,-76503997.4,23.20359612285013,31.97848761137731,NaN,NaN,-11.96299084689157,-6.507852395193465
2007-11-01T09:30:00-04:00,26.588743,27.157052,25.97984,25.97984,112438651,75332449.3,35.15472279442341,41.247496488455106,NaN,NaN,-104.03495939419781,-63.750501820909314,-0.1130475278469808,-0.3436805998666408,-0.23063307201966,-88014593,-56188161.8,27.05224978469242,29.23995927323714,NaN,NaN,-15.371873962436316,-7.774141190513872
2007-11-02T09:30:00-04:00,26.036679,26.093502,25.159859,25.849941,196625765,82723141.9,34.273541516513006,40.11589266734669,NaN,NaN,-146.3059420928754,-79.21856237200558,-0.15128609390322978,-0.41974068939869724,-0.26845459549546746,-284640358,-94700956.2,24.541391741073866,26.74766827708435,NaN,NaN,-18.262074094362156,-9.272417319635055
2007-11-05T09:30:00-05:00,25.135503,25.622617,24.932536,25.387175,124973052,87679105.8,31.26674161623575,39.21781275339064,NaN,NaN,-165.24864706564105,-103.02406235612962,-0.19440781498291732,-0.5114643642241141,-0.3170565492411968,-409613410,-167610827.8,20.636410780817002,24.653771192875897,NaN,NaN,-21.685198260570242,-11.045671739768654
2007-11-06T09:30:00-05:00,25.49271,25.817466,25.127376,25.817466,101415093,90767634.75,36.81721250349418,38.729142426389004,NaN,NaN,-131.38516419784148,-117.71446693958637,-0.18089378502358266,-0.5431737805206751,-0.36227999549709244,-308198317,-213208524,18.638932694269357,23.027746133163596,NaN,NaN,-22.576409298273887,-12.692919962412258
2007-11-07T09:30:00-05:00,25.330344,25.435887,24.404812,24.404812,125426031,95027964.15,28.64016330345595,37.92871849081677,NaN,NaN,-178.69590913530322,-145.1341243771718,-0.24979014222848928,-0.6745176732827041,-0.4247275310542148,-433624348,-304818205.2,15.411384907294504,21.6457381200763,NaN,NaN,-26.591238235034186,-14.678394001358248
2007-11-08T09:30:00-05:00,24.762035,24.778272,23.779664,24.656492,146104908,98456658.9,31.556743719138396,37.89661853210238,NaN,NaN,-181.4550563224359,-160.61814376281941,-0.2599448427091189,-0.7496585844406134,-0.4897137417314945,-287519440,-344719174.6,14.253661434903918,20.68599129787651,NaN,NaN,-28.560745280022825,-16.661587041167472
2007-11-09T09:30:00-05:00,24.153132,25.16797,23.909572,24.469762,165321502,104660797,30.558799043113737,37.45156539940944,NaN,NaN,-149.2607439002652,-161.2091041242974,-0.26013491970726754,-0.8148823913655789,-0.5547474716583114,-452840942,-378359291.4,13.343552513321185,19.899712308374585,NaN,NaN,-30.419476796381268,-18.62699986334087
2007-11-12T09:30:00-05:00,24.648373,25.314098,24.502228,24.559067,134177658,106623333.85,31.6717119608563,36.93715525155271,NaN,NaN,-110.95489894969155,-150.35035450110746,-0.2358605906692972,-0.8495732099949329,-0.6137126193256357,-318663284,-360169266.2,16.450067997615363,19.443097069818254,NaN,NaN,-31.51108757877026,-20.467583822687924
2007-11-13T09:30:00-05:00,25.111131,25.858068,24.98124,25.711923,161914237,110542195.75,44.121751194626896,37.442526471946316,NaN,NaN,-50.78256980448912,-134.229835622437,-0.1291140321550216,-0.7751051595194127,-0.6459911273643911,-156749047,-329879412.2,21.496781673263357,19.47245643711002,NaN,NaN,-28.105417590328464,-21.558702932350858
2007-11-14T09:30:00-05:00,26.255876,26.377664,25.598261,25.614499,118796181,111901668.55,43.40204384512039,37.91246414622105,NaN,NaN,-19.804248255973587,-102.45150344657108,-0.055766980666818955,-0.7156998531979148,-0.6599328725310959,-275545228,-298263588.2,26.488067208436973,19.978064826650343,NaN,NaN,-25.715896109584445,-22.152587671955658
2007-11-15T09:30:00-05:00,25.362827,25.598261,24.404812,24.965002,134508214,114181047.25,38.85202934642085,37.39066048626245,NaN,NaN,-78.59918103406152,-81.88032838889619,-0.04230397165321864,-0.7128128370976192,-0.6705088654444006,-410053442,-322770388.6,25.153063031602656,20.354709590799388,NaN,NaN,-25.190733202083848,-22.58660846197397
2007-11-16T09:30:00-05:00,24.965002,25.086775,24.445406,24.770146,100718942,113694562.45,37.57919640881139,36.70294031514212,NaN,NaN,-86.66085509377339,-69.36035062759784,-0.037970327690729166,-0.7179717750578121,-0.6800014473670829,-510772384,-334356677,24.52375718510274,20.69984814088721,NaN,NaN,-25.1773949817978,-22.956720821948803
2007-11-19T09:30:00-05:00,24.445406,24.518474,23.820266,24.10442,168274014,118075411.6,33.536743202069545,36.058457864050354,NaN,NaN,-119.71715678169342,-71.11280219399823,-0.06954925095901665,-0.7669380110658537,-0.697388760106837,-679046398,-406433299.8,21.00334072260131,20.871161271274598,NaN,NaN,-26.48761266428641,-23.461133942282746
2007-11-20T09:30:00-05:00,23.666002,24.234328,23.097701,23.576697,180045751,124035707.7,30.716036830793414,34.86767409179091,NaN,NaN,-141.03555712032178,-89.16339965716477,-0.1130165104149563,-0.8386593981255324,-0.7256428877105761,-859092149,-546901920.2,16.140469486399198,20.36665222581382,NaN,NaN,-28.512045138621705,-24.18269268461688
2007-11-21T09:30:00-05:00,23.251957,23.60918,22.935328,23.211363,134890738,124340647.15,28.903620396336564,34.42116677764185,NaN,NaN,-147.48340591529998,-114.69923118903004,-0.15103564901324218,-0.9144374489771288,-0.7634017999638866,-993982887,-690589452,12.860398338620755,19.352948551094414,NaN,NaN,-30.755652265771637,-25.121686910496134
2007-11-23T09:30:00-05:00,23.422458,23.925809,23.422458,23.763435,88477672,123920890.3,35.132504559053515,34.48252128068046,NaN,NaN,-105.73388493311303,-120.12617196884034,-0.12475603644884115,-0.9193468455249381,-0.7945908090760969,-905505215,-789679806.6,11.173957544334797,18.398131822755907,NaN,NaN,-30.6445187691473,-25.910662890303442
2007-11-26T09:30:00-05:00,23.86897,23.86897,22.813555,22.967794,127808796,125435460.85,30.927097419868645,34.458260980939954,NaN,NaN,-125.6749059193502,-127.92898213395571,-0.14527638395918052,-0.9761862890250725,-0.830909905065892,-1033314011,-894188132,9.725421516144422,17.61877544670787,NaN,NaN,-31.950539703937714,-26.773502435108337
2007-11-27T09:30:00-05:00,23.21949,23.519874,22.927217,23.381856,122950265,129232357.4,35.269600433444694,34.34771726165071,NaN,NaN,-114.14669026858085,-126.8148888313332,-0.11652279561506207,-0.9765633995847196,-0.8600406039696575,-910363746,-940451601.6,9.15936518265201,16.941663481592343,NaN,NaN,-31.59295779508818,-27.4619960579626
2007-11-28T09:30:00-05:00,23.950165,24.778272,23.860859,24.778272,205360148,137743075.6,47.30219023753518,35.6807191855135,NaN,NaN,-24.144262370475374,-103.43662988136391,0.004564546857090734,-0.8543349203982942,-0.8588994672553849,-705003598,-909633891.4,12.800301266636737,16.755157507259646,NaN,NaN,-26.899400849400575,-27.38162531388231
2007-11-29T09:30:00-05:00,24.599661,24.762035,24.177489,24.559067,107154160,137869088.9,45.861021376951996,36.70245330392877,NaN,NaN,-12.791854955127194,-76.49831968932936,0.07406173767452717,-0.7663222951622259,-0.8403840328367531,-812157758,-873268865.6,17.026413011652977,16.95321119131315,NaN,NaN,-23.757510090017742,-26.863894567615944
2007-11-30T09:30:00-05:00,25.460243,25.720033,25.021842,25.16797,145074635,139500888.1,50.383171362541184,38.11847989817358,NaN,NaN,71.11737329163128,-41.12806804438047,0.1602591795882098,-0.6400600583514908,-0.8003192379397006,-667083123,-825584447.2,22.34129251921142,17.595906906019597,NaN,NaN,-19.62231496572482,-25.829383195917213
2007-12-03T09:30:00-05:00,25.038071,25.151733,24.770146,24.965002,72612235,133300211.6,48.916429144952225,39.350245411323286,NaN,NaN,43.37566483441975,-7.317953893626489,0.20022842938306318,-0.5500337012108716,-0.7502621305939348,-739695358,-766860716.6,28.42201079663286,18.451045677377987,NaN,NaN,-16.81363498033363,-24.54141916511956
2007-12-04T09:30:00-05:00,24.559067,24.68084,24.396693,24.502228,75441417,130823629.85,45.65307372092468,39.45962559177313,NaN,NaN,1.9478355485268923,15.900951269795058,0.19209091676802337,-0.5101484846339055,-0.7022394014019289,-815136775,-747815322.4,30.32741731336955,19.081805365957003,NaN,NaN,-15.502207539061855,-23.250103218539888
2007-12-05T09:30:00-05:00,24.883807,25.086775,24.591534,24.867578,107125603,131109155.35,48.57016237278399,39.82877691517768,NaN,NaN,44.27844313955769,29.58549237180166,0.20663872429122976,-0.4439409960378917,-0.6505797203291215,-708011172,-748416837.2,30.299983159242245,19.354085076728808,NaN,NaN,-13.513275049365806,-21.859127765800732
2007-12-06T09:30:00-05:00,24.908163,25.671329,24.84323,25.671329,122173116,130946509.6,54.37244567708803,40.937378081653904,NaN,NaN,100.12292614416148,52.1684485916594,0.2621493870638789,-0.3228929864992729,-0.5850423735631518,-585838056,-703152896.8,35.06051742025694,20.06176039020411,NaN,NaN,-9.900160075087264,-20.150703809984524
2007-12-07T09:30:00-05:00,25.720033,25.776872,25.330344,25.330344,100441794,128663353.9,51.70722344998422,41.9465228703091,NaN,NaN,96.91027718893227,57.3270293711196,0.26677294456646927,-0.2515761928550653,-0.5183491374215345,-686279850,-706992242.2,34.84313245039536,20.798858623439298,NaN,NaN,-7.768371163175885,-18.38179914615472
2007-12-10T09:30:00-05:00,25.606372,26.052908,25.403404,25.866178,97804998,125287528.7,55.40641344138531,43.50864217311737,NaN,NaN,112.06447987334126,71.06479237890389,0.29460758647614416,-0.15008965432635435,-0.4446972408024985,-588474852,-676748141,38.09907342891009,22.01998238817564,NaN,NaN,-4.803201270948402,-16.441999449696674
2007-12-11T09:30:00-05:00,25.91489,26.093502,24.550957,24.559067,168416519,126999471.75,46.12475789617603,44.60926510635899,NaN,NaN,41.32384177958955,78.93999362511643,0.21724743376827077,-0.17313794859216003,-0.3903853823604308,-756891371,-665099060.2,39.35608482916911,23.678240626944923,NaN,NaN,-5.240993407902702,-14.841855729440393
2007-12-12T09:30:00-05:00,25.387175,25.452133,23.909572,24.372337,175993614,127703440.6,44.965887446292406,45.756569895641555,NaN,NaN,-1.0155898199135476,69.88118703322218,0.14901351595198603,-0.20411848742044825,-0.3531320033724343,-932884985,-710073822.8,36.29190833151983,25.351919912152,NaN,NaN,-5.9606028194716165,-13.573105313730569
2007-12-13T09:30:00-05:00,24.10442,24.388567,23.682248,24.364211,167688482,130148055.65,44.91300393336937,46.455176993806965,NaN,NaN,-38.58998402483546,42.13860499942281,0.10113513816763553,-0.22671308066288987,-0.3278482188305254,-1100573467,-813020905,30.44814550590091,26.72864762369244,NaN,NaN,-6.542899407940005,-12.568790184331917
2007-12-14T09:30:00-05:00,24.039471,24.453524,23.820266,23.828393,86586374,127751963.65,41.4512225659889,47.20690021852984,NaN,NaN,-45.025914053834015,13.751366750869556,0.03461850410899159,-0.28457508869428594,-0.3191935928032775,-1187159841,-913196903.2,26.05212032480506,27.894840395739628,NaN,NaN,-8.097556226600103,-11.930042476084514
2007-12-17T09:30:00-05:00,23.706604,24.03136,23.560467,23.576697,85765730,127004303.05,39.89562758848714,47.53733072960431,NaN,NaN,-69.83863176843104,-22.629255577484905,-0.022040216322738615,-0.3467438632067008,-0.3247036468839622,-1272925571,-1050087047,21.48686072526651,28.775375791640663,NaN,NaN,-9.84633990650105,-11.632370680429734
2007-12-18T09:30:00-05:00,23.925809,23.958276,23.195134,23.592942,103553977,123768301.2,40.052000660190984,47.01946004550829,NaN,NaN,-77.67312969131524,-46.42864987166586,-0.05240044095126756,-0.3902041980730466,-0.33780375712177907,-1169371594,-1132583091.6,19.292733537547633,29.239120953848584,NaN,NaN,-11.222819633011753,-11.57386338794145
2007-12-19T09:30:00-05:00,23.722841,24.10442,23.47928,23.73096,135714929,121551760.1,41.44584512609737,46.70409031330439,NaN,NaN,-60.413291681421576,-58.308190243967466,-0.05679504517344225,-0.4087975635885819,-0.35200251841513963,-1033656665,-1152737427.6,18.787969134656052,29.364946391205944,NaN,NaN,-12.003637972068006,-11.635259757102387
2007-12-20T09:30:00-05:00,23.942054,24.088183,23.21949,23.560467,121023454,120858395.9,40.20234311127084,45.9768882953565,NaN,NaN,-79.42615479107322,-66.47542439721502,-0.06424353303315034,-0.43230693470657755,-0.3680634016734272,-1154680119,-1163558758,18.507973875679752,29.09113791666797,NaN,NaN,-13.000492402710865,-11.830292992189312
2007-12-21T09:30:00-05:00,23.666002,23.828393,23.414331,23.779664,83202818,120594653.2,42.58732988729387,45.52480977695234,NaN,NaN,-73.82859471303132,-72.23596052905448,-0.04820014453164345,-0.42831358233798156,-0.3801134378063381,-1071477301,-1140422250,21.21152972555406,28.576103554448057,NaN,NaN,-13.236201098620917,-12.031137007393827
2007-12-24T09:30:00-05:00,23.885215,24.250557,23.86897,24.209972,54014913,116904959.05,47.051919330217466,45.62472732047325,NaN,NaN,-36.682840981641775,-65.60480237169664,-0.004691055270409361,-0.3859772568943498,-0.38128620162394045,-1017462388,-1089329613.4,26.97319122025769,28.336515976368638,NaN,NaN,-12.238954509924884,-12.060825222041121
2007-12-26T09:30:00-05:00,24.16937,24.177489,23.877097,24.039471,29027149,112208803.25,45.54077349336181,45.40834240051452,NaN,NaN,-53.08993013587374,-60.688162460608325,0.015420649856782043,-0.3620103893029629,-0.37743103915974496,-1046489537,-1064753202,29.63860328805609,28.2892745569982,NaN,NaN,-11.788257866001347,-12.021887028321153
2007-12-27T09:30:00-05:00,23.974521,23.974521,23.536119,23.552341,44500227,104165807.2,41.44527568848732,44.48497311561447,NaN,NaN,-83.31090518505711,-65.26768516133544,-0.00042863078159910417,-0.37796682763674383,-0.3775381968551447,-1090989764,-1076219821.8,29.104839781524717,27.86386901137447,NaN,NaN,-12.513826458594998,-12.092164089788845
2007-12-28T09:30:00-05:00,23.787791,23.787791,23.325025,23.495518,39865929,100801395.65,40.98229114265827,43.71890652223404,NaN,NaN,-89.19892669160448,-67.2222395414417,-0.010524550736372151,-0.3906938852756099,-0.38016933453923774,-1130855693,-1071454936.6,29.67163137412672,27.49447607735528,NaN,NaN,-13.243219058447329,-12.256600513882914
2007-12-31T09:30:00-05:00,23.422458,23.812147,23.251957,23.487391,61093761,96602351.95,40.911897754100764,42.6835839731423,NaN,NaN,-84.46024013086937,-69.3485686250093,-0.013353478331744273,-0.3968611824539181,-0.38350770412217383,-1191949454,-1095549367.2,28.433720410949917,26.80409371892955,NaN,NaN,-13.872238637338333,-12.48740596009083
2008-01-02T09:30:00-05:00,23.60918,23.682248,22.998653,23.024633,80493418,96996411.1,37.0133538015935,42.03276939495783,NaN,NaN,-106.41174596393856,-83.29434962146865,-0.04046235188299069,-0.4340856439759122,-0.3936232920929215,-1272442872,-1146545464,25.96463995576478,25.847561942257812,NaN,NaN,-15.49964538612707,-12.917725878096007
2008-01-03T09:30:00-05:00,23.122058,23.243757,22.862259,22.878488,55324680,95990574.25,35.85143944856313,41.38173739512003,NaN,NaN,-121.11746361283805,-96.89985631686152,-0.06107060935287667,-0.4699615537840174,-0.4088909444311407,-1327767552,-1202801067,23.536584891257235,24.936467410810483,NaN,NaN,-17.20342650847125,-13.529968825292471
2008-01-04T09:30:00-05:00,22.659292,22.678785,22.188407,22.229001,93377865,95303187.35,31.16864790413193,40.39999767874592,NaN,NaN,-170.13334503540375,-114.26434428693082,-0.1085070059600029,-0.5445247018811443,-0.4360176959211414,-1421145417,-1268832197.6,21.04850093664942,24.265064227292523,NaN,NaN,-20.1532534276242,-14.47615233991129
2008-01-07T09:30:00-05:00,22.391375,22.594342,21.977329,22.285831,112083914,94798727.25,32.00552889766162,39.725305273865395,NaN,NaN,-165.77723741451433,-129.5800064315128,-0.12494925586586259,-0.5922042657534696,-0.46725500988760704,-1309061503,-1304473359.6,19.829983521054302,23.82062588416747,NaN,NaN,-22.367544068119802,-15.603494015369648
2008-01-08T09:30:00-05:00,22.440087,22.586232,21.473961,21.473961,148622474,97207761.25,26.962112349711518,38.801482756809996,NaN,NaN,-199.42257627609462,-152.57247366055785,-0.17625666509582483,-0.687575841257388,-0.5113191761615632,-1457683977,-1357620264.2,18.143285596904065,23.581799089284434,NaN,NaN,-26.018960929703127,-17.09141786027443
2008-01-09T09:30:00-05:00,21.59575,21.969202,21.035552,21.879896,164205560,100527789.35,32.674699260543846,38.2745326568352,NaN,NaN,-189.7731910106763,-169.2447626699054,-0.16860806688816354,-0.7220792597717676,-0.553471192883604,-1293478417,-1361827373.2,18.012673438947004,23.490366225098676,NaN,NaN,-27.41329558017158,-18.565971820259737
2008-01-10T09:30:00-05:00,21.660683,22.748597,21.457716,22.253357,275527717,105883349.25,37.51667065571214,37.993877337521965,NaN,NaN,-115.40927050592289,-168.10312404852237,-0.12609606046749655,-0.7110912684679747,-0.5849952080004781,-1017950700,-1299864002.8,26.414884654663823,24.03514590509923,NaN,NaN,-27.113524246365632,-19.787050738274864
2008-01-11T09:30:00-05:00,22.139695,22.821666,21.92049,22.326425,224740335,108320685.3,38.44937295362794,37.86866518340462,NaN,NaN,-83.25789850703512,-150.72803474284865,-0.08284387587846442,-0.6885500528485586,-0.6057061769700942,-793210365,-1174276992.4,39.86607691822648,25.56072469385257,NaN,NaN,-26.59634827779527,-20.759807529634923
2008-01-14T09:30:00-05:00,22.602461,22.651165,22.24523,22.634936,108332772,105352899.8,42.361556696812855,37.85253852694169,NaN,NaN,-59.936858207409145,-129.5599589014276,-0.026180872767194052,-0.6384322679290868,-0.6122513951618928,-684877593,-1049440210.4,49.70747448400936,27.59614931945652,NaN,NaN,-25.00156520292926,-21.365772911534116
2008-01-15T09:30:00-05:00,22.212763,22.24523,21.701285,21.701285,141940911,108120626.65,35.09220034275836,36.998272884980324,NaN,NaN,-105.70188133818436,-110.81581991384556,-0.043294802089376416,-0.6663698977736132,-0.6230750956842368,-826818504,-923267115.8,57.31169976102855,29.763185643797296,NaN,NaN,-25.830562792008983,-22.00360003731624
2008-01-16T09:30:00-05:00,21.831184,22.488799,21.620098,22.066618,176390466,112651863.45,39.469321894279915,36.564597770760194,NaN,NaN,-79.66828047654174,-88.79483780701864,-0.022756741081530252,-0.6515210220361496,-0.6287642809546193,-650428038,-794657040,63.38834417045725,32.173881421111666,NaN,NaN,-25.11264226969166,-22.447748927655585
2008-01-17T09:30:00-05:00,22.10722,22.115347,20.930009,20.946246,208527237,117900526.45,32.28006304051807,35.90993972447667,NaN,NaN,-126.8031465358031,-91.07361301299468,-0.07445813607674312,-0.7218369510505482,-0.6473788149738051,-858955275,-762857955,64.72537576427081,34.71820541987924,NaN,NaN,-26.984107490876962,-23.095800150972924
2008-01-18T09:30:00-05:00,21.10862,21.270994,20.272394,20.702685,220429221,122136241.05,30.959822386645868,35.19404909904721,NaN,NaN,-154.9998868640519,-105.42201068439803,-0.11260181524260449,-0.7881310840270608,-0.6755292687844563,-1079384496,-820092781.2,60.44655328463129,36.91641412777243,NaN,NaN,-28.903811317608373,-23.925516031920846
2008-01-22T09:30:00-05:00,19.655381,21.644454,19.574186,21.149214,314548132,131812474.95,36.11830271236586,34.851649453209006,NaN,NaN,-137.23192033761435,-120.88102311043906,-0.095951652154047,-0.7954688339770151,-0.6995171818229681,-764836364,-836084535.4,59.26762434459593,39.11883583731857,NaN,NaN,-28.767003803482684,-24.617157142143967
2008-01-23T09:30:00-05:00,20.589023,22.651165,20.467251,22.651165,302089920,142756830.05,49.72524689322539,35.759641816897,NaN,NaN,-43.70711075839369,-108.48206899448091,0.02174266027031324,-0.6723388564850765,-0.6940815167553898,-462746444,-763270123.4,62.82308113227187,41.751581635640505,NaN,NaN,-23.487292404993624,-24.45574789397963
2008-01-24T09:30:00-05:00,22.651165,22.870378,22.358892,22.659292,197429775,149927573.15,49.78757078546274,36.75507976953269,NaN,NaN,23.728327723492086,-87.80274735447416,0.10121784385436894,-0.5675592119374286,-0.6687770557917976,-265316669,-686247849.6,66.18543304778146,44.797927932535096,NaN,NaN,-19.54071161294313,-23.75359985383156
2008-01-25T09:30:00-05:00,23.048989,23.065227,21.92049,22.066618,166294781,156790954.75,45.37036906422,37.76948842382469,NaN,NaN,6.313804734858119,-61.17935710034192,0.11399938527916986,-0.5262778241928352,-0.6402772094720051,-431611450,-600779084.6,69.48364257648687,48.257580906809196,NaN,NaN,-17.77187872897288,-22.899068264566033
2008-01-28T09:30:00-05:00,22.188407,23.536119,21.863651,22.854132,113368219,160234354.35,51.52461256420192,39.16370868572043,NaN,NaN,57.82125140268968,-18.6151294469936,0.17212916047754567,-0.4251157588750729,-0.5972449193526186,-318243231,-448550831.6,74.2931051677261,52.14780388157146,NaN,NaN,-14.11677804965439,-21.644455376721513
2008-01-29T09:30:00-05:00,23.024633,23.21949,22.626817,23.203245,124450032,164463559.5,53.99866697772283,41.0948911591498,NaN,NaN,94.84555558748436,27.80036573802614,0.2272650263829148,-0.31316363637397515,-0.5404286627568899,-193793199,-334342198.6,77.19678242219186,56.365910797663446,NaN,NaN,-10.36733420515954,-20.033438066498373
2008-01-30T09:30:00-05:00,22.975921,23.804037,22.73236,22.73236,263843580,174601050.45,50.27178385700898,42.35182577318302,NaN,NaN,109.84056016948308,58.509899923601495,0.22478571508535639,-0.25944651890019443,-0.4842322339855508,-457636779,-333320265.6,77.22157550765085,60.595118088285155,NaN,NaN,-8.515765682743082,-18.388056297390474
2008-01-31T09:30:00-05:00,22.383264,24.299261,22.293958,23.657892,224010228,181776890.95,56.61059349956163,43.715677404886556,NaN,NaN,146.8090906407895,83.12605250706096,0.2749280350446749,-0.14057219017970723,-0.4155002252243821,-233626551,-326982242,77.38579769452187,64.23589759113216,NaN,NaN,-4.723738620933586,-16.43601091503949
2008-02-01T09:30:00-05:00,23.54423,24.096293,23.454924,24.096293,163008934,187161103.65,59.259668009079945,45.20212705170456,NaN,NaN,184.4663769809849,118.75656695628632,0.32370985175962314,-0.01086291052485322,-0.33457276228447635,-70617617,-254783475.4,79.22336777530096,67.04713265235176,NaN,NaN,-0.76866233853479,-14.197818261253104
2008-02-04T09:30:00-05:00,23.836503,23.942054,23.284423,23.398102,93417438,187163082.3,53.642623475865385,46.0079175359226,NaN,NaN,127.33416828116899,132.65915033198218,0.2958092615722189,0.035188814680797265,-0.2606204468914216,-164035055,-223941840.2,79.97203988860755,69.20888732410877,NaN,NaN,0.6680146090180856,-12.074127851214364
2008-02-05T09:30:00-05:00,22.878488,22.992167,22.293958,22.448197,154548151,189286294.15,47.10121361742232,46.86570419839859,NaN,NaN,25.818594549456705,118.85375812437664,0.2045702107912935,-0.004907683402304741,-0.20947789419359825,-318583206,-248899841.6,77.53712768975882,70.65356074758951,NaN,NaN,-0.377410779151497,-10.403168269491097
2008-02-06T09:30:00-05:00,22.561859,22.683648,22.042262,22.188407,129205414,188315441.15,45.46817732602243,47.29419387209449,NaN,NaN,-4.478307623839185,95.9899845657122,0.12199001196239387,-0.056990379240605904,-0.17898039120299977,-447788620,-246930209.8,77.59510365615336,71.66832928228209,NaN,NaN,-1.7427060301230417,-9.165959378152804
2008-02-07T09:30:00-05:00,21.977329,22.683648,21.92049,22.391375,159170271,188063676.7,47.01384446760718,48.34660683117228,NaN,NaN,-5.630526855102267,65.50206106653386,0.07842009882673284,-0.08095526766958372,-0.15937536649631656,-288618349,-257928569.4,76.40918251114212,72.50288690705862,NaN,NaN,-2.3506500869401434,-8.192343765122423
2008-02-08T09:30:00-05:00,22.310188,22.375137,21.709412,22.017914,128552916,180714936.65,44.51371680077134,49.31474214646696,NaN,NaN,-37.83711674093921,21.041362322149027,0.024619996446480663,-0.12860037093821575,-0.1532203673846964,-417171265,-327239299,69.22853100571922,73.13017102999348,NaN,NaN,-3.6275618117207213,-7.540232057493609
2008-02-11T09:30:00-05:00,21.977329,21.977329,21.335944,21.530792,134980349,176226937.35,41.419714099961126,49.69341438843804,NaN,NaN,-75.77978519966399,-19.58142837401757,-0.040081593532552307,-0.20332235930038678,-0.16324076576783447,-552151614,-404862610.8,62.180775761060225,73.33825327402664,NaN,NaN,-5.664367228032369,-7.272251367570575
2008-02-12T09:30:00-05:00,21.782472,22.164051,21.547022,22.123457,189444201,180282508.8,46.30940355998438,49.44942557892083,NaN,NaN,-37.67776145283182,-32.280699574475264,-0.03922342266056131,-0.21227004409353611,-0.1730466214329748,-362707413,-413687452.2,61.41528214537844,73.23769620353424,NaN,NaN,-5.904267927949787,-7.076825161910462
2008-02-13T09:30:00-05:00,22.050389,22.10722,21.563267,22.042262,106412977,178506112.1,45.74604098208364,49.160744878679466,NaN,NaN,-42.03651156443692,-39.792340362594814,-0.0402334233517897,-0.22333840062271193,-0.18310497727092223,-469120390,-417953806.2,61.02415149597817,72.8690332355483,NaN,NaN,-6.263209280447982,-6.960594321701537
2008-02-14T09:30:00-05:00,21.952957,22.099101,21.441487,21.441487,128104095,176091793.55,41.703464949729096,48.89882315621583,NaN,NaN,-63.02965500617236,-51.27216599280884,-0.07542809353734858,-0.27739009419260796,-0.20196200065525938,-597224485,-479675033.4,55.51576881636646,71.87132796696827,NaN,NaN,-7.794246467658194,-7.0796874854096306
2008-02-15T09:30:00-05:00,21.482088,21.782472,21.246638,21.782472,125276903,171929276.85,44.69097118730785,48.41070591500911,NaN,NaN,-71.66730294682519,-58.03820323398603,-0.06993125056765842,-0.2893760638648324,-0.21944481329717397,-471947582,-490630296.8,54.57413473699222,70.4628300790587,NaN,NaN,-8.200936382088706,-7.239865899220927
2008-02-19T09:30:00-05:00,22.050389,22.123457,21.404961,21.749989,117508803,166783255.95,44.45724136463208,47.729175514074065,NaN,NaN,-65.72353944157672,-56.02695408236857,-0.06289237687441784,-0.2980602843901963,-0.23516790751577843,-589456385,-498091251,53.90357173748214,68.79902931586516,NaN,NaN,-8.597176501982867,-7.433767413901204
2008-02-20T09:30:00-05:00,21.335944,22.001685,21.262875,22.001685,145578794,158334789.05,46.77984620758111,47.47975139625778,NaN,NaN,-76.36237750742562,-63.76387729328734,-0.03697699325318399,-0.2813891490822584,-0.24441215582907444,-443877591,-514325286.6,52.39502225605546,67.02570408360835,NaN,NaN,-8.293098713882364,-7.556529028184227
2008-02-21T09:30:00-05:00,21.969202,22.139695,21.522666,21.611979,93123519,147886469,43.730690004024076,46.559758289433674,NaN,NaN,-74.2098067796001,-70.19853633631998,-0.041437205301096625,-0.2962086624554452,-0.25477145715434857,-537001110,-527901430.6,51.10690261368556,65.14864014926289,NaN,NaN,-8.87910365188784,-7.745468260141886
2008-02-22T09:30:00-05:00,21.66881,22.082864,21.181688,22.082864,137777979,144903879.2,48.13014019308578,45.764792016862664,NaN,NaN,-65.72767415844392,-70.73814016677429,-0.009687089660374237,-0.26688031922981637,-0.25719322956944213,-399223131,-488301159.8,54.61210140182249,63.390692551157294,NaN,NaN,-8.14298272953594,-7.8022560414838935
2008-02-25T09:30:00-05:00,21.831184,22.277713,21.530792,22.082864,184671260,145822703.15,48.130140193085786,45.371043210949836,NaN,NaN,-41.68044846192087,-64.74076926979343,0.013065862548549856,-0.24086090138375482,-0.2539267639323047,-399223131,-473756269.6,55.8636801914741,61.66866685850489,NaN,NaN,-7.539900564434062,-7.764776687619632
2008-02-26T09:30:00-05:00,21.993558,22.610588,21.928601,22.277713,127634049,146535994.65,50.00598757243404,45.57852706487925,NaN,NaN,-4.5170949402116305,-52.499480369520406,0.04139184790368716,-0.2021869540526957,-0.24357880195638287,-271589082,-410182809,60.93432862230265,60.482752639400886,NaN,NaN,-6.521282811580477,-7.587134705328324
2008-02-27T09:30:00-05:00,22.034152,22.659292,21.92049,22.375137,121480493,146387517.7,50.96092983114002,45.970866529530504,NaN,NaN,5.3799361659262885,-36.15101763485002,0.0654142312169721,-0.16181101293516775,-0.22722524415213985,-150108589,-351429008.6,64.94288792973785,59.579022944656934,NaN,NaN,-5.407834996290641,-7.275806175465798
2008-02-28T09:30:00-05:00,22.17217,22.188407,21.676929,21.676929,109460421,138668359.75,44.413410494393574,45.785121245729535,NaN,NaN,-49.47918857834833,-31.204893994599672,0.03455543935320318,-0.18403094496063588,-0.21858638431383906,-259569010,-295942588.6,68.25568204626379,58.99663005430848,NaN,NaN,-6.197263805538142,-7.121728694047561
2008-02-29T09:30:00-05:00,21.392783,21.417131,20.791991,20.970602,172461265,136090911.6,38.96004543199084,45.38843043367378,NaN,NaN,-151.5336435373717,-48.36608787038522,-0.029681035473932554,-0.25568767865625475,-0.2260066431823222,-432030275,-302504017.4,67.44405154447891,58.86916723564847,NaN,NaN,-8.560023884362144,-7.327199435521073
2008-03-03T09:30:00-05:00,20.840703,20.873186,20.394174,20.686448,136288223,134754876.05,36.992190214329234,45.07217872755722,NaN,NaN,-220.4395878998197,-84.117915757965,-0.08446086952255122,-0.3315827300855112,-0.24712186056295998,-568318498,-336323090.8,63.268128341560924,58.946835277112804,NaN,NaN,-11.13618345746236,-7.871340010084114
2008-03-04T09:30:00-05:00,20.329217,20.629617,19.955765,20.572786,200790845,140123546.4,36.20445207972132,44.350396478967006,NaN,NaN,-247.87925654951545,-132.79034807982575,-0.11936891037064429,-0.39633299852626536,-0.27696408815562107,-769109343,-435827143,52.891455661660665,58.33799052827582,NaN,NaN,-13.489223596263642,-8.673894808109761
2008-03-05T09:30:00-05:00,20.637735,20.873186,20.150622,20.410412,225170827,143654680.2,35.05598160103864,43.58682080889236,NaN,NaN,-187.36977755133105,-171.34029082327723,-0.14282837918449753,-0.455499562136243,-0.31267118295174545,-994280170,-604661459.2,40.695320188050474,56.88593114913812,NaN,NaN,-15.793608506211646,-9.69099676498146
2008-03-06T09:30:00-05:00,20.077545,20.215555,19.566075,19.704085,172326623,145810740.65,30.52049915069192,42.78803753753257,NaN,NaN,-214.83344732126497,-204.41114257186055,-0.19227059564206622,-0.5530094275043282,-0.360738831862262,-1166606793,-786069015.8,32.12403189841956,55.2150927978562,NaN,NaN,-19.285415616938632,-11.06162802954677
2008-03-07T09:30:00-05:00,19.379337,20.174978,19.322506,19.744687,245495421,150126998.15,31.07255099676253,41.81529323820791,NaN,NaN,-175.17297227493043,-209.1390083193723,-0.20730096486967836,-0.61986503794936,-0.4125640730796816,-921111372,-883885235.2,28.623280850541576,53.36146037739543,NaN,NaN,-21.974319976868063,-12.620584022021239
2008-03-10T09:30:00-04:00,19.793391,19.898926,19.078945,19.184488,208729456,154135825.15,27.79148804230607,40.624882286613186,NaN,NaN,-169.57494384482146,-198.96607950837264,-0.2378439735381057,-0.7098690400023138,-0.47202506646420805,-1129840828,-996189701.2,25.224490207090454,51.312954553796025,NaN,NaN,-25.370634410870714,-14.442019791856879
2008-03-11T09:30:00-04:00,20.053189,20.564667,19.509236,20.442878,280520359,161412825.65,42.48367363757126,40.31801281732677,NaN,NaN,-86.80026159721912,-166.75028051791338,-0.15990869314285638,-0.6719109328927786,-0.5120022397499222,-849320469,-1012231926.4,24.771990633647462,49.339880866481174,NaN,NaN,-23.70497656796371,-15.765299331300712
2008-03-12T09:30:00-04:00,20.491607,21.035552,19.931409,20.101893,210995671,162490399.15,40.10258750724895,40.058862638985694,NaN,NaN,-63.712514497156604,-142.0188279070785,-0.11977073072694944,-0.661715653158609,-0.5419449224316596,-1060316140,-1025439120.4,24.384166946187435,47.431114033088456,NaN,NaN,-23.130903886378622,-16.8175285534547
2008-03-13T09:30:00-04:00,19.574186,20.913763,19.030233,20.053189,258947782,170117139.4,39.75981073165833,39.460981963169445,NaN,NaN,-83.07897463407157,-115.66793336963983,-0.0865018209586974,-0.6500721986300313,-0.5635703776713339,-1319263922,-1055970546.2,23.469428058051818,45.20663736567626,NaN,NaN,-22.78366976001177,-17.66983444010571
2008-03-14T09:30:00-04:00,20.248038,20.377945,19.095182,19.48488,313631808,179393525.05,35.90343307398604,38.5876457403766,NaN,NaN,-98.22018969060616,-100.27737685277496,-0.0922451335991431,-0.6788767946702627,-0.5866316610711196,-1632895730,-1198327417.8,19.74930670798102,42.62703925971247,NaN,NaN,-23.69306892007801,-18.53029650867318
2008-03-17T09:30:00-04:00,18.096574,19.322506,18.096574,19.038351,261446487,186202004.25,33.180320210055996,37.3858123573496,NaN,NaN,-141.68716571719304,-94.69982122724929,-0.11415751709556943,-0.7293285574405814,-0.615171040345012,-1894342217,-1351227695.6,16.68939011049946,39.46668650886938,NaN,NaN,-25.32048728652489,-19.500323762652
2008-03-18T09:30:00-04:00,20.012587,20.735152,19.655381,20.637735,343895530,197521340.6,48.30445510763444,37.19606416281349,NaN,NaN,-28.842287161444887,-83.10822634009443,-0.01423010149885251,-0.6329586672185776,-0.6187285657197251,-1550446687,-1491452939.2,14.474448100748376,35.861797949655845,NaN,NaN,-21.364294522113635,-19.766605299717945
2008-03-19T09:30:00-04:00,20.905653,21.189815,20.093783,20.093783,267078325,203596317.15,44.60653789987606,37.2098589774908,NaN,NaN,-16.360034018816247,-73.63773024442635,0.020075516475964728,-0.5936341701247692,-0.6137096866007339,-1817525012,-1642894713.6,12.538971292521822,31.882032895817133,NaN,NaN,-19.506090563215594,-19.729388908789037
2008-03-20T09:30:00-04:00,20.248038,21.538911,20.2318,21.368427,274312784,212655780.4,53.57529323621329,38.25380524922098,NaN,NaN,35.20068899712647,-49.98179751818673,0.12746509781050452,-0.45437831433760323,-0.5818434121481078,-1543212228,-1687684374.8,12.026757482864156,27.923654748558935,NaN,NaN,-14.470556348062994,-18.9781271143996
2008-03-24T09:30:00-04:00,21.603861,22.220882,21.555148,21.644454,182755012,214904632.05,55.264464371847254,39.5589676890437,NaN,NaN,98.97816409056458,-10.542126761952627,0.21101282947078703,-0.318077375309624,-0.529090204780411,-1360457216,-1633196672,16.495688776030747,24.582766208163918,NaN,NaN,-10.024265006120386,-17.699003956073998
2008-03-25T09:30:00-04:00,21.59575,21.798718,21.157332,21.579505,156322741,213487206.1,54.75958201596383,40.88433411306102,NaN,NaN,78.76833232329481,33.54897284614495,0.2529960088391573,-0.21284519373146438,-0.46584120257062167,-1516779957,-1557684220,22.38045139200571,22.403408760331423,NaN,NaN,-6.785046296595916,-16.139867147577128
2008-03-26T09:30:00-04:00,21.254748,21.335944,20.718922,20.800109,158308753,215020941.3,48.97717869963759,41.878705334389515,NaN,NaN,39.869550787344544,47.29134043590283,0.2205555368922254,-0.19014678145533992,-0.4107023183475653,-1675088710,-1582612624.6,21.83343208424452,21.056131038631,NaN,NaN,-5.947799283860513,-14.683857452760469
2008-03-27T09:30:00-04:00,21.003077,21.035552,20.394174,20.475361,151398465,216516839.9,46.76148586143056,43.03877581372799,NaN,NaN,20.19631675421535,54.60261059050915,0.17168022780837866,-0.196102033587092,-0.36778226139547066,-1826487175,-1584405057.2,21.79218742953738,20.318142147996557,NaN,NaN,-5.989839845187154,-13.441854937392852
2008-03-28T09:30:00-04:00,20.524074,20.637735,19.931409,20.012587,109152411,216501439.4,43.72577467190397,43.94257750480953,NaN,NaN,-22.93369130704807,42.975734529674234,0.10586621483500525,-0.23544949285171413,-0.34131570768671937,-1935639586,-1662890528.8,20.009734348116893,19.702888826394798,NaN,NaN,-6.994277462842184,-12.520772441028472
2008-03-31T09:30:00-04:00,19.947654,20.540311,19.817747,20.191207,108322228,213294487.55,45.20441827283696,45.186358235561734,NaN,NaN,-19.68493663206757,19.243114385147813,0.0735764058819865,-0.24934520033423624,-0.32292160621622273,-1827317358,-1756262557.2,18.111760781990313,19.19483672460193,NaN,NaN,-7.357096556759302,-11.783104457561448
2008-04-01T09:30:00-04:00,20.913763,21.693166,20.85694,21.611979,206248842,216792518.5,55.2717594294897,46.09979293498448,NaN,NaN,126.94769829098999,28.87898757868685,0.1430951469133246,-0.144052672574567,-0.2871478194878916,-1621068516,-1777120269,17.70770105108059,18.69024461156144,NaN,NaN,-4.292901295332648,-10.713075434385905
2008-04-02T09:30:00-04:00,21.758116,22.058508,21.43336,21.59575,157710667,214638509.6,55.14712324068654,47.17440263023002,NaN,NaN,138.55773989344613,48.616625399907164,0.1807490379277139,-0.0612115220782492,-0.2419605600059631,-1778779183,-1797858363.6,17.294575853426807,18.183845247792817,NaN,NaN,-1.9599838150579498,-9.462633774481912
2008-04-03T09:30:00-04:00,21.352181,21.798718,21.254748,21.693166,121485577,209454247.1,55.79154387145457,48.31952642592976,NaN,NaN,108.66109300896107,66.3095806508563,0.20329737387447935,0.012161157337136075,-0.19113621653734328,-1657293606,-1764019649.8,20.551696247882774,17.975435832780743,NaN,NaN,0.10509368020531581,-8.095815566669451
2008-04-04T09:30:00-04:00,21.652573,21.701285,21.246638,21.400893,109694823,206322657.1,53.316494820041484,49.563316550648,NaN,NaN,84.52161400828568,87.80064171392306,0.18986342208506984,0.04619306106899401,-0.14367036101607583,-1766988429,-1730289418.4,23.77418956842517,18.262927465669613,NaN,NaN,1.1141452896046198,-6.780106872916012
2008-04-07T09:30:00-04:00,21.725633,21.904253,21.449605,21.530792,121471644,200121468.25,54.28712931126959,51.07094577216326,NaN,NaN,90.72112608240256,109.88185425681709,0.1810899930116093,0.0826921302484358,-0.0983978627631735,-1645516785,-1693929303.8,27.202004933929913,19.013828524486076,NaN,NaN,2.220710928677057,-5.494275758402717
2008-04-08T09:30:00-04:00,21.335944,21.506444,21.084264,21.287231,111112153,195240603.1,52.0997962774032,51.34204157000388,NaN,NaN,52.62194979937639,95.01670455849437,0.15145152148245583,0.09091653908989628,-0.06053498239255954,-1756628938,-1721041388.2,26.25395238164505,19.855221687407266,NaN,NaN,2.555751286181805,-4.3442718948906425
2008-04-09T09:30:00-04:00,21.352181,21.352181,20.775753,20.930009,120966637,187262917,48.982526765589405,51.65461220326912,NaN,NaN,22.205706721895655,71.74629792418428,0.10269017507780138,0.0678277364546922,-0.034862438623109185,-1877595575,-1740804666.6,25.55477977662106,20.784922293414354,NaN,NaN,1.9772353654268708,-3.4411994291309975
2008-04-10T09:30:00-04:00,20.743279,21.092383,20.556557,20.800109,135534782,183489872.55,47.86108556259234,51.24645451229619,NaN,NaN,-0.7715045005742008,49.859778422277216,0.0587722388189358,0.03860285990056056,-0.020169378918375235,-2013130357,-1811972016.8,23.162651454147337,21.580343291363153,NaN,NaN,1.1860027643720499,-2.780170544344848
2008-04-11T09:30:00-04:00,20.394174,20.865059,20.345462,20.402293,113601399,176222553.4,44.500909815902894,50.477629186871596,NaN,NaN,-34.68525569706256,26.01840448120757,0.002960581956600282,-0.016468651472624884,-0.019429233429225166,-2126731756,-1883920682.2,21.02035751729447,21.903533915739132,NaN,NaN,-0.44292684295109896,-2.446278587002884
2008-04-14T09:30:00-04:00,20.272394,20.29675,19.80962,19.923282,123065811,166694253.55,40.787644374176594,49.47963364102965,NaN,NaN,-98.36116721346977,-11.7980541779669,-0.06256851226203806,-0.09763987375677274,-0.03507136149473468,-2249797567,-2004776838.6,18.007521778425797,21.591181800483422,NaN,NaN,-2.950702757913475,-2.5183391828472543
2008-04-15T09:30:00-04:00,20.11002,20.321106,19.785272,20.126249,115203567,159382107.55,42.959519782928574,49.04980086126473,NaN,NaN,-111.02338070154573,-44.52712027815132,-0.08708831552612696,-0.14393175590239338,-0.056843440376266416,-2134594000,-2080369851,16.42204411447716,21.204654088357184,NaN,NaN,-4.477175115174229,-2.7981728874653937
2008-04-16T09:30:00-04:00,20.524074,20.775753,20.386056,20.670218,138224021,149098532.1,48.420073565618274,49.16827141156385,NaN,NaN,-44.726687030424294,-57.913599028615316,-0.06265847821335015,-0.1351665381429541,-0.07250805992960395,-1996369979,-2104124731.8,15.946886207003757,20.787132572461925,NaN,NaN,-4.27968550729311,-3.009817547440782
2008-04-17T09:30:00-04:00,20.515955,21.141087,20.48348,21.027425,155259694,143507600.55,51.690585819234386,49.73718649351603,NaN,NaN,-11.484491851618298,-60.056196498824136,-0.020604510123004266,-0.09826369758335929,-0.07765918746035502,-1841110285,-2069720717.4,19.57629407848154,20.756172553202255,NaN,NaN,-3.1640434660474117,-3.031849821527443
2008-04-18T09:30:00-04:00,21.697234,21.831184,21.335944,21.490199,155131594,137548541.05,55.616910963715405,50.48093597143592,NaN,NaN,74.61981888417132,-38.195181582577355,0.037075384367059594,-0.03131495700153053,-0.06839034136859012,-1685978691,-1981570104.4,28.138385127759832,21.472360006471508,NaN,NaN,-1.0289088794505459,-2.7457154012307434
2008-04-21T09:30:00-04:00,21.262875,21.270994,20.954365,21.157332,80731683,132447374.6,52.32284483562407,50.270299214731224,NaN,NaN,24.281034457897764,-13.66674124830385,0.05066517926118967,-0.005058867292103031,-0.0557240465532927,-1766710374,-1884952665.8,36.16068423424308,22.790430233840254,NaN,NaN,-0.1702741803145568,-2.377795226814145
2008-04-22T09:30:00-04:00,21.003077,21.059908,20.743279,20.865059,103609730,129811724.05,49.54790613141723,49.8703551354977,NaN,NaN,-5.545252696361969,7.4288843527329025,0.03838289244430534,-0.007745430997911029,-0.04612832344221637,-1870320104,-1832097886.6,40.10018156321578,24.41940207025375,NaN,NaN,-0.24717397487394682,-2.07342076225126
2008-04-23T09:30:00-04:00,20.913763,21.051781,20.580913,20.727041,100916629,126942117.85,48.24665543833998,49.331434533132374,NaN,NaN,-19.579864418181966,12.458248875181365,0.020285055163181083,-0.020772004488240015,-0.0410570596514211,-1971236733,-1827071237.4,40.47638338623634,25.84259400870758,NaN,NaN,-0.6785726656054134,-1.8741567484447104
2008-04-24T09:30:00-04:00,20.808228,21.620098,20.800109,21.473961,151706021,126957495.65,55.116479624228674,49.46000487628861,NaN,NaN,51.14696587920505,24.98454042134604,0.05591930409205408,0.028842070463646508,-0.027077233628407575,-1819530712,-1822755322.8,40.82005911716874,27.060156119332117,NaN,NaN,0.9957748936870037,-1.4641665138544655
2008-04-25T09:30:00-04:00,21.709412,21.936727,21.246638,21.879896,102618951,126630822.65,58.35216803066553,49.75036478481689,NaN,NaN,99.30969372690421,29.922515389892617,0.10147545998000002,0.09976709134659245,-0.0017083686334075678,-1716911761,-1828941936.8,40.459443673478354,28.00711602929987,NaN,NaN,3.413236447891382,-0.7673946621764873
2008-04-28T09:30:00-04:00,21.896134,22.050389,21.676929,21.936727,94386579,125934040.2,58.799974892319675,50.22894897159664,NaN,NaN,118.57990645867375,48.78228979004781,0.12835206115191683,0.1587317078064885,0.030379646654571647,-1622525182,-1800104898.4,42.98770262371549,29.20238390373347,NaN,NaN,5.504262782858688,0.12855640139996627
2008-04-29T09:30:00-04:00,21.839295,21.961083,21.59575,21.66881,79226950,119582945.6,55.75634195520898,50.712792913712306,NaN,NaN,90.25024285767229,67.94138890085466,0.12109456446625157,0.1817478522373861,0.06065328777113453,-1701752132,-1766391304,45.88102808079615,30.654258782603115,NaN,NaN,6.418904457949612,1.02717755233563
2008-04-30T09:30:00-04:00,21.693166,21.961083,21.449605,21.603861,106348533,117014838.9,55.01291775432316,51.22363807026452,NaN,NaN,80.28749426472159,87.91486063743538,0.10549987108194384,0.19252812662356433,0.0870282555416205,-1808100665,-1733764090.4,48.59968341616285,32.47118963703279,NaN,NaN,6.971926887464422,1.8764274573540287
2008-05-01T09:30:00-04:00,21.547022,22.423849,21.473961,22.342662,125977075,117239413.8,61.32924674629938,52.42566213672141,NaN,NaN,129.77457046432949,103.64038155446028,0.13655007566830007,0.2577158501269956,0.12116577445869553,-1682123590,-1706282666,50.83975841577445,34.60114684406708,NaN,NaN,9.371820876345971,2.947197945781449
2008-05-02T09:30:00-04:00,22.781072,22.870378,22.253357,22.496926,121317136,117820529.45,62.51278391760951,53.97745781839518,NaN,NaN,167.35471898903288,117.24938660688599,0.1575936846097053,0.31815788022082714,0.16056419561112184,-1560806454,-1675061604.6,53.32829233389053,37.12405902660027,NaN,NaN,11.705683607777004,4.198410183209385
2008-05-05T09:30:00-04:00,22.326425,22.383264,22.026033,22.10722,78788850,115686389.75,57.707809827845814,55.03090710731784,NaN,NaN,112.0053096412741,115.93446724340606,0.13618813003516056,0.33079935815507255,0.194611228119912,-1639595304,-1678475629,53.01227591568049,39.73764701240051,NaN,NaN,12.329258920836681,5.3599600028704275
2008-05-06T09:30:00-04:00,21.798718,22.358892,21.04367,22.342662,124644566,116363010.4,59.72209348456355,55.83819424438536,NaN,NaN,73.49212815541755,112.58284430295512,0.12888346129148717,0.35571555473427097,0.2268320934427838,-1514950738,-1641115350.2,56.07951261157067,42.60426318415529,NaN,NaN,13.43763085326393,6.513912981498071
2008-05-07T09:30:00-04:00,22.367018,22.367018,21.449605,21.538911,119069328,116268144.95,50.82304791666302,55.77622725134455,NaN,NaN,53.52275584108484,107.22989661822776,0.06418725641858342,0.30706616396601305,0.24287890754742963,-1634020066,-1606299230.4,58.7799046361795,45.40452108113372,NaN,NaN,11.65917241497036,7.248950043422683
2008-05-08T09:30:00-04:00,21.628217,21.628217,21.019314,21.100509,166681246,117825468.15,46.732659166504675,55.141637837258074,NaN,NaN,-8.752305324947466,79.52452146037237,-0.00991994555945816,0.23047897559810693,0.2403989211575651,-1800701312,-1630014774.8,56.24321565328902,47.41200897581438,NaN,NaN,8.840495023738384,7.4763136120392115
2008-05-09T09:30:00-04:00,20.970602,21.449605,20.92189,21.100509,142152768,119253036.6,46.732659166504675,54.7423388608924,NaN,NaN,-24.23309872823179,41.20695791691944,-0.05804055520213314,0.16784822715489867,0.2258887823570318,-1800701312,-1677993746.4,51.409467992027196,48.501207815656095,NaN,NaN,6.604002955713471,7.3516978039926775
2008-05-12T09:30:00-04:00,21.124857,21.417131,21.04367,21.352181,83452395,117272365.8,49.44177418784266,54.73475800777993,NaN,NaN,-20.42110563146628,14.721674862371367,-0.0711573050859271,0.13694215099962292,0.20809945608555003,-1717248917,-1693524469,49.91405183473039,49.20219854933572,NaN,NaN,5.499118289047078,7.087043587571878
2008-05-13T09:30:00-04:00,21.425249,21.441487,21.019314,21.157332,92769394,116150657.15,47.430496380998626,54.67646093225556,NaN,NaN,-42.03316173233438,-8.383383115179017,-0.08998045728059303,0.09562388448480874,0.18560434176540178,-1810018311,-1752537983.6,44.6046718462474,49.497076296479364,NaN,NaN,3.989460533436956,6.6445317226954606
2008-05-14T09:30:00-04:00,21.262875,21.409012,21.149214,21.303477,80154586,113247185.4,49.10290155734486,54.246919641763846,NaN,NaN,-37.62694194889772,-26.61332267317553,-0.08942700703134138,0.07382058297622507,0.16324759000756645,-1729863725,-1771706715.4,43.00451831360691,49.65310909622495,NaN,NaN,3.1861422198666958,6.150476079434209
2008-05-15T09:30:00-04:00,21.287231,21.59575,21.10862,21.514555,90153664,109991883.9,51.502669002085455,53.75766971115098,NaN,NaN,-23.448281987724787,-29.552518005730995,-0.0724099959310919,0.07273509509370157,0.14514509102479348,-1639710061,-1739508465.2,46.477791207979784,50.082991062975054,NaN,NaN,3.161690790636409,5.723506752463095
2008-05-16T09:30:00-04:00,21.579505,21.579505,21.124857,21.425249,64599642,105465286.3,50.41949805884956,53.159064223045974,NaN,NaN,-26.796106140045087,-30.065119488093654,-0.06497077178320804,0.06393162629578342,0.12890239807899145,-1704309703,-1720230143.4,48.50135060231023,50.476823061446105,NaN,NaN,2.84901063754588,5.312864450332064
2008-05-19T09:30:00-04:00,21.303477,21.555148,21.051781,21.222282,85775584,105717481.35,47.95120744906911,52.601554615464565,NaN,NaN,-46.8092438834296,-35.342747138486324,-0.07103019332311314,0.04011465642510004,0.11114484974821318,-1790085287,-1734797417.4,47.05368156989311,50.56058402495303,NaN,NaN,1.91143972860943,4.826946632943117
2008-05-20T09:30:00-04:00,21.003077,21.011196,20.605261,20.727041,97250939,105399541.8,42.48585718004004,51.706764574444335,NaN,NaN,-133.9345251189193,-53.72301981580331,-0.10372301127418855,-0.01850891434452251,0.08521409692966604,-1887336226,-1750261000.4,45.5011019172255,50.339256775028936,NaN,NaN,-0.5211035513293759,4.0629394637613325
2008-05-21T09:30:00-04:00,20.670218,20.800109,20.085672,20.199326,133511365,107029278.6,37.57172215206949,50.00979853199935,NaN,NaN,-195.23475016491264,-85.2445814590063,-0.1532313236729531,-0.10632505766152534,0.046906266011427764,-2020847591,-1808457773.6,40.13393084649809,49.574554805794904,NaN,NaN,-4.218283565995189,2.8799076023675436
2008-05-22T09:30:00-04:00,20.061316,20.515955,20.061316,20.312987,81777092,103532832.15,39.20283038299506,48.34480185095547,NaN,NaN,-177.34905155870166,-116.02473537320165,-0.1694035915458399,-0.16484822342087213,0.004555368124967776,-1939070499,-1868329861.2,35.495160734921484,48.300759691582826,NaN,NaN,-6.792415875495239,1.4981471055300033
2008-05-23T09:30:00-04:00,20.223682,20.2318,19.915171,20.012587,89089928,102856381,36.48926855419099,46.82919175998012,NaN,NaN,-183.0015661682482,-147.2658273788423,-0.1898719961771541,-0.23278462709647485,-0.04291263091932075,-2028160427,-1933100006,31.28274559376095,46.748650382874295,NaN,NaN,-9.816938795163598,-0.1182937374262254
2008-05-27T09:30:00-04:00,19.915171,20.215555,19.907052,20.118139,83716831,102322893.6,38.110301664395166,45.285492344253804,NaN,NaN,-156.88273904388302,-169.28052641093296,-0.18562048355688948,-0.2749382353654326,-0.08931775180854312,-1944443596,-1963971667.8,29.486541514839104,44.84915244739347,NaN,NaN,-11.872511180325795,-1.7974676578404496
2008-05-28T09:30:00-04:00,20.280513,20.29675,19.720314,20.004477,139138354,105318463.8,37.01470041205767,44.29918180821057,NaN,NaN,-140.50736967017977,-170.59509532118506,-0.1796645357514995,-0.31389842149791747,-0.13423388574641798,-2083581950,-2003220812.6,27.337409711549242,42.60325995277702,NaN,NaN,-13.906324745448003,-3.5273043846415284
2008-05-29T09:30:00-04:00,19.955765,20.451005,19.955765,20.3617,96740079,104838041.1,42.59981665233946,44.00397877148448,NaN,NaN,-95.9185967370984,-150.73186463562223,-0.14249222917200693,-0.31234917221142666,-0.16985694303941973,-1986841871,-1996419668.6,28.312443014765364,40.60820476431105,NaN,NaN,-14.12733146328413,-5.041593967304757
2008-05-30T09:30:00-04:00,20.475361,20.499718,19.931409,20.101893,79072403,102492807.5,39.83328729224916,43.51116649475194,NaN,NaN,-91.23736882106458,-133.50952808809478,-0.12675539190141225,-0.32830118291618504,-0.2015457910147728,-2065914274,-2021788423.6,26.864380625772355,38.85498423814999,NaN,NaN,-15.108575208497586,-6.479734144618018
2008-06-02T09:30:00-04:00,20.053189,20.053189,19.606652,19.801509,104725278,101663214.6,36.85329901291074,42.61198969654252,NaN,NaN,-115.05241744098333,-119.91969834264182,-0.127579470699803,-0.36102012938952655,-0.23344065868972355,-2170639552,-2050284248.6,25.299135454030406,37.096775925242845,NaN,NaN,-16.829598479722993,-7.9582861924901565
2008-06-03T09:30:00-04:00,19.963883,20.020714,19.436168,19.73656,151590535,105303298.85,36.22230555995354,41.811404637896445,NaN,NaN,-112.42524131704411,-111.02819879727403,-0.12342472017832867,-0.3877215589126344,-0.2642968387343057,-2322230087,-2125841546.8,21.69041479209764,35.460043278517865,NaN,NaN,-18.42944032780077,-9.454165354677386
2008-06-04T09:30:00-04:00,19.622898,19.97201,19.379337,19.614779,169160698,107529105.45,35.011832643919405,40.80489971550892,NaN,NaN,-108.5994092855027,-104.64660672033861,-0.11971271034939635,-0.4139377266710511,-0.29422501632165476,-2491390785,-2207403313.8,18.605252322487658,33.71723856486649,NaN,NaN,-20.118543817249023,-10.97764799218762
2008-06-05T09:30:00-04:00,19.695958,20.004477,19.647254,20.004477,138094226,108480350.35,41.723158379160054,40.10636324244281,NaN,NaN,-76.86897867506525,-100.83668310793198,-0.08355854714420402,-0.3986732002519098,-0.31511465310770576,-2353296559,-2280694251.4,16.35418982970522,31.565552752132593,NaN,NaN,-19.7122639346648,-12.22545026968436
2008-06-06T09:30:00-04:00,19.752797,19.760916,18.932817,18.940927,192733516,109782963.85,32.00804977652869,38.791259793705606,NaN,NaN,-138.286356555171,-110.24648065475326,-0.12151797716545354,-0.4670121245645227,-0.34549414739906914,-2546030075,-2376717411.6,13.969446761522207,29.098988192076302,NaN,NaN,-22.591960822586643,-13.7063803486704
2008-06-09T09:30:00-04:00,19.046478,19.16014,18.356381,18.681121,210267969,113188723.9,30.160544813911315,37.520498176908625,NaN,NaN,-172.77538730006933,-121.79107462657046,-0.15237044711745984,-0.5359572062958939,-0.3835867591784341,-2756298044,-2493849110,11.723701717335501,26.57541820260791,NaN,NaN,-25.53942578032689,-15.396815410335613
2008-06-10T09:30:00-04:00,18.453805,18.981521,18.380737,18.73796,217476788,119889943.55,31.09755213983928,36.70704781689428,NaN,NaN,-160.02435001804815,-131.31089636677126,-0.15659624749668594,-0.5793320685492915,-0.4227358210526056,-2538821256,-2537167343.8,11.01823846790711,24.112356527656598,NaN,NaN,-27.571994075286906,-17.136126648185797
2008-06-11T09:30:00-04:00,18.811028,18.843511,18.129057,18.194007,214704856,125986716.65,27.319908282798608,35.97477539766065,NaN,NaN,-171.35751448701248,-143.8625174070732,-0.18189567114945587,-0.6501054099894255,-0.4682097388399696,-2753526112,-2589594409.2,10.216930323318977,21.975427918858088,NaN,NaN,-30.59799825781245,-19.05925116384675
2008-06-12T09:30:00-04:00,18.340143,18.819138,18.250838,18.689247,245347161,134246345.4,35.05522413004471,35.678517808164194,NaN,NaN,-133.7832909850286,-155.24537986906589,-0.1523439494690343,-0.6586396756762625,-0.5062957262072282,-2508178951,-2620570887.6,9.76505039041713,20.13756289425063,NaN,NaN,-30.606651664409952,-20.70887980678435
2008-06-13T09:30:00-04:00,18.794782,18.981521,18.413203,18.981521,157523840,137614854.2,39.169941150973,35.86999442222005,NaN,NaN,-101.59071421051101,-147.9062514001339,-0.10256733589699474,-0.6345048960784716,-0.5319375601814769,-2350655111,-2581495894.8,14.879382613424582,18.965894109940894,NaN,NaN,-29.256954451725804,-21.93003332749027
2008-06-16T09:30:00-04:00,18.802909,19.281912,18.681121,19.16014,152812484,142025496.3,41.604914451224126,36.11960962127926,NaN,NaN,-67.50614157917998,-126.85240225595604,-0.049742949119404356,-0.5941162465807324,-0.544373297461328,-2197842627,-2469804811.4,27.524172539895204,18.8257248974449,NaN,NaN,-27.38898195415585,-22.70988313129964
2008-06-17T09:30:00-04:00,19.354981,19.363108,18.526882,18.599942,151222180,145297826.1,36.649875686123195,36.09355071228394,NaN,NaN,-78.5873290089107,-110.56499805412855,-0.0448136194705645,-0.6003903217995337,-0.5555767023289692,-2349064807,-2431853521.6,31.260753046516854,19.10596370708544,NaN,NaN,-27.35688293858712,-23.373740246626422
2008-06-18T09:30:00-04:00,18.260499,18.754205,18.080345,18.291431,185532166,149711887.45,34.23192453853473,35.495844132726454,NaN,NaN,-112.12827768363337,-98.71915069345273,-0.053998171697186126,-0.6230744169504518,-0.5690762452532657,-2534596973,-2388067693.8,35.39896154724265,19.61214360226239,NaN,NaN,-28.10801289669742,-24.05006491092228
2008-06-19T09:30:00-04:00,18.332025,18.526882,17.92609,18.48628,205246830,153298660.7,37.05640622252439,35.29749548488898,NaN,NaN,-106.07499886217337,-93.17749226888168,-0.03930123023227872,-0.6182027830436141,-0.5789015528113354,-2329350143,-2352301932.2,38.64800048242986,20.453830734880786,NaN,NaN,-27.833348749613418,-24.5905340307353
2008-06-20T09:30:00-04:00,18.023514,18.267075,17.04927,18.007268,222641023,160341857.25,33.27326977079724,35.04177911045229,NaN,NaN,-144.2916989880347,-101.71768922438643,-0.053320928444386406,-0.6455527133668184,-0.592231784922432,-2551991166,-2392569143.2,36.426715951818714,21.248657913294235,NaN,NaN,-28.80218967963598,-25.192199123435397
2008-06-23T09:30:00-04:00,17.909852,17.942335,17.317187,17.438968,150613176,163418019.65,29.433958478084847,34.556897176033104,NaN,NaN,-146.5867130214553,-117.5338035128415,-0.09018134671087019,-0.7049584683110197,-0.6147771216001495,-2702604342,-2493521486.2,31.533456183546832,21.95173229839775,NaN,NaN,-30.917040286137627,-26.010033575250002
2008-06-24T09:30:00-04:00,17.398366,17.836784,17.162932,17.641935,249891987,171726777.45,32.43261958413969,34.372667671763125,NaN,NaN,-134.32505582434425,-128.6813488759282,-0.08999960212404623,-0.7272766242552073,-0.6372770221311611,-2452712355,-2514250995.8,30.62376467697888,22.81019746657569,NaN,NaN,-31.663815407167302,-26.81771669409533
2008-06-25T09:30:00-04:00,17.747478,18.234608,17.593223,17.601333,270737472,178306733.35,32.13840605328511,33.6880425056292,NaN,NaN,-101.43802672843039,-126.5432986848876,-0.08194895209839559,-0.7397132122541556,-0.6577642601557601,-2723449827,-2552021566.6,28.98311152366277,23.712263301858375,NaN,NaN,-32.34592644448268,-27.607460944150667
2008-06-26T09:30:00-04:00,17.236,17.390255,16.895015,16.968075,178041982,182371828.5,27.88897227294416,33.393822683944585,NaN,NaN,-156.98360042782042,-136.725018998017,-0.10702339609625411,-0.7915435052760778,-0.6845201091798236,-2901491809,-2666449899.8,24.67083371064443,24.47664808393853,NaN,NaN,-34.31418581433078,-28.565564497033538
2008-06-27T09:30:00-04:00,16.935608,17.097982,16.521563,16.700174,179677554,187402086.05,26.304395136636842,33.118383421282125,NaN,NaN,-163.98375406353335,-140.66343001311674,-0.12798540533267277,-0.8445018658456647,-0.7165164605129919,-3081169363,-2772285539.2,21.486551874030283,25.173994523702447,NaN,NaN,-36.44004082163345,-29.690489686262097
2008-06-30T09:30:00-04:00,16.716403,16.748878,16.286112,16.448478,180641058,191197875.05,24.874444865973373,32.67387575886313,NaN,NaN,-165.04287608344117,-144.3546626255139,-0.14394508709976583,-0.8964478193876992,-0.7525027322879334,-3261810421,-2884126755,18.734677963550254,25.725168773391243,NaN,NaN,-38.64751602240423,-30.970064877139546
2008-07-01T09:30:00-04:00,16.180561,16.570267,15.888304,16.497207,292237368,198230216.7,25.716385577930666,32.55933842280113,NaN,NaN,-152.7773467015784,-148.04512080096075,-0.13643227240689537,-0.9230430727965526,-0.7866108003896572,-2969573053,-2987498894.6,16.616390898687143,26.182273100203254,NaN,NaN,-40.183011952998044,-32.28620017369076
2008-07-02T09:30:00-04:00,16.586496,16.830065,16.2374,16.245511,180507342,198797548.9,24.207300661023908,31.784486746442504,NaN,NaN,-125.25182741451258,-152.8078809381772,-0.13346265073747854,-0.9534391138115055,-0.8199764630740269,-3150080395,-3072825008.2,15.098833517249048,26.563257609262678,NaN,NaN,-41.93171423958929,-33.6641307545334
2008-07-03T09:30:00-04:00,16.440367,16.545911,16.066899,16.188688,102758067,197030740.95,23.86679032758275,30.691404544771775,NaN,NaN,-125.0695620925404,-146.4250732711212,-0.12075575893497947,-0.9709211617427513,-0.8501654028077719,-3252838462,-3143094338.8,13.96748799428029,26.498122279323802,NaN,NaN,-43.46693339876824,-35.06453113228124
2008-07-07T09:30:00-04:00,16.351062,16.521563,15.49048,15.652854,235131476,199150638.95,20.883605244361192,29.211311029995848,NaN,NaN,-136.23714685035446,-140.87575182848542,-0.1329059872827314,-1.016297886911186,-0.8833918996284547,-3487969938,-3224454453.8,12.774022257498686,25.444540116295478,NaN,NaN,-45.761199910249545,-36.592626671991
2008-07-08T09:30:00-04:00,15.774626,16.675802,15.571658,16.667691,306120122,203943246.6,36.95600175963206,29.233177178103627,NaN,NaN,-93.66030294355475,-126.59923720050816,-0.060736121731996384,-0.9593120517934501,-0.8985759300614538,-3181849816,-3208462332.8,14.323665486950162,24.234748147755,NaN,NaN,-42.518018239904556,-37.43911118169294
2008-07-09T09:30:00-04:00,16.667691,16.748878,15.693447,15.717803,277525810,206945697.7,30.674632682908936,28.979084902701782,NaN,NaN,-99.18390896781465,-115.88054965375538,-0.06474504812166304,-0.9795072402135325,-0.9147621920918695,-3459375626,-3306422847.4,12.821076992102363,22.622042108102118,NaN,NaN,-41.882268296136004,-38.07384791232766
2008-07-10T09:30:00-04:00,15.571658,15.945127,15.384522,15.604141,287463125,210583611.15,30.017176598191725,28.47628278667802,NaN,NaN,-113.62190744793291,-113.55456566043947,-0.06277765412050773,-0.9932342597425041,-0.9304566056219964,-3746838751,-3425774518.6,11.269878879093454,20.66646199357809,NaN,NaN,-41.61924989650148,-38.58033391006678
2008-07-11T09:30:00-04:00,15.165723,15.660964,14.849094,15.165723,383965629,217514534.55,27.563177357200217,28.06841904284966,NaN,NaN,-127.99588946546079,-114.13983113502354,-0.07774963858186801,-1.0276436538493314,-0.9498940152674634,-4130804380,-3601367702.2,9.457030855788219,18.740055915290196,NaN,NaN,-42.22753189594099,-39.101362193763094
2008-07-14T09:30:00-04:00,15.587904,15.75027,14.386336,14.386336,291442679,224210476.5,23.832975642974645,27.66834884034179,NaN,NaN,-139.571460049675,-114.80669377488763,-0.12413667898852687,-1.105064864003122,-0.9809281850145951,-4422247059,-3788223126.4,7.985048950016207,17.058026827180868,NaN,NaN,-44.06967920087458,-39.81112176620759
2008-07-15T09:30:00-04:00,14.256437,14.792271,13.61506,13.939808,577858031,245462753.85,21.996298329136025,26.922897322127238,NaN,NaN,-172.47075171579067,-130.5687835293348,-0.1662571661794936,-1.188749642738962,-1.0224924765594685,-5000105090,-4151874181.2,6.020905162900817,15.300679719032436,NaN,NaN,-46.201619192007676,-40.724049969893315
2008-07-16T09:30:00-04:00,14.410692,15.766515,14.207725,15.766515,448283316,260315810.65,41.76722272130458,27.61066994127149,NaN,NaN,-90.99071968078239,-128.9301456719284,-0.058043954211743465,-1.095047419324148,-1.0370034651124045,-4551821774,-4370363410.8,5.194210546241493,13.601472506359485,NaN,NaN,-40.21780979986078,-40.65172994560295
2008-07-17T09:30:00-04:00,16.407901,16.959964,15.839576,16.448478,650002941,283539349.4,47.15255338282964,28.986640020549025,NaN,NaN,0.8076609372608323,-106.04423199488963,0.06580019871919829,-0.9547532167134065,-1.0205534154326048,-3901818833,-4401359427.2,5.087490148227715,12.20266225190115,NaN,NaN,-33.438257902853394,-39.62123393949587
2008-07-18T09:30:00-04:00,16.943727,17.122338,16.399774,16.781353,317010812,289127548.5,49.60251233744819,30.650791249178408,NaN,NaN,39.63864648578491,-72.51732480464048,0.17052145489514703,-0.807401596813671,-0.977923051708818,-3584808021,-4292160155.4,11.951067392978317,11.521556217540297,NaN,NaN,-27.402209696024844,-37.87565904757144
2008-07-21T09:30:00-04:00,17.203525,17.438968,16.732641,16.846303,260980817,291044538.2,50.08871375544627,32.45181045556932,NaN,NaN,67.74789453104815,-31.053453888495834,0.24028018809773122,-0.6775728165866539,-0.9178530046843851,-3323827204,-4072476184.4,23.87733056802064,11.888888546431039,NaN,NaN,-22.68983321011794,-35.70625535650665
2008-07-22T09:30:00-04:00,16.391655,18.258964,16.156205,18.258964,408097493,303918754.05,59.28833040730986,34.8498065148107,NaN,NaN,120.11277893389587,27.463252241441477,0.369928341540921,-0.4554425777582338,-0.8253709192991548,-2915729711,-3655601108.6,40.38030677391575,13.58631110894737,NaN,NaN,-14.978448438544008,-32.74514008251199
2008-07-23T09:30:00-04:00,17.828673,18.746078,17.747478,18.234608,439011289,313374719.15,59.08611738755805,37.34115056670599,NaN,NaN,174.14833655127347,80.49106348785264,0.4377674435776906,-0.2781616148270416,-0.7159290584047322,-3354741000,-3416184953.8,47.42925899960835,15.89562721483018,NaN,NaN,-9.281054153245107,-29.393127806902434
2008-07-24T09:30:00-04:00,18.356381,18.356381,16.959964,17.008676,335577981,316616744.6,49.86684071866107,39.19829702321159,NaN,NaN,105.55392717115978,101.44031673463243,0.3856300580311224,-0.2338914858658292,-0.6195215438969516,-3690318981,-3373884983.4,48.58587338164704,18.368369028213518,NaN,NaN,-7.562808746013884,-26.27451079820407
2008-07-25T09:30:00-04:00,17.073626,17.398366,16.627098,16.943727,241549371,319792114.05,49.426828325152265,41.23709867183952,NaN,NaN,64.32605063467247,106.37779756440996,0.3342391561862601,-0.20172259866412645,-0.5359617548503866,-3931868352,-3443297049.6,46.76755976170727,20.796478849942705,NaN,NaN,-6.404922049353468,-23.435998119796842
2008-07-28T09:30:00-04:00,16.86254,17.211644,16.075026,16.148094,209350245,321275748.6,44.273137544629975,41.7597512279108,NaN,NaN,18.18888276229408,96.46599521065913,0.23861778734245398,-0.23768952067231908,-0.47630730801477306,-4141218597,-3606775328.2,42.713128625785615,22.824297645573807,NaN,NaN,-7.171125934505768,-21.112444950469545
2008-07-29T09:30:00-04:00,16.261756,17.455205,16.034432,17.455205,307886967,327638044.05,52.952309432878266,43.3510138529086,NaN,NaN,61.947425265006956,84.83292447688135,0.2539346003137027,-0.1588890576226447,-0.4128236579363474,-3833331630,-3790295712,38.6611349923356,24.670016074161897,NaN,NaN,-4.7426995518911115,-18.77390989352977
2008-07-30T09:30:00-04:00,17.755597,17.958564,17.106109,17.723122,334657873,329759069.3,54.51597917584333,45.10092832274086,NaN,NaN,104.49000035387996,70.90125723740265,0.27108468211797343,-0.07396780528888058,-0.345052487406854,-3498673757,-3819082263.4,38.051362819842964,26.58297921278686,NaN,NaN,-2.3305339582637554,-16.424856188491766
2008-07-31T09:30:00-04:00,17.37401,17.86114,17.30095,17.560748,208579107,331162657.55,53.35850508736307,46.94345173203821,NaN,NaN,91.57147285412286,68.10476637399526,0.2604067624760124,-0.019544034311838487,-0.2799507967878509,-3707252864,-3822469040,37.97547400008654,28.620010865951027,NaN,NaN,-0.8056800575852883,-14.193545312647984
2008-08-01T09:30:00-04:00,17.568867,17.715012,17.081737,17.560748,233233616,337686435,53.35850508736307,49.05241812092309,NaN,NaN,73.6775725172311,69.97507075050699,0.24261535449575694,0.023318396331845292,-0.21929695816391165,-3707252864,-3777545942.4,39.69353770433552,30.884902919830978,NaN,NaN,0.39655346586077395,-12.109245487146733
2008-08-04T09:30:00-04:00,17.398366,17.666283,17.081737,17.414612,173799076,334619815,52.20164264220494,51.20994271471373,NaN,NaN,62.43851252068623,78.82499670218542,0.21141897725286962,0.04497676340217538,-0.16644221385069424,-3881051940,-3725512611,41.70765140314068,33.433956222705255,NaN,NaN,1.052501358720582,-10.228995937737118
2008-08-05T09:30:00-04:00,17.690639,18.299542,17.560748,18.299542,222974200,330462518.9,58.122626661682915,52.37818585331218,NaN,NaN,101.3394292124651,86.70339749167704,0.23877434736521702,0.13202572035582705,-0.10674862700938997,-3658077740,-3690461833,43.08656062345067,36.14055265679163,NaN,NaN,3.4363253472684554,-8.276807182736322
2008-08-06T09:30:00-04:00,18.007268,18.242719,17.788072,18.11282,174849648,325328710.8,56.53136483906844,53.04810095732925,NaN,NaN,92.74218223715265,84.35383386833158,0.23246026257782987,0.18382670121289735,-0.04863356136493251,-3832927388,-3757312559.2,41.090127522537365,38.71216961209946,NaN,NaN,4.927713701231909,-6.390447056455146
2008-08-07T09:30:00-04:00,17.747478,17.92609,17.057381,17.219771,232777484,322594428.75,49.54486657713261,53.04398340302099,NaN,NaN,42.43194800820391,74.52592889914779,0.15976784751147657,0.15107624802441322,-0.008691599487063356,-4065704872,-3829002960.8,39.00299302487729,40.64445001437796,NaN,NaN,4.113951765341633,-4.889818653341321
2008-08-08T09:30:00-04:00,17.097982,17.966683,17.074998,17.812428,217546060,314273450.3,53.63963845472447,53.29762088154086,NaN,NaN,55.46946787839653,70.88430797138088,0.14373158030221733,0.1709728758907083,0.027241295588490977,-3848158812,-3857184150.4,38.18197197150975,41.66621011462718,NaN,NaN,4.6833654741391655,-3.5222209208441084
2008-08-11T09:30:00-04:00,17.755597,18.478153,17.617579,18.11282,198756411,309639136.9,55.606237980321396,53.03461427961311,NaN,NaN,90.53162924371652,76.50293131598694,0.14506767372250068,0.20857588774161684,0.06350821401911616,-3649402401,-3810854242.6,40.4030666371655,41.66783581914502,NaN,NaN,5.744887142357891,-2.19834834038668
2008-08-12T09:30:00-04:00,17.853029,17.869251,17.04927,17.195398,235496993,292521085,48.797974110053545,52.29974690264851,NaN,NaN,11.26198521944522,58.487442517382966,0.07917370298491141,0.16247534275025544,0.08330163976534402,-3884899394,-3856218573.4,38.92819591206084,41.06061702717734,NaN,NaN,4.523878975928527,-1.2380301523416504
2008-08-13T09:30:00-04:00,16.992431,17.033033,16.432257,16.700174,282309433,284222390.85,45.55553915224908,51.99179679076194,NaN,NaN,-102.3170853855152,19.475588992849396,0.001358738470836826,0.08500006285389006,0.08364132438305323,-4167208827,-3923074861.2,36.79634541111873,40.218507886425314,NaN,NaN,2.476567549011185,-0.7073733378626739
2008-08-14T09:30:00-04:00,16.610868,17.260348,16.545911,17.219771,159928087,259718648.15,49.35771670659625,51.986860246579354,NaN,NaN,-66.91968705564886,-2.3947380199211623,-0.0150884763980694,0.06478072888546649,0.07986920528353589,-4007280740,-3911390034.8,37.4411761514158,39.552337628547356,NaN,NaN,1.9359111498256267,-0.3297612681929166
2008-08-15T09:30:00-04:00,17.276594,17.568867,17.122338,17.341543,164805715,252108393.3,50.23485774294558,52.4126974036019,NaN,NaN,-13.968937917576051,-16.282419179115678,-0.017563256917562928,0.057915134136582225,0.07547839105414515,-3842475025,-3910253277.4,37.507973367087075,39.1805408243546,NaN,NaN,1.7598443540608866,-0.031246179299516175
2008-08-18T09:30:00-04:00,17.276594,17.276594,16.602741,16.675802,199203084,249019506.65,45.586156107627,51.886543594655386,NaN,NaN,-104.48451359817854,-55.28564774749469,-0.06136786386451062,-0.0012314387764931212,0.060136425088017496,-4041678109,-3988708419,34.75015985216352,38.90118545719945,NaN,NaN,0.18575130377924953,-0.0002465388596925022
2008-08-19T09:30:00-04:00,16.440367,16.505317,16.010076,16.188688,214482614,239338762.7,42.48800346518064,51.0274024724652,NaN,NaN,-178.66294233170757,-93.27063325772525,-0.11724146783460535,-0.0864154097052392,0.030826058129366153,-4256160723,-4062960684.8,32.32753135412638,38.492340352505416,NaN,NaN,-2.097954758251081,-0.29991914162989086
2008-08-20T09:30:00-04:00,16.213044,16.521563,15.920771,16.521563,210654572,227920926.85,45.22748136187573,50.44661506350182,NaN,NaN,-140.6084928414861,-100.92891474891942,-0.12515369931972675,-0.1256160660202923,-0.0004623667005655349,-4045506151,-4038620149.6,33.95303510469917,38.20502328854917,NaN,NaN,-3.1930994419701944,-0.713230613107077
2008-08-21T09:30:00-04:00,16.123738,16.407901,16.05067,16.221163,162569908,219270523.2,43.22641272909312,49.72289418076825,NaN,NaN,-131.56516142927515,-113.85800962364469,-0.1427187799060577,-0.17886084158313764,-0.03614206167707996,-4208076059,-4078779213.4,32.563267840481615,37.695718298273896,NaN,NaN,-4.6971349942483185,-1.2823598104129688
2008-08-22T09:30:00-04:00,16.610868,16.903142,16.440367,16.838192,181546306,216270369.95,48.287517195113544,49.443313791690294,NaN,NaN,-59.38462317482183,-122.94114667509385,-0.10653982828598552,-0.16931684703456185,-0.06277701874857633,-4026529753,-4115590159,31.298628018557977,36.952216627946555,NaN,NaN,-4.507780196758834,-1.7431341513195209
2008-08-25T09:30:00-04:00,16.610779,16.618979,16.2374,16.245511,118762324,211740973.9,44.21065504233766,48.44960153316563,NaN,NaN,-105.2737650595076,-123.09899696735965,-0.11552975917808528,-0.20718921772118293,-0.09165945854309765,-4145292077,-4136312952.6,30.578659793343377,36.05879514008175,NaN,NaN,-5.581982918603003,-2.291541118074304
2008-08-26T09:30:00-04:00,16.261756,16.505317,16.083226,16.375418,130538534,202873552.25,45.30076088812236,47.647415536669484,NaN,NaN,-99.82703508350384,-107.33181551771891,-0.10598220977650855,-0.22413722076373332,-0.11815501098722478,-4014753543,-4088031516.6,34.366817517241685,35.57855871113206,NaN,NaN,-6.1421135328717495,-2.8416228916167965
2008-08-27T09:30:00-04:00,16.383528,16.716403,16.253637,16.692047,109439097,191612613.45,47.96933694954334,47.534877706127396,NaN,NaN,-64.17078627446244,-92.04427420431418,-0.07315850845629826,-0.2096031465575976,-0.13644463810129934,-3905314446,-4059993175.6,36.5327338151128,35.402111624720305,NaN,NaN,-5.851634823488237,-3.2716245961698593
2008-08-28T09:30:00-04:00,16.870659,17.414612,16.805709,17.365899,190764846,190721900.4,53.20201451749055,47.503618853467835,NaN,NaN,16.548204737848913,-62.42160097088936,-0.004502558348135843,-0.14207283603646914,-0.1375702776883333,-3714549600,-3961287883.8,43.59015330202691,35.78841029118582,NaN,NaN,-4.031241737778294,-3.38014133068535
2008-08-29T09:30:00-04:00,17.187288,17.487672,17.138576,17.390255,171604439,187640441.55,53.384496973134645,47.3449230672402,NaN,NaN,35.675791714937134,-43.40951799293756,0.041574237623388216,-0.08560248065909803,-0.12717671828248625,-3542945161,-3864570965.4,49.51412195308611,36.43919995660872,NaN,NaN,-2.5038190830159417,-3.2549524381611485
2008-09-02T09:30:00-04:00,17.828673,17.958564,17.317187,17.633816,200302472,188965611.35,55.26314688438217,47.8067211225494,NaN,NaN,70.25553773499217,-8.303657434037603,0.08497783032985204,-0.020954430370171195,-0.10593226070002323,-3342642689,-3704041087.8,57.49322533808336,37.7652734870389,NaN,NaN,-0.6816265377142917,-2.887334452383026
2008-09-03T09:30:00-04:00,17.552629,17.92609,17.37401,17.909852,178582383,186746020.5,57.360493968002984,48.64993218081754,NaN,NaN,87.22060505147513,29.105870592958194,0.12630941993552988,0.051954514219389125,-0.07435490571614076,-3164060306,-3533902440.4,63.98925588704083,39.707624235319045,NaN,NaN,1.4643909902458008,-2.2656593891503367
2008-09-04T09:30:00-04:00,17.650062,17.804301,17.024914,17.033033,226400463,189323561.25,49.43276666932026,48.655292892440684,NaN,NaN,37.35125558820117,49.41027896549092,0.09031525037634577,0.03853915725429147,-0.051776093122054306,-3390460769,-3430931705,67.25122939048538,41.83691375239544,NaN,NaN,1.109474209568183,-1.7834974464762625
2008-09-05T09:30:00-04:00,16.773234,17.650062,16.748878,17.650062,294183255,192393849.8,54.22706333192501,48.94045043451064,NaN,NaN,46.54195382860657,55.409028783642455,0.10286970960154915,0.07681104387988213,-0.026058665721667016,-3096277514,-3307277287.8,70.68533589114311,44.20672536125658,NaN,NaN,2.2648256772605815,-1.2051655716567136
2008-09-08T09:30:00-04:00,19.054589,19.078945,17.739368,18.413203,518553955,207444244.55,59.35923819543842,49.92424201221146,NaN,NaN,173.85416044327778,83.04470252931057,0.15428544892686202,0.16679814543691052,0.01251269651004849,-2577723559,-3114232967.4,75.07890925095069,47.08735031831281,NaN,NaN,4.920638522152298,-0.3300507011125692
2008-09-09T09:30:00-04:00,18.039751,18.429449,17.179169,17.236,408079835,217910415.75,50.038899850542336,50.46359175402301,NaN,NaN,78.23422224608821,84.64043943152978,0.10318351890544646,0.14149209514185657,0.03830857623641011,-2985803394,-3042865108.4,76.48223754723193,50.24125790353464,NaN,NaN,4.133273196769303,0.30756699858484104
2008-09-10T09:30:00-04:00,17.357781,17.779945,16.756997,17.024914,310325781,221651855.15,48.56634482525087,50.70208200140694,NaN,NaN,22.59118079819646,71.71455458087405,0.051924501251520136,0.10321420280081028,0.05128970154929015,-3296129175,-3069278882.2,74.80333432818202,53.1591364194977,NaN,NaN,3.0311624532157055,0.6966520635321074
2008-09-11T09:30:00-04:00,16.480961,17.463316,16.375418,17.414612,411814817,228127124.35,51.40930218188865,51.286574105178055,NaN,NaN,6.252054566346935,65.4947143765032,0.041476391417188715,0.10313519082077605,0.06165879940358733,-2884314358,-2968049600,76.89649839386499,56.32579574473937,NaN,NaN,3.0255263834009543,1.0293483949419426
2008-09-12T09:30:00-04:00,16.976202,17.471442,16.870659,17.171042,314137741,235837607.05,49.565219894594414,51.377838583712396,NaN,NaN,17.15305439928133,59.61693449063815,0.01664725773137618,0.08246787156780755,0.06582061383643137,-3198452099,-2988484517,75.53240250569418,59.4853510652491,NaN,NaN,2.454892854732798,1.2329976034834933
2008-09-15T09:30:00-04:00,16.026322,16.838192,15.498598,15.498598,556131755,255403909.05,39.17433200299653,51.01810122375946,NaN,NaN,-131.0810436220331,-1.37010632242403,-0.10711938191937406,-0.06807861356278622,0.039040768356587846,-3754583854,-3223856576,61.909687797034806,61.723281636941344,NaN,NaN,-1.7528905620425603,0.8064421512654857
2008-09-16T09:30:00-04:00,14.767915,16.659572,14.61366,16.659572,594778494,275182679.55,47.41550321151764,51.16915424685912,NaN,NaN,-111.2350678968921,-39.26396435102009,-0.10534381768743424,-0.09263900375270495,0.012704813934729286,-3159805360,-3258656969.2,60.18143669715602,63.567183006935224,NaN,NaN,-2.3780275730090663,0.35151790494054974
2008-09-17T09:30:00-04:00,15.831465,15.969483,14.702966,15.060188,625705534,295743825.55,39.47970091056632,50.56275167264647,NaN,NaN,-174.1919138497988,-78.62058328061914,-0.20089340922052695,-0.23841194759092943,-0.03751853837040246,-3785510894,-3356533313,55.48964776678023,64.92124828919718,NaN,NaN,-5.99455547201808,-0.5550640060535401
2008-09-18T09:30:00-04:00,15.287512,16.618979,13.931689,16.245511,1051210346,337771614.25,46.61132243902751,50.09198795275626,NaN,NaN,-124.81669899502438,-104.8343339928934,-0.1742642835363032,-0.25534889279078143,-0.08108460925447826,-2734300548,-3326530551,56.60643246277959,65.85098251496522,NaN,NaN,-6.1684753128872885,-1.3569799070297899
2008-09-19T09:30:00-04:00,19.647254,19.890815,17.024914,18.169651,523146296,355800433.65,55.73086226923884,50.259585473906554,NaN,NaN,135.7075482332855,-81.12343522609257,-0.02490508918527351,-0.11221597073607015,-0.08731088155079664,-2211154252,-3129070981.6,63.15810285812893,66.82555257961114,NaN,NaN,-2.5910157475786004,-1.5332707413939057
2008-09-22T09:30:00-04:00,18.055997,18.072218,15.790871,16.683929,231924914,358319364.05,48.79941468315395,49.797890316675975,NaN,NaN,-10.980366129297023,-57.103299727545355,-0.02400338428727386,-0.11731511190988897,-0.09331172762261511,-2443079166,-2866770044,69.70213038115585,67.6976172255449,NaN,NaN,-2.5548009652465677,-1.6792036305157145
2008-09-23T09:30:00-04:00,16.675802,17.016803,16.2374,16.635224,213992703,363080883,48.58608036602964,49.17114648796359,NaN,NaN,-34.43260470321558,-41.74280708881005,-0.024437450165226943,-0.12385854032914878,-0.09942109016392184,-2657071869,-2766223345.8,71.77196849152817,68.25352526872256,NaN,NaN,-2.606769022593034,-1.8117129722410459
2008-09-24T09:30:00-04:00,16.789463,16.805709,16.196806,16.448478,168378641,364972888.35,47.72458934936097,49.049133822252216,NaN,NaN,-50.57053155198657,-17.018530629247614,-0.03443975307572507,-0.14247078150857817,-0.1080310284328531,-2825450510,-2574211269,75.24937787101076,68.82482158876009,NaN,NaN,-2.9383550599629347,-1.9726618419156015
2008-09-25T09:30:00-04:00,16.537792,17.033033,16.391655,16.903142,196942328,369348049.9,50.046925362313864,48.75055253870857,NaN,NaN,-22.53997180611965,3.4368148085333337,-0.008903121431084904,-0.11915993022170923,-0.11025680879062433,-2628508182,-2553052795.8,75.60599224913358,69.17629704290228,NaN,NaN,-2.4481345258498926,-2.0405865110490717
2008-09-26T09:30:00-04:00,16.115628,17.365899,16.010076,17.365899,253035742,372461594.7,52.36639232516963,48.25106354797508,NaN,NaN,-6.863549186580576,-25.077404675439887,0.03810672182897927,-0.06262340650440024,-0.1007301283333795,-2375472440,-2585916433.4,73.82672044575297,69.08685498538814,NaN,NaN,-1.317656382708416,-1.937310778428978
2008-09-29T09:30:00-04:00,16.683929,16.789463,14.930289,15.076434,422682685,385015507,41.98058717567011,47.675469785484204,NaN,NaN,-124.44382892913676,-47.770097235407825,-0.07961600681424731,-0.20025013685118864,-0.12063413003694133,-2798155125,-2656931625.2,69.99349741631455,68.62337354746548,NaN,NaN,-3.922546367591876,-2.220915862595106
2008-09-30T09:30:00-04:00,15.344335,16.359172,15.157613,16.148094,212883993,385644583.05,47.25392240082642,47.58172532659675,NaN,NaN,-86.0340875413697,-58.09039380303865,-0.0797380938797991,-0.2203067473866902,-0.1405686535068911,-2585271132,-2642571477.8,70.32898406841836,68.3037771003395,NaN,NaN,-4.206142868942854,-2.5045197206447845
2008-10-01T09:30:00-04:00,16.123738,16.781353,15.904533,16.781353,236263894,388528658.6,50.13789853658216,47.49091078050343,NaN,NaN,-24.78229114383062,-52.93274572140746,-0.03393996549179848,-0.1829936103716392,-0.1490536448798407,-2349007238,-2547282823.4,72.52419975193082,67.99147005448705,NaN,NaN,-3.4544930335711044,-2.640230193919973
2008-10-02T09:30:00-04:00,16.635224,16.805709,15.904533,15.945127,213750201,387896145.5,46.52068171056856,47.27344376735872,NaN,NaN,-46.03991975925509,-57.63273531203455,-0.05546249291622998,-0.21838176102512818,-0.1629192681088982,-2562757439,-2534132674.8,72.82302687563578,67.7979432237686,NaN,NaN,-4.042849738745575,-2.8406044146093445
2008-10-03T09:30:00-04:00,16.391655,16.765107,15.246919,15.246919,322943091,389334137.3,43.68666047566563,47.59575294397795,NaN,NaN,-82.77139480563794,-72.81430443584603,-0.10911766016912952,-0.2993163433203101,-0.19019868315118058,-2885700530,-2636178292.8,66.75558463074857,68.14407871189101,NaN,NaN,-5.447253858734535,-3.2129829066272286
2008-10-06T09:30:00-04:00,14.629897,15.027706,13.98852,14.451286,420625213,384437700.2,40.64782627110278,47.112347448234026,NaN,NaN,-183.02557960468442,-84.53065457095555,-0.18606898570315028,-0.4227849152801184,-0.23671592957696813,-3306325743,-2737812416.4,61.27936276549459,68.22250200248662,NaN,NaN,-7.5929046790417996,-3.8386860169721673
2008-10-07T09:30:00-04:00,14.702966,14.735432,12.92497,12.92497,436758003,385871608.6,35.54045432765392,46.83097269231171,NaN,NaN,-227.35547388195857,-112.79493183907331,-0.31979436948064577,-0.6364588914277753,-0.3166645219471296,-3743083746,-2969374939.2,51.011600783103425,67.90264150365256,NaN,NaN,-11.193097439615975,-4.889316220206997
2008-10-08T09:30:00-04:00,12.389136,13.533873,12.251118,12.405374,486547570,394682698.05,33.97539535960348,45.928406472352854,NaN,NaN,-238.2534653005594,-155.48916667041908,-0.41711913290621305,-0.8380634380798959,-0.42094430517368286,-4229631316,-3345499754.8,39.44919727427292,66.67712470447351,NaN,NaN,-14.593009189055778,-6.275558072899679
2008-10-09T09:30:00-04:00,13.05487,13.127938,11.106382,11.1145,486292790,398406596.7,30.394397901591518,44.1186590175209,NaN,NaN,-237.0208017481153,-193.68534306819112,-0.5347972290076224,-1.0894408414332108,-0.5546436124255885,-4715924106,-3776133088.2,30.832385044070136,64.36814486061216,NaN,NaN,-18.70272368747708,-8.050867446410736
2008-10-10T09:30:00-04:00,10.724803,12.259237,10.383817,12.259237,648940938,415146756.55,36.75997891435322,43.25869931974942,NaN,NaN,-191.5987399094214,-215.4508120889478,-0.5024096044173316,-1.182655617947253,-0.6802460135299213,-4066983168,-4012389615.8,27.308173505722053,61.34000508379547,NaN,NaN,-20.053741378153518,-9.76556372237399
2008-10-13T09:30:00-04:00,12.973683,13.265956,12.064388,13.217244,275056745,401093006.05,41.57543050818433,42.75793861561761,NaN,NaN,-110.1573112589729,-200.8771584198055,-0.38843308540183674,-1.1657873702822172,-0.7773542848803805,-3791926423,-4109509751.8,25.992889448063963,58.07007086640517,NaN,NaN,-19.586556179238425,-11.168562644783195
2008-10-14T09:30:00-04:00,14.150886,14.508117,13.485071,14.069707,410940746,391901118.65,45.54867258517601,42.6025159896044,NaN,NaN,-50.99491358410448,-165.60504636023467,-0.23514331940064115,-1.0712834341311819,-0.8361401147305407,-3380985677,-4037090138,28.74871186676026,54.74859472324442,NaN,NaN,-17.907259422015944,-12.131233612959303
2008-10-15T09:30:00-04:00,13.460805,13.663772,12.543391,12.543391,256350696,373433376.75,40.26828027473882,41.904041340491894,NaN,NaN,-86.42078884332577,-135.23851106878797,-0.21652065397507925,-1.1067909321993898,-0.8902702782243106,-3637336373,-3918631149.4,33.13477226358103,51.71493615284781,NaN,NaN,-18.20905172104765,-12.99949334268621
2008-10-16T09:30:00-04:00,12.892496,13.05487,11.842748,12.827546,383437151,340044717,41.62506945206136,41.13680399241273,NaN,NaN,-88.02613340359282,-105.43957739988346,-0.16724742515147972,-1.0993295596636603,-0.9320821345121806,-3253899222,-3626226172.6,42.53775986319891,49.480010396951094,NaN,NaN,-18.017844503357367,-13.716400651353517
2008-10-17T09:30:00-04:00,12.559629,13.290312,12.445967,12.462204,292426127,328508708.55,40.35583267466314,41.020750099483664,NaN,NaN,-74.16575904985964,-81.95298122797112,-0.14241419154915014,-1.1100998739486183,-0.9676856823994682,-3546325349,-3522094608.8,45.47823656710848,47.72892033629351,NaN,NaN,-18.246278557756387,-14.363526066553927
2008-10-20T09:30:00-04:00,12.786952,13.079226,12.381017,13.079226,170837163,325454321,43.48983956841144,40.75188704002545,NaN,NaN,-63.304308730563775,-72.58238072228929,-0.07118450636198459,-1.0566663153519489,-0.9854818089899643,-3375488186,-3438806961.4,47.77997085849459,46.11827653558468,NaN,NaN,-17.50082930539871,-14.811712243531753
2008-10-21T09:30:00-04:00,12.689528,13.168531,12.673291,12.681409,163072590,322908315.35,41.95901771877521,40.16768126732495,NaN,NaN,-57.66003023263581,-73.91540405199557,-0.03921081221097222,-1.0344953242536796,-0.9952845120427074,-3538560776,-3470321981.2,46.97190795832705,44.293112836041544,NaN,NaN,-17.323893404677506,-15.170595266552574
2008-10-22T09:30:00-04:00,12.42973,12.567748,11.496079,11.885777,218997583,325439262.45,39.002105152419084,39.63064008459998,NaN,NaN,-85.75527164459555,-73.78230061224951,-0.05881638116698107,-1.0688049885014337,-1.0099886073344526,-3757558359,-3494366378.4,46.328146159096804,42.40062135628877,NaN,NaN,-18.03232847364465,-15.579414296137157
2008-10-23T09:30:00-04:00,11.934489,12.05627,11.041432,11.763996,248861970,328035244.55,38.55425017137018,39.264039348578876,NaN,NaN,-94.25975930843293,-75.02902579321754,-0.0665854256495424,-1.0932203893963806,-1.0266349637468382,-4006420329,-3644870599.8,42.410048628355874,40.661654498975004,NaN,NaN,-18.7379516874766,-16.030633923471363
2008-10-24T09:30:00-04:00,10.716684,11.609741,10.692328,11.000839,252372759,328002095.4,35.781403999702164,38.91643775776454,NaN,NaN,-112.11426514684538,-82.6187270126147,-0.10730765604903514,-1.160769533808132,-1.053461877759097,-4258793088,-3787364147.6,39.04331892719541,39.073365653382204,NaN,NaN,-20.14002016937193,-16.61768910145716
2008-10-27T09:30:00-04:00,11.17945,11.55291,10.659853,10.700447,183604665,316048194.4,34.72281448118339,38.85803491158807,NaN,NaN,-111.25675542245068,-92.20921635099208,-0.13677242131329947,-1.2244274044007213,-1.0876549830874218,-4442397753,-4000746061,34.6121785899543,37.90197835387155,NaN,NaN,-21.611312390018057,-17.33106385696586
2008-10-28T09:30:00-04:00,11.309349,12.478442,10.55431,12.381017,241880852,317498037.35,44.5980640600388,39.616796961619166,NaN,NaN,-67.56874486662353,-94.19095927778962,-0.030904534874821366,-1.1262856516809485,-1.0953811168061272,-4200516901,-4133137286,32.17246214395945,37.382211558849164,NaN,NaN,-20.01776963411205,-17.714878967986742
2008-10-29T09:30:00-04:00,12.096863,12.567748,11.61786,11.61786,214881692,316428927.25,41.52587841121242,40.41190271230637,NaN,NaN,-58.1523677673195,-88.6703785023344,-0.0016450441855284659,-1.0974374220380376,-1.0957923778525092,-4415398593,-4264705332.8,29.91570140500106,37.31673415605851,NaN,NaN,-19.58324397713112,-17.981788255007366
2008-10-30T09:30:00-04:00,12.17805,12.291712,11.772115,12.023795,197803904,315631612.4,43.74568226135078,40.9108815228062,NaN,NaN,-44.6202224569854,-78.7424711320449,0.05267642696485919,-1.0299468441464352,-1.0826232711112944,-4217594689,-4306940204.8,29.207429532481314,37.45239530082703,NaN,NaN,-18.568026256760657,-18.065536540972122
2008-10-31T09:30:00-04:00,11.861421,12.632697,11.861421,12.608341,173748033,308171859.5,46.87327922089817,41.289299288000045,NaN,NaN,-6.568501389806501,-57.633318380637114,0.13113711717707544,-0.9187018746399502,-1.0498389918170257,-4043846656,-4263950918.4,30.998180060823273,37.80991605888126,NaN,NaN,-16.789020260872014,-17.883177072386392
2008-11-03T09:30:00-05:00,12.575866,12.786952,12.523095,12.681409,82969716,291289084.65,47.26793900738437,41.412104032443494,NaN,NaN,33.78050267208152,-28.625866761730684,0.18767454414130325,-0.8152458116403967,-1.0029203557817,-3960876940,-4167646755.8,34.96690788959468,38.254072917655144,NaN,NaN,-15.223210304542484,-17.503181819837263
2008-11-04T09:30:00-05:00,12.916852,13.420211,12.860021,13.395855,138686991,276385534.05,51.09356692536477,42.1853387932025,NaN,NaN,97.328140366103,4.353510284814623,0.26801060641603647,-0.6679070977616544,-0.9359177041776908,-3822189949,-4091981365.4,37.984946523001476,38.60051393618517,NaN,NaN,-12.76357212719517,-16.826094720888392
2008-11-05T09:30:00-05:00,13.17665,13.265956,12.137456,12.169931,147639715,259440141.3,45.05357863103082,42.430232305986024,NaN,NaN,22.46686118944644,20.477356076167812,0.23461111238684862,-0.64265381369413,-0.8772649260809786,-3969829664,-4002867579.6,41.432262848505545,38.52154986370709,NaN,NaN,-12.319284145781246,-16.182264638730228
2008-11-06T09:30:00-05:00,12.023795,12.291712,11.325586,11.333705,201930732,245222038.4,41.453775365146775,42.50865678387772,NaN,NaN,-72.56314406693264,14.888771754178364,0.15601012152963933,-0.6822522741689294,-0.8382623956985688,-4171760396,-3993700721,41.79071943668788,38.25815578296276,NaN,NaN,-13.024837022992847,-15.731203550767745
2008-11-07T09:30:00-05:00,11.544791,11.715284,11.260637,11.544791,140418717,219795927.35,42.698395166423666,42.452125040878585,NaN,NaN,-86.54434209397886,-1.106396386656104,0.11967952848549246,-0.6886629850917032,-0.8083425135771957,-4031341679,-3991199725.6,41.8952076059191,37.83781555063593,NaN,NaN,-13.242155974308204,-15.37562532555924
2008-11-10T09:30:00-05:00,11.828946,11.934895,10.968364,11.203806,140247970,213055488.6,41.17561086792777,42.3961674086752,NaN,NaN,-90.52240471758843,-25.966977864590092,0.07624305626213412,-0.7130386932495281,-0.7892817495116622,-4171589649,-4033342267.4,40.57357518851568,37.38079178136369,NaN,NaN,-13.856915309036308,-15.15866675177025
2008-11-11T09:30:00-05:00,10.984682,11.171331,10.635497,10.814108,214957291,203256315.85,39.4442479804986,42.427749039252305,NaN,NaN,-133.65652752877887,-72.16391144356646,0.02734724507716335,-0.755097693165208,-0.7824449382423714,-4386546940,-4146213665.6,37.189681882756666,36.72804433305368,NaN,NaN,-14.864807225648072,-15.116686819467082
2008-11-12T09:30:00-05:00,10.627378,10.830346,10.124019,10.148375,233232532,202100407.65,36.612019233529736,42.289018257977986,NaN,NaN,-167.52468821174014,-110.16222132380378,-0.04008541352037964,-0.8325517051428459,-0.7924662916224663,-4619779472,-4276203627.2,33.70343496951702,36.10614335742233,NaN,NaN,-16.554505011802092,-15.322089418372084
2008-11-13T09:30:00-05:00,10.30263,10.976482,9.498879,10.887177,323162654,199086682.8,41.62168617446261,42.706181270460874,NaN,NaN,-137.92313795892056,-123.23422010220138,-0.02587617235084383,-0.8248115070610211,-0.7989353347101773,-4296616818,-4301174911.6,33.06224927529695,35.678924096572445,NaN,NaN,-16.594398746296054,-15.503847893789795
2008-11-14T09:30:00-05:00,10.651734,10.935889,10.197087,10.335105,235623240,196246538.45,39.132852985888356,43.02118402079695,NaN,NaN,-119.8399155292566,-129.89333478925693,-0.0435618279074651,-0.8533876195945087,-0.8098257916870436,-4532240058,-4401354587.4,30.551167295392304,35.388851861246586,NaN,NaN,-17.347196253323077,-15.767183373723121
2008-11-17T09:30:00-05:00,10.156494,10.245799,9.620659,9.67749,227350368,199072198.7,36.34493085671231,42.43167450627362,NaN,NaN,-159.36754329826206,-143.66236250539163,-0.0869476970116263,-0.9185104129515764,-0.8315627159399501,-4759590426,-4518954742.8,27.874757838521646,35.08187298228675,NaN,NaN,-18.814697600847342,-16.20254254902658
2008-11-18T09:30:00-05:00,9.718084,9.831746,9.141656,9.539472,266077475,204222442.95,35.76896830905466,42.020466641833785,NaN,NaN,-164.27597216212814,-149.7862514320615,-0.11080996506545426,-0.970075172271768,-0.8592652072063137,-5025667901,-4646778935,25.282194582896807,34.750908209279295,NaN,NaN,-20.18735837258255,-16.77180195239172
2008-11-19T09:30:00-05:00,9.482642,9.547591,8.475923,8.540872,255107108,206027919.2,31.83770070033509,41.16989653033267,NaN,NaN,-180.86574185946,-152.45446216160548,-0.17585209313262695,-1.0790803236220974,-0.9032282304894704,-5280775009,-4778978042.4,22.909043614786583,34.301023500872525,NaN,NaN,-22.592922997727207,-17.603390673153932
2008-11-20T09:30:00-05:00,8.394736,8.589585,7.501679,7.623459,493873117,218278476.55,28.715242106377687,39.87289387929549,NaN,NaN,-203.38132390617903,-165.5460993510572,-0.25771337667556593,-1.2253699513339278,-0.9676565746583619,-5774648126,-5074584304,18.68543553428688,33.42154174897707,NaN,NaN,-25.671867800931665,-18.756030262836465
2008-11-21T09:30:00-05:00,7.980682,7.996919,7.038913,7.858902,442703703,227795023.75,30.596473033069742,38.68207488113016,NaN,NaN,-179.11473856001174,-177.4010639572082,-0.27166531972317065,-1.307238224312325,-1.0355729045891544,-5331944423,-5234525177,16.872860909058133,32.12910982179589,NaN,NaN,-27.652479626082084,-20.02695160044298
2008-11-24T09:30:00-05:00,8.289193,9.409573,8.18365,9.052351,378394846,237534532.8,39.335847191259155,37.842237757265465,NaN,NaN,-96.4991528263412,-164.82738586282403,-0.18056473480260538,-1.261278823092411,-1.0807140882898056,-4953549577,-5273317007.2,16.455914550181035,30.591321823737285,NaN,NaN,-26.735879463512013,-20.9853698665957
2008-11-25T09:30:00-05:00,9.620659,9.758677,9.109181,9.580066,288732885,239877134.45,42.767637347429186,37.67895623700821,NaN,NaN,-59.6459707312795,-143.9013855766543,-0.0704689488042578,-1.168800274295128,-1.0983313254908702,-4664816692,-5201146765.4,20.3970658600649,29.08880775313438,NaN,NaN,-24.912672991521582,-21.54641317015654
2008-11-26T09:30:00-05:00,9.312149,10.067188,9.255318,10.026594,168472785,237556689.1,45.57329435096818,37.973207593138305,NaN,NaN,-40.158602382919284,-115.75995768134617,0.04074070652111361,-1.0474054423394783,-1.088146148860592,-4496343907,-5044260545,28.313934970807253,28.12618029128576,NaN,NaN,-22.541089302403805,-21.68850976047758
2008-11-28T09:30:00-05:00,10.042832,10.36758,9.92917,10.278274,67147262,231023857,47.14602815902655,38.29089566403851,NaN,NaN,-15.481745470146073,-78.18004199413956,0.1342911191933287,-0.9202822498689311,-1.0545733690622598,-4429196645,-4775170248.8,39.43927674851882,27.950756658614317,NaN,NaN,-20.12108056317944,-21.464591303720702
2008-12-01T09:30:00-05:00,9.880458,9.904814,8.548991,8.565229,205462707,232609590.7,38.90543928411622,38.128740550909114,NaN,NaN,-72.35635257261556,-56.828364796660324,0.08617875730081903,-0.9468499224362361,-1.0330286797370551,-4634659352,-4635713234.6,44.26675124816308,28.21455494858913,NaN,NaN,-20.4637363378145,-21.32161202287696
2008-12-02T09:30:00-05:00,8.841264,9.328386,8.475923,9.263437,241487174,240535463.6,43.25868578153985,38.40120039384063,NaN,NaN,-64.87301892624004,-50.503138016640094,0.10548115680073744,-0.9011772337361332,-1.0066583905368707,-4393172178,-4523637754.8,47.86362112528503,28.9769791801983,NaN,NaN,-19.351310019906162,-21.040140308166844
2008-12-03T09:30:00-05:00,8.889976,9.856102,8.841264,9.74244,257215603,246461894.2,46.096387111335375,39.078655242255316,NaN,NaN,-30.90049646600746,-44.754043163585685,0.15179639513283438,-0.8169128966208277,-0.968709291753662,-4135956575,-4417865731.4,51.07288109729524,30.21765390361103,NaN,NaN,-17.54558969427903,-20.540918791897155
2008-12-04T09:30:00-05:00,9.506998,10.188969,9.409573,9.636897,219536842,250056750.55,45.55577395916692,39.359661512591344,NaN,NaN,-4.474325266699245,-37.617187740341684,0.17496450138989728,-0.7500036650162905,-0.9249681664061877,-4355493417,-4389695633.4,51.92170062360789,31.564757571347524,NaN,NaN,-16.254181897026577,-19.928527806915643
2008-12-05T09:30:00-05:00,9.401455,10.465004,9.385217,10.400055,275397075,253730067.7,50.111810245818795,40.14387274544351,NaN,NaN,30.924608633292433,-28.335916919653982,0.23744961216904237,-0.6281561511948848,-0.8656057633639271,-4080096342,-4319875572.8,54.04950856819334,33.24321051940474,NaN,NaN,-13.754374149458842,-19.046505855850384
2008-12-08T09:30:00-05:00,10.830346,11.220043,10.708971,11.098263,248734560,259145859.85,53.91178148886696,41.398647790597416,NaN,NaN,116.07605277045572,9.350564148960279,0.31661613396467203,-0.4698355959080871,-0.7864517298727591,-3831361782,-4159216058.8,58.59091031621705,35.4372214106687,NaN,NaN,-10.446835030834722,-17.81798145227672
2008-12-09T09:30:00-05:00,10.903414,11.195687,10.55431,10.651734,238140490,264040485.85,51.22451961084548,42.50261574072533,NaN,NaN,103.64152428220696,43.05347279064968,0.32831212788399144,-0.37606157001776985,-0.7043736979017613,-4069502272,-4094482077.6,60.293732796627495,37.938045568792326,NaN,NaN,-8.47458537138926,-16.48321058357851
2008-12-10T09:30:00-05:00,10.732921,10.789752,10.237681,10.465004,191469077,262866075.15,50.09988321899206,43.807057349200825,NaN,NaN,79.41308483677706,65.11618905120659,0.3129372542158163,-0.31320213013199094,-0.6261393843478072,-4260971349,-4119485032.4,59.279765677815405,40.53595428758009,NaN,NaN,-7.173992541466275,-15.153322291848191
2008-12-11T09:30:00-05:00,10.30263,10.383817,9.612541,9.661253,191121810,260760539.05,45.47211590749781,45.003976906423695,NaN,NaN,24.997326185273298,71.0105193416011,0.24131077542762125,-0.3245009150632807,-0.565811690490902,-4452093159,-4138804980.8,58.46163632119083,43.37711148664466,NaN,NaN,-7.392965989649383,-14.044699962962648
2008-12-12T09:30:00-05:00,9.312149,9.880458,9.198487,9.847983,164558522,252830332.45,46.703824858144905,46.1545020367862,NaN,NaN,5.6336078743264455,65.9523191898079,0.20084184610653755,-0.31475938285773,-0.5156012289642675,-4287534637,-4180292639.8,56.653464799895936,46.21858319313308,NaN,NaN,-7.2242080552693,-13.070343976149312
2008-12-15T09:30:00-05:00,9.823627,9.856102,9.30403,9.442048,136945570,247896448.95,44.358036379942725,46.51322983597788,NaN,NaN,-0.5930596848933116,42.618496698738085,0.14374305839624474,-0.3359224059689616,-0.47966546436520635,-4424480207,-4298916324.8,51.72712708218847,48.73795551684789,NaN,NaN,-7.745898057485415,-12.309708844911611
2008-12-16T09:30:00-05:00,9.661253,10.513717,9.604422,10.497479,274336019,250245731.5,51.218446209327595,47.116859040399206,NaN,NaN,68.8807306415725,35.666337970611195,0.17214755502078405,-0.2644810205892263,-0.43662857561001034,-4150144188,-4315044708,51.07680938672944,50.929365768752504,NaN,NaN,-6.16754583699109,-11.43225698663725
2008-12-17T09:30:00-05:00,10.30263,10.700447,10.188969,10.400055,188677596,246375737.55,50.59828555643453,47.4757869836468,NaN,NaN,83.02937399203284,36.38959580166236,0.17868997122297275,-0.21326611158129438,-0.39195608280426714,-4338821784,-4330614795,50.41782337672186,52.508214940603544,NaN,NaN,-5.059500734649182,-10.52186323635324
2008-12-18T09:30:00-05:00,10.448767,10.594904,9.986001,10.099663,182742084,242757486.35,48.642588527632164,47.58268415283292,NaN,NaN,57.204646195272964,42.831059803662285,0.15782648050773684,-0.19467298216959605,-0.3524994626773329,-4521563868,-4344508936.8,49.800361286371846,53.248292407593055,NaN,NaN,-4.67314422630592,-9.686331949203623
2008-12-19T09:30:00-05:00,9.953526,10.188969,9.783034,9.92917,162699762,226198818.6,47.51993818071607,48.19800550259004,NaN,NaN,23.024456314465855,46.309229491690175,0.12880932917404248,-0.19148780120977982,-0.3202971303838223,-4684263630,-4423854735.4,46.31218541427691,53.394394848029755,NaN,NaN,-4.6563093535412365,-8.967757292680425
2008-12-22T09:30:00-05:00,9.953526,10.002238,9.433929,9.580066,148179821,211472624.5,45.21861279782413,48.3380002894675,NaN,NaN,-30.25285056558332,40.37727131555217,0.08451062908006246,-0.21465884403374424,-0.2991694731138067,-4832443451,-4505447384.2,42.97846937315127,53.045455437163056,NaN,NaN,-5.2709878865124535,-8.439647377513571
2008-12-23T09:30:00-05:00,9.628778,9.718084,9.328386,9.352742,73560959,196230930.15,43.73339382191997,48.16921505450926,NaN,NaN,-69.01513747294905,12.798097692647861,0.04053505961628889,-0.24850064859344556,-0.28903570820973445,-4906004410,-4656619428.6,37.580819463640296,52.08173674904485,NaN,NaN,-6.196707404312862,-8.119227381342041
2008-12-24T09:30:00-05:00,9.425811,9.571947,9.336505,9.55571,22262992,182907435.5,45.45600462971095,48.16208867383383,NaN,NaN,-65.70070383001253,-16.947917871761213,0.02643513678808762,-0.2559917872246249,-0.2824269240127125,-4883741418,-4765603355.4,34.24203079600646,50.81890318993046,NaN,NaN,-6.5391169167538825,-7.893497314972304
2008-12-26T09:30:00-05:00,9.653134,9.669372,9.446107,9.563829,37241095,176345851,45.527845345974235,47.834662609559224,NaN,NaN,-51.481592782575945,-38.68516566733099,0.019304772736052134,-0.2582959580926474,-0.2776007308286995,-4846500323,-4830590646.4,32.39388436590849,49.27207288976725,NaN,NaN,-6.808922089716575,-7.738557997078629
2008-12-29T09:30:00-05:00,9.588185,9.596303,9.30403,9.482642,47482656,175362620.7,44.89111906732752,47.19032957944926,NaN,NaN,-60.69983140583673,-55.430023211391514,0.011173278801182907,-0.2636341323272209,-0.2748074111284038,-4893982979,-4872534516.2,31.22257834823462,47.31719203491137,NaN,NaN,-7.198838231021979,-7.66145517335625
2008-12-30T09:30:00-05:00,9.531354,9.896695,9.498879,9.847983,72405207,168709745.7,48.389071896288904,46.987797599838075,NaN,NaN,-24.425928931490724,-54.26463888457299,0.031311470026246346,-0.23566807359559583,-0.2669795436218422,-4821577772,-4870361380.4,31.361056414645702,45.25057229334124,NaN,NaN,-6.667377944369389,-7.5194441406438415
2008-12-31T09:30:00-05:00,9.872339,10.253918,9.799271,10.164612,109276273,162099200.65,51.27560016060001,47.0717773813815,NaN,NaN,22.00065801657247,-36.06147978666869,0.06493282376021081,-0.18581351392157863,-0.25074633768178944,-4712301499,-4831620798.2,33.91551332325872,43.43883998230148,NaN,NaN,-5.452010360161075,-7.224096457717732
2009-01-02T09:30:00-05:00,10.172731,10.400055,9.912933,10.278274,117997255,155138283.25,52.30679316478378,47.55996861404479,NaN,NaN,38.69766650587216,-15.181805719491752,0.09214180081111029,-0.13556908666790157,-0.22771088747901186,-4594304244,-4773733363.4,37.64948387215402,41.952257664513134,NaN,NaN,-4.144128035078097,-6.784100968769212
2009-01-05T09:30:00-05:00,10.229562,10.343224,10.050951,10.107781,127980844,150560483.35,50.577661178029906,47.836671208322294,NaN,NaN,29.662332931927825,1.046979423409001,0.09556116678320783,-0.10825942900000207,-0.2038205957832099,-4722285088,-4748890316.4,39.23627938984004,40.70817299236628,NaN,NaN,-3.433111753050843,-6.305388223666588
2009-01-06T09:30:00-05:00,10.229562,10.408173,10.156494,10.270156,153440210,144462640.1,52.19838824354684,48.39669634143687,NaN,NaN,46.977823484076225,22.58251040139159,0.10491547148849786,-0.07267625642258757,-0.17759172791108543,-4568844878,-4683862696.2,43.30364956000279,40.10649602649588,NaN,NaN,-2.4058069227533343,-5.74830518067898
2009-01-07T09:30:00-05:00,10.034713,10.107781,9.718084,9.734321,131095727,138580698.45,46.7500364486217,48.077524215672156,NaN,NaN,-21.283100975470756,23.211075992595585,0.072702058067105,-0.08671415532720417,-0.15941621339430917,-4699940605,-4659535262.8,44.792498209598534,39.65761665670082,NaN,NaN,-2.894923999809498,-5.340679297697626
2009-01-08T09:30:00-05:00,9.67749,9.839864,9.588185,9.693728,132352401,133291294,46.35529552127753,47.77445349887523,NaN,NaN,-44.76628203535449,9.857687982210194,0.04756296935405868,-0.09996250170173582,-0.1475254710557945,-4832293006,-4683533564.2,43.57681661206264,39.16897331636802,NaN,NaN,-3.4106129034166695,-5.064955527086061
2009-01-09T09:30:00-05:00,9.774915,9.831746,9.36898,9.385217,125822646,130008972.45,43.35881282631608,47.397040948781225,NaN,NaN,-79.31759175240634,-13.745363669445505,0.010969456403612743,-0.13381365055127858,-0.14478310695489133,-4958115652,-4756295845.8,40.02946054095664,38.47105183455265,NaN,NaN,-4.664009331780536,-5.007677499185272
2009-01-12T09:30:00-05:00,9.352742,9.377098,8.760077,8.889976,179600872,129432925.55,39.00054678396703,46.788512991870576,NaN,NaN,-172.32782257784496,-54.14339477140006,-0.04282684930769434,-0.19831666858950925,-0.1554898192818149,-5137716524,-4839382133,36.38693592111834,37.76210544218417,NaN,NaN,-7.032071992309024,-5.296876712488665
2009-01-13T09:30:00-05:00,8.760077,9.1173,8.670772,9.011757,253561304,133883064.65,40.58216197557642,46.4573379331386,NaN,NaN,-164.11163027357406,-96.36128552293012,-0.06511092739180821,-0.23687847852157518,-0.17176755112976697,-4884155220,-4902444201.4,33.867898872214354,37.11135040640296,NaN,NaN,-8.616791977857705,-5.771150321827099
2009-01-14T09:30:00-05:00,8.711365,8.727603,8.427211,8.49216,201777447,137124658.5,36.26201429733262,45.92366796709665,NaN,NaN,-201.95012899394624,-132.4946911266252,-0.10725842810656852,-0.3058405862629776,-0.1985821581564091,-5085932667,-4979642613.8,31.03539096492821,36.6438197993521,NaN,NaN,-11.310020041202778,-6.562417424595052
2009-01-15T09:30:00-05:00,8.467804,8.475923,7.78421,8.102463,326745355,139745125.3,33.39098420836959,45.06188079414369,NaN,NaN,-223.35110777608568,-168.21165627477143,-0.1511121174911436,-0.3874723050203386,-0.236360187529195,-5412678022,-5095719617,27.33367265446212,36.15036564638465,NaN,NaN,-14.523876255063882,-7.699768686090599
2009-01-16T09:30:00-05:00,8.321667,8.410973,7.501679,7.858902,250916703,142857080.65,31.701585448164195,44.07429080144298,NaN,NaN,-208.83283271904799,-194.11470446809977,-0.1840658568150063,-0.4664425085479529,-0.28237665173294657,-5663594725,-5236815431.6,23.64229553742743,35.525252158636,NaN,NaN,-17.757456655553646,-9.136581253156749
2009-01-20T09:30:00-05:00,7.420492,7.509797,6.551791,6.55991,300528941,148746423.5,24.563565352754296,42.62232267897347,NaN,NaN,-249.37291519474343,-209.52372299147947,-0.27539584655947447,-0.6266214599322897,-0.3512256133728152,-5964123666,-5402096860,20.200756704484917,34.73797918408245,NaN,NaN,-23.45756555506335,-11.18243615342912
2009-01-21T09:30:00-05:00,6.949607,7.542272,6.665453,7.526035,390044080,160113639.4,36.089598335118865,41.7437888531756,NaN,NaN,-168.78894759189473,-210.45918645514362,-0.25334511209877764,-0.6679070034962873,-0.41456189139750965,-5574079586,-5540081733.2,17.862951332867553,33.77382882109829,NaN,NaN,-24.346431520843336,-13.063006920202579
2009-01-22T09:30:00-05:00,7.225643,7.436729,6.86842,7.063269,289653663,167187331.5,33.45298532783177,40.470744936549295,NaN,NaN,-148.08500814481357,-199.68616228531707,-0.2519965329066337,-0.7295575575308018,-0.47756102462416805,-5863733249,-5695641849.6,15.662315651440167,32.470028987396965,NaN,NaN,-25.9876320669399,-14.909381941165053
2009-01-23T09:30:00-05:00,6.74664,7.379898,6.722284,7.298711,284219848,177720275.95,36.014251846738034,39.30699198526032,NaN,NaN,-124.90782162867103,-179.99750505583413,-0.21856200382814073,-0.750763529409344,-0.5322015255812033,-5579513401,-5729008925.4,15.228935463582104,30.868561243927548,NaN,NaN,-26.419477559113723,-16.55368131515772
2009-01-26T09:30:00-05:00,7.444848,7.631578,7.063269,7.168812,248595918,189036922.25,35.20908209571742,38.20923633652371,NaN,NaN,-98.9068815306489,-158.01231481815432,-0.18958637833080227,-0.769184498494706,-0.5795981201639038,-5828109319,-5761911844.2,14.794219002402599,29.12269978768202,NaN,NaN,-27.015535268622315,-18.048231879938378
2009-01-27T09:30:00-05:00,7.314949,7.452967,7.193168,7.420492,167338830,195541809,38.096793448154095,37.201979565424224,NaN,NaN,-83.63234676841657,-124.86420113288894,-0.14014087133585618,-0.754774209333724,-0.6146333379978678,-5660770489,-5701241208.8,19.364985234700583,27.41279519301758,NaN,NaN,-26.61117602320174,-19.271509614690288
2009-01-28T09:30:00-05:00,8.069988,8.532754,7.948207,8.37038,385423045,212438828.45,47.5909116073941,37.26204207676511,NaN,NaN,-23.812622499628908,-95.86893611443577,-0.035579841555055,-0.6591081399416865,-0.6235282983866315,-5275347444,-5641494780.4,23.70540572639773,25.906574301360376,NaN,NaN,-23.055354314712392,-19.81205885755059
2009-01-29T09:30:00-05:00,8.05375,8.126819,7.672171,7.712765,203739909,219005563.55,42.707436449295265,37.00148071448066,NaN,NaN,-46.41963932334277,-75.53586235014163,-0.004460724201134303,-0.6291042036380494,-0.6246434794369151,-5479087353,-5564565601.2,29.004513002020957,24.865695472071685,NaN,NaN,-21.671098985901356,-20.077636018743554
2009-01-30T09:30:00-05:00,7.818308,7.891376,7.37178,7.501679,282895044,227686502.1,41.244441623100606,36.85045419996527,NaN,NaN,-56.44416173372461,-61.84313037115233,0.007501714195907505,-0.6152663366920308,-0.6227680508879383,-5761982397,-5601059400.4,28.010609622506607,24.00720612075383,NaN,NaN,-21.038453901863026,-20.21489571633205
2009-02-02T09:30:00-05:00,7.30683,7.574747,7.233762,7.501679,148535169,229213397.8,41.244441623100606,37.01073240276053,NaN,NaN,-61.19899071351128,-54.30155220772478,0.020283944022078004,-0.5974131208603408,-0.6176970648824188,-5761982397,-5587834016,28.960670322040045,23.47675857796252,NaN,NaN,-20.54015254241887,-20.261360977201598
2009-02-03T09:30:00-05:00,7.623459,7.639697,7.201287,7.363661,226344119,234131561.55,40.20017148538449,36.98344736774681,NaN,NaN,-58.78060941385013,-49.3312047368115,0.02405572008867385,-0.5876274147715765,-0.6116831348602504,-5988326516,-5653345221.4,27.055923778010154,22.990188928376508,NaN,NaN,-20.432002311211612,-20.2857383106316
2009-02-04T09:30:00-05:00,7.436729,7.599103,7.225643,7.282474,261892766,239554189.35,39.5655711212689,37.21941571231368,NaN,NaN,-56.60162967606924,-55.88900617209957,0.025554189366657543,-0.5797403981519285,-0.605294587518586,-6250219282,-5848319589,22.34545257762943,22.369479043569452,NaN,NaN,-20.519030545128896,-20.319065772702643
2009-02-05T09:30:00-05:00,7.193168,7.582866,6.93337,7.396136,474666574,256732731.7,40.970502083735674,37.76080984626841,NaN,NaN,-58.035224792871716,-58.21212326600536,0.03792580656571509,-0.5578873293114421,-0.5958131358771572,-5775552708,-5907612660,21.14008416660704,21.92707986586552,NaN,NaN,-20.211176917261092,-20.303653079068138
2009-02-06T09:30:00-05:00,7.599103,8.029394,7.542272,7.948207,326989690,266464596.15,47.3702936871679,38.88000329191153,NaN,NaN,3.7924129643861537,-46.16480832638321,0.08435575920899296,-0.490368436865916,-0.574724196074909,-5448563018,-5844928784.2,25.702960909318193,22.074270249572002,NaN,NaN,-18.095274788873127,-19.988170466183135
2009-02-09T09:30:00-05:00,8.021276,8.191768,7.899495,8.037513,209107448,270628836.25,48.345894106342584,40.578741060024974,NaN,NaN,41.8062327411448,-25.563763635452027,0.1199740368144504,-0.42475665005684604,-0.5447306868712964,-5239455570,-5740423418.8,32.69490285291232,22.966709260173957,NaN,NaN,-16.063231265334817,-19.427464866061946
2009-02-10T09:30:00-05:00,7.940089,8.021276,7.144456,7.217524,399880217,281642803.5,40.85697247780059,40.91926778450223,NaN,NaN,-30.23416519043495,-19.854474790768993,0.08864606927542718,-0.43392310027701253,-0.5225691695524397,-5639335787,-5670625273,36.96187285689669,24.330917940461752,NaN,NaN,-16.395462499530808,-18.994321670843213
2009-02-11T09:30:00-05:00,7.339305,7.582866,7.30683,7.565005,225145799,280222028.25,44.76184258722497,41.72704330303032,NaN,NaN,-18.588517308354145,-12.251852317225977,0.09130292172361737,-0.408440517397918,-0.49974343912153535,-5414189988,-5503419414.2,45.822823027071735,26.485239895864005,NaN,NaN,-15.494612128365755,-18.494363164775006
2009-02-12T09:30:00-05:00,7.323067,7.509797,7.022676,7.469204,282382194,284252265.6,43.90123836190125,42.29039948268485,NaN,NaN,-42.146752568906436,-9.074157872432917,0.08662420486913419,-0.3914631830351176,-0.4780873879042518,-5696572182,-5487623309,46.58667606049345,28.7250785099291,NaN,NaN,-15.007362743639998,-17.996220247470006
2009-02-13T09:30:00-05:00,7.30683,7.428611,7.160693,7.185049,209150706,278372533.15,41.36109907091958,42.72982926662785,NaN,NaN,-55.68682001857584,-20.97000446902531,0.06537521502216886,-0.3963683691265407,-0.4617435841487096,-5905722888,-5579055283,42.8230712902926,30.727139387635535,NaN,NaN,-15.324817591960201,-17.614591296682892
2009-02-17T09:30:00-05:00,6.730402,6.819708,6.470604,6.470604,274427561,279548076.05,35.758849177245125,42.56283324727722,NaN,NaN,-205.61307718363219,-70.45386645398071,0.007245100339933974,-0.4526872087237921,-0.45993230906372606,-6180150449,-5767194258.8,36.320825797738635,31.93827085642397,NaN,NaN,-17.35992860395729,-17.578210912007805
2009-02-18T09:30:00-05:00,6.665453,6.68169,6.267636,6.470604,269475339,277995395.95,35.758849177245125,41.717685930838,NaN,NaN,-215.30719009411777,-107.46847143471727,-0.02537641443882055,-0.4916528271122518,-0.46627641267343123,-6180150449,-5875357191.2,33.199747315671246,32.61643811280065,NaN,NaN,-18.985393410277897,-17.779236983189247
2009-02-19T09:30:00-05:00,6.592384,6.624859,6.089025,6.129618,257302671,271358325.5,33.264867180514756,41.04321669735368,NaN,NaN,-213.74409384953054,-146.49958674295254,-0.062002651205477766,-0.5437797266802784,-0.48177707547480064,-6437453120,-6080009817.6,28.252831617682133,32.562746585347874,NaN,NaN,-21.126076955936327,-18.257356979295974
2009-02-20T09:30:00-05:00,5.829227,6.194568,5.561309,6.040313,503779570,282064620.85,32.623126934589436,40.42740850531717,NaN,NaN,-223.05978006885354,-182.682192242942,-0.08301595224526193,-0.585547015781378,-0.5025310635361161,-6941232690,-6328941919.2,23.638863488295314,32.25047900433278,NaN,NaN,-23.07709301908478,-18.945890699265803
2009-02-23T09:30:00-05:00,6.259518,6.30823,5.829227,5.829227,262911786,280999217.75,31.096096486812982,39.70252670986805,NaN,NaN,-169.38332798916147,-205.4214938370591,-0.10072438445074439,-0.6284365440995465,-0.5277121596488021,-7204144476,-6588626236.8,19.97421851632393,31.608589589638775,NaN,NaN,-25.176081844094,-19.835918005669832
2009-02-24T09:30:00-05:00,5.910414,6.535554,5.837345,6.535554,328133578,284976100.75,41.04105303446445,39.762589677659484,NaN,NaN,-106.02988403776652,-185.50485520788598,-0.056656357956261005,-0.5985326070941284,-0.5418762491378674,-6876010898,-6727798326.6,18.333819936485256,30.985582172386994,NaN,NaN,-24.119577591636094,-20.447869375093585
2009-02-25T09:30:00-05:00,6.438129,6.795352,6.113381,6.49496,400506130,296634465.75,40.67767729101502,39.84202583264135,NaN,NaN,-75.19743927595803,-157.482905044254,-0.023715784701494602,-0.5715209800147356,-0.547805195313241,-7276517028,-6947071642.4,16.091514238722965,30.538872291036537,NaN,NaN,-23.36817910393639,-20.865056479213987
2009-02-26T09:30:00-05:00,6.803471,6.949607,6.535554,6.600503,388621350,296794381,42.11274587733112,39.923614675041016,NaN,NaN,-41.9535921296391,-123.12480470027572,0.009903692163344524,-0.5354255801090604,-0.5453292722724049,-6887895678,-7037160154,15.26543924611282,30.11925479671552,NaN,NaN,-22.338747771312303,-21.075583806656603
2009-02-27T09:30:00-05:00,6.129618,6.478723,6.1215,6.170212,309045714,302059671.25,38.06933973443995,39.25926082127474,NaN,NaN,-82.69130420671767,-95.05110952784854,0.00796805753579588,-0.53536920035266,-0.5433372578884559,-7196941392,-7088301894.4,14.800921726698448,29.340537712242682,NaN,NaN,-22.583364448411018,-21.290981041192946
2009-03-02T09:30:00-05:00,5.93477,6.040313,5.715565,5.780514,230946235,299462230.8,34.80959649133095,38.29238242020248,NaN,NaN,-114.8799190448434,-84.15042773898493,-0.013578973380090398,-0.5603109746135688,-0.5467320012334784,-7427887627,-7133050524.6,14.388356233982549,28.032927239461987,NaN,NaN,-23.765055431854126,-21.644420239858828
2009-03-03T09:30:00-05:00,5.926651,5.967244,5.553191,5.666853,234213832,303746163.95,33.89790298649058,37.79530602796604,NaN,NaN,-114.14646395810769,-85.77374372305317,-0.028641530893919964,-0.5825339148508784,-0.5538923839569584,-7662101459,-7290268636.8,13.015650260111329,26.322482768263033,NaN,NaN,-25.005773172551578,-22.124613515957794
2009-03-04T09:30:00-05:00,5.86982,5.877939,5.439529,5.593784,285232010,306690558.5,33.294197943904535,36.97618855344316,NaN,NaN,-112.62737725894642,-93.25973131965085,-0.0361943754977152,-0.5991353533291024,-0.5629409778313872,-7947333469,-7424431925,11.966474248035126,23.904172141188987,NaN,NaN,-26.204399868460786,-22.707440137743937
2009-03-05T09:30:00-05:00,5.439529,5.455766,4.944288,5.066069,346659322,310928886.3,29.24348017625975,35.92920582589734,NaN,NaN,-146.54796677063942,-114.17860624785092,-0.0675762962231179,-0.6474113481102846,-0.5798350518871667,-8293992791,-7705651347.6,10.124253049213095,21.299713354668963,NaN,NaN,-28.503448427353877,-23.535441321973927
2009-03-06T09:30:00-05:00,5.139137,5.260918,4.773796,5.017357,265975764,300494345.8,28.894024046256263,35.038700466992815,NaN,NaN,-144.60816367941564,-126.56197814239049,-0.08152585560501113,-0.6817423713934305,-0.6002165157884194,-8559968555,-7978256780.2,8.722447411569433,18.863954506188737,NaN,NaN,-30.48862154713059,-24.528752782710594
2009-03-09T09:30:00-04:00,4.911813,5.236562,4.846864,5.082306,300755362,299182629.4,30.09352935742848,34.63403476557734,NaN,NaN,-129.79432347025818,-129.54485902747348,-0.07637849626131099,-0.6956896361150582,-0.6193111398537472,-8259213193,-8144521893.4,7.995317769686281,16.840703932756423,NaN,NaN,-31.821194607469316,-25.570530186247556
2009-03-10T09:30:00-04:00,5.407054,5.86982,5.358342,5.837345,436141549,310534334.45,42.282920670707504,35.10003987225323,NaN,NaN,-60.0112431371755,-118.71781486328703,-0.015317377644917807,-0.6384578619098944,-0.6231404842649766,-7823071644,-8176715930.4,7.858707421028782,15.030629654567676,NaN,NaN,-29.37860250220729,-26.114540517098945
2009-03-11T09:30:00-04:00,6.064669,6.218924,5.853583,5.991601,511424853,316111566.25,44.41536056921445,35.89650368573178,NaN,NaN,-16.76606203438863,-99.54555181837547,0.0392828211981614,-0.5740369577672748,-0.6133197789654362,-7311646791,-8049578594.8,14.100654410197464,14.019759854033058,NaN,NaN,-26.71731083957128,-26.20065056316642
2009-03-12T09:30:00-04:00,5.967244,6.68169,5.894176,6.608622,476794678,328694010.2,52.0471964082141,37.28393721956211,NaN,NaN,38.57555397648969,-62.52084766894965,0.11641425575121245,-0.46780195927642065,-0.5842162150276331,-6834852113,-7757750459.2,26.421862786851648,14.218545518215654,NaN,NaN,-21.83643039700016,-25.577190539428383
2009-03-13T09:30:00-04:00,6.730402,6.819708,6.365061,6.649215,341760488,331662924.9,52.50917286938993,38.81344267546047,NaN,NaN,77.96940054868625,-18.005334823329264,0.16657285513564912,-0.37600014610807175,-0.5425730012437209,-6493091625,-7344375073.2,39.63112761515589,15.622610453846509,NaN,NaN,-17.79863630387129,-24.46596850577737
2009-03-16T09:30:00-04:00,6.811589,7.047032,6.49496,6.519316,353947661,338902772.65,50.821859537044666,39.512071711359056,NaN,NaN,99.10697043674773,27.774923958071906,0.18593595295348442,-0.3101530600518654,-0.4960890130053498,-6847039286,-7061940291.8,46.67510733565104,17.646988125215493,NaN,NaN,-14.937148303964666,-23.104708476946982
2009-03-17T09:30:00-04:00,6.511197,6.965845,6.389417,6.9423,276401709,339001480.05,55.802251489433516,40.59239843981752,NaN,NaN,107.60559295064057,61.29829117563511,0.21984189719051173,-0.22128664151721011,-0.44112853870772184,-6570637577,-6811453478.4,52.02196765592295,20.21344908358692,NaN,NaN,-10.880677207714871,-21.35841829562811
2009-03-18T09:30:00-04:00,6.860301,7.672171,6.787233,7.638073,509613332,351008379.7,62.525190462927355,42.05043019593153,NaN,NaN,173.6431689887607,99.38013738026498,0.2779933027395301,-0.09363691028330923,-0.37163021302283933,-6061024245,-6561328969.2,56.69173942239966,23.172470524750263,NaN,NaN,-4.9314457356939725,-19.011707929923233
2009-03-19T09:30:00-04:00,7.858902,7.875139,7.014557,7.032418,508359614,363561226.85,54.72213844955352,43.23991581843965,NaN,NaN,143.54972883015455,120.37497235099795,0.2646052034006404,-0.040873708772038775,-0.3054789121726792,-6569383859,-6508235318.4,57.63436233652583,26.232001996880793,NaN,NaN,-2.38403591730585,-16.636326213835037
2009-03-20T09:30:00-04:00,6.957726,6.990201,6.568028,6.608622,375259605,357135228.6,50.018277848239244,44.32625020107595,NaN,NaN,64.63402862699017,117.70789796665875,0.21808208238019916,-0.03287630919743023,-0.2509583915776294,-6944643464,-6598545686.2,55.424580637003295,29.163160882810846,NaN,NaN,-1.868609715013367,-14.526652428289085
2009-03-23T09:30:00-04:00,7.185049,7.810189,7.030794,7.692468,458283419,366903810.25,59.586179451347505,46.16112709142288,NaN,NaN,139.95352518308954,125.8772089159271,0.2489465277156851,0.060224768066976964,-0.18872175964870813,-6486360045,-6526409838,56.847791096436524,32.29402808540551,NaN,NaN,2.171520959608446,-12.141199087160865
2009-03-24T09:30:00-04:00,7.485441,7.850783,7.266236,7.323067,369069530,368950607.85,55.674384516661696,47.75971184661982,NaN,NaN,119.25649741986041,128.2073898097711,0.2333878071878058,0.10301299933604913,-0.13037480785175667,-6855429575,-6583368237.6,55.345185994389986,35.39250749585942,NaN,NaN,3.935680357828687,-9.84450202359093
2009-03-25T09:30:00-04:00,7.49356,7.761477,7.05515,7.566628,440839838,370967293.25,57.64859184530961,49.788648394409094,NaN,NaN,104.96048727159217,114.47085346633737,0.22813342432950479,0.15479197256012434,-0.07334145176938046,-6414589737,-6654081336,53.45608496077983,38.48763834668562,NaN,NaN,5.993634262064395,-7.58191112564017
2009-03-26T09:30:00-04:00,7.704646,7.753359,7.404254,7.655934,306461398,366859295.65,58.380559342886315,51.894829487025525,NaN,NaN,107.6994863971685,107.30080497974015,0.2192488881733029,0.20071965844724815,-0.01852922972605474,-6108128339,-6561830232,55.58595007163644,41.83503139383326,NaN,NaN,7.8352259079843165,-5.379462977979529
2009-03-27T09:30:00-04:00,7.452967,7.704646,7.404254,7.420492,245312062,363672613.05,55.64984731627084,53.72028076979998,NaN,NaN,88.56829977177021,112.08765920869617,0.1873304130689445,0.2156337866101259,0.02830337354118139,-6353440401,-6443589619.4,58.22464464223636,45.42284045615827,NaN,NaN,8.487690701400414,-3.398441023782394
2009-03-30T09:30:00-04:00,7.006438,7.1201,6.714165,6.779114,273204843,365785543.45,48.934919700005544,54.195423557606986,NaN,NaN,30.17903235806087,90.13276064369043,0.11631507939726538,0.17369722278776312,0.057382143390497735,-6626645244,-6471646659.2,57.3538985160603,48.95821124866052,NaN,NaN,6.861566949818602,-1.9327255989822518
2009-03-31T09:30:00-04:00,6.957726,7.274355,6.852183,7.152575,300237328,369086718.25,52.52695293571541,54.774823012357054,NaN,NaN,45.73184499970002,75.42783015965836,0.0890168818829384,0.16865324574417073,0.07963636386123234,-6326407916,-6365842327.4,59.79566363855962,52.22214047925782,NaN,NaN,6.658553903037388,-0.7053999558365891
2009-04-01T09:30:00-04:00,6.949607,7.404254,6.93337,7.355542,214749198,365562577.65,54.40413603979328,54.943175843184136,NaN,NaN,54.2495240103738,65.28563750741468,0.07946733873720092,0.1789705372827335,0.09950319854553256,-6111658718,-6305256123.6,61.166806274025234,54.70392215691307,NaN,NaN,7.074313227337023,0.4059876417596411
2009-04-02T09:30:00-04:00,7.785833,7.810189,7.452967,7.55851,293491953,362904209.2,56.266483664914965,55.21155518572164,NaN,NaN,86.22479683211814,60.99069959440461,0.08136185281078366,0.20120551455901214,0.11984366174822848,-5818166765,-6247263808.8,62.485635954260744,56.3363870382777,NaN,NaN,7.976981801420386,1.4875582359968904
2009-04-03T09:30:00-04:00,7.485441,7.891376,7.444848,7.86702,225078438,360859342.9,59.00723047829419,55.796224538668035,NaN,NaN,94.89890063049039,62.256819766148645,0.09687997043720928,0.24094362479474007,0.1440636543575308,-5593088327,-6095193394,65.76862143560584,57.70020947398875,NaN,NaN,9.562773332416823,2.641160392628309
2009-04-06T09:30:00-04:00,7.607222,7.761477,7.534154,7.655934,222328244,356937987,56.402700926716534,55.83911378418826,NaN,NaN,81.79139026715997,72.57929134796845,0.08674340157061386,0.2524929063207981,0.16574950475018427,-5815416571,-5932947659.4,68.89613350033534,58.905507034303916,NaN,NaN,10.120532518743602,3.7096421249304936
2009-04-07T09:30:00-04:00,7.420492,7.639697,7.412373,7.428611,213033791,345782599.1,53.656002350878865,55.20560034761336,NaN,NaN,55.09526670154593,74.45197568833764,0.05982443474796176,0.24053004818513646,0.1807056134371747,-6028450362,-5873356148.6,69.98097665803952,59.854738265421055,NaN,NaN,9.79178449963486,4.578519607031117
2009-04-08T09:30:00-04:00,7.542272,7.6194,7.314949,7.469204,154857915,327954252.2,54.085982935267126,55.16016066802148,NaN,NaN,46.19922681126755,72.84191624851638,0.040759143969201106,0.23165454339867608,0.19089539942947498,-5873592447,-5825742894.4,70.85562890346924,60.799114448774155,NaN,NaN,9.640133725561423,5.301607338249732
2009-04-09T09:30:00-04:00,8.143056,8.670772,8.029394,8.630178,385004614,323364749,64.29054922469625,56.179608623482714,NaN,NaN,220.85143597595277,99.76724407728332,0.09902301890215001,0.3146741730571625,0.2156511541550125,-5488587833,-5759827108,72.06894096712415,61.98799732949707,NaN,NaN,12.801127244486985,6.372967324855054
2009-04-13T09:30:00-04:00,8.459604,9.141656,8.402854,8.99552,307351846,321644316.9,66.79179545327683,56.69429548076339,NaN,NaN,267.58425213794357,134.30431437877394,0.15169995919888213,0.4052761031536152,0.25357614395473305,-5181235987,-5677456640,73.55076851500745,63.18106714510928,NaN,NaN,16.238267623811815,7.782295938991734
2009-04-14T09:30:00-04:00,8.857502,9.036113,8.346024,8.402854,393273287,323610598.2,59.50970351685323,56.96824683791993,NaN,NaN,189.6565235370058,155.87734103274312,0.1366301174762798,0.4243637908000828,0.287733673323803,-5574509274,-5629275180.6,74.40611023763869,64.54256173391276,NaN,NaN,16.78929479055693,9.069010060643905
2009-04-15T09:30:00-04:00,8.289193,8.873739,8.167412,8.80879,237944340,321687729.75,62.52356667322542,57.3164593256282,NaN,NaN,160.21372375529134,176.90103244349217,0.14330493031054714,0.46686483621198693,0.3235599059014398,-5336564934,-5490898095,76.73329271341319,66.20521943052943,NaN,NaN,18.23202383192961,10.378012027970433
2009-04-16T09:30:00-04:00,8.971164,9.052351,8.593644,8.906214,267778398,309595983.05,63.230939188700376,57.66291502890062,NaN,NaN,157.25810273679602,199.11280762859786,0.14324383061521984,0.5026146941704646,0.3593708635552447,-5068786536,-5329936912.8,79.11245072801894,67.88568376312818,NaN,NaN,19.596449174010303,11.694931620261842
2009-04-17T09:30:00-04:00,8.86562,9.198487,8.703246,9.019876,281318516,298243928.15,64.0827191150468,58.265263014527484,NaN,NaN,141.22244012940243,183.18700845928782,0.1396737839494958,0.5339630934921145,0.39428930954261865,-4787468020,-5189712950.2,80.94087541335355,69.50827167535083,NaN,NaN,20.956962002427098,13.018078817714022
2009-04-20T09:30:00-04:00,8.597703,8.646416,7.988801,8.013157,325726946,295767295.2,52.485325136441425,58.51886340284433,NaN,NaN,42.798446312176594,138.22984729413443,0.06227310223534782,0.4721306873368034,0.4098575851014556,-5113194966,-5176104746,81.11365828868774,71.20539737339564,NaN,NaN,18.391222159447864,13.785670723675999
2009-04-21T09:30:00-04:00,7.672171,8.613941,7.639697,8.605822,356538972,290680072.85,57.37590494258561,58.86521711762078,NaN,NaN,45.68456504167586,109.43545559506845,0.04458129787475634,0.46558420744490103,0.4210029095701447,-4756655994,-5012534090,83.09721767669757,72.8697940904055,NaN,NaN,17.843612315517372,14.365376665367624
2009-04-22T09:30:00-04:00,8.321667,8.816908,8.272955,8.297311,299704928,287211842.75,54.24589631783628,58.85391428033814,NaN,NaN,59.47910753464826,89.28853235093985,0.007628737900824523,0.43053883194617537,0.42291009404535085,-5056360922,-4956493287.6,83.72777970254678,74.48129219244277,NaN,NaN,16.370718050123998,14.651854006047106
2009-04-23T09:30:00-04:00,8.419092,8.74384,8.297311,8.687009,208231918,275581446.75,57.406713274741286,58.935359252468594,NaN,NaN,65.43842001947155,70.92459580747496,0.005081703505995072,0.4292622234278447,0.42418051992184963,-4848129004,-4912361781.2,84.22680033865751,76.03423250561397,NaN,NaN,16.16485170846012,14.86799653496325
2009-04-24T09:30:00-04:00,8.735721,9.052351,8.573347,8.881858,288442573,274680505.5,58.934290968179525,58.9301492874604,NaN,NaN,85.96189744799345,59.872487271193144,0.011786515542681064,0.43891366435020096,0.4271271488075199,-4559686431,-4866805463.4,84.74681637192229,77.38981785820799,NaN,NaN,16.47114639310719,15.097017943269528
2009-04-27T09:30:00-04:00,8.630178,8.86562,8.548991,8.738157,157169399,270273372.35,57.30207071356618,58.99438998652109,NaN,NaN,66.8025999840419,64.6733180055662,0.0023063944198936648,0.43001014183238695,0.4277037474124933,-4716855830,-4787537636.2,85.63429307035086,78.58540068463768,NaN,NaN,16.233007780959667,15.25930220579669
2009-04-28T09:30:00-04:00,8.394736,8.646416,8.37038,8.467804,166295096,264927885,54.25749668359795,59.0373538674296,NaN,NaN,36.63392066352017,62.86318912993507,-0.02490905713583047,0.3965674259927052,0.4214764831285357,-4883150926,-4812836622.6,83.95535107038256,79.58357028551931,NaN,NaN,15.13225841661555,15.241153093056527
2009-04-29T09:30:00-04:00,8.581466,8.914333,8.565229,8.833146,192272004,259529618.8,57.54059029840347,59.284111536225055,NaN,NaN,68.27028249367117,64.62142412173965,-0.021188648694154544,0.3949906722608425,0.41617932095499705,-4690878922,-4739740222.6,84.8778764218211,80.58515939397304,NaN,NaN,15.152978857898509,15.228556773748238
2009-04-30T09:30:00-04:00,8.987401,9.052351,8.638297,8.711365,215671770,259575747.4,56.09530213104585,58.69873674382145,NaN,NaN,68.88680564647629,65.31110124714061,-0.029312031126958737,0.3795392820462986,0.40885131317325735,-4906550692,-4751424560.2,84.04600167625361,81.44066373033942,NaN,NaN,14.755938668601534,15.161039901584424
2009-05-01T09:30:00-04:00,8.719484,8.849383,8.565229,8.646416,137607548,251781527.15,55.29755784536322,57.87771977182762,NaN,NaN,46.93082364120677,57.504886485783274,-0.040739337578911905,0.35792714119961744,0.39866647877852934,-5044158240,-4848318922,77.28175404151239,81.70716269651835,NaN,NaN,14.207554866037391,15.024827753649133
2009-05-04T09:30:00-04:00,8.760077,9.531354,8.751959,9.523235,260891206,253572165.55,62.95653801569055,58.12392223603029,NaN,NaN,145.64009756636793,73.27238600224848,0.006555845497815127,0.40686128565079827,0.40030544015298314,-4783267034,-4861601162.8,76.37433598978507,81.84775025024308,NaN,NaN,16.027480928405147,15.16806392147142
2009-05-05T09:30:00-04:00,9.344624,9.55571,9.287793,9.385217,200142032,252462854.95,61.17966158505971,58.02792901544702,NaN,NaN,166.18881735395087,99.18336534033463,0.02339838712525244,0.42955342405954866,0.4061550369342962,-4983409066,-4881652790.8,74.94370193529943,81.71992233752067,NaN,NaN,16.992286016064988,15.42866707784193
2009-05-06T09:30:00-04:00,9.669372,10.197087,9.620659,10.132138,330480397,258335185.25,66.6632328690234,58.2730928497558,NaN,NaN,255.71149767279786,136.67160837615995,0.07669229913876263,0.5020204108577495,0.4253281117189869,-4652928669,-4874062740.2,75.13357969408975,81.4357172636686,NaN,NaN,19.62171585703153,16.027674046297587
2009-05-07T09:30:00-04:00,10.611141,10.611141,9.685609,9.839864,350647507,268124664.85,62.91799628853422,58.18989836214775,NaN,NaN,230.8288146191998,169.06001017070466,0.08354567458411244,0.5297602049491275,0.446214530365015,-5003576176,-4893467837,73.59797690470455,80.9112245130508,NaN,NaN,20.63451184951457,16.685793732471442
2009-05-08T09:30:00-04:00,9.99412,10.61926,9.912933,10.570547,369160658,267332467.05,67.78999515766444,59.283089077949406,NaN,NaN,215.91362889379053,202.8565712212214,0.12602406457972987,0.6037446110896774,0.4777205465099475,-4634415518,-4811519292.6,75.8433647472783,80.53477497437869,NaN,NaN,23.141202141867574,17.607994933813746
2009-05-11T09:30:00-04:00,10.237681,10.359461,9.912933,9.953526,254156217,264672685.6,60.55483072589777,59.51015520532884,NaN,NaN,139.25072298020052,201.57869630398793,0.10231018099550415,0.6056082727543277,0.5032980917588236,-4888571735,-4832580232.8,74.09919462606146,79.89205904219041,NaN,NaN,22.853251411945624,18.357317287832586
2009-05-12T09:30:00-04:00,10.026594,10.050951,9.433929,9.74244,254395013,257728771.9,58.263826070867474,59.79715018768821,NaN,NaN,83.14851870047313,184.97063657329238,0.06402402141580277,0.583328118528577,0.5193040971127743,-5142966748,-4864491769.2,71.41915865773224,79.01287182470365,NaN,NaN,21.8828672096744,18.860967276667132
2009-05-13T09:30:00-04:00,9.466404,9.539472,9.011757,9.247199,237830095,257723059.65,53.180249251864616,59.49525990033988,NaN,NaN,21.448815718487637,138.11810018243034,0.0003312333464411399,0.5197181387958256,0.5193869054493845,-5380796843,-5010065404,60.64376834685924,77.32836953957519,NaN,NaN,19.40493656515016,18.93867717502185
2009-05-14T09:30:00-04:00,9.166012,9.645016,9.157894,9.55571,214517023,255059990.9,55.76925711163637,59.269186053443946,NaN,NaN,40.02524712828001,99.95738668424639,-0.02465423607313877,0.488569110357961,0.5132233464310998,-5166279820,-5042606132.8,58.51837285461285,75.45490928833881,NaN,NaN,18.181574858554598,18.830519701240814
2009-05-15T09:30:00-04:00,9.588185,9.669372,9.279674,9.360861,188193144,250403722.3,53.74774328169846,59.01530552259625,NaN,NaN,34.74037668480243,63.722736242448775,-0.056135995723112564,0.44305335177720906,0.4991893475003216,-5354472964,-5186617622,50.142763888533764,72.91980006106616,NaN,NaN,16.563673286269236,18.50668449910202
2009-05-18T09:30:00-04:00,9.628778,10.042832,9.55571,9.977882,169052385,242569994.25,58.83617580256803,59.34235403109411,NaN,NaN,77.85421677627684,51.443435001664035,-0.038099586360407334,0.4515648645498125,0.4896644509102198,-5185420579,-5245987390.8,47.14684736334356,70.29062122484909,NaN,NaN,16.74501416793891,18.25501730893586
2009-05-19T09:30:00-04:00,9.977882,10.140256,9.758677,9.774915,194568785,234471484.9,56.62917986008939,59.27725328550025,NaN,NaN,75.00714682868123,49.81516062730567,-0.04221452822389943,0.4368962906303455,0.47911081885424495,-5379989364,-5293391914,44.84299240640842,67.43098665231962,NaN,NaN,16.21756043963388,17.963952041892718
2009-05-20T09:30:00-04:00,10.002238,10.042832,9.450167,9.515116,338547678,236413622.4,53.844988312624544,59.116516584184446,NaN,NaN,41.15184690208159,53.75576686402445,-0.06352846586202482,0.39970023652671394,0.46322870238873876,-5718537042,-5360939953.8,41.714955206548574,64.40734047591212,NaN,NaN,14.940674201446697,17.532055207543287
2009-05-21T09:30:00-04:00,9.377098,9.636897,9.352742,9.531354,267831588,239393605.9,53.99722614911656,59.02363574873825,NaN,NaN,13.841802929300469,48.51907802422854,-0.07674425832974702,0.36729837947655497,0.444042637806302,-5450705454,-5417825080.6,39.23297008416042,61.68957019324413,NaN,NaN,13.951718301851773,17.020578506730214
2009-05-22T09:30:00-04:00,9.620659,9.645016,9.425811,9.466404,118159843,230879469.4,53.24077753906727,58.32965285755087,NaN,NaN,10.290237061175956,43.62905009950324,-0.0891978094141112,0.33254537603866297,0.42174318545277417,-5568865297,-5460703547.2,37.42538452808742,58.907502231694295,NaN,NaN,12.924346662138886,16.43540252893145
2009-05-26T09:30:00-04:00,9.352742,9.815508,9.344624,9.774915,185380122,232290005.55,56.36753308020181,57.98592939291816,NaN,NaN,26.027435885786883,33.26369392140523,-0.07648405824257049,0.32613811264956105,0.40262217089213154,-5383485175,-5500316466.4,35.78505302456391,56.11045588092747,NaN,NaN,12.883612484664278,15.928003951178997
2009-05-27T09:30:00-04:00,9.864221,9.896695,9.450167,9.482642,211404761,234545488.8,52.76758223985423,56.99338291940608,NaN,NaN,11.767849430523391,20.61583444177366,-0.08682871413274851,0.29408627822619593,0.38091499235894444,-5594889936,-5543296580.8,34.04167457687622,53.1753198011265,NaN,NaN,11.845361996726426,15.344769386257202
2009-05-28T09:30:00-04:00,9.55571,9.783034,9.393336,9.750559,228751834,236369480.3,55.56883016229243,56.468442481817384,NaN,NaN,10.820616337940878,14.549588328945514,-0.07513573160096909,0.2869953278577331,0.36213105945870216,-5366138102,-5472816792.8,39.26681282686249,50.72309379556635,NaN,NaN,11.727116786711072,14.827961872036326
2009-05-29T09:30:00-04:00,9.831746,10.026594,9.645016,9.92917,232100666,237190925.1,57.38343644843315,55.72511685972944,NaN,NaN,54.76406048895974,22.734039840877365,-0.05577100046654915,0.29241730887551576,0.3481883093420649,-5134037436,-5409483189.2,43.59124392030835,48.41937087935421,NaN,NaN,12.127723459118549,14.442213527333786
2009-06-01T09:30:00-04:00,10.059069,10.221443,9.937289,10.034713,236484442,242134769.8,58.46296969603923,55.57569821473954,NaN,NaN,94.744383244341,39.624869077510375,-0.037148812807681675,0.3017522933324628,0.33890110614014446,-4897552994,-5275220728.6,51.478754189487454,46.80362513388464,NaN,NaN,12.757722656509232,14.201571974358849
2009-06-02T09:30:00-04:00,9.896695,10.026594,9.815508,9.872339,237384073,240959413.15,56.10816236707458,55.4217222358972,NaN,NaN,44.99159785578623,43.41770147151025,-0.036981410240833346,0.2926743433391028,0.32965575357993615,-5134937067,-5225511107,54.0410767395073,45.562333568297156,NaN,NaN,12.674555663756973,13.983426787130009
2009-06-03T09:30:00-04:00,9.80739,9.896695,9.645016,9.74244,172876504,239596136.75,54.226423019912055,55.49644893361488,NaN,NaN,-1.1631642475179795,40.831498735901974,-0.04623311821324816,0.271864355813376,0.31809747402662414,-5307813571,-5168095834,56.87386463262329,45.293054731566016,NaN,NaN,12.107911816632084,13.715496077058877
2009-06-04T09:30:00-04:00,9.831746,10.107781,9.80739,10.091544,200853811,233114807.45,58.276368889545196,55.67552834632264,NaN,NaN,72.14471009332541,53.096317486978876,-0.030229325323483713,0.2803108173722695,0.3105401426957532,-5106959760,-5116260165.6,59.312204950121235,45.349757024102324,NaN,NaN,12.702383939828765,13.57076577174029
2009-06-05T09:30:00-04:00,10.262037,10.286393,9.92917,10.002238,188160508,224990457.5,56.889682125409415,55.899952549444855,NaN,NaN,92.59828989368596,60.66316336792412,-0.02714422228908664,0.27660986483439487,0.3037540871234815,-5295120268,-5148476732,57.14947998557928,45.85023674531986,NaN,NaN,12.836654148616319,13.465892682722579
2009-06-08T09:30:00-04:00,9.904814,10.172731,9.896695,10.075307,114454442,212255146.7,57.774987064459744,55.8241533538657,NaN,NaN,97.40176372701552,61.19463946445902,-0.0218937696426722,0.27638687507014126,0.29828064471281346,-5180665826,-5205099298.4,53.45987284150762,46.3011671366173,NaN,NaN,13.181780666853909,13.425305251884197
2009-06-09T09:30:00-04:00,10.132138,10.18085,10.026594,10.148375,114831192,205288895.45,58.68859603749215,55.97125450939446,NaN,NaN,118.52342208166027,75.90100430963383,-0.01551151870091766,0.2788912463366664,0.29440276503758406,-5065834634,-5191278811.8,54.23648763787656,46.97213108172217,NaN,NaN,13.711484832280455,13.466188049083662
2009-06-10T09:30:00-04:00,10.205206,10.213325,9.872339,9.99412,193254545,202231872.05,55.936989288769766,56.12068315054769,NaN,NaN,79.27039715334712,91.98771658980687,-0.02322631555800625,0.2653698705900762,0.28859618614808247,-5259089179,-5181533933.4,54.8091079933845,47.90742770935331,NaN,NaN,13.474218802472798,13.467335299567825
2009-06-11T09:30:00-04:00,9.99412,10.221443,9.977882,10.075307,192849377,199982836.15,57.07762846093039,56.34071188710583,NaN,NaN,92.03767241530481,95.96630905420274,-0.024294150594945052,0.25822849790440117,0.2825226484993462,-5066239802,-5173389941.8,55.312354171749554,49.0559551441811,NaN,NaN,13.557046100250497,13.480151128236779
2009-06-12T09:30:00-04:00,10.067188,10.148375,10.042832,10.140256,101166521,194315311.05,58.014002254660376,56.68165650964819,NaN,NaN,91.6736189512,95.78137486570554,-0.02212072100057816,0.2548717472486235,0.27699246824920165,-4965073281,-5107380544.4,59.27133070123051,50.61637987083418,NaN,NaN,13.861812823117447,13.534674227505446
2009-06-15T09:30:00-04:00,10.042832,10.067188,9.839864,9.880458,117639070,190787607.35,53.03045151921115,56.44329354100601,NaN,NaN,24.13034924732597,81.12709196976763,-0.038703841573873354,0.22861266628185994,0.2673165078557333,-5082712351,-5087789849.4,60.39282752730868,52.374078049601664,NaN,NaN,12.846579224113814,13.436374941306642
2009-06-16T09:30:00-04:00,9.904814,9.92917,9.669372,9.709965,139726488,189321312.5,49.99523219297777,56.24526853765769,NaN,NaN,-34.70112071860735,50.482183409714104,-0.06038643948357081,0.19183345850126976,0.25221989798484057,-5222438839,-5119110690.4,57.659227907076456,54.06104614461596,NaN,NaN,11.144991324869023,13.109034424672696
2009-06-17T09:30:00-04:00,9.645016,9.661253,9.344624,9.425811,255948622,192390304.35,45.33769730047865,55.514473333242414,NaN,NaN,-122.68706782903624,10.09069041323744,-0.09124459995988737,0.13816414803498134,0.2294087479948687,-5478387461,-5162970346.8,53.9749031252074,55.11162402306917,NaN,NaN,8.30518206102341,12.422769801294226
2009-06-18T09:30:00-04:00,9.458285,9.701846,9.450167,9.653134,149201384,182922989.65,49.39896152593886,54.9441536959214,NaN,NaN,-78.14990417347302,-23.946824904518127,-0.09338695739325381,0.11267505125330146,0.20606200864655527,-5329186077,-5215559601.8,49.86089074571632,55.559455939169744,NaN,NaN,6.92836764829544,11.637855208008686
2009-06-19T09:30:00-04:00,9.726203,9.831746,9.588185,9.774915,218774631,180470141.8,51.47878203794257,54.44528314891449,NaN,NaN,-41.458110945286364,-50.57317088381539,-0.08394109598861985,0.10113563866078046,0.1850767346494003,-5110411446,-5244627234.8,47.6968723054501,55.28932151888136,NaN,NaN,6.329077031598716,10.879458325664405
2009-06-22T09:30:00-04:00,9.645016,9.710046,9.198487,9.206606,164066680,182765483.65,42.66557939306661,53.48509865077107,NaN,NaN,-159.21980836156402,-87.2432024055934,-0.11157574406744633,0.0456070545650924,0.15718279863253873,-5274478126,-5282980389.8,44.92625073078841,54.63826251825858,NaN,NaN,3.0128304101168806,9.755654337729045
2009-06-23T09:30:00-04:00,9.279674,9.409573,9.174131,9.312149,172812455,182137100.3,44.56372328202398,52.7949058123505,NaN,NaN,-162.38941470047112,-112.78086120196615,-0.11774511911623498,0.01000139973724501,0.12774651885347998,-5101665671,-5258825756.2,47.01378794091905,53.933971325993994,NaN,NaN,0.8557444130068943,8.48423863419731
2009-06-24T09:30:00-04:00,9.442048,9.580066,9.352742,9.425811,133193974,178226560.95,46.613541539683794,51.96184671593183,NaN,NaN,-108.06152258124688,-109.85575215240829,-0.10935056749038283,-0.008941690509498557,0.10040887698088427,-4968471697,-5156842603.4,54.803280386966826,53.61190528576868,NaN,NaN,-0.34239673921242453,7.223290723710205
2009-06-25T09:30:00-04:00,9.393336,9.628778,9.336505,9.628778,156674167,174622677.6,50.15770814637378,51.480991431715,NaN,NaN,-80.93574639773371,-110.41292059726042,-0.08631921651268477,-0.007490143659971693,0.07882907285271308,-4811797530,-5053364894,61.05874146726224,53.89113824874604,NaN,NaN,-0.32959550478980426,6.144306976781633
2009-06-26T09:30:00-04:00,9.580066,9.718084,9.527294,9.67749,90076076,167521448.1,50.99849830382733,50.996956520241255,NaN,NaN,-44.89632275023458,-111.10056295825007,-0.06496859951610935,-0.0023816765424236053,0.06258692297368575,-4721721454,-4975626895.6,64.98011617741057,54.7140127727391,NaN,NaN,-0.08008049954844497,5.255108765877336
2009-06-29T09:30:00-04:00,9.701846,9.823627,9.596709,9.799271,137194536,162556952.8,53.127312362908526,50.59972197205671,NaN,NaN,-13.105425306900809,-81.87768634731742,-0.04097949918326923,0.011362548994599209,0.05234204817786844,-4584526918,-4837636654,70.63319197666851,55.885205939795675,NaN,NaN,0.7317075509945574,4.608908592322653
2009-06-30T09:30:00-04:00,9.80739,9.831746,9.628778,9.701846,124766733,156926085.8,51.210570977213344,50.26212066408839,NaN,NaN,-16.378605021842166,-52.67552441159163,-0.030490011137605827,0.014229534255861154,0.04471954539346698,-4709293651,-4759162250,73.27528179042699,57.20421835387013,NaN,NaN,0.9003576359008374,4.079115598548108
2009-07-01T09:30:00-04:00,9.718084,9.766796,9.636897,9.645016,71884572,151876489.2,50.07565365177848,49.76197960629183,NaN,NaN,-26.29234040001592,-36.321687975345434,-0.026351523873449148,0.011780140551655549,0.0381316644251047,-4781178223,-4721703555.2,74.4566310337568,58.57166670115636,NaN,NaN,0.7408331292991532,3.6022181029411144
2009-07-02T09:30:00-04:00,9.547591,9.55571,9.287793,9.312149,125145730,148091085.15,43.934027279962805,48.756267108099145,NaN,NaN,-105.32669702613711,-41.199878101026115,-0.04396664321468761,-0.01682663959325481,0.027140003621432797,-4906323953,-4740608839.8,72.70971167547006,59.531551056459186,NaN,NaN,-1.1651145917812797,2.9211705751236297
2009-07-06T09:30:00-04:00,9.222843,9.336505,9.133538,9.320268,107696355,144067877.5,44.11407006829107,48.11938271874771,NaN,NaN,-126.97121207446061,-57.614855965871314,-0.05243194928736704,-0.038399932987776,0.014032016299591039,-4798627598,-4755990068.6,71.24511823885196,60.30671467871228,NaN,NaN,-2.683659341781002,2.120480586994397
2009-07-07T09:30:00-04:00,9.328386,9.352742,9.141656,9.174131,119709352,144330623,41.529012031152725,47.51465270718877,NaN,NaN,-124.20594664814894,-79.83496023412093,-0.06444331886360838,-0.06652213227991943,-0.0020788134163110556,-4918336950,-4822752075,65.1142273946494,60.83921464211034,NaN,NaN,-4.723030263135727,1.1428361798329507
2009-07-08T09:30:00-04:00,9.190368,9.214806,8.792552,9.019876,248272516,151002689.2,38.93541935173009,47.05734713942102,NaN,NaN,-163.94116545002163,-109.34747231975685,-0.07841882893982172,-0.10010234959108821,-0.02168352065126649,-5166609466,-4914215238,57.7786038574233,61.11090755155435,NaN,NaN,-7.230157148121415,-0.05330572416052992
2009-07-09T09:30:00-04:00,9.149775,9.230962,9.060469,9.133538,160884831,149384203.5,41.81874682766737,46.51590323240163,NaN,NaN,-114.28903602793005,-126.94681144533968,-0.07561623548737156,-0.11620381501048094,-0.04058757952310938,-5005724635,-4959124520.4,54.530180239399485,61.444428229674564,NaN,NaN,-8.593441765439023,-1.2733251586288858
2009-07-10T09:30:00-04:00,9.068588,9.092944,8.946807,9.011757,117804574,145631963.35,39.658092279521476,45.671568249657255,NaN,NaN,-134.96249823424742,-132.87397168696174,-0.0772974458948337,-0.13720938689165152,-0.05991194099681781,-5123529209,-5002565571.6,51.51319623925476,61.717022796374906,NaN,NaN,-10.369442667089439,-2.5727705169803934
2009-07-13T09:30:00-04:00,9.214725,9.596303,9.157894,9.588185,278312951,154489284.85,52.23730271430207,46.35526277260265,NaN,NaN,-7.6860709684755655,-109.01694346576474,-0.03696664211701804,-0.10612024364309036,-0.06915360152607232,-4845216258,-5011883303.6,50.86316529742041,62.141088122562905,NaN,NaN,-8.087946725241258,-3.360652832446231
2009-07-14T09:30:00-04:00,9.596303,9.612541,9.433929,9.547591,195387655,158376714.1,51.42427751401335,46.84530236060188,NaN,NaN,27.74937378356831,-78.62587937942128,-0.011710377242500583,-0.08379157307919805,-0.07208119583669746,-5040603913,-5036336696.2,49.11165112166567,62.290935492616235,NaN,NaN,-6.5064148802581725,-3.8100474107050797
2009-07-15T09:30:00-04:00,9.701846,10.067188,9.685609,9.953526,223005141,162540646.75,58.39734192222452,47.68700238792622,NaN,NaN,149.7482028190699,-15.888005725602971,0.03129661147639852,-0.032960431491199316,-0.06425704296759784,-4817598772,-4966534557.4,53.982935429321536,62.232339424213,NaN,NaN,-2.7606700398382396,-3.6601363577241024
2009-07-16T09:30:00-04:00,9.864221,10.018476,9.758677,9.921051,147948868,157140659.05,57.683936115171846,48.224590099983224,NaN,NaN,128.02525160109693,32.57485180020242,0.05512527929545349,0.004649556151719025,-0.05047572314373446,-4965547640,-4958499158.4,54.52262485357815,61.76547395180699,NaN,NaN,-0.0055229195255325735,-3.1380487236957353
2009-07-17T09:30:00-04:00,9.945408,9.986001,9.783034,9.856102,173356108,158348395.25,56.20507601328991,48.596488507801986,NaN,NaN,109.5789056488504,81.48313257682199,0.06348615250119616,0.02888196748276073,-0.03460418501843542,-5138903748,-4961574066.2,54.26037387770587,60.99977807325666,NaN,NaN,1.8158107735485356,-2.4303545098036965
2009-07-20T09:30:00-04:00,9.92917,10.001751,9.864221,9.937289,135689368,154194132.1,57.6661060060479,48.920688053740506,NaN,NaN,118.53549182658112,106.72744513583334,0.07089518125134003,0.05401479154573963,-0.01688038970560041,-5003214380,-4993173690.6,51.51795686651161,59.63440413681688,NaN,NaN,3.7595972957931036,-1.546075680432725
2009-07-21T09:30:00-04:00,9.945408,9.977963,9.750559,9.847983,156972874,153839441.8,55.47379550936946,49.22520409175166,NaN,NaN,87.87739346462959,118.75304907204558,0.0662771693911258,0.06596607203330684,-0.00031109735781895825,-5160187254,-5017090358.8,49.479599490523775,57.934712543966654,NaN,NaN,4.785369601492095,-0.6415834973006078
2009-07-22T09:30:00-04:00,9.669372,9.937289,9.653134,9.856102,123178893,151357763.7,55.638911910503076,49.62257968166056,NaN,NaN,68.90968663294261,102.58534583482012,0.060429302113351006,0.0752255302838698,0.014796228170518793,-5037008361,-5060972276.6,45.89181355544216,55.894368438372744,NaN,NaN,5.677485407838115,0.261140632004924
2009-07-23T09:30:00-04:00,9.872339,10.197087,9.815508,10.140256,156719060,152534018,61.07887374142782,50.84721157176521,NaN,NaN,115.32612862915809,100.04552124043236,0.07159531838075472,0.1042903761464622,0.032695057765707476,-4880289301,-5043920608.8,47.485295761650164,54.092624444528475,NaN,NaN,8.080932285125868,1.378253725307916
2009-07-24T09:30:00-04:00,10.050951,10.140256,9.953526,10.083425,89380989,149169359.1,59.50714010110413,51.946716574109,NaN,NaN,104.66349728427127,99.06243956751652,0.07091591990717187,0.12133995764967231,0.05042403774250044,-4969670290,-5010073917.2,50.595472271830296,52.61764973259836,NaN,NaN,9.650625466907938,2.5600211169650615
2009-07-27T09:30:00-04:00,10.1159,10.270156,10.075307,10.245799,113549745,150343042.55,62.47804824225629,53.44307630347354,NaN,NaN,120.94123717301821,99.54358863680395,0.07667517941926277,0.1462680120165789,0.06959283259731613,-4856120545,-4980655150.2,53.1904379421318,51.765950485989954,NaN,NaN,11.878421388933258,3.891221155817661
2009-07-28T09:30:00-04:00,10.156494,10.262037,10.124019,10.221443,73755157,147171073.6,61.74624307687454,55.07242085526957,NaN,NaN,110.47984412969045,104.06407876981612,0.07407672451052708,0.16218873823547497,0.0881120137249479,-4929875702,-4934592839.8,56.998905889325115,51.710257773982946,NaN,NaN,13.526749040621096,5.2677251393610085
2009-07-29T09:30:00-04:00,10.156494,10.270156,10.124019,10.221443,124841484,147174811.15,61.74624307687454,56.49581344449865,NaN,NaN,100.09178818477149,110.30049908018191,0.0677615385993158,0.17281393697409264,0.10505239837477684,-4929875702,-4913166308,58.68288448399923,52.006879505740066,NaN,NaN,14.897742900883246,6.643441962435614
2009-07-30T09:30:00-04:00,10.318868,10.578666,10.318868,10.456886,161904068,151675785.95,66.18649301498175,58.39069921131725,NaN,NaN,128.74233529798607,112.9837404139475,0.07431881015061814,0.19795091106304952,0.12363210091243138,-4767971634,-4890702774.6,60.432360821722554,52.64396269020205,NaN,NaN,17.415948774232476,8.182371506978022
2009-07-31T09:30:00-04:00,10.456886,10.570953,10.391936,10.562429,161733026,153505150.75,67.98070370949952,59.51522785383135,NaN,NaN,127.03614436101805,117.45826982929687,0.08014124351698487,0.22380865530866245,0.14366741179167758,-4606238608,-4818016438.2,65.51988184973894,53.690871015367634,NaN,NaN,20.09449450730513,9.884103364167608
2009-08-03T09:30:00-04:00,10.757277,10.846583,10.685833,10.830346,141863303,155213498.15,72.03694157754259,60.9875610012263,NaN,NaN,163.20555985912642,125.91113436651851,0.09537754420688552,0.26288934205028447,0.16751179784339895,-4464375305,-4739667390.2,69.99787766771264,55.18274434008528,NaN,NaN,23.781680722118043,11.869471558160527
2009-08-04T09:30:00-04:00,10.773515,11.106382,10.732921,11.049551,123263419,155391201.5,74.84479458345965,62.162379048457375,NaN,NaN,172.6262820788344,138.34042195634729,0.11238949174327406,0.30799866252249153,0.19560917077921747,-4341111886,-4621914627,75.208997837609,56.69889165496295,NaN,NaN,27.904275957936985,14.160157900985734
2009-08-05T09:30:00-04:00,11.1145,11.487961,11.057669,11.43113,205392883,153247219.85,78.82983425544023,63.672800344190826,NaN,NaN,202.45950166022385,158.81396465143774,0.1397287568812687,0.37027011688080336,0.23054135999953465,-4135719003,-4463083287.2,80.20373046110939,58.53325634121518,NaN,NaN,33.037762615111596,16.856958574432284
2009-08-06T09:30:00-04:00,11.609741,11.650334,11.249271,11.349943,290798714,159742914,76.06863887522037,65.09162626290015,NaN,NaN,184.08573598872317,169.88264478958519,0.14225670004863256,0.4083622350603253,0.26610553501169276,-4426517717,-4394792503.8,81.89291565053018,60.507009324988346,NaN,NaN,36.264015029029196,19.62939521080327
2009-08-07T09:30:00-04:00,11.512317,11.853302,11.447367,11.650334,233184504,165511910.5,78.9996541278907,66.61545112874606,NaN,NaN,180.42834850257444,180.56108561789648,0.15312805305116123,0.4575156013256443,0.30438754827448306,-4193333213,-4312211424.8,83.70377252612812,62.80599615781809,NaN,NaN,40.06887706253899,22.54932118962266
2009-08-10T09:30:00-04:00,11.634097,11.731521,11.463604,11.601622,117226196,157457572.75,77.34533783637923,68.1777041521039,NaN,NaN,146.3441789591735,177.1888094379059,0.14603105171195013,0.4869263629144207,0.3408953112024706,-4310559409,-4281448245.6,84.3323722583,65.29547992694496,NaN,NaN,42.559262595397215,25.407884247590452
2009-08-11T09:30:00-04:00,11.528554,11.536673,11.155094,11.171331,157739303,155575155.15,64.49707626822419,68.8104301776554,NaN,NaN,94.81445271612361,161.62644356536373,0.10335955586586965,0.47009475603480766,0.366735200168938,-4468298712,-4306885610.8,81.5318439237087,67.84119638182115,NaN,NaN,40.39921043045565,27.54950227371405
2009-08-12T09:30:00-04:00,11.138856,11.487961,11.130738,11.398655,128645817,150857188.95,67.5627244239734,69.2735623692658,NaN,NaN,88.2809059068773,138.79072441469444,0.08235944203507134,0.4696845027127772,0.38732506067770583,-4339652895,-4347672389.2,77.11014531401412,69.95725706413286,NaN,NaN,39.64314616667515,29.27716568699421
2009-08-13T09:30:00-04:00,11.577266,11.642216,11.36618,11.634097,166322963,151775893.7,70.41237510723221,70.05250772684637,NaN,NaN,98.77052775488426,121.72768276792662,0.07637374924193757,0.4827922472301278,0.40641849798819024,-4173329932,-4297034832.2,78.6576837644037,71.96170074217382,NaN,NaN,39.97657936111247,30.80565335472539
2009-08-14T09:30:00-04:00,11.625978,11.634097,11.36618,11.561029,133489115,149782544.05,68.40394658457015,70.47578617986879,NaN,NaN,86.06039016285565,102.85409109998288,0.06025012589691375,0.4817311553593324,0.42148102946241867,-4306819047,-4319731999,76.17182549315356,73.60322842438964,NaN,NaN,39.585492690535354,32.059916116983956
2009-08-17T09:30:00-04:00,11.220043,11.236281,11.057669,11.073907,141759148,150086033.05,56.776792049784966,70.12082539221954,NaN,NaN,37.496296023385725,81.08451451282531,0.012056189866464395,0.43655126679549916,0.42449507692903476,-4448578195,-4347335756.2,73.14423893196312,74.7564664988638,NaN,NaN,35.098917236101876,32.4940591340008
2009-08-18T09:30:00-04:00,11.17945,11.349943,11.163212,11.30123,99704396,147222609.15,60.17852304555563,70.00884538998248,NaN,NaN,48.993123029295795,71.92024857545977,-0.008145658755801422,0.414313003484283,0.42245866224008444,-4348873799,-4323450773.6,74.10338897904236,75.8579311056526,NaN,NaN,32.61193876703478,32.51089908157708
2009-08-19T09:30:00-04:00,11.122619,11.36618,11.098263,11.293112,96337768,145880552.9,59.99692869166078,69.56673365260241,NaN,NaN,41.60919371798247,62.585906137680794,-0.024750323983606826,0.3915207572605759,0.4162710812441827,-4445211567,-4344562508,71.66697094841744,76.66040325755937,NaN,NaN,30.64154842112692,32.243848987227054
2009-08-20T09:30:00-04:00,11.325586,11.609741,11.317468,11.585385,111336859,143611442.85,64.18703834264586,69.29575755497,NaN,NaN,69.86826713664625,56.80545401403318,-0.019003237512951687,0.3925170343529931,0.4115202718659448,-4333874708,-4376671463.2,68.00478693026378,76.83789647759686,NaN,NaN,30.308866084526343,31.96742285826981
2009-08-21T09:30:00-04:00,11.715284,11.869539,11.650334,11.812709,134463714,145865579.1,67.07565842218267,68.94138018673,NaN,NaN,104.13176837620755,60.419729656703566,-0.003649359097534388,0.4069585729940268,0.4106079320915612,-4199410994,-4355189852.6,69.14092059562388,76.77668525816195,NaN,NaN,30.9740885351053,31.825517954960596
2009-08-24T09:30:00-04:00,11.983201,12.064388,11.690928,11.721779,152665525,147821368.1,64.82334807763404,68.22556257917104,NaN,NaN,107.83939974440135,74.48835040090668,-0.0033809144362999533,0.40638178904618627,0.4097627034824862,-4352076519,-4335889517.4,70.16595686096841,76.41646804554476,NaN,NaN,30.801601463709037,31.679244170496087
2009-08-25T09:30:00-04:00,11.812709,11.983201,11.812709,11.869539,116401177,149953669.1,66.77568045578374,67.36455159348128,NaN,NaN,117.78523369072958,88.24677253319344,0.002658544253031192,0.4130858837987752,0.410427339545744,-4235675342,-4313249826,71.3674110548954,75.78530237367234,NaN,NaN,31.25800192161851,31.61906670637072
2009-08-26T09:30:00-04:00,11.80459,11.917034,11.699047,11.837065,114059600,149414574.9,65.9098887493549,66.6389265844909,NaN,NaN,101.50405409256514,100.22574460810998,0.0004903921471927086,0.4110403297297349,0.4105499375825422,-4349734942,-4294154501,72.37781350931216,75.10565222072819,NaN,NaN,31.372943580608993,31.58390625983333
2009-08-27T09:30:00-04:00,11.828946,11.983201,11.699047,11.958845,100346804,146336711.7,67.60611211206884,65.82510215478933,NaN,NaN,108.24359003887747,107.90080918855622,0.0031345389305063587,0.4144681112456752,0.4113335723151688,-4249388138,-4277257187,73.27648839201534,74.3608462111487,NaN,NaN,31.959181538860015,31.63751701398
2009-08-28T09:30:00-04:00,12.072507,12.096863,11.837065,11.975083,99370510,143218585.9,67.83592109026534,65.14585810149549,NaN,NaN,122.7269653843904,111.6198485901928,0.0019137427612730962,0.4137257507667602,0.4118120080054871,-4150017628,-4267378513.8,73.81289929460581,73.60945528517054,NaN,NaN,32.50338497434933,31.761212436889902
2009-08-31T09:30:00-04:00,11.755878,11.942608,11.73964,11.934489,101530185,141201930,66.5645828066597,65.29353713995518,NaN,NaN,91.36967544196587,108.32590372970571,-0.005296775898716466,0.40519103813209156,0.41048781403080803,-4251547813,-4247272772.6,74.91646687034026,73.13692835278708,NaN,NaN,32.62124365218502,31.88407403907492
2009-09-01T09:30:00-04:00,11.845183,11.975083,11.268756,11.293112,234868813,146782199.7,50.470247331882604,64.07264591909153,NaN,NaN,-17.51270291258188,81.26631640904341,-0.05421204437039728,0.3427227585678114,0.3969348029382087,-4486416626,-4297421029.4,67.29852749975807,72.43609850891166,NaN,NaN,27.523651635927703,31.261156552911032
2009-09-02T09:30:00-04:00,11.195687,11.36618,11.155094,11.195687,130072548,143016182.95,48.54998462406839,62.511046598865555,NaN,NaN,-98.77269758951266,41.21096607262784,-0.09186551678280958,0.28210290695969675,0.37396842374250633,-4616489174,-4350771875.8,60.27627000801701,71.12314038345546,NaN,NaN,22.781142726770277,30.049726006319496
2009-09-03T09:30:00-04:00,11.317468,11.455486,11.236281,11.414892,97545488,133353521.65,52.89285368903648,61.403111392041716,NaN,NaN,-58.09406592153707,7.943434880544932,-0.10007048936942825,0.24888031203072103,0.3489508014001493,-4518943686,-4404682985.4,54.12975571972251,69.54870682821038,NaN,NaN,20.07996881404406,28.625474978851578
2009-09-04T09:30:00-04:00,11.487961,11.544791,11.382417,11.544791,89331878,126160890.35,55.30071694498158,61.297677455984335,NaN,NaN,-19.335265821578336,-20.469011360648818,-0.0948588139538693,0.23037728395781265,0.32523609791168195,-4429611808,-4460601821.4,48.5945401632784,67.79515691616147,NaN,NaN,18.581668122435413,27.19064542793498
2009-09-08T09:30:00-04:00,11.715284,11.731521,11.528554,11.594397,99428174,125270989.25,56.22100522919014,61.01499761195822,NaN,NaN,18.98019382530167,-34.94690768398166,-0.08641895738732702,0.21721240117752316,0.3036313585648502,-4330183634,-4476328985.6,47.134664486251786,65.86881945239072,NaN,NaN,17.63393236095134,25.825400704080177
2009-09-09T09:30:00-04:00,11.625978,11.812709,11.593504,11.772115,111406762,122954362.2,59.44263038720364,60.97540487592557,NaN,NaN,45.50959271800548,-22.34244855786419,-0.06802539581137534,0.21859961380063098,0.2866250096120063,-4218776872,-4422801034.8,52.37847048445963,64.49106941925088,NaN,NaN,17.773476419399366,24.675125806268632
2009-09-10T09:30:00-04:00,11.731521,11.893896,11.593504,11.869539,114302792,122237210.95,61.13123953166995,60.757133532284435,NaN,NaN,57.27448938752439,8.86698883754322,-0.04932639752396717,0.22496701270704733,0.2742934102310145,-4104474080,-4320398016,60.45900426500273,63.952084943160806,NaN,NaN,18.383331763369654,23.776298085854492
2009-09-11T09:30:00-04:00,11.910133,11.918252,11.784293,11.796471,80499252,117946025.4,59.1423800476325,60.190470791245126,NaN,NaN,65.15837070441275,33.51747616273318,-0.04218416611390613,0.22156320258863182,0.26374736870253795,-4184973332,-4253603945.2,64.67004663020779,63.63273680277394,NaN,NaN,18.3327047350784,22.99864189288648
2009-09-14T09:30:00-04:00,11.642216,11.983201,11.634097,11.950726,88976609,115720400.1,61.95635201467864,59.98568535817689,NaN,NaN,65.45341847226227,50.475213021501304,-0.028056530823702075,0.2286767051729104,0.25673323599661246,-4095996723,-4186880928.2,68.3016702662101,63.49957347457691,NaN,NaN,19.09593546497678,22.441112403185095
2009-09-15T09:30:00-04:00,11.983201,12.096863,11.828946,11.975083,129184327,115091659.05,62.39674598089131,59.67290432425601,NaN,NaN,92.25691387153593,65.13055703074815,-0.01851701408349793,0.23358696839224002,0.25210398247573795,-3966812396,-4114206680.6,71.71237278499194,63.52421359815524,NaN,NaN,19.848407012532263,22.07072591880612
2009-09-16T09:30:00-04:00,12.048151,12.389136,12.015676,12.389136,153681471,117790512.8,68.97221582493381,59.89164197251164,NaN,NaN,174.46445382063305,90.92152925127367,0.012558373945160017,0.267801949907188,0.25524357596202796,-3813130925,-4033077491.2,74.95244095802698,63.70811555877773,NaN,NaN,22.617577335324622,22.148847549737333
2009-09-17T09:30:00-04:00,12.381017,12.527154,12.259237,12.348543,138025644,119874906.6,67.7219263888763,59.89991442085504,NaN,NaN,200.50574792601145,119.56778095897107,0.026459937029590097,0.2883184972490156,0.2618585602194255,-3951156569,-4002413989,76.06818006876229,63.9075221071168,NaN,NaN,24.49995605798363,22.484720193772517
2009-09-18T09:30:00-04:00,12.36478,12.381017,12.218725,12.291712,112479682,119932047.75,65.9202610061436,59.76308155770348,NaN,NaN,157.22844871742686,137.9817965615739,0.027771957669271208,0.2965735073060145,0.2688015496367433,-4063636251,-3978146572.8,76.94351995811058,64.1311378687957,NaN,NaN,25.55166369105305,22.922854979098307
2009-09-21T09:30:00-04:00,12.17805,12.243,12.137456,12.17805,103649756,118391349.85,62.347697719552905,59.461875480053,NaN,NaN,106.63051407932973,146.2172156829874,0.01743419915296851,0.29059429857795394,0.2731600994249854,-4167286007,-3992404429.6,75.20310753961479,64.15161220231532,NaN,NaN,25.443335136918087,23.282923573072562
2009-09-22T09:30:00-04:00,12.356418,12.470323,12.283593,12.454086,105901033,116053125.25,67.02203438312557,60.6441459837132,NaN,NaN,146.78991936288514,157.12381678125726,0.025166387027152126,0.3046180832089256,0.27945169618177346,-4061384974,-4011318945.2,72.84898383822637,64.54807336934877,NaN,NaN,26.752817820685564,23.77862275130299
2009-09-23T09:30:00-04:00,12.478442,12.535273,12.186169,12.202406,134165637,116941348.25,59.73987134123778,61.443423606368164,NaN,NaN,104.91877503812641,143.21468102475592,0.010084171594786528,0.29205691067525663,0.2819727390804701,-4195550611,-4087802882.4,64.10968071659349,64.82188841996138,NaN,NaN,25.63115646565805,24.043270424782285
2009-09-24T09:30:00-04:00,12.275474,12.307949,11.885777,11.958845,163380147,119407375.6,53.66323346902157,61.49845073350995,NaN,NaN,36.87352240849358,110.48823592125234,-0.018011883440889276,0.2594578847793585,0.27746976822024777,-4358930758,-4169357720.2,56.34736831155111,64.9802893193777,NaN,NaN,22.698267732104224,23.851127182971133
2009-09-25T09:30:00-04:00,11.893896,11.999439,11.755878,11.845183,143817586,121580914.7,51.05338184617649,61.195069655023865,NaN,NaN,-8.024464972934284,77.43765318318012,-0.044461015950407634,0.22189349828223826,0.2663545142326459,-4502748344,-4257180138.8,49.409608439434855,65.0385084819603,NaN,NaN,19.468002239562686,23.224966476769925
2009-09-28T09:30:00-04:00,11.910133,12.259237,11.893896,12.243,96661189,121445448.65,58.63592697317126,61.36756406530823,NaN,NaN,53.07880065769052,66.72731049885228,-0.03574865157476975,0.22166869976418369,0.25741735133895344,-4406087155,-4304940368.4,46.08635342390046,64.96362912036379,NaN,NaN,19.071744626456546,22.6316490695823
2009-09-29T09:30:00-04:00,12.291712,12.381017,12.161813,12.186169,127242440,122731061.4,57.27098678036796,61.21244666481997,NaN,NaN,71.16645667876091,51.60261796202742,-0.0343875534912049,0.2144329094749473,0.2488204629661522,-4533329595,-4399329292.6,40.315225934735174,64.10196879538348,NaN,NaN,18.323411712555256,22.016186590007006
2009-09-30T09:30:00-04:00,12.259237,12.29983,11.99132,12.129338,180112737,119993257.6,55.8703802791287,60.83667100392416,NaN,NaN,42.90297719310835,39.199458393023825,-0.03762706152217088,0.2017866360634386,0.2394136975856095,-4713442332,-4502907636.8,35.11821774828569,62.29191261561797,NaN,NaN,17.293521960197463,21.341520214319928
2009-10-01T09:30:00-04:00,12.064388,12.088744,11.585385,11.593504,157603734,121369816.9,44.75646869208521,59.80910590709936,NaN,NaN,-59.12019240017984,20.00071543128913,-0.07406341271042996,0.14683443169757204,0.220897844408002,-4871046066,-4605330698.4,30.87921217757794,59.87828158328726,NaN,NaN,12.46857531496503,20.07395665726923
2009-10-02T09:30:00-04:00,11.398655,11.735581,11.341824,11.601622,159079497,124446517.35,44.93518449712561,58.593308227274136,NaN,NaN,-116.88727110131327,-1.7718457943866668,-0.09451429695444766,0.10275497321494242,0.19726927016939008,-4711966569,-4647174343.4,29.322021256424208,57.09402093973113,NaN,NaN,8.80571088584445,18.464207261351405
2009-10-05T09:30:00-04:00,11.747759,11.99132,11.715284,11.966964,121845024,126072174.65,52.39858326732175,57.87915374773345,NaN,NaN,-35.78215809015801,-19.544037543956374,-0.08086111272158172,0.09619287926741293,0.17705399198899466,-4590121545,-4683981221.4,27.985156284816128,53.97064833257571,NaN,NaN,8.060419193426052,16.977951823076353
2009-10-06T09:30:00-04:00,12.129338,12.251118,11.942608,12.121219,157106669,128956099.4,55.16191992316365,56.89270404046415,NaN,NaN,21.477028864108508,-29.481923106886853,-0.059834661921175175,0.1022606645875257,0.16209532650870087,-4433014876,-4663918277.6,29.862291557897024,50.74992337542358,NaN,NaN,8.363851899619808,15.747366119725418
2009-10-07T09:30:00-04:00,12.064388,12.259237,12.039951,12.251118,120771256,129424324.1,57.4044064126057,56.155738327873394,NaN,NaN,41.51491241811119,-29.759536061886287,-0.036706999497781834,0.11621157713647357,0.1529185766342554,-4312243620,-4583678535.2,36.941676397138664,47.95517311316474,NaN,NaN,9.329549701604458,14.830535202850996
2009-10-08T09:30:00-04:00,12.340424,12.413492,12.226762,12.267356,112689154,129343642.2,57.689275094275665,55.56781076273997,NaN,NaN,75.55994014198747,-2.8235095534528227,-0.020644645427478847,0.12711276984990683,0.14775741527738567,-4199554466,-4449380215.2,46.648106359696925,45.791214998992345,NaN,NaN,10.182839867562828,14.166578726381257
2009-10-09T09:30:00-04:00,12.234881,12.381017,12.210525,12.372899,73881109,129012735.05,59.581371183683416,55.37021601017786,NaN,NaN,76.7242497335629,35.89879461352241,-0.004106415107123562,0.14262439639348123,0.1467308115006048,-4125673357,-4332121572.8,53.393707060984354,44.23340067909016,NaN,NaN,11.455852632972508,13.77933214160858
2009-10-12T09:30:00-04:00,12.42973,12.486561,12.356661,12.470323,91697104,129148759.8,61.30167857384212,54.96161916665762,NaN,NaN,111.10270626046703,65.27576748364743,0.01135434760412185,0.1609237460057571,0.14956939840163525,-4033976253,-4220892514.4,58.72481963696281,43.22453180757134,NaN,NaN,13.025515467370196,13.67164404528881
2009-10-13T09:30:00-04:00,12.389136,12.42973,12.240889,12.348543,91591018,127269094.35,57.979712211454576,54.83589351453024,NaN,NaN,68.51529709034244,74.68342112889421,0.011314329728545791,0.1637123105623175,0.1523979808337717,-4125567271,-4159402993.4,61.356410022005115,43.027869615100734,NaN,NaN,13.421595501103322,13.635922824690883
2009-10-14T09:30:00-04:00,12.61646,12.795071,12.527154,12.770715,164563528,127813197.2,65.0504210164861,55.64926405363485,NaN,NaN,178.0592296626472,101.99228457780141,0.03624877890717956,0.19770895446774617,0.1614601755605666,-3961003743,-4089155018,64.16719427446486,43.58642861245172,NaN,NaN,16.050473853318824,13.980858685923446
2009-10-15T09:30:00-04:00,12.632697,12.681409,12.543391,12.657053,103101944,126067012.2,62.024366035758845,56.43290578146217,NaN,NaN,141.20882226863813,115.12206100313153,0.04125134279781573,0.21302435405783626,0.17177301126002054,-4064105687,-4062065262.2,65.21785469619483,44.71558905936315,NaN,NaN,17.282552466959515,14.452529226071455
2009-10-16T09:30:00-04:00,12.421611,12.454086,12.324187,12.356661,138853284,127385692.3,54.77254060644532,56.15694961241031,NaN,NaN,57.89930951518833,111.35707295945663,0.021488051950032533,0.1986330761975612,0.17714502424752868,-4202958971,-4077522385,64.06360131089045,45.999678194148146,NaN,NaN,16.039328172604904,14.679214789861948
2009-10-19T09:30:00-04:00,12.405374,12.478442,12.29983,12.413492,114281389,127917273.95,55.824852867383235,56.05365433291139,NaN,NaN,58.2161330541907,100.77975831820136,0.009986189215032304,0.18962776076631904,0.17964157155128674,-4088677582,-4088462650.8,63.210873669825205,47.635081603797445,NaN,NaN,15.362839054479188,14.776875399092983
2009-10-20T09:30:00-04:00,12.389136,12.462204,12.241213,12.316068,131471708,129195807.7,53.52568838570134,55.88617634052373,NaN,NaN,42.149488361584865,95.50659657244984,-0.005601578056252027,0.1726395989809717,0.17824117703722372,-4220149290,-4107379054.6,61.682064499246486,49.532499228866065,NaN,NaN,14.115387133841633,14.682377075485647
2009-10-21T09:30:00-04:00,12.283593,12.486561,12.072507,12.080626,105909960,127783023.85,48.343823172371,56.14241594625843,NaN,NaN,4.451451134672873,60.78504086685498,-0.03172839381114148,0.13858068477329688,0.17030907858443836,-4326059250,-4180390156,56.04758977869092,51.33024048608843,NaN,NaN,11.427107186649689,14.217338519937654
2009-10-22T09:30:00-04:00,12.137456,12.462204,12.088744,12.437848,148555960,127041814.5,55.39899279841151,56.88983082492171,NaN,NaN,37.51020461956375,40.0453173370401,-0.02519652278954984,0.13881342509750105,0.1640099478870509,-4177503290,-4203069676.6,54.385675146887344,53.120501478264366,NaN,NaN,11.297366623912552,13.800199677648353
2009-10-23T09:30:00-04:00,12.462204,12.502798,12.17805,12.259237,108887422,125295306.3,51.60389989690826,56.83306772703503,NaN,NaN,27.306643025118984,33.92678403902623,-0.03267541335695953,0.12316568119085147,0.155841094547811,-4286390712,-4219756024.8,53.1372487307259,54.91707951011506,NaN,NaN,9.967166475922088,13.252623505973173
2009-10-26T09:30:00-04:00,12.251118,12.291712,11.877658,11.942608,149707613,127947627.5,45.63558978363397,56.15261557421148,NaN,NaN,-65.78196372761084,9.12716468266593,-0.05727743450116163,0.08424430142135897,0.1415217359225206,-4436098325,-4289240173.4,48.1777885428893,56.225329294757366,NaN,NaN,6.819459743290743,12.333600111304253
2009-10-27T09:30:00-04:00,11.950726,11.999439,11.780234,11.853302,125418246,127856417.8,44.086801410252654,55.201358074043405,NaN,NaN,-103.84775550258706,-20.07228409016845,-0.07668445390815633,0.04566616853732519,0.12235062244548152,-4561516571,-4357513629.6,43.84737135217237,56.718593220116915,NaN,NaN,3.8061335797571054,11.115390606797519
2009-10-28T09:30:00-04:00,11.80459,11.853302,11.455486,11.486337,145111586,126106360.25,38.33029187314728,53.818573558248524,NaN,NaN,-158.15826100420307,-52.59422651794364,-0.10936276818010576,-0.014352837779650685,0.09500993040045508,-4706628157,-4433627411,39.57650120048007,56.213478565887144,NaN,NaN,-0.7917491798047553,9.414370637282907
2009-10-29T09:30:00-04:00,11.690928,11.983201,11.601622,11.966964,147383280,125595337.55,47.92157445823791,52.985730935002415,NaN,NaN,-93.62276748645043,-78.82082093914649,-0.09430562055217603,-0.02287209528976497,0.07143352526241106,-4559244877,-4509975728.4,35.80874525588159,54.957409865522656,NaN,NaN,-1.4667086037186245,7.85993074571126
2009-10-30T09:30:00-04:00,11.861421,11.861421,11.341824,11.406774,168914353,126087080.35,40.094469821798874,51.470930309856456,NaN,NaN,-178.86106582527054,-120.05436270922442,-0.11632569857079378,-0.07397359795108116,0.04235210061971262,-4728159230,-4598329432,32.010775250389344,53.04926383791026,NaN,NaN,-5.015169548972387,6.020630703613596
2009-11-02T09:30:00-05:00,11.496079,11.699047,11.187569,11.504198,209506053,130470131.8,41.872610704361676,50.32042305934983,NaN,NaN,-173.58243815304007,-141.61445759431027,-0.1181982154721509,-0.10539566872047601,0.01280254675167489,-4518653177,-4614840402.4,31.341786675891143,50.90536217033069,NaN,NaN,-7.078510736546119,4.14932478359078
2009-11-03T09:30:00-05:00,11.309349,11.585385,11.30123,11.535049,135093746,129369485.65,42.45510811879527,48.7064721380862,NaN,NaN,-141.7567942603016,-149.1962653458532,-0.1113236066494047,-0.126351961560081,-0.015028354910676289,-4383559431,-4579248974.4,34.518643718971504,48.78760855922402,NaN,NaN,-8.471226892034053,2.3463888299300892
2009-11-04T09:30:00-05:00,11.707165,11.73964,11.358061,11.374299,157026223,131182234,40.19488952758398,47.14722381607371,NaN,NaN,-116.92194561498515,-140.94900226800956,-0.11130064642414203,-0.15415416294085382,-0.0428535165167118,-4540585654,-4546040473.8,37.427851748443764,46.802608348670375,NaN,NaN,-10.32774169378604,0.5357987551134993
2009-11-05T09:30:00-05:00,11.471723,11.682809,11.390536,11.666572,128930671,131994309.85,45.840578016076925,46.509226488190244,NaN,NaN,-87.9498445419231,-139.8144176791041,-0.08640882421156229,-0.15086454678116468,-0.06445572256960239,-4411654983,-4516522495,39.98039030559167,45.082378991149035,NaN,NaN,-10.087928535507858,-0.9818765721181231
2009-11-06T09:30:00-05:00,11.471723,11.672904,11.455486,11.61786,91116952,132856102,45.07680607759358,45.741508860348134,NaN,NaN,-78.25979309206238,-119.69416313246248,-0.06879847445520018,-0.1504538156386026,-0.08165534118340242,-4502771935,-4471445036,43.75386485621577,43.692592647319785,NaN,NaN,-10.128772470175345,-2.2885759861262978
2009-11-09T09:30:00-05:00,11.780234,12.048151,11.707165,12.031913,123356419,134439067.75,52.345003464531985,45.65717422312175,NaN,NaN,-13.483622123580707,-87.6743999265706,-0.026985787366419725,-0.11538757539142708,-0.08840178802500735,-4379415516,-4443597503.8,46.01203762573431,42.57330501349749,NaN,NaN,-7.80298872940638,-3.0763492351663095
2009-11-10T09:30:00-05:00,11.975083,12.072507,11.877658,11.99132,86780060,134198519.85,51.62372958913904,45.89145325289089,NaN,NaN,-0.8359819216425367,-59.49023745883879,-0.0011483737802257254,-0.08983725525028952,-0.08868888147006379,-4466195576,-4460124732.8,44.86089166271727,41.7742551480708,NaN,NaN,-6.173526436271174,-3.5188031210384327
2009-11-11T09:30:00-05:00,12.1131,12.283593,12.072507,12.153694,123507458,132145716.35,54.334326038216176,45.815405627162654,NaN,NaN,44.02864141228644,-27.30012005338447,0.02627710510075143,-0.0558425000941245,-0.08211960519487593,-4342688118,-4420545225.6,48.20298577900297,41.33263447893621,NaN,NaN,-3.9837622305828346,-3.5852258509733472
2009-11-12T09:30:00-05:00,12.129338,12.210525,11.902014,11.92637,112872908,132634264.55,50.101803095527046,45.708112998492574,NaN,NaN,19.617645066344114,-5.786622131731016,0.028330756828913103,-0.04670615915873455,-0.07503691598764765,-4455561026,-4429326434.2,47.514876933446345,40.93103649341624,NaN,NaN,-3.377718705964223,-3.5555819731149008
2009-11-13T09:30:00-05:00,11.942608,11.99132,11.80459,11.902014,92165159,130299858.3,49.655491998464214,45.995248870980454,NaN,NaN,-1.1140143496813097,9.642533616745208,0.02726255507878242,-0.04095872213916962,-0.06822127721795204,-4547726185,-4438317284.2,46.77856600487976,40.831092026415554,NaN,NaN,-3.0157291512786277,-3.4784601414240046
2009-11-16T09:30:00-05:00,12.048151,12.194287,11.975083,12.031913,150166445,132094111.1,52.10596693488069,46.56804640845389,NaN,NaN,47.34145280646508,21.807548602754355,0.03407568980419244,-0.025626664962711487,-0.05970235476690393,-4397559740,-4441946129,46.46558686680841,41.01810742031813,NaN,NaN,-2.009035478777109,-3.268542332474448
2009-11-17T09:30:00-05:00,12.007557,12.088744,11.960875,12.064388,70471912,129044121.3,52.725484023294825,47.59627441917871,NaN,NaN,46.02471465422007,31.179687917926877,0.03917650029549437,-0.010731729397535972,-0.04990822969303034,-4327087828,-4414124579.4,49.26809731850961,41.71036428589167,NaN,NaN,-1.0056135709403196,-2.94526679511243
2009-11-18T09:30:00-05:00,12.080626,12.169931,12.031913,12.161813,90644285,128280837.55,54.621860269239505,48.07486626282168,NaN,NaN,71.49672824462284,36.67330528439416,0.04699233231163983,0.008832185696519446,-0.038160146615120384,-4236443543,-4392875664.4,51.3623399440287,42.821335335045035,NaN,NaN,0.3690529036648634,-2.4717925524299593
2009-11-19T09:30:00-05:00,12.088744,12.096863,11.877658,11.92637,95856489,125645864,49.45843562804271,48.74372096326767,NaN,NaN,35.269858522105764,39.80374797554649,0.03475020524094597,0.005277609936062078,-0.029472595304883893,-4332300032,-4368223465.6,53.74785053991567,44.3739835700112,NaN,NaN,0.16432543395989826,-2.09520426865998
2009-11-20T09:30:00-05:00,11.828946,11.92637,11.80459,11.853302,65258093,123464397.55,47.94372642804801,49.177372086388125,NaN,NaN,11.167506046187647,42.26005205472028,0.020861080947468573,-0.0033962441205481753,-0.024257325068016748,-4397558125,-4338189853.6,56.54420949831472,46.174156628755746,NaN,NaN,-0.42460233910248374,-1.8565468501517661
2009-11-23T09:30:00-05:00,11.983201,12.104982,11.958845,12.023795,91262611,120542147.45,51.66359225263719,49.83512095309112,NaN,NaN,65.61526583405737,45.91481466023875,0.022163688942395725,0.0034472861099779095,-0.018716402832417815,-4306295514,-4319937008.4,58.19831232300381,47.86556152904377,NaN,NaN,0.09428785743631447,-1.5778561776391833
2009-11-24T09:30:00-05:00,11.99132,12.029153,11.869539,11.934489,75323211,118037395.7,49.66172724625903,50.5113236472822,NaN,NaN,36.671238438033974,44.044119417001525,0.016289614786860966,0.0016456156511583941,-0.014643999135702572,-4381618725,-4330843187.8,56.80694114295506,49.24978220008029,NaN,NaN,-0.013421232792861343,-1.354365471232566
2009-11-25T09:30:00-05:00,11.999439,12.007557,11.885777,11.910133,54316045,113497618.65,49.102913017096206,50.74434757592643,NaN,NaN,30.0046195198392,35.74569767204479,0.010333093906343288,-0.001727631752773462,-0.01206072565911675,-4435934770,-4370741433.2,51.91695458845712,50.10239393457067,NaN,NaN,-0.25158289301589415,-1.1968251029158985
2009-11-27T09:30:00-05:00,11.569148,11.772115,11.528554,11.593504,93380487,110797479,42.42026721537482,50.554594800053664,NaN,NaN,-65.11402784440146,15.668920398743342,-0.014038583585056589,-0.029608955140437487,-0.015570371555380899,-4529315257,-4410144478.2,47.56251984508511,50.37444071948992,NaN,NaN,-2.403453234292328,-1.3692005502553883
2009-11-30T09:30:00-05:00,11.650334,11.92637,11.642216,11.902014,124489447,108576233.7,49.61544968767436,50.35962667313526,NaN,NaN,-9.258266375830905,11.58376591433963,-0.008748013559887798,-0.026505388505240646,-0.017757374945352847,-4404825810,-4411598015.2,47.40456834177949,50.473907199207424,NaN,NaN,-2.1693868893096924,-1.4835128844060033
2009-12-01T09:30:00-05:00,11.983201,12.015676,11.845183,11.910133,106819978,103441929.95,49.793258051626516,50.22887870617008,NaN,NaN,20.254456159311715,2.511603979390504,-0.00429337522694033,-0.02312409397902826,-0.01883071875208793,-4298005832,-4409940078.8,47.61824908134252,50.6708613005378,NaN,NaN,-1.9296920414620067,-1.5472527639854323
2009-12-02T09:30:00-05:00,11.885777,11.958845,11.837065,11.902014,76542815,100514383.4,49.60473579771953,49.891050831848894,NaN,NaN,2.410115021517511,-4.340620703912789,-0.001622687940812672,-0.02085907867810377,-0.0192363907372911,-4374548647,-4408526063.2,47.81298712867711,50.64300425408595,NaN,NaN,-1.784921982350439,-1.5812055094661475
2009-12-03T09:30:00-05:00,11.999439,12.129338,11.634097,11.658453,205532215,102939683,44.19856081776053,49.46939066915129,NaN,NaN,-57.279425230872114,-21.79742965405505,-0.01523180842110295,-0.03827615126366979,-0.023044342842566838,-4580080862,-4437355281.6,44.20468840850062,50.406562216589826,NaN,NaN,-3.2158297535049805,-1.814723258614552
2009-12-04T09:30:00-05:00,11.877658,11.92637,11.674691,11.877658,240861458,108536222.35,49.5298133988478,49.46041362632155,NaN,NaN,-61.135253517097254,-21.001674788594208,-0.008764023046798648,-0.03399937165106515,-0.0252353486042665,-4339219404,-4399336111,49.605895091440104,50.60851429420128,NaN,NaN,-2.893906132864281,-1.9688922406502276
2009-12-07T09:30:00-05:00,11.828946,11.902014,11.642216,11.682809,99977838,108979266.65,45.37954306614178,48.979954778554486,NaN,NaN,-130.5245763632393,-45.25493678607589,-0.016455458027022876,-0.045804671138045094,-0.029349213111022218,-4439197242,-4406210397.4,48.68814178924583,50.76726821723253,NaN,NaN,-3.873147409000056,-2.2409286932716315
2009-12-08T09:30:00-05:00,11.609741,11.666572,11.544791,11.577266,133794425,109501166.95,43.26478736506258,48.3041907315379,NaN,NaN,-186.21424203786813,-86.54867642551186,-0.026881614682282708,-0.0629512314638756,-0.03606961678159289,-4572991667,-4461207564.4,41.99423421383351,50.247706566898515,NaN,NaN,-5.322469634710785,-2.681148827762939
2009-12-09T09:30:00-05:00,11.601622,11.682809,11.512317,11.61786,90684863,109696407.1,44.33918912463749,47.569714221209175,NaN,NaN,-152.9313751356298,-117.6169744569413,-0.02908789496804432,-0.0724294854916483,-0.04334159052360397,-4482306804,-4482759195.8,39.69132596852929,49.41406271150571,NaN,NaN,-6.207393510038879,-3.1848980680880734
2009-12-10T09:30:00-05:00,11.650334,11.707165,11.544791,11.601622,86265811,107834324.75,43.9804087668656,47.17842658826795,NaN,NaN,-128.38124585475833,-131.83733858171857,-0.02958704740616379,-0.0803253997813087,-0.050738352375144916,-4568572615,-4480457546.4,40.06931561890974,48.43702450286243,NaN,NaN,-7.035776157611158,-3.735023509448514
2009-12-11T09:30:00-05:00,11.609741,11.690928,11.512317,11.682809,81326143,106256986.5,46.31923650742017,47.06239159393739,NaN,NaN,-107.9417380361374,-141.1986354855266,-0.02270516802300769,-0.07911981240390453,-0.05641464438089684,-4487246472,-4510062960,36.86842143201486,47.0316110695553,NaN,NaN,-7.11532499399849,-4.217923721527082
2009-12-14T09:30:00-05:00,11.715284,11.755878,11.601622,11.747759,73010802,105299268.65,48.18307088209755,46.813782924613136,NaN,NaN,-64.86639541038583,-128.0669992949559,-0.012542218114356615,-0.07209241702384261,-0.059550198909486,-4414235670,-4505070645.6,37.77116938343821,45.5725294310149,NaN,NaN,-6.684883388777256,-4.57034653113425
2009-12-15T09:30:00-05:00,11.674691,11.723403,11.512317,11.561029,105435441,103062718.45,43.506160813330894,46.37409960797542,NaN,NaN,-102.46742173328552,-111.31763523403939,-0.01688855877043237,-0.08066089737252646,-0.0637723386020941,-4519671111,-4494406534.4,39.75298310530496,44.35438957118275,NaN,NaN,-7.5950175981571455,-5.002442397851807
2009-12-16T09:30:00-05:00,11.634097,11.707165,11.585385,11.634097,112117161,105144980.9,45.72616041380449,46.13290299345458,NaN,NaN,-73.21003620842811,-95.37336744859904,-0.013483005435486445,-0.08062609539645216,-0.06714308996096571,-4407553950,-4479455963.6,42.51692540624394,43.68295891531038,NaN,NaN,-7.76024852334003,-5.396414701492982
2009-12-17T09:30:00-05:00,11.536673,11.569148,11.414892,11.414892,113442260,106284879.65,40.57486127948726,46.001088283748324,NaN,NaN,-141.64285742768232,-98.02568976318382,-0.02401868941959917,-0.09716645173546468,-0.0731477623158655,-4520996210,-4469940682.6,44.269337172996885,43.447731581589785,NaN,NaN,-9.409230067738509,-5.969674039528057
2009-12-18T09:30:00-05:00,11.451426,11.561029,11.374299,11.544791,116360303,107310070.35,44.560615113122054,45.6400286712803,NaN,NaN,-116.34605259039083,-99.70655267403451,-0.020406427743741504,-0.09865579699554239,-0.07824936925180088,-4404635907,-4453418569.6,47.27500754967,43.438477239296255,NaN,NaN,-9.666234231130836,-6.4977540668998826
2009-12-21T09:30:00-05:00,11.601622,11.715284,11.593504,11.715284,71684836,107631407.5,49.361350931817704,45.60917816272253,NaN,NaN,-26.643505965035438,-92.06197478496443,-0.005478743923857582,-0.08509779915662286,-0.07961905523276527,-4332951071,-4437161649.8,50.125271287621324,43.61755025403045,NaN,NaN,-8.450312290669553,-6.776690956009835
2009-12-22T09:30:00-05:00,11.707165,11.747759,11.682809,11.73964,32159966,104676275.25,50.02709619744136,45.63934676270266,NaN,NaN,5.219010539587239,-70.52468833038988,0.006445058655397531,-0.07156273191351836,-0.0780077905689159,-4300791105,-4393385648.6,56.88432931946838,44.2655032676584,NaN,NaN,-7.265132351706381,-6.846468298252199
2009-12-23T09:30:00-05:00,11.755878,11.772115,11.666572,11.690928,47532003,103286714.85,48.649508944323316,45.957271628885714,NaN,NaN,4.723377007291093,-54.93800568724604,0.011183302581316446,-0.06402866234227034,-0.07521196492358678,-4348323108,-4381539480.2,58.52244756544642,45.288200350297394,NaN,NaN,-6.651476767635504,-6.818612365306957
2009-12-24T09:30:00-05:00,11.731521,11.796471,11.723403,11.796471,22500922,101695958.7,51.74972371991332,46.115836651818974,NaN,NaN,52.60275760054763,-16.08888268160006,0.020988095698015075,-0.04897684530106794,-0.06996494099908301,-4325822186,-4342504675.4,63.45025017762408,46.27708285645339,NaN,NaN,-5.247664031278458,-6.594191174731457
2009-12-28T09:30:00-05:00,11.812709,11.845183,11.707165,11.755878,36326623,98843265.5,50.487213279930295,46.48067023851815,NaN,NaN,46.15028646780791,16.410385130039693,0.024080626000087507,-0.03986415849897362,-0.06394478449906113,-4362148809,-4334007255.8,64.4406570508568,47.40226251799703,NaN,NaN,-4.406500005983408,-6.281663864910307
2009-12-29T09:30:00-05:00,11.788352,11.796471,11.707165,11.707165,32466853,94242135.8,48.94407281590036,46.88633348500657,NaN,NaN,28.257276904649984,27.390541703976773,0.022230840411629482,-0.03615623398452428,-0.05838707439615376,-4394615662,-4346340174,61.82224796125731,48.81854921424159,NaN,NaN,-4.099342212330192,-5.969903628827433
2009-12-30T09:30:00-05:00,11.658453,11.723403,11.609741,11.715284,35536073,90677940.55,49.222644191950046,47.23515170410032,NaN,NaN,-1.500486154989337,26.046642365061466,0.02095649267668085,-0.0321914585503027,-0.05314795122698355,-4359079589,-4357997870.8,59.36668036879183,50.2239316714032,NaN,NaN,-3.7693065098663796,-5.655532611832997
2009-12-31T09:30:00-05:00,11.731521,11.788352,11.674691,11.690928,40947875,88898193.55,48.370025700157946,47.54869577076405,NaN,NaN,37.24199064836604,32.550365093276454,0.01798937893590214,-0.030661227557105875,-0.048650606493008015,-4400027464,-4368338742,57.19645291363119,51.447298621026164,NaN,NaN,-3.700352230338999,-5.376221128762426
2010-01-04T09:30:00-05:00,11.788352,11.958845,11.763996,11.92637,93009353,83272050.45,56.25777862091902,48.258591636013975,NaN,NaN,171.3634051718043,56.302494607527784,0.030655513253240146,-0.010331214926457832,-0.04098672817969798,-4307018111,-4364577927,57.80064883167276,52.94245772100172,NaN,NaN,-1.419635278615425,-4.810994578741425
2010-01-05T09:30:00-05:00,11.910133,12.145575,11.893896,12.145575,96831463,76070550.7,62.06818159141217,49.250385258107876,NaN,NaN,272.4379650411922,101.56003032220464,0.05135020737326805,0.023201031036887088,-0.028149176336380963,-4210186648,-4334185494.8,62.417556691425986,54.70291395728656,NaN,NaN,2.4610347884934356,-3.772133240565017
2010-01-06T09:30:00-05:00,12.137456,12.218643,12.048151,12.169931,75541887,74848753.15,62.661654208130386,50.618634786307844,NaN,NaN,258.62350888370565,147.63327671801576,0.06344035168954741,0.051151263275553305,-0.01228908841399411,-4134644761,-4282191314.6,68.72214047359192,56.77213948359277,NaN,NaN,5.807371242346125,-2.4036326001491393
2010-01-07T09:30:00-05:00,12.194287,12.502798,12.169931,12.42973,117946607,74056362.25,68.35001044331815,52.234624074130245,NaN,NaN,274.5098714689482,202.83534824280326,0.08438437437165244,0.09319137955057144,0.008807005178919,-4016698154,-4213715027.6,74.73365592083101,59.073334520348986,NaN,NaN,10.744050403090178,-0.5253921711149512
2010-01-08T09:30:00-05:00,12.36478,12.42973,12.259237,12.356661,111943025,75119270.35,65.3352046520748,54.00322002931507,NaN,NaN,200.07235916982495,235.40142194709506,0.08834472902992202,0.11923791646632154,0.03089318743639951,-4128641179,-4159437770.6,78.29468420386425,61.50371645112523,NaN,NaN,13.897125382208086,1.5349674793597683
2010-01-11T09:30:00-05:00,12.478442,12.486561,12.291712,12.36478,72802315,74446095.55,65.5172071088252,55.50011945757957,NaN,NaN,165.7185028052423,234.27244147378264,0.08643231424608051,0.13893358024400015,0.05250126599791964,-4055838864,-4109201921.2,80.96825758999513,63.910377168291305,NaN,NaN,16.492267998618924,3.6717246963967907
2010-01-12T09:30:00-05:00,12.267356,12.324187,12.104982,12.186169,137700075,77264792.15,58.269208926277,56.13639502861239,NaN,NaN,96.94668278804002,199.17418502315223,0.06882554420116269,0.138533196249373,0.0697076520482103,-4193538939,-4105872379.4,81.13412397588264,66.12529521745283,NaN,NaN,16.620161885044062,5.521501437632115
2010-01-13T09:30:00-05:00,12.186169,12.36478,12.088744,12.324187,100907544,78659629.25,61.787118698134165,56.97639663580473,NaN,NaN,96.8862913672755,166.82674151986618,0.06235448804806365,0.14765076210828987,0.08529627406022622,-4092631395,-4097469706.2,81.57064744109839,67.88860365471211,NaN,NaN,17.805619644603244,7.276375467199419
2010-01-14T09:30:00-05:00,12.283593,12.421611,12.251118,12.381017,70907628,76933238.6,63.16409367569786,58.013152688045764,NaN,NaN,104.14619422891089,132.75400607185873,0.05787895810288175,0.1576449716888284,0.09976601358594665,-4021723767,-4098474828.8,81.32823315870475,69.51758833994485,NaN,NaN,19.193231845714692,8.97878352127303
2010-01-15T09:30:00-05:00,12.307949,12.316068,12.1131,12.129338,118136903,77234225.7,53.90079912045149,58.16680093094135,NaN,NaN,57.30203589285829,104.19994141646539,0.03506855850029546,0.14360171171131597,0.10853315321102051,-4139860670,-4100718727,80.75127742850745,70.75337600072224,NaN,NaN,17.468244354550556,10.191563640312676
2010-01-19T09:30:00-05:00,12.080626,12.291712,12.015676,12.283593,100496779,76586951.65,57.96933730540809,58.70123836133262,NaN,NaN,53.35361609882147,81.72696407518123,0.02778780784716145,0.14326791301997233,0.11548010517281088,-4039363891,-4097423732.4,80.96482482053275,71.93367369855623,NaN,NaN,17.312818870832007,11.208885816101152
2010-01-20T09:30:00-05:00,12.202406,12.332305,12.121219,12.251118,99417847,75739828.85,56.83214569898192,59.26467213869559,NaN,NaN,56.886439501406834,73.7149154178546,0.018642402876706266,0.1387831087686937,0.12014070589198744,-4138781738,-4086472292.2,81.69183161402687,73.35292967375406,NaN,NaN,16.835921988411627,12.01274812643122
2010-01-21T09:30:00-05:00,12.243,12.324187,11.772115,11.902014,310189897,87665081.9,46.314024328451794,59.05691357701715,NaN,NaN,-10.624907522538507,52.21267563989179,-0.011441326938922997,0.1058390472183337,0.1172803741572567,-4448971635,-4157740340.2,64.44281296646548,73.7155105735879,NaN,NaN,12.744054485403197,12.117220463427216
2010-01-22T09:30:00-05:00,11.861421,11.918252,11.447367,11.51394,261094983,99111832.75,37.91387978799849,58.310046011862894,NaN,NaN,-113.14081345233498,8.755274103642616,-0.05553265155734366,0.047864559710577126,0.10339721126792079,-4710066618,-4295408910.4,44.775317655869976,72.82828662660495,NaN,NaN,5.862170181460996,11.223641851717757
2010-01-25T09:30:00-05:00,11.674691,11.723403,11.463604,11.577266,179503260,105710395.6,39.83164129484894,57.13675048857217,NaN,NaN,-118.83583088231315,-26.47229925139167,-0.07715846153869643,0.006949134344550245,0.08410759588324668,-4530563358,-4373549448,37.73564288508761,71.39507191613458,NaN,NaN,1.2712243798161291,9.801867927160382
2010-01-26T09:30:00-05:00,11.504198,11.690928,11.358061,11.374299,151889006,112179799.8,35.99404895823261,55.27431244334507,NaN,NaN,-136.55197032759708,-64.45341653667538,-0.1003879988902984,-0.04137740272962631,0.05901059616067208,-4682452364,-4502167142.6,29.51115098427411,69.04461436562373,NaN,NaN,-3.892617164489409,7.845512914067554
2010-01-27T09:30:00-05:00,11.406774,11.674691,11.358061,11.650334,254824501,123104693.7,43.90898385011153,53.93483598920086,NaN,NaN,-107.16408336372767,-97.26352110970228,-0.09260739759538296,-0.056748650833556624,0.035858746761826335,-4427627863,-4559936367.6,26.69668991914861,66.04279646887777,NaN,NaN,-5.435530645311683,5.948220977013378
2010-01-28T09:30:00-05:00,11.73964,11.796471,11.447367,11.593504,275625250,135262613.55,42.73724271037567,52.10535257970497,NaN,NaN,-90.66015374038949,-113.27057035327248,-0.0868297098147604,-0.07267839050662417,0.014151319308136234,-4703253113,-4610792663.2,24.48304764700309,62.45346730646149,NaN,NaN,-7.023061527746459,4.095180619190544
2010-01-29T09:30:00-05:00,11.674691,11.832437,11.479842,11.512317,222970968,144634358.3,41.05183719596708,50.37082633284013,NaN,NaN,-89.35817198760445,-108.51404206032637,-0.08396678972774425,-0.09080716785154408,-0.006840378123799829,-4926224081,-4654024155.8,22.755697560074367,58.48639683190506,NaN,NaN,-8.837506717247996,2.2476538568421813
2010-02-01T09:30:00-05:00,11.585385,11.73964,11.585385,11.707165,155279007,150350914.9,46.50450755218871,49.01277636450895,NaN,NaN,-72.09206394069673,-99.16528867200309,-0.06527358243392559,-0.08843235616620682,-0.02315877373228123,-4770945074,-4702100499,20.982760222419614,54.20171844850682,NaN,NaN,-8.597305139484074,0.698374000224145
2010-02-02T09:30:00-05:00,11.715284,11.853302,11.668358,11.819203,135234774,152462185.95,49.40265688621016,48.37945121878989,NaN,NaN,-46.06476160981445,-81.06784692844657,-0.04277415566079921,-0.07662646830828024,-0.03385231264748103,-4635710300,-4692752086.2,22.251252341919695,49.99579904608089,NaN,NaN,-7.4732574680339035,-0.469001923812719
2010-02-03T09:30:00-05:00,11.755878,11.837065,11.658453,11.690928,131466013,154193913.45,46.30927918685809,47.27389125369875,NaN,NaN,-52.111271811991166,-70.05728461809926,-0.034307244678696044,-0.07673636849585108,-0.04242912381715504,-4767176313,-4760661776.2,19.768577272107677,45.58136546258155,NaN,NaN,-7.504471080269563,-1.4740689461636967
2010-02-04T09:30:00-05:00,11.585385,11.601622,11.17945,11.187569,267047995,163769218.85,36.61947049505599,45.37784674079575,NaN,NaN,-122.67232350077936,-76.45971857017723,-0.05893828366910653,-0.1161019784035382,-0.05716369473443167,-5034224308,-4826856015.2,17.695987476102403,41.036205056681375,NaN,NaN,-10.992596219070125,-2.8338585565789005
2010-02-05T09:30:00-05:00,11.252518,11.349943,10.968364,11.317468,315401490,173641963,40.10258623276433,44.39226010596095,NaN,NaN,-130.3906003799555,-84.66620424864745,-0.0624758982993876,-0.13525856760866617,-0.07278266930927857,-4718822818,-4785375762.6,23.134443240507878,36.920716900395696,NaN,NaN,-12.56114811816849,-4.223471351091699
2010-02-08T09:30:00-05:00,11.341824,11.341824,11.073907,11.090144,132276881,174658655.8,36.33894261189749,42.847231913567335,NaN,NaN,-127.60639840113923,-95.76907114073595,-0.07526185769586373,-0.16685999142910823,-0.0915981337332445,-4851099699,-4801406687.6,22.515240242630483,32.745746573402684,NaN,NaN,-15.161524229096953,-5.786050333663878
2010-02-09T09:30:00-05:00,11.228162,11.284993,11.041432,11.203806,190284158,180532747.95,39.401288147804195,41.602170659911785,NaN,NaN,-118.19075543166149,-110.19426990510536,-0.07124177239009256,-0.1806503492208602,-0.10940857683076764,-4660815541,-4806427735.8,22.313789983244533,28.504457885489664,NaN,NaN,-16.22582028644001,-7.2774460412033255
2010-02-10T09:30:00-05:00,11.220043,11.414892,11.147543,11.293112,155311958,181413342.1,41.77138887393051,41.27769669887455,NaN,NaN,-89.26616708475724,-117.62524895965858,-0.05829069197668747,-0.18227194180162698,-0.12398124982493951,-4505503583,-4754093189.8,29.403866397457364,26.001675987703372,NaN,NaN,-16.32734031336353,-8.570288080083355
2010-02-11T09:30:00-05:00,11.293112,11.374299,11.022515,11.317468,92266456,180981287.7,42.43267509035129,41.600467791899746,NaN,NaN,-93.62543055729411,-111.8158703709615,-0.04443285487480644,-0.17952231841844757,-0.13508946354364113,-4413237127,-4629895753.6,42.75587879850003,25.857430355034086,NaN,NaN,-16.20942185586743,-9.661592905195365
2010-02-12T09:30:00-05:00,11.187569,11.325586,11.1145,11.325586,125475989,183709705.75,42.66639196875537,41.80294998289306,NaN,NaN,-84.7952744014746,-102.69680517526533,-0.031668130728225496,-0.174674626953923,-0.1430064962256975,-4287761138,-4543683417.6,49.84684670604944,26.722516342245648,NaN,NaN,-16.04764110278623,-10.573885504851203
2010-02-16T09:30:00-05:00,11.406774,11.577266,11.333705,11.561029,134890521,184547386.65,49.11841724277171,42.74040486036014,NaN,NaN,-19.507749877765583,-81.0770754705906,-0.005678168034295883,-0.15010420626856735,-0.14442603823427147,-4152870617,-4404037601.2,58.758398721330316,28.81160546632109,NaN,NaN,-13.971537833287318,-11.059264408913505
2010-02-17T09:30:00-05:00,11.650334,11.650334,11.544791,11.601622,81127293,183578912.35,50.159814633273825,43.18689277344316,NaN,NaN,20.616748402798756,-53.31557470369855,0.014816751073525924,-0.12590509939236405,-0.14072185046588997,-4071743324,-4286223157.8,64.49096702057098,31.51119668785126,NaN,NaN,-11.966488890464644,-11.188867906277952
2010-02-18T09:30:00-05:00,11.55291,11.707165,11.544791,11.674691,73660659,182291052.95,52.06178788041295,43.85293171416011,NaN,NaN,49.13978480644831,-25.63438432545745,0.032831877869704706,-0.09968200312875908,-0.13251388099846378,-3998082665,-4184738974.2,68.54665939602039,34.65859752706678,NaN,NaN,-9.736147555065253,-10.98133642753328
2010-02-19T09:30:00-05:00,11.601622,11.780234,11.593504,11.73964,72679517,170415533.95,53.751251065779215,44.760032704860976,NaN,NaN,81.78058839057037,9.446819464115439,0.04775530625019467,-0.07281974818572046,-0.12057505443591512,-3925403148,-4087172178.4,71.8728028894968,38.1669621934541,NaN,NaN,-7.377764859047929,-10.46654048917823
2010-02-22T09:30:00-05:00,11.780234,11.958845,11.763996,11.893896,86161262,161668847.9,57.57543342747038,45.55081312452395,NaN,NaN,132.37263836193492,52.88040201679735,0.06554912728409416,-0.038638645330797416,-0.10418777261489158,-3839241886,-3997468328,74.53872844556003,41.99238849510699,NaN,NaN,-4.194010117210383,-9.570464721754252
2010-02-23T09:30:00-05:00,11.837065,11.92637,11.634097,11.674691,144604747,159923922.25,51.10815072350354,45.67263411290205,NaN,NaN,81.30270343501338,73.04249267935313,0.06022646505559871,-0.028904691295393192,-0.0891311563509919,-3983846633,-3963663531.2,75.48183644236356,45.794573073710126,NaN,NaN,-3.222133042485928,-8.663560196144491
2010-02-24T09:30:00-05:00,11.682809,11.893896,11.682809,11.877658,87348723,156696908.1,56.03277748585281,46.36716970568739,NaN,NaN,95.34466539561718,87.98807607791682,0.06749862418104381,-0.004757876124687144,-0.07225650030573096,-3896497910,-3928614448.4,76.45559668334772,49.8436458887987,NaN,NaN,-0.8515748690281431,-7.547562292270728
2010-02-25T09:30:00-05:00,11.715284,11.861421,11.642216,11.845183,130484259,150479896,55.07687290774074,47.68555559230773,NaN,NaN,76.96349355097253,93.55281782682167,0.06710455330823814,0.011624191329566713,-0.05548036197867142,-4026982169,-3934394349.2,75.92010918634598,54.002511725244666,NaN,NaN,0.7937887250576272,-6.355940718366677
2010-02-26T09:30:00-05:00,11.845183,11.958845,11.780234,11.918252,129940901,143195678.55,56.860153463774374,48.88252468023702,NaN,NaN,99.66308926104975,97.12931800091755,0.06850872249753423,0.030155541143246367,-0.03835318135428786,-3897041268,-3928721973.2,76.09704710654353,57.785554858532926,NaN,NaN,2.687972861948351,-5.0639530640359585
2010-03-01T09:30:00-05:00,11.958845,11.983201,11.876521,11.950726,65503826,135322321.45,57.66449726969653,50.40577858436552,NaN,NaN,103.85355370796259,91.42550107012309,0.06821956155173366,0.046921270585379204,-0.02129829096635445,-3831537442,-3927181084.4,76.14831864799697,61.61648903034482,NaN,NaN,4.484523121370464,-3.699885037549327
2010-03-02T09:30:00-05:00,11.983201,12.104982,11.975083,11.99132,71193348,131118038.5,58.701100014631926,51.78433657485322,NaN,NaN,116.5808464696468,98.48112967704976,0.06724692562713241,0.06276036606756108,-0.004486559559571342,-3760344094,-3882480576.6,77.64627954325368,65.56880971320261,NaN,NaN,6.280681539361489,-2.2740898122763533
2010-03-03T09:30:00-05:00,12.007557,12.088744,11.966964,11.999439,69751876,127843893.6,58.917764176803935,53.00907766791561,NaN,NaN,107.91483258970948,100.99516311586822,0.06367114003066182,0.07510236547875593,0.01143122544809411,-3690592218,-3841299438.2,78.95742517421564,69.10834962582821,NaN,NaN,7.8410608081937765,-0.8290682950663348
2010-03-04T09:30:00-05:00,12.031913,12.129338,12.015676,12.121219,65138349,124527510.4,62.127236978705994,54.41583208851238,NaN,NaN,114.34279551791093,108.4710235092559,0.06575965932062915,0.09363079959888054,0.027871140278251397,-3625453869,-3760993778.2,81.2651490816248,71.85901178890855,NaN,NaN,10.10410599220728,0.7328137459727531
2010-03-05T09:30:00-05:00,12.186169,12.381017,12.169931,12.356661,99700848,116160153.05,67.42567339428862,56.184352190336185,NaN,NaN,147.5154702121007,118.04149969946612,0.07839273528473928,0.1258620593841755,0.047469324099436216,-3525753021,-3686736128.8,83.1097436882599,74.23493300192358,NaN,NaN,13.788909065172605,2.5979702201441603
2010-03-08T09:30:00-05:00,12.381017,12.42973,12.356661,12.381017,66200844,103700120.75,67.92557703416875,57.52772074686454,NaN,NaN,151.95276276742055,127.6613415113577,0.08332300008743547,0.15162307420873056,0.06830007412129509,-3459552177,-3612339075.8,84.73170487457169,76.09016915572654,NaN,NaN,16.971328804595828,4.651307160780113
2010-03-09T09:30:00-05:00,12.316068,12.502798,12.275474,12.421611,110673048,102619929.1,68.78540029076373,58.85811972239953,NaN,NaN,141.4874235815438,132.6426569337371,0.08401320070793869,0.17331657500621844,0.08930337429827975,-3348879129,-3530046082.8,86.2989919340116,77.6478852209723,NaN,NaN,19.8920652994039,6.828558323440653
2010-03-10T09:30:00-05:00,12.502798,12.632697,12.478442,12.559629,123906773,99301059.85,71.5753947671372,60.251948785736985,NaN,NaN,158.99661045483487,142.8590125067622,0.08803551878694182,0.19934777278195703,0.11131225399501521,-3224972356,-3436922110.4,87.82235876699568,79.02472089032767,NaN,NaN,23.30111185795453,9.181780256942636
2010-03-11T09:30:00-05:00,12.527154,12.673291,12.510917,12.665172,75334267,95302175.3,73.52421929437284,61.66430365920795,NaN,NaN,151.71059820274974,150.33257304372995,0.09166235758727473,0.2258902009791086,0.13422784339183388,-3149638089,-3341758954.4,89.14998095186061,80.25880503763938,NaN,NaN,26.83063307633467,11.703044945427212
2010-03-12T09:30:00-05:00,12.770715,12.770715,12.559629,12.61646,125257117,96951708.35,71.10125631063092,62.63043386514799,NaN,NaN,139.9155494197457,148.81258888525895,0.08479808196794061,0.24022544585175964,0.15542736388381903,-3274895206,-3291587391.4,89.78243943782664,81.347641537087,NaN,NaN,29.131231409807263,14.192785868910077
2010-03-15T09:30:00-04:00,12.543391,12.640816,12.478442,12.61646,86526700,95004243.9,71.10125631063092,64.05851283565708,NaN,NaN,111.11938163953991,140.64591265968284,0.07463342980585533,0.24871915114113818,0.17408572133528286,-3274895206,-3254655997.2,90.23372677642,82.4013479895196,NaN,NaN,31.032364884725634,16.598440014026586
2010-03-16T09:30:00-04:00,12.657053,12.778834,12.624579,12.769903,92890556,92904245.65,74.2065729655764,65.35664108420879,NaN,NaN,123.39971928396326,137.02837180016672,0.07255528253417512,0.26477982450300175,0.19222454196882663,-3182004650,-3221281101.4,90.63622662513626,83.41425012821878,NaN,NaN,33.643172923492976,19.03340185823607
2010-03-17T09:30:00-04:00,12.843459,12.965564,12.827546,12.92497,113735568,94534659.4,76.90717717550507,66.91594853190624,NaN,NaN,138.51667298604792,132.93238430640935,0.0755928115008459,0.286715556344884,0.2111227448440381,-3068269082,-3189940446.6,91.01087769051625,84.49216216423095,NaN,NaN,36.78518134369937,21.569370356159396
2010-03-18T09:30:00-04:00,12.900614,12.916852,12.770715,12.851902,92032901,95453271.5,73.02720094123899,68.07073763743942,NaN,NaN,113.57427174797068,125.30511901545351,0.06694618089557908,0.29480547096351195,0.22785929006793287,-3160301983,-3192073225.4,90.74479279415141,85.53842971334579,NaN,NaN,38.31825554416598,23.962068240160335
2010-03-19T09:30:00-04:00,12.860021,12.882997,12.689528,12.73824,110207299,97329660.6,67.33626164810391,68.7615779501828,NaN,NaN,90.71618933217115,115.46524699793858,0.048686217961518674,0.2887170625198312,0.24003084455831253,-3270509282,-3191196040.6,90.75676243176366,86.58188998361484,NaN,NaN,37.96287709783799,25.962183791257143
2010-03-22T09:30:00-04:00,12.608341,12.811309,12.600222,12.80319,78955576,96969376.3,68.8310181763391,69.48514353316189,NaN,NaN,77.2212817662406,108.68562702327874,0.03664565682598747,0.28583791559079685,0.24919225876480938,-3191553706,-3174527740.6,90.99508189796606,87.5353758660943,NaN,NaN,38.08879917963072,27.694557418167655
2010-03-23T09:30:00-04:00,12.835665,12.916852,12.763002,12.908733,80049682,93741623.05,71.14204548722245,70.35830648390606,NaN,NaN,94.37274924220851,102.88023301492778,0.03164150992153625,0.2887441461667297,0.25710263624519347,-3111504024,-3160427615.4,91.20173818741395,88.40996965275133,NaN,NaN,38.86580194168115,29.290449492955297
2010-03-24T09:30:00-04:00,12.827546,12.981801,12.827546,12.916852,86414228,93694898.3,71.3182213198193,71.01480536541416,NaN,NaN,95.24994413687469,94.22688724509312,0.02502048730751738,0.2883782453795902,0.26335775807207285,-3025089796,-3151791758.2,91.33293047566468,89.12909689518274,NaN,NaN,39.54938001529075,30.756010996146077
2010-03-25T09:30:00-04:00,13.006157,13.249727,12.957445,12.973683,150995543,94720462.5,72.58009025499737,71.38297799832192,NaN,NaN,119.18973967245047,95.34998082998908,0.020784782557168202,0.2893387362685331,0.2685539537113649,-2874094253,-3094550212.2,92.16670130871958,89.77602243950129,NaN,NaN,40.478817835322815,32.144983401742756
2010-03-26T09:30:00-04:00,13.026454,13.152294,12.916852,12.98992,219103275,99178581.2,72.94630841767169,71.74160166857213,NaN,NaN,105.49537460496592,98.30581788454803,0.0156282045058716,0.2880892093437044,0.2724610048378328,-2654990978,-2971446551.4,93.5939752240718,90.40904175017987,NaN,NaN,41.35357290520608,33.460496187951804
2010-03-29T09:30:00-04:00,13.062988,13.103582,12.92497,13.006157,76121645,99709472.15,73.3299122928521,72.0662096687213,NaN,NaN,98.04951822731304,102.4714651767625,0.01012913741278132,0.2851224266038095,0.27499328919102817,-2578869333,-2848909676.8,94.64073774828529,91.0048807369137,NaN,NaN,42.192242022518464,34.707888450032755
2010-03-30T09:30:00-04:00,13.014276,13.05487,12.892496,12.92497,59222683,99110938.9,68.1281730195448,71.81997954389327,NaN,NaN,78.68803439293096,99.33452220690701,-0.0015367834256404533,0.2730723099089776,0.274609093334618,-2638092016,-2754227275.2,95.28221966351205,91.53772794380772,NaN,NaN,41.55233685512689,35.68566679361763
2010-03-31T09:30:00-04:00,12.843783,12.998031,12.835665,12.949326,72513698,99249030,68.84223814564652,71.48555231898425,NaN,NaN,65.8749331420933,93.45952000795073,-0.009717411539861498,0.26246232890979115,0.27217974044965265,-2565578318,-2662324979.6,95.80685878724485,92.01321921776376,NaN,NaN,41.18762435157998,36.471660730469395
2010-04-01T09:30:00-04:00,13.05487,13.095463,12.966376,13.05487,59523263,98968275.7,71.79156019572824,71.53485973934833,NaN,NaN,96.00511161146959,88.82259439575456,-0.01008130721574324,0.2595781064299736,0.26965941364571683,-2506055055,-2588717140,96.17385900582741,92.46974918690667,NaN,NaN,41.643137676050216,37.21044315126665
2010-04-05T09:30:00-04:00,13.127938,13.200998,13.091404,13.184777,55333114,96749889,74.9363006274106,71.80879147626118,NaN,NaN,128.4608691323419,93.41569330122977,-0.003948983339932377,0.26472318447080134,0.2686721678107337,-2450721941,-2547863332.6,96.36406995074611,92.90763084221567,NaN,NaN,42.9558065876858,38.03120935646939
2010-04-06T09:30:00-04:00,13.17665,13.355261,13.152294,13.322787,63409166,96610305.1,77.77147091736843,72.06342704424631,NaN,NaN,160.2167583980314,105.84914133537343,0.006459693609181083,0.27674678482221005,0.27028709121302896,-2387312775,-2509552021,96.53788797774166,93.32917808168747,NaN,NaN,44.991918507351365,39.025596378023955
2010-04-07T09:30:00-04:00,13.355261,13.403966,13.192888,13.274083,91607868,95657046.1,74.56584614796462,71.89618911370772,NaN,NaN,153.97439380566937,120.90641321792111,0.0070726915422702485,0.2791279556408668,0.27205526409859654,-2478920643,-2477717746.4,96.67991817960583,93.73410954519387,NaN,NaN,45.737065441943585,39.98437767286962
2010-04-08T09:30:00-04:00,13.225354,13.420211,13.168531,13.379618,86498459,93786630.4,76.7975791662284,72.16550184406411,NaN,NaN,149.46565650117316,137.62455788973708,0.011340865832260294,0.2862313463889219,0.2748904805566616,-2392422184,-2443086519.6,96.83216885047462,94.16892212064553,NaN,NaN,47.05573094519922,40.99457099748813
2010-04-09T09:30:00-04:00,13.428322,13.460805,13.347143,13.429142,65017798,93270806.95,77.78276647484427,72.91168076025984,NaN,NaN,159.67505052375807,150.3585456721948,0.014075949805772259,0.29248541781387694,0.2784094680081047,-2327404386,-2407356385.8,96.98575108799783,94.61384988180511,NaN,NaN,48.445367944278104,42.05897056131527
2010-04-12T09:30:00-04:00,13.468923,13.540774,13.452694,13.485161,56751647,89845533.45,78.875409094492,73.62913725441364,NaN,NaN,164.49601913222415,157.56557567217124,0.016089158638023404,0.29852091630563393,0.28243175766761053,-2270652739,-2371342545.4,97.13644772405645,95.052518869383,NaN,NaN,49.93636003542135,43.18431191475899
2010-04-13T09:30:00-04:00,13.468923,13.56871,13.403966,13.493279,85333326,89785864.75,79.03630844694067,74.19301318010778,NaN,NaN,141.39455383125903,153.80113475881677,0.014450774021555035,0.3004952251945543,0.28604445117299926,-2185319413,-2330943873,97.29954394578576,95.48807642355241,NaN,NaN,51.20376107077114,44.329947508475016
2010-04-14T09:30:00-04:00,13.663772,13.850502,13.647535,13.842383,155461243,92914399.1,84.50280936879595,75.1347694693204,NaN,NaN,192.0008621922857,161.40642843614,0.032337521880889564,0.32646635352411124,0.2941288316432217,-2029858170,-2241131378.4,97.62359510025921,95.93740961102344,NaN,NaN,54.389369679044044,45.76700781855631
2010-04-15T09:30:00-04:00,13.874858,13.899214,13.744951,13.785553,101686467,92311944.05,80.80871992827502,75.72252873169738,NaN,NaN,166.6988592872334,164.85306899335208,0.03554512833441442,0.3385602420612397,0.30301511372682527,-2131544637,-2188955869,97.78954349454025,96.33904119572492,NaN,NaN,55.71992885273197,47.1888536805814
2010-04-16T09:30:00-04:00,13.728567,13.744951,13.046759,13.282193,468817362,111151167.1,57.02857463053063,74.5855477469016,NaN,NaN,44.993425235489944,141.91674393569843,0.000806469344375893,0.30402320040729514,0.30321673106291924,-2600361999,-2243547391.6,90.65619723081927,96.1291999104926,NaN,NaN,47.34656934676094,47.21138449003562
2010-04-19T09:30:00-04:00,13.127938,13.436449,13.111692,13.412092,319887568,121635180.55,60.27725731611554,73.65321524856326,NaN,NaN,29.656208062834516,114.94878172182052,-0.015483843912451611,0.28386192617235473,0.29934577008480634,-2280474431,-2245511730,90.4006634694706,95.82633746200584,NaN,NaN,42.18610515848674,46.493487442671494
2010-04-20T09:30:00-04:00,13.517627,13.590712,13.436449,13.590712,151265833,125250693.4,64.27660549145013,73.37810328227079,NaN,NaN,82.57134451672312,103.18413985891334,-0.01621257511696611,0.2790800511885987,0.2952926263055648,-2129208598,-2234289567,90.56429614853637,95.48934292522185,NaN,NaN,39.5958965088562,45.50811730926931
2010-04-21T09:30:00-04:00,13.598822,13.720595,13.355261,13.509517,210266274,131761523,61.25740159629692,72.83632924303153,NaN,NaN,73.52295313099225,79.48855804665463,-0.023693241461747894,0.26567607447837993,0.2893693159401278,-2339474872,-2296212907.4,82.23430853771733,94.51987505025559,NaN,NaN,36.51429603594581,44.22328569879453
2010-04-22T09:30:00-04:00,13.363388,13.623179,13.306549,13.582585,233746782,139128150.7,62.94425624294518,72.20437896068988,NaN,NaN,60.27371999788825,58.203530188785614,-0.02511503509127644,0.25797552207603225,0.2830905571673087,-2105728090,-2291049598,82.37983958498644,93.53458794876697,NaN,NaN,34.68320265409169,42.86041669240841
2010-04-23T09:30:00-04:00,13.606933,13.679677,13.533873,13.623179,109120228,137034384.95,63.8850517285925,71.41500403934575,NaN,NaN,85.59324485598354,66.32349411288433,-0.024679884480884595,0.25224070156620293,0.2769205860470875,-1996607862,-2170298770.6,85.39333915183423,92.75096432027327,NaN,NaN,33.55019058851961,41.53038439185286
2010-04-26T09:30:00-04:00,13.61506,13.61506,13.379618,13.410063,128986325,132528537.45,55.86594922585109,69.85032391852307,NaN,NaN,34.66259143128034,67.3247707865735,-0.039238577548166176,0.22787236411187983,0.267110941660046,-2125594187,-2139322721.8,86.05233600368888,92.00199632212663,NaN,NaN,29.84394112252562,39.86089249623468
2010-04-27T09:30:00-04:00,13.261905,13.412092,12.92497,12.956633,290053668,143225138.6,43.38729018830015,67.62328420711847,NaN,NaN,-93.07427248465017,32.19564738629883,-0.07767877601320192,0.1700124716435436,0.24769124765674552,-2415647855,-2196610573.2,78.95743074975033,90.73610436285125,NaN,NaN,21.507606700527283,37.23899452541934
2010-04-28T09:30:00-04:00,13.136048,13.233481,13.022387,13.144175,195031677,150015588.3,48.510180758922566,65.60275574945378,NaN,NaN,-87.91002217928187,-0.09094767575598724,-0.0879899594210834,0.13770379838039126,0.22569375780147466,-2220616178,-2172838834.4,79.70517377667372,89.51274757186548,NaN,NaN,16.822093567604924,34.32229438858871
2010-04-29T09:30:00-04:00,13.31466,13.517627,13.249727,13.444567,153267532,154053280,55.462109082401575,64.008423078565,NaN,NaN,0.8661255407405013,-11.972466567185538,-0.0727275215901742,0.13478435581375692,0.20751187740393112,-2067348646,-2165162945.6,79.95289188077234,88.29611477134937,NaN,NaN,15.604309454665218,31.648296540885354
2010-04-30T09:30:00-04:00,13.379618,13.420211,13.095463,13.119007,206267939,161390513.8,47.91196466037459,61.79674847612806,NaN,NaN,-86.61372471528253,-46.41386048143875,-0.08201714919026987,0.10499044091609377,0.18700759010636364,-2273616585,-2220564690.2,73.0246747279345,86.57384527162637,NaN,NaN,11.63862607410968,28.78977218848883
2010-05-03T09:30:00-04:00,13.233481,13.403966,13.192888,13.371499,110887289,164168222.55,53.22973937159923,59.953422113603665,NaN,NaN,-43.920583252019014,-62.13049541809862,-0.06913169624229343,0.10059296980349686,0.16972466604579028,-2162729296,-2227991712,72.12241101281275,84.77547863355687,NaN,NaN,10.552995445043912,26.1845183679967
2010-05-04T09:30:00-04:00,13.17665,13.217244,12.92497,13.006157,195297040,170762616.25,45.923939717093006,57.19778856705345,NaN,NaN,-152.63475086860146,-74.04259109488888,-0.08229396653270182,0.066857207879913,0.14915117441261483,-2358026336,-2216467408.2,72.68634512019793,82.99424649212392,NaN,NaN,6.784450893456582,23.413080157348112
2010-05-05T09:30:00-04:00,12.795071,13.152294,12.746359,12.935119,227334957,177548970.7,44.64095149721136,54.614376536263194,NaN,NaN,-169.7075445377044,-90.4020955665734,-0.09212309883414987,0.03399730086992747,0.12612039970407735,-2585361293,-2289416431.2,63.8776505776413,80.57196842663116,NaN,NaN,3.515853871640811,20.570619259389925
2010-05-06T09:30:00-04:00,12.876258,13.022387,11.820827,12.389136,385297232,192488909.35,36.257004420756125,53.13069294985073,NaN,NaN,-274.80712980238974,-145.53674663519945,-0.1294477386256696,-0.03568927357800966,0.09375846504765994,-2970658525,-2470078407,48.27460420118794,77.54471178165748,NaN,NaN,-2.6795385174399904,17.249168148414224
2010-05-07T09:30:00-04:00,12.397255,12.61443,12.072507,12.251118,434349262,210955482.55,34.49343398149577,51.28899128309217,NaN,NaN,-227.22046524428947,-173.65809474100084,-0.15571899974126618,-0.1008902846289228,0.05482871511234339,-3405007787,-2696356647.4,36.31105473165696,73.6811683003851,NaN,NaN,-8.019575256002028,13.639347662069046
2010-05-10T09:30:00-04:00,12.884377,13.006157,12.722003,12.933901,220306975,219133248.95,47.975105770952226,50.124598445913755,NaN,NaN,-81.92449151331532,-181.2588763932601,-0.12094851694511717,-0.09635693106905308,0.0245915858760641,-3184700812,-2900750950.6,29.257746299972155,69.30212902548764,NaN,NaN,-7.320103782074702,10.645140312905653
2010-05-11T09:30:00-04:00,12.73824,13.095463,12.730122,12.884377,150034404,222368302.85,47.2160627615889,49.12164567200604,NaN,NaN,-69.82447138835677,-164.69682049721115,-0.09619943360568822,-0.09565770613104618,0.0005417274746420432,-3334735216,-3096092726.6,24.38299850564161,65.16989259462511,NaN,NaN,-7.0902024504831616,8.111519918135823
2010-05-12T09:30:00-04:00,12.965564,13.038632,12.860021,13.030514,108117526,220001117,49.7428986495803,48.17869155819427,NaN,NaN,-47.53928386061123,-140.26316836179254,-0.06632307125497588,-0.0823621115940778,-0.016039040339101925,-3226617690,-3224344006,21.813290790995026,60.84371053791142,NaN,NaN,-6.022847392661262,6.092324588021954
2010-05-13T09:30:00-04:00,12.98992,13.022387,12.795071,12.795071,117567157,220795151.5,45.92816169832695,46.89605655603244,NaN,NaN,-63.80943693035319,-98.06362978738522,-0.05899957849903931,-0.08978851346290107,-0.030788934963861755,-3344184847,-3299049270.4,20.460627367773057,56.20565969619276,NaN,NaN,-6.4591211271406905,4.299260914427291
2010-05-14T09:30:00-04:00,12.648935,12.657053,12.33263,12.462204,185724236,206640495.2,41.126169892449845,45.84321517507521,NaN,NaN,-134.2996398934529,-79.47946471721791,-0.0722785971811692,-0.12113718144032326,-0.048858584259154056,-3529909083,-3324029529.6,20.013710659727337,51.48861502876692,NaN,NaN,-8.486556716239244,2.472715538617786
2010-05-17T09:30:00-04:00,12.462204,12.575785,12.169931,12.470323,215296852,201410959.4,41.28741629233592,45.693224182506334,NaN,NaN,-131.36044010240565,-89.366654435036,-0.07584909533588582,-0.14366995342901134,-0.06782085809312552,-3314612231,-3350011813.4,19.535738561842308,47.24420844391636,NaN,NaN,-9.987419096208733,0.6926963050711406
2010-05-18T09:30:00-04:00,12.61646,12.624579,12.023795,12.1131,245446546,206119995.05,36.544830035152366,44.838556273665596,NaN,NaN,-142.42561662454585,-103.88688348227383,-0.09628970699958839,-0.188182991842611,-0.09189328484302262,-3560058777,-3395076525.6,18.701490673289882,42.886802507960375,NaN,NaN,-12.85599612832472,-1.2428311854139822
2010-05-19T09:30:00-04:00,11.995379,12.251118,11.885777,12.129338,282616517,209737507.2,36.89964923546749,43.51266628459888,NaN,NaN,-151.84231176859822,-124.74748906387121,-0.10217977607572673,-0.21961800493768102,-0.11743822886195429,-3277442260,-3405241439.6,18.509486161422558,38.49798781372111,NaN,NaN,-14.988077525354829,-3.206437805405532
2010-05-20T09:30:00-04:00,11.902014,11.942608,11.544791,11.565088,264922650,211296300.6,30.514511901907596,42.26999108756552,NaN,NaN,-183.74886128826984,-148.73537393545456,-0.135453579450651,-0.28675520317526804,-0.15130162372461703,-3542364910,-3444877452.2,17.744472425144465,34.54940193495039,NaN,NaN,-19.131872827546374,-5.481499951425652
2010-05-21T09:30:00-04:00,11.325586,12.127958,11.325586,11.975083,256887885,218684683.45,38.801226797131065,41.239383046532076,NaN,NaN,-139.14663836946733,-149.70477363065743,-0.12166394322464807,-0.3033815527554271,-0.18171760953077903,-3285477025,-3395991040.6,22.025148006943823,30.971026005959754,NaN,NaN,-19.786447111756495,-7.525063831472915
2010-05-24T09:30:00-04:00,12.031913,12.031913,11.61786,11.634097,132745922,218872663.3,35.05666069767561,40.46314883085942,NaN,NaN,-127.6359868176865,-148.9598829737136,-0.12674728659914192,-0.34015171777970643,-0.2134044311805645,-3418222947,-3416713183.8,21.51405413454411,27.315862364127334,NaN,NaN,-21.627951193430555,-9.539762026038291
2010-05-25T09:30:00-04:00,11.309349,11.747759,11.236281,11.73964,202962760,214518117.9,37.08069347415163,39.92313040064086,NaN,NaN,-134.40794787194557,-147.35634922319355,-0.11460805038599861,-0.3566644941630628,-0.24205644377706417,-3215260187,-3347753465.8,27.54000553579526,24.72031628970976,NaN,NaN,-22.402166883659564,-11.377248434269902
2010-05-26T09:30:00-04:00,11.92637,11.950726,11.593504,11.658453,154019653,212467516.7,36.147434557513314,39.9153039818378,NaN,NaN,-102.08561036036343,-137.40500894154658,-0.10396585120058333,-0.37201375777779333,-0.26804790657721,-3369279840,-3366120981.8,26.94656558138668,23.196884959723956,NaN,NaN,-23.308227497789417,-13.08167401477269
2010-05-27T09:30:00-04:00,11.910133,12.194287,11.841124,12.186169,150259662,212317123.2,45.71183805720423,40.71661855867412,NaN,NaN,-51.5518772033959,-110.96561212457179,-0.05572412133183979,-0.33770305824200975,-0.28197893691016995,-3219020178,-3301452035.4,32.46448104602321,22.922129696464406,NaN,NaN,-20.914146553922734,-14.200598663222696
2010-05-28T09:30:00-04:00,12.153694,12.161813,11.873599,11.918252,157039151,209855683.8,42.25158959334439,40.307795974559276,NaN,NaN,-58.22922784667271,-94.78213002001289,-0.037093078022033044,-0.32834528443771127,-0.2912522064156782,-3376059329,-3319568496.2,31.741178964206924,23.09951774390975,NaN,NaN,-20.07464255668878,-15.039747790860707
2010-06-01T09:30:00-04:00,11.788352,11.958845,11.650334,11.666572,102331969,209427917.8,39.24614503052213,39.73851613662594,NaN,NaN,-84.46523641341973,-86.14797993915951,-0.03687735943430337,-0.33734890570855747,-0.3004715462742541,-3478391298,-3331602166.4,31.24323928548526,23.589534942470006,NaN,NaN,-20.35893608569161,-15.799631832979408
2010-06-02T09:30:00-04:00,11.788352,12.031913,11.674691,12.031913,97117775,204518954.55,45.3258449025533,39.42301229755258,NaN,NaN,-54.33576234867168,-70.13354283450474,-0.008754428234961253,-0.31141458156795565,-0.3026601533329944,-3381273523,-3364804833.6,29.851740322594296,24.163709909012812,NaN,NaN,-18.57734637417421,-16.196448196007236
2010-06-03T09:30:00-04:00,12.080626,12.104982,11.837065,11.966152,126191533,199461783.35,44.463333200705286,39.318381690579606,NaN,NaN,-39.51585859389308,-57.61959248121068,0.007893983258042192,-0.29279267426044164,-0.30068665751848384,-3507465056,-3392441876.8,28.705704151634023,24.75264396500288,NaN,NaN,-17.438855529268537,-16.373934957901707
2010-06-04T09:30:00-04:00,11.723403,11.788352,11.43113,11.487961,147001051,187546974.3,38.69683447902983,39.14485773247817,NaN,NaN,-99.7262585842353,-67.2544687573785,-0.009860660216111983,-0.3130124827886238,-0.30315182257251183,-3654466107,-3479531062.6,25.39692930037748,25.137159582192176,NaN,NaN,-18.31725322968366,-16.651551853870558
2010-06-07T09:30:00-04:00,11.536673,11.593504,11.218582,11.260637,128246975,172241859.95,36.287506703943464,38.78772133330728,NaN,NaN,-122.39148622028617,-80.0869204321012,-0.03221552398849159,-0.3434212275581263,-0.31120570356963473,-3782713082,-3560861813.2,22.758650152693875,25.367367552967288,NaN,NaN,-19.81601619623301,-17.103618188493765
2010-06-08T09:30:00-04:00,11.325586,11.504198,11.122619,11.496079,181072930,170280157.7,40.42473746119972,39.06485757802495,NaN,NaN,-113.44025078339914,-85.8819233060971,-0.026675767114168303,-0.3445504124623451,-0.3178746453481768,-3601640152,-3585511584,22.0122914889387,25.603853325513633,NaN,NaN,-19.743783990434736,-17.48078473162819
2010-06-09T09:30:00-04:00,11.577266,11.666572,11.325586,11.374299,153532659,170455070.45,39.01357314335528,39.21585214287408,NaN,NaN,-94.79301211470752,-93.97337325930425,-0.026678879671530098,-0.3512232449375894,-0.3245443652660593,-3755172811,-3660291441.6,19.882095042468322,25.701896817016905,NaN,NaN,-20.11565496743792,-17.857194765315295
2010-06-10T09:30:00-04:00,11.544791,11.772115,11.460925,11.747759,138806853,171989536.8,45.317765264298224,40.27322738304484,NaN,NaN,-50.16792529117022,-96.10378659875968,0.001509874152366364,-0.32265702257560136,-0.3241668967279677,-3616365958,-3682071622,19.296372947351145,25.81274685431738,NaN,NaN,-18.45196361112355,-17.942161743287905
2010-06-11T09:30:00-04:00,11.634097,11.820827,11.601622,11.780234,66445179,169433437.9,45.842027288535824,40.776141703859466,NaN,NaN,-26.00384206002959,-81.35930329391854,0.024126735196193294,-0.2940084777327261,-0.3181352129289194,-3549920779,-3661162556.4,21.68171394307089,25.788215849755026,NaN,NaN,-16.967441831113344,-17.80291604154868
2010-06-14T09:30:00-04:00,11.877658,11.934489,11.715284,11.731521,111694453,165731948.75,45.142875037830066,41.496585585299066,NaN,NaN,-1.2667415035597034,-57.13435435057325,0.03682941036258902,-0.2720984499756831,-0.30892786033827213,-3661615232,-3636942986.4,24.466634066957837,25.999114416356004,NaN,NaN,-15.950841729479636,-17.53833399696739
2010-06-15T09:30:00-04:00,11.80459,12.031913,11.731521,12.009587,124602687,161197240.5,49.84515550842814,42.408332873461674,NaN,NaN,54.35288028917443,-23.575728136058522,0.06342250135694183,-0.22964973364209484,-0.2930722349990367,-3537012545,-3624017465,25.979388940816207,25.88764180242893,NaN,NaN,-13.68340122271994,-16.98762931493204
2010-06-16T09:30:00-04:00,11.934489,12.080626,11.886751,12.015676,76919960,152770911.2,49.946335382333444,43.39396864666311,NaN,NaN,91.3312172986191,13.649117746606796,0.07982629265547914,-0.19328936917968775,-0.2731156618351669,-3460092585,-3565001419.8,32.61526078305178,26.292548602547868,NaN,NaN,-11.808326839664572,-16.2477289613224
2010-06-17T09:30:00-04:00,12.048151,12.064388,11.869539,11.999439,88777444,143078957.55,49.65864811698938,43.67588365093348,NaN,NaN,89.76796766568687,41.63629633797821,0.08737698102781477,-0.1638944355503984,-0.25127141657821317,-3548870029,-3551502234,34.071198051478916,26.40731410293756,NaN,NaN,-10.326388426213452,-15.401823170592552
2010-06-18T09:30:00-04:00,12.031913,12.064388,11.950726,12.040032,82239452,133944797.65,50.42740445420022,44.25987042670889,NaN,NaN,94.45105629882285,65.72727600974869,0.09241050445816396,-0.1357582860055082,-0.22816879046367217,-3466630577,-3534844193.6,35.91138941007918,26.70518627764272,NaN,NaN,-8.872238243654797,-14.46902532388716
2010-06-21T09:30:00-04:00,12.17805,12.218643,11.958845,12.023795,105603271,126380566.95,50.097853722324764,45.034992476123364,NaN,NaN,100.72758545285616,86.12614140103187,0.09176507198560038,-0.1134624504816717,-0.20522752246727208,-3572233848,-3516967916.8,37.91410193416156,27.181676466833885,NaN,NaN,-7.719360850901795,-13.504787542032107
2010-06-22T09:30:00-04:00,12.031913,12.088744,11.820827,11.833005,102464443,124866493,46.271348401881674,45.102528440361105,NaN,NaN,42.41286631363399,83.73813860592378,0.07624529877590344,-0.10992089899739277,-0.1861661977732962,-3674698291,-3544505066,36.04550569524354,27.624088279165978,NaN,NaN,-7.651567812609826,-12.668613294971781
2010-06-23T09:30:00-04:00,11.845183,11.903232,11.709195,11.780234,147499515,122093330.75,45.24203012299252,45.158149649095904,NaN,NaN,-2.2370784924132994,65.02447944771731,0.06085042079659908,-0.11010317177754736,-0.17095359257414644,-3822197806,-3616926110.2,31.6303218131618,27.832989540703675,NaN,NaN,-7.853265549227717,-11.9807064741512
2010-06-24T09:30:00-04:00,11.707165,11.809217,11.520435,11.569148,180545377,123419616.95,41.285754459607915,45.343072504851484,NaN,NaN,-59.62734857529196,35.14541619952155,0.036098865805524405,-0.12583001031724095,-0.16192887612276535,-4002743183,-3707700741,27.14253275228691,27.957675501554352,NaN,NaN,-9.083088440971528,-11.566761040839818
2010-06-25T09:30:00-04:00,11.715284,11.910133,11.55291,11.881717,174444716,124628869.65,48.47137341786143,46.21334869870277,NaN,NaN,-0.897869483545089,16.075631043047963,0.04011640647428599,-0.11178336802990785,-0.15189977450419384,-3828298467,-3780034319,24.196476144569402,28.060377358116888,NaN,NaN,-8.209938059544953,-11.087214900654837
2010-06-28T09:30:00-04:00,11.893896,11.92637,11.73964,11.772115,98020008,121677912.5,46.33024575760767,46.63517071987476,NaN,NaN,15.012220624536647,-1.067441922615934,0.03492185247546575,-0.10824745890986165,-0.1431693113853274,-3926318475,-3850851244.4,21.711807397506078,28.038914208728844,NaN,NaN,-8.062928817880145,-10.655174031687023
2010-06-29T09:30:00-04:00,11.609741,11.625978,11.260637,11.349943,190383012,126080464.65,39.155512222355156,46.645309225517614,NaN,NaN,-123.42372164528425,-34.234759514399585,0.004198561965904984,-0.13792110892794618,-0.14211967089385116,-4116701487,-3939251883.6,19.078169305754514,27.981490941820717,NaN,NaN,-10.132536202284841,-10.580511484629568
2010-06-30T09:30:00-04:00,11.333705,11.463604,11.163212,11.211925,152677763,128858464.05,37.13105126806969,46.06054394007271,NaN,NaN,-143.93554517488272,-62.57445285089348,-0.022790605285992582,-0.1706079275013419,-0.14781732221534932,-4269379250,-4028688172.4,16.85111046973151,27.806829336276458,NaN,NaN,-12.480084168220705,-10.851879010856873
2010-07-01T09:30:00-04:00,11.195687,11.284993,10.834162,11.106382,164629805,130780377.65,35.61461843417146,45.33001473618954,NaN,NaN,-174.41569225861542,-85.53212158755817,-0.04390005664515545,-0.20269239302179365,-0.1587923363766382,-4434009055,-4114941346.8,15.029013567150272,27.33163645228213,NaN,NaN,-14.88729866716384,-11.42836753318644
2010-07-02T09:30:00-04:00,11.187569,11.203887,10.887177,10.976482,82390037,127549826.95,33.78574427230042,44.51879111008028,NaN,NaN,-160.4747103699247,-117.44748976483409,-0.0616719733982595,-0.23588230312446257,-0.17421032972620307,-4516399092,-4252561471.8,12.674206791391015,26.489320218313065,NaN,NaN,-17.464460684217066,-12.290666554762245
2010-07-06T09:30:00-04:00,11.220043,11.276874,10.919651,11.041432,131727138,127723835.1,35.56736840060411,43.49894917380714,NaN,NaN,-133.98955744867425,-147.24784537947625,-0.06384492017897483,-0.2540164799499216,-0.19017155977094677,-4384671954,-4344232167.6,11.393591434858578,25.447477539316093,NaN,NaN,-19.109697285522767,-13.264813802013748
2010-07-07T09:30:00-04:00,11.1145,11.55291,11.098263,11.528554,135354635,125437920.35,47.07027282707899,43.2935161341461,NaN,NaN,-59.48951846203287,-134.461004742826,-0.029039279065577628,-0.22647065860291882,-0.1974313795373412,-4249317319,-4370755334,11.045834364327646,23.906804223692944,NaN,NaN,-17.045873233865347,-13.80496514942112
2010-07-08T09:30:00-04:00,11.666572,11.682809,11.439248,11.61786,99439250,122733249.9,48.872396756175505,43.237355322659404,NaN,NaN,-16.653900706250823,-109.00467584909961,0.0017977539665403608,-0.19518418707916574,-0.1969819410457061,-4149878069,-4346855097.8,13.604811409759861,22.444919463570155,NaN,NaN,-14.808978701975564,-13.948395656928898
2010-07-09T09:30:00-04:00,11.577266,11.80053,11.565088,11.780234,99872738,120786544.15,52.06784983023831,43.354529992376406,NaN,NaN,15.880890637712834,-70.94535926983396,0.033189743725594495,-0.155494761388713,-0.18868450511430748,-4050005331,-4270054353,21.42688656082821,21.410312117195083,NaN,NaN,-11.940559559571238,-13.661561928734947
2010-07-12T09:30:00-04:00,11.763996,11.820827,11.650334,11.796471,67116104,120820090.4,52.38830306141251,43.51813351659696,NaN,NaN,25.457281109417877,-33.75896097396544,0.053882181556952985,-0.12133177816811624,-0.17521395972506923,-3982889227,-4163352380,30.800881047098187,20.902224910976276,NaN,NaN,-9.528590921900667,-13.071137499187193
2010-07-13T09:30:00-04:00,11.950726,12.153694,11.942608,12.088744,103898643,120430299.9,57.85083856243936,44.345239956636796,NaN,NaN,93.05677635765377,11.650305787300164,0.08427677999960587,-0.06986798472556188,-0.15414476472516775,-3878990584,-4062216106,38.313017085925516,21.0641900103107,NaN,NaN,-5.686899011894055,-12.016246286716745
2010-07-14T09:30:00-04:00,12.031913,12.040032,11.869539,11.999439,95257792,118963055.15,55.74624614746125,45.0955411012417,NaN,NaN,70.50239642977081,37.6486887656609,0.09461566932299986,-0.035875178071417935,-0.1304908473944178,-3974248376,-4007202317.4,42.00134950311087,21.80497770244992,NaN,NaN,-3.115371425987447,-10.744692735183989
2010-07-15T09:30:00-04:00,12.015676,12.040032,11.715284,11.975083,118353608,121034737.55,55.15689648654011,46.086336960308294,NaN,NaN,58.299007570711254,52.63927042105331,0.0957712922496825,-0.010776732082314666,-0.10654802433199717,-4092601984,-3995747100.4,42.76868746083835,22.921131610203595,NaN,NaN,-1.1731564535328598,-9.377330409233828
2010-07-16T09:30:00-04:00,11.828946,11.853058,11.439248,11.470911,174496153,125320673,44.63703170424056,45.81245540933537,NaN,NaN,-13.591053919901066,46.74488150953053,0.06027142371503462,-0.031208744688203893,-0.09148016840323851,-4267098137,-4039165661.6,40.57734999153217,24.091194027843795,NaN,NaN,-2.6376279296980725,-8.414515769300149
2010-07-19T09:30:00-04:00,11.487961,11.536673,11.276874,11.463604,87865121,125601956.45,44.50454881026947,45.6820484845255,NaN,NaN,-46.975664941971154,32.258292299252716,0.03522895780310037,-0.04744397114936305,-0.08267292895246342,-4354963258,-4113580467.8,37.071508978932656,25.188315569374264,NaN,NaN,-3.8381791232333407,-7.760753391290605
2010-07-20T09:30:00-04:00,11.252518,11.601622,11.236281,11.585385,113693473,126006466.55,47.31131950719519,46.264606147728365,NaN,NaN,-29.069840145796277,7.832968998562711,0.026211557371321303,-0.04990848223831179,-0.0761200396096331,-4241269785,-4186036308,33.99198371319409,26.253588027048522,NaN,NaN,-4.024983951655351,-7.227072042771283
2010-07-21T09:30:00-04:00,11.796471,11.796471,11.36618,11.397843,126254814,127195985.1,43.65000111803881,46.730245422726156,NaN,NaN,-12.29548571903388,-8.726607431198227,0.007911051890201831,-0.06623122474688081,-0.07414227663708264,-4367524599,-4264691552.6,30.98308771707832,27.26301497328758,NaN,NaN,-5.285291164184244,-6.949674774401706
2010-07-22T09:30:00-04:00,11.544791,11.780234,11.544791,11.731521,103529658,124997492.25,50.92665637474074,47.82396241848111,NaN,NaN,36.00754118748512,-13.184900707843454,0.01799643059280201,-0.05164673839608014,-0.06964316898888215,-4263994941,-4298970144,29.74726090396814,28.314318354488854,NaN,NaN,-4.126584425470037,-6.546376153125753
2010-07-23T09:30:00-04:00,11.707165,11.853302,11.601622,11.820827,85991067,120269776.75,52.68762017902615,49.17409641181865,NaN,NaN,53.68759686889039,0.2708294499148394,0.029708571710832764,-0.03250745435034119,-0.062216026061173955,-4178003874,-4281151291.4,31.28169004739115,29.64342430134601,NaN,NaN,-2.6412856642647156,-5.9885060832884625
2010-07-26T09:30:00-04:00,11.837065,12.007557,11.774145,11.983201,97639474,116429514.65,55.79367907754847,50.61883288874325,NaN,NaN,94.49924057996076,28.56581055430122,0.04642168341990215,-0.0041889217862962624,-0.050610605206198415,-4080364400,-4226231519.8,35.92677669617956,31.395794677154647,NaN,NaN,-0.4347355277463705,-5.195110289639592
2010-07-27T09:30:00-04:00,12.137456,12.194287,11.99132,12.015676,115026415,117279835,56.41004506708019,51.28595947731476,NaN,NaN,124.36718341883825,59.25321526722812,0.056997522558731084,0.020636297992215447,-0.03636122456651564,-3965337985,-4171045159.8,40.29420276496352,33.48496384862864,NaN,NaN,1.53717157277275,-4.2333557378664
2010-07-28T09:30:00-04:00,11.983201,12.05627,11.869539,11.910133,60872819,110804325.35,53.78532466358444,51.63688289927255,NaN,NaN,83.16484719572044,78.34528185017899,0.05423433997774629,0.03143170040566723,-0.022802639572079064,-4026210804,-4102782400.8,45.26421136735375,35.746349559885346,NaN,NaN,2.4588081880604005,-3.2773323198768574
2010-07-29T09:30:00-04:00,12.015676,12.072507,11.80459,11.950726,86075751,107474224.75,54.65914609704725,51.821975489758906,NaN,NaN,75.17386440638695,86.17854649395936,0.05245781468778414,0.042769628787651115,-0.009688185900133027,-3940135053,-4038010423.2,49.5550878382843,37.755506793989355,NaN,NaN,3.4665134581934884,-2.3139257801525224
2010-07-30T09:30:00-04:00,11.796471,12.023795,11.796471,11.942608,72832704,102884369.7,54.43746774549945,51.96834439576511,NaN,NaN,64.66698383370999,88.37442388692327,0.04816465127135657,0.05051762818906269,0.0023529769177061174,-4012967757,-4005003199.8,51.6357685533073,39.243713044432866,NaN,NaN,4.245109467256188,-1.3769207448084209
2010-08-02T09:30:00-04:00,12.109041,12.251118,12.064388,12.243,120082417,104768988.7,60.77659828618406,52.17732723317545,NaN,NaN,131.0430245734652,95.68318068562417,0.062097773034478956,0.07997519321080482,0.01787742017632586,-3892885340,-3967507387.8,53.95899386772026,40.36128281456106,NaN,NaN,6.8070464515576665,-0.20778257389898003
2010-08-03T09:30:00-04:00,12.17805,12.210525,12.088744,12.104982,81893347,102277299.15,56.86209426222649,52.25703066994439,NaN,NaN,107.89783970093755,92.38931194204403,0.058604544599973184,0.09113310092629234,0.03252855632631916,-3974778687,-3969395528.2,53.81879734750988,41.205386232018135,NaN,NaN,7.885991861232404,0.9484709168340748
2010-08-04T09:30:00-04:00,12.153694,12.194287,12.080626,12.153694,82080943,99613614.55,57.892908744212356,52.452460116920975,NaN,NaN,101.78279265694891,96.11290103428972,0.05615503902596985,0.10272235510878147,0.04656731608281162,-3892697744,-3942692916.2,55.57667481092834,42.12024247131028,NaN,NaN,9.07271131111796,2.1090766874460583
2010-08-05T09:30:00-04:00,12.064388,12.129338,12.031913,12.104982,50608614,97172082.75,56.440473475940735,53.29556310061384,NaN,NaN,77.44491690506237,96.5671115340248,0.04814276507775429,0.10674577243000449,0.0586030073522502,-3943306358,-3943327177.2,55.52261279940026,43.18776124330085,NaN,NaN,9.67521018182908,3.189952900929347
2010-08-06T09:30:00-04:00,11.983201,12.048151,11.837065,11.999439,101996092,97278250.45,53.31919066355033,53.92518037584819,NaN,NaN,30.99426223770236,89.83256721482329,0.033327323569021336,0.10026216181352687,0.06693483824450554,-4045302450,-3949794115.8,54.93583886254165,44.46378480641578,NaN,NaN,9.342387689646342,4.068872156460346
2010-08-09T09:30:00-04:00,12.05627,12.096863,11.942608,12.064388,49612514,96403070.95,54.96954253154277,54.47219630615874,NaN,NaN,52.63294442434586,74.1505511849994,0.025828879785621775,0.09922093797653275,0.07339205819091098,-3995689936,-3970355035,53.017400619270006,45.822743156849775,NaN,NaN,9.499370329508569,4.844657609752949
2010-08-10T09:30:00-04:00,11.950808,12.05627,11.873599,11.958845,81222678,95269272.7,51.76673670582205,55.05196313385754,NaN,NaN,29.28890448138152,58.42876414108819,0.012370398855094958,0.08885505675977967,0.07648465790468471,-4076912614,-3990781820.4,51.10788949338716,47.26022899801469,NaN,NaN,8.762018469047762,5.404280589652208
2010-08-11T09:30:00-04:00,11.772115,11.780234,11.520435,11.536673,117480936,96380429.9,41.38067817560542,54.37010754820501,NaN,NaN,-84.55995528068411,21.160214553561588,-0.024352919802865705,0.046043508151102586,0.07039642795396829,-4194393550,-4051120981.6,45.854173870849586,48.41072278136337,NaN,NaN,4.731573395765841,5.308179561954155
2010-08-12T09:30:00-04:00,11.414892,11.528554,11.374299,11.455486,88877913,94906645.15,39.72986174741845,53.444553374518755,NaN,NaN,-117.03694381668224,-17.736157590787336,-0.05191671965993435,0.005500528379050351,0.0574172480389847,-4283271463,-4119114002.6,40.768452183358235,49.088348648218165,NaN,NaN,0.9060578899906722,4.679305037387944
2010-08-13T09:30:00-04:00,11.447367,11.561029,11.423011,11.423011,64081017,89385888.35,39.05864056855858,52.249193481019475,NaN,NaN,-106.91689000323785,-45.318388038975385,-0.06906755590078056,-0.02891719683699101,0.040150359063789554,-4347352480,-4179524008.6,36.85712296169781,49.15480195289803,NaN,NaN,-2.4094486399694293,3.6666259406226045
2010-08-16T09:30:00-04:00,11.386477,11.439248,11.333705,11.390536,68344636,88409864.1,38.360697851233446,50.95995439417328,NaN,NaN,-128.77495059003274,-81.5999670418511,-0.07863525417262066,-0.05814370865198626,0.02049154552063439,-4415697116,-4263525444.6,32.227093045657725,48.578579830090476,NaN,NaN,-5.351068458483636,2.3783838836074276
2010-08-17T09:30:00-04:00,11.512317,11.593504,11.414892,11.479842,79856962,86718038.55,41.45869637894005,50.07948094527011,NaN,NaN,-98.36309631913697,-107.1303672019548,-0.0749974293540885,-0.07325524117197624,0.0017421881821122615,-4335840154,-4315310952.6,29.746242015655966,47.47015344782635,NaN,NaN,-7.022760568290264,1.0353632476220431
2010-08-18T09:30:00-04:00,11.471723,11.609741,11.43113,11.528554,68423230,83826459.35,43.13746077465654,49.256503422242204,NaN,NaN,-90.61303745509016,-108.34098363683601,-0.0656930192173082,-0.08037408583952299,-0.01468106662221479,-4267416924,-4329915627.4,29.06665825616311,46.00669419196055,NaN,NaN,-7.980543965847459,-0.2526234971593142
2010-08-19T09:30:00-04:00,11.455486,11.504198,11.236281,11.260637,124545102,84877231.55,36.874218896170746,48.001985647290155,NaN,NaN,-128.7338104237836,-110.68035695825627,-0.07338145113502464,-0.10640788054099559,-0.03302642940597095,-4391962026,-4351653740,28.03982298373515,44.32126950841968,NaN,NaN,-10.752529370607991,-1.752610050509125
2010-08-20T09:30:00-04:00,11.220043,11.252518,11.122619,11.228162,81195659,84637461.15,36.18834093018258,46.2456815504329,NaN,NaN,-138.16316232665477,-116.92961142293966,-0.07612501736555033,-0.12818270111290886,-0.05205768374735853,-4473157685,-4376814781,26.85716988228161,42.3854249380312,NaN,NaN,-13.229358889997519,-3.392145599007467
2010-08-23T09:30:00-04:00,11.284993,11.30123,11.146975,11.155094,66289686,83069971.75,34.627674489016485,44.65750870948933,NaN,NaN,-118.66492292618696,-114.9076058901705,-0.07804246142024471,-0.14961076052266442,-0.07156829910241971,-4539447371,-4401564832,25.708510665744,40.37754731790507,NaN,NaN,-15.777060169356766,-5.161419109057366
2010-08-24T09:30:00-04:00,11.017076,11.073907,10.935889,10.968364,116191942,83128248.1,30.953780066573984,42.733285232515165,NaN,NaN,-141.70224173645528,-123.57543497363417,-0.0864173612629007,-0.17959000068104558,-0.09317263941814488,-4655639313,-4465524663.8,22.97397834498463,38.048783284623376,NaN,NaN,-19.16395687736766,-7.161781647387408
2010-08-25T09:30:00-04:00,10.887177,11.041432,10.789752,11.000839,90836040,84626409.15,32.29907556857846,41.00889966770357,NaN,NaN,-133.22600301785326,-132.0980280861868,-0.08421452955922411,-0.198440801367175,-0.1142262718079509,-4564803273,-4525001933.6,20.76235506922073,35.56590773246769,NaN,NaN,-21.57742556233337,-9.221159349522546
2010-08-26T09:30:00-04:00,11.057669,11.130738,10.879058,10.911533,88333649,84739304.05,30.53701617355881,39.38160148984703,NaN,NaN,-115.0083840721016,-129.35294281585038,-0.0830770936945966,-0.21807263892619666,-0.13499554523160007,-4653136922,-4577236912.8,19.029737087205362,33.00118617708653,NaN,NaN,-24.15270865695432,-11.354237822012799
2010-08-27T09:30:00-04:00,10.960245,11.155094,10.838464,11.146975,107656624,86480500.05,39.85306834033348,38.301853333332076,NaN,NaN,-92.8387175064963,-120.28805385181867,-0.06175304537852799,-0.21218685195476006,-0.15043380657623207,-4545480298,-4591701435.4,18.567663834604318,30.540490692467557,NaN,NaN,-23.689605980194354,-13.116433273181592
2010-08-30T09:30:00-04:00,11.098263,11.122619,10.903414,10.911533,78575121,84405135.25,34.823450765384706,37.091618623300846,NaN,NaN,-99.03719000429066,-116.36250726743943,-0.0588042304339588,-0.22393909461868056,-0.16513486418472176,-4624055419,-4608623045,18.01651230813974,28.176820893521317,NaN,NaN,-24.874081811993044,-14.796097350154657
2010-08-31T09:30:00-04:00,10.903414,11.049551,10.822227,11.004492,131312825,86876109.15,38.14281957858389,36.86034300922787,NaN,NaN,-95.04702736935062,-107.03146439401849,-0.04643542617988203,-0.2231791469095743,-0.17674372072969227,-4492742594,-4576043701.2,22.769719102031743,26.527931267177184,NaN,NaN,-24.803771711621962,-16.22576511607856
2010-09-01T09:30:00-04:00,11.146975,11.447367,11.138856,11.432347,163098387,90926981.35,50.6105679841714,37.63753631185308,NaN,NaN,-12.909694458863752,-82.96820268222059,-0.007332632208538359,-0.18590951099036523,-0.17857687878182688,-4329644207,-4529011888,29.155318162206186,25.698421694237748,NaN,NaN,-20.281479775835614,-16.80515292461528
2010-09-02T09:30:00-04:00,11.423011,11.544791,11.414892,11.544791,82253326,92509216.95,53.27596907238187,38.653059776411894,NaN,NaN,32.61737360128298,-53.44305114754368,0.02636459490951029,-0.14562113514493902,-0.1719857300544493,-4247390881,-4447862679.8,38.5900587154846,25.822202819508238,NaN,NaN,-15.758561458214887,-16.655639857986653
2010-09-03T09:30:00-04:00,11.699047,11.788352,11.650334,11.787541,109040156,92861420.15,58.48483248073817,40.090497964233656,NaN,NaN,98.34869342975168,-15.205568960294084,0.06316298737620454,-0.09303199583419364,-0.15619498321039818,-4138350725,-4366436765.2,46.31567675598198,26.828530227388544,NaN,NaN,-10.082324817781316,-15.716594852243034
2010-09-07T09:30:00-04:00,11.674691,11.682809,11.504198,11.516376,69677795,93864684.2,51.568915902447245,40.81265650162703,NaN,NaN,65.46584699565462,17.695038439694965,0.0670352817386661,-0.07240088103706555,-0.13943616277573165,-4208028520,-4283231385.4,52.84404363625021,28.478373200288136,NaN,NaN,-7.720742843562267,-14.574330279574353
2010-09-08T09:30:00-04:00,11.561029,11.715284,11.55291,11.634097,63620747,92984587.65,54.106180123266796,41.59613645509919,NaN,NaN,93.88368081940635,55.48118007744637,0.07473215266924116,-0.0460209719391802,-0.12075312460842136,-4144407773,-4213564421.2,57.503839833293874,30.509600455797475,NaN,NaN,-4.976524731816056,-13.203215201323168
2010-09-09T09:30:00-04:00,11.812709,11.877658,11.707165,11.780234,100273137,92124197.7,57.11009432576632,43.04155612864173,NaN,NaN,132.90486066753041,84.6440911027252,0.08606582444804287,-0.013170844048367769,-0.09923666849641063,-4044134636,-4156462507,60.91317157739109,32.85769678391575,NaN,NaN,-1.7334583503194116,-11.564678508322631
2010-09-10T09:30:00-04:00,11.788352,11.837065,11.748084,11.796471,48963484,90128476.25,57.443390725052254,44.55977397113242,NaN,NaN,121.66955310540322,102.45452700354925,0.09059876678616596,0.014011789986296819,-0.07658697679986914,-3995171152,-4106018561.2,63.6848953020633,35.488248599614444,NaN,NaN,0.9073881406888467,-9.78295470132099
2010-09-13T09:30:00-04:00,11.975083,12.080626,11.975083,12.048151,93947927,91621821.75,62.32991169635721,46.53850520022819,NaN,NaN,160.67416109502767,114.91962053660446,0.10545044864166817,0.05522608400221607,-0.050224364639452096,-3901223225,-4058593061.2,66.11755729895262,38.37460907341506,NaN,NaN,4.815741777809197,-7.697426632873821
2010-09-14T09:30:00-04:00,12.007557,12.031913,11.877658,11.942608,81372475,92273213.7,59.25708245692647,48.560169656681936,NaN,NaN,121.10863398305666,126.04817793408486,0.10295368659052932,0.07846774359870956,-0.024485942991819762,-3982595700,-4013506497.2,68.29216519887136,41.61162242012126,NaN,NaN,7.047563327882714,-5.590999495622888
2010-09-15T09:30:00-04:00,11.849243,11.999439,11.812709,11.983201,91820276,92871379.4,60.07239030740838,50.54397785231264,NaN,NaN,104.6289788303048,128.19723753626454,0.09880554622886825,0.09902098979426555,0.00021544356539730108,-3890775424,-3962780027.4,70.57998259358962,45.1700243861476,NaN,NaN,9.091647718268469,-3.4934784650669797
2010-09-16T09:30:00-04:00,11.938548,11.958845,11.869539,11.946667,65531141,92726774.95,58.92942651473767,52.572007162396844,NaN,NaN,93.34334299995886,120.28493400275025,0.08869254352349666,0.11108112296976813,0.02238857944627147,-3956306565,-3945214413.2,71.3508503673756,48.90724676330262,NaN,NaN,10.43667311353385,-1.503456810981147
2010-09-17T09:30:00-04:00,11.966964,11.990914,11.845183,11.861827,80980708,90548555.25,56.25278795567446,53.743415706349765,NaN,NaN,79.53832106030502,111.8586875937306,0.07208609665671038,0.11249620026715945,0.04041010361044907,-4037287273,-3953637637.4,70.39827642946995,52.6094333772216,NaN,NaN,10.817426881115388,0.2566694307469293
2010-09-20T09:30:00-04:00,11.877658,12.121219,11.861421,12.084685,64422668,89709905.7,61.23385496054795,55.62987314886143,NaN,NaN,92.96437366797001,98.31673010831906,0.07175249089964425,0.13010071723500438,0.05834822633536013,-3972864605,-3967965913.4,68.71766165921586,56.2309440451556,NaN,NaN,12.641338785551268,2.0259079100046917
2010-09-21T09:30:00-04:00,12.121219,12.153694,11.934489,11.975083,103781620,91584502.4,57.75121890875086,57.03047310101622,NaN,NaN,84.85009615596466,91.06502254290066,0.060255515904256415,0.13366762121568065,0.07341210531142424,-4076646225,-3986776018.4,66.47408715297395,59.35268462022291,NaN,NaN,13.153429816460177,3.6155538966411895
2010-09-22T09:30:00-04:00,11.893896,12.007557,11.755878,11.779828,114921728,91520991.7,52.06963539173217,57.13469220155627,NaN,NaN,48.82237130550813,79.90370103794133,0.036760738899640835,0.11936302893597528,0.08260229003633444,-4191567953,-4046934524.2,59.754629990796076,61.53834975083647,NaN,NaN,11.861870287174455,4.793599095288799
2010-09-23T09:30:00-04:00,11.666572,11.763996,11.528554,11.55291,127435574,93350968.4,46.36123177172681,56.640782394366624,NaN,NaN,-2.9603381703292,60.642964803883714,0.004873163216208551,0.08869374405659514,0.08382058084038659,-4319003527,-4119473916.6,52.82115071701667,62.55485632237447,NaN,NaN,8.90110479399845,5.380385623675892
2010-09-24T09:30:00-04:00,11.690928,11.861421,11.682809,11.857361,94666170,93667594.45,53.695932813698214,56.29871813243519,NaN,NaN,32.01914740321215,51.13913007246515,0.0032963646058861013,0.08794103659774422,0.08464467199185811,-4224337357,-4156883933.4,49.62325995359026,62.79111226506078,NaN,NaN,8.697193582154412,5.854215332029966
2010-09-27T09:30:00-04:00,11.861421,11.861421,11.707165,11.727462,76774143,92123470.4,50.521590752567185,56.22390919315804,NaN,NaN,16.883418504643526,35.92293903979985,-0.006926283124577645,0.07598681808613605,0.0829131012107137,-4301111500,-4222533312.4,44.5285262317612,62.197146736168705,NaN,NaN,7.489391789939398,6.0878119688741705
2010-09-28T09:30:00-04:00,11.772115,11.788352,11.61786,11.755878,101401712,93264799.95,51.20120619635791,56.0164110555217,NaN,NaN,-7.9821049936987025,17.35649880986718,-0.011913013651883103,0.06802183414585983,0.07993484779774293,-4199709788,-4247146025,42.75617972166075,61.14374244248063,NaN,NaN,6.740608687413288,6.181068642951187
2010-09-29T09:30:00-04:00,11.715284,11.772115,11.609741,11.666572,82279576,90813137.5,48.92665651845478,55.43187978357087,NaN,NaN,-44.512031106568756,-1.3103816725482047,-0.020842150910473894,0.053882159159650556,0.07472431007012445,-4281989364,-4265230307.2,41.450704283298506,59.75356620718831,NaN,NaN,5.433539257440743,6.07427873073541
2010-09-30T09:30:00-04:00,11.735581,11.877658,11.642216,11.645869,132459393,89281187.8,48.3899856086704,54.7852079895436,NaN,NaN,-40.82199176338171,-8.882712391158712,-0.027348645532586938,0.04053850315439078,0.06788714868697772,-4414448757,-4284319353.2,40.06026737492046,58.066092783820956,NaN,NaN,4.216445129184248,5.8088739305138155
2010-10-01T09:30:00-04:00,11.763996,11.812709,11.642216,11.772115,162749957,93306019.35,51.85781216052282,54.03720087984114,NaN,NaN,-39.455563967161986,-23.17765466523354,-0.022555318509406827,0.03969300055021918,0.06224831905962601,-4251698800,-4289791641.8,39.649658551749376,56.175528587592154,NaN,NaN,4.155554894954114,5.572685496862429
2010-10-04T09:30:00-04:00,11.755878,11.845183,11.634097,11.690928,105371096,93122566.35,49.55192795627814,53.34397555836626,NaN,NaN,-49.57745600319521,-36.46982956680129,-0.024117237641366432,0.03210177200791797,0.056219009649284404,-4357069896,-4300983321,38.77433279055018,54.06711198699778,NaN,NaN,3.4493005886293733,5.269344795686278
2010-10-05T09:30:00-04:00,11.796471,12.003498,11.709439,11.958845,163827489,97830051.05,56.43605622919059,53.08423740992214,NaN,NaN,39.64701226746635,-26.944006114568275,-0.007246653787542731,0.04716069241485599,0.05440734620239872,-4193242407,-4299689844.8,38.94210497484078,51.807263585658575,NaN,NaN,4.893894751500123,5.215709075088256
2010-10-06T09:30:00-04:00,11.983201,12.015676,11.910133,11.950726,79759528,98636990.1,56.18583843017251,52.8882668324532,NaN,NaN,73.32609668419877,-3.376380556414756,0.0026932258981680196,0.05777387857510874,0.05508065267694072,-4273001935,-4297892359,39.19147406313282,49.51016527821266,NaN,NaN,5.984918461586798,5.325596130302333
2010-10-07T09:30:00-04:00,12.007557,12.048151,11.833979,11.902014,88432423,98044954.4,54.62110582085413,52.771718108537456,NaN,NaN,49.16775314136013,14.621568424533612,0.005171320729403926,0.06154480358869563,0.0563734828592917,-4361434358,-4287289479.2,40.72921964526249,47.39094693648356,NaN,NaN,6.4597110395567645,5.4876125459101095
2010-10-08T09:30:00-04:00,11.918252,11.958845,11.869539,11.934489,76887521,99441156.25,55.51064937349487,52.36291770946223,NaN,NaN,40.739597359882275,30.660600689942463,0.008011985733110696,0.06638846502568008,0.05837647929256938,-4284546837,-4293859086.6,40.053355848819685,45.343496521455265,NaN,NaN,7.098458368965607,5.717733377775181
2010-10-11T09:30:00-04:00,11.942608,11.958845,11.869539,11.918252,50828078,97285163.8,54.93085898379158,52.161463429108,NaN,NaN,43.22635129493167,49.22136214956784,0.007804043367270995,0.06813153350165813,0.06032749013438713,-4335374915,-4289520090.4,40.752644692295995,43.506250631406836,NaN,NaN,7.483215471915495,5.969945105509511
2010-10-12T09:30:00-04:00,11.853302,12.072507,11.828946,12.05221,81085710,97270825.55,58.75806052411291,52.63920808142091,NaN,NaN,85.8194290981221,58.45584551569899,0.015263500669627353,0.07940686597142133,0.06414336530179397,-4254289205,-4301729450,39.361254450522964,42.04958094995875,NaN,NaN,8.867962240255808,6.383947553330411
2010-10-13T09:30:00-04:00,12.129338,12.17805,12.031913,12.063576,138774611,99618542.3,59.07560749438141,53.54737777589624,NaN,NaN,139.52948358311835,71.6965228954829,0.019279374815586267,0.08824258382127681,0.06896320900569054,-4115514594,-4270231981.8,44.614820172872065,41.46341448251985,NaN,NaN,10.111323636709454,6.916429850955988
2010-10-14T09:30:00-04:00,11.950726,11.975083,11.73964,11.849243,208448012,106764385.85,51.087409054065404,53.36105465020818,NaN,NaN,-0.43461000795776933,61.776050265619325,0.006478834492753979,0.07706175212163302,0.07058291762887904,-4323962606,-4262737631.4,45.81765173869482,41.191585324313046,NaN,NaN,9.021764813130693,7.2171919884095175
2010-10-15T09:30:00-04:00,11.889836,11.950726,11.569148,11.646275,163647204,110897710.65,44.896225347519625,52.95924283556193,NaN,NaN,-73.79768794979636,38.8685932036836,-0.015480361980472077,0.05123246515328894,0.06671282713376102,-4487609810,-4303350226,40.66381357778526,40.91553442045762,NaN,NaN,6.150056444931297,7.064744053626915
2010-10-18T09:30:00-04:00,11.609741,11.92637,11.609741,11.910133,96453471,112499250.8,52.889187944916344,53.07981296045896,NaN,NaN,-13.139532340962655,27.595416476504738,-0.012201861725477853,0.05146049997691371,0.06366236170239156,-4391156339,-4314506510.8,39.35423090750845,40.672538076589596,NaN,NaN,6.098604290092691,6.92672408740774
2010-10-19T09:30:00-04:00,11.820827,11.99132,11.699047,11.744105,180742611,116347300.35,48.15581303439787,53.02475271159775,NaN,NaN,-9.831182888519342,8.465294079176449,-0.020683236214367254,0.0378083164344325,0.05849155264879975,-4571898950,-4378028459.8,32.864324553216264,40.059225238726576,NaN,NaN,4.503862465796113,6.580600998606079
2010-10-20T09:30:00-04:00,11.755878,11.92637,11.650334,11.861421,118985650,116550496.45,51.461423215767674,53.24414111210469,NaN,NaN,-7.836991107256083,-21.008000858898438,-0.017961371284701558,0.03603983854292281,0.054001209827624366,-4452913300,-4445508201,27.648198111772587,39.17264886278743,NaN,NaN,4.246836824913021,6.247206116649928
2010-10-21T09:30:00-04:00,11.910133,11.999439,11.763509,11.857767,90651222,114711278.85,51.35159813966212,53.2079829677575,NaN,NaN,27.629598164210524,-15.395159224464782,-0.01603930278123561,0.033952081351079855,0.049991384132315464,-4543564522,-4489428584.2,24.8802638189199,38.11769209615676,NaN,NaN,4.01070958883324,5.927706612676116
2010-10-22T09:30:00-04:00,11.885777,11.92637,11.820827,11.85452,50826186,112519279.65,51.246936855104586,53.32905503195939,NaN,NaN,20.42653528070176,3.4496854216348374,-0.014656758585469595,0.031670435900478466,0.04632719448594806,-4594390708,-4510784763.8,23.640910132413993,37.03673333486131,NaN,NaN,3.790237036849596,5.62235381612947
2010-10-25T09:30:00-04:00,11.958845,11.975083,11.796471,11.812709,56372256,111499185.3,49.838334005902986,52.85778915886742,NaN,NaN,12.87199250755917,8.651990391339204,-0.01611251169462452,0.02618655486766741,0.04229906656229193,-4650762964,-4562706088.8,20.913369782133273,35.74896653538221,NaN,NaN,3.2154341953932324,5.2785081560242935
2010-10-26T09:30:00-04:00,11.763996,11.853302,11.73964,11.828946,58394649,109348832.15,50.408404613959746,52.44511531485222,NaN,NaN,-34.818547742314,3.654517420580274,-0.015529730161383128,0.022886903860563024,0.03841663402194615,-4592368315,-4566799961.8,20.71047525182796,34.42889519171757,NaN,NaN,2.8868040351213544,4.936836138752445
2010-10-27T09:30:00-04:00,11.788352,11.877658,11.747759,11.837065,77230472,109096376.95,50.710049877761236,52.16575417605986,NaN,NaN,-32.30992529674266,-1.2400694173170421,-0.014182461376734318,0.020688557301028254,0.03487101867776257,-4515137843,-4579244870.4,20.0729469225915,32.95344714009821,NaN,NaN,2.6877285322199937,4.615535052104952
2010-10-28T09:30:00-04:00,11.902014,11.934489,11.763996,11.833005,71330612,106039937.9,50.5444841756788,51.81102809050157,NaN,NaN,-18.381217088009095,-10.442232467760965,-0.013171563478769799,0.018406564329300323,0.03157812780807012,-4586468455,-4587825657,19.624381821936126,31.494234709606527,NaN,NaN,2.477880701402907,4.310155859147517
2010-10-29T09:30:00-04:00,11.80459,11.845183,11.756284,11.820015,49055952,100355237.65,49.98219533346568,51.457552115478286,NaN,NaN,-60.7469150185732,-26.676922527615954,-0.012964360354621805,0.015372677364792864,0.02833703771941467,-4635524407,-4596052396.8,19.181804507474894,29.95346041069073,NaN,NaN,2.1610015244046306,4.003133811327104
2010-11-01T09:30:00-04:00,11.845183,11.92637,11.707165,11.820827,80981634,99135764.55,50.0196250698244,50.833378154457684,NaN,NaN,-57.844475885986476,-40.820216206325085,-0.012361399679020408,0.01288528812063916,0.025246687799659568,-4554542773,-4576808358.6,23.526480311859203,28.82240511507189,NaN,NaN,1.897217170588101,3.702288576935818
2010-11-02T09:30:00-04:00,11.889836,11.902014,11.820827,11.849243,67237306,94306255.4,51.390521673377904,50.28444345295743,NaN,NaN,-12.663053466313624,-36.38911735112501,-0.009752197109883922,0.013056441412304665,0.022808638522188587,-4487305467,-4555795789,28.073282940351348,27.640866741320412,NaN,NaN,1.984607538390029,3.4569055714292767
2010-11-03T09:30:00-04:00,11.861421,11.975083,11.772115,11.966964,133259640,96981261,56.69039071525074,50.684656428756384,NaN,NaN,46.325524023291806,-20.662027487118117,-0.0003008360023025701,0.022432593519310373,0.022733429521612943,-4354045827,-4523577385.8,34.50345973470546,26.832710169606887,NaN,NaN,3.4091022058442917,3.45007651920285
2010-11-04T09:30:00-04:00,12.088744,12.389136,12.080626,12.365592,205055232,102812401.45,69.01136733688068,52.4071665708536,NaN,NaN,331.32234068594846,49.278684067673396,0.030871115711773194,0.06132232416132943,0.03045120844955624,-4148990595,-4436081813.8,48.07863691758702,27.362340408164158,NaN,NaN,9.032225127090253,4.247526320329622
2010-11-05T09:30:00-04:00,12.397255,12.730122,12.36478,12.648935,203977247,109166887.75,74.55288572184878,53.9545735549202,NaN,NaN,349.0803215940544,131.2441313901989,0.06659544671166437,0.1136955168391367,0.04710007012747233,-3945013348,-4297979602,61.60546111856244,28.95171399466801,NaN,NaN,16.230014132730997,5.959310293529818
2010-11-08T09:30:00-05:00,12.632778,12.640816,12.437848,12.551104,110819476,112166457.65,69.90472050510779,55.5080669456852,NaN,NaN,228.18874217667792,188.45077500273177,0.07882297370902466,0.14562878726375317,0.0668058135547285,-4055832824,-4198237612.2,68.07462118114387,31.466735182377125,NaN,NaN,20.393623804730233,8.021355080844163
2010-11-09T09:30:00-05:00,12.592104,12.600222,12.234881,12.316068,150499227,115637133.5,60.194742675577515,56.131875478528755,NaN,NaN,135.99670789239346,218.1827272744732,0.0667464159306714,0.15023883346806777,0.08349241753739636,-4206332051,-4142042929,71.03565912910709,34.565839540758155,NaN,NaN,20.49065516225604,9.802683663903002
2010-11-10T09:30:00-05:00,12.312009,12.462204,12.210525,12.454086,150060280,116201416.95,63.40894146867556,56.993114287744,NaN,NaN,116.50349421623896,232.21832131306263,0.06372490795209129,0.16314855247751048,0.09942364452541919,-4056271771,-4082488117.8,73.80820930176216,38.06069278953261,NaN,NaN,21.704598914546928,11.502957271137848
2010-11-11T09:30:00-05:00,12.332305,12.389136,12.267356,12.332305,73628339,109460433.3,58.890332173644545,57.539071096211146,NaN,NaN,87.85595614495047,183.52504440486305,0.04981231500597287,0.16168903828288528,0.11187672327691241,-4129900110,-4078670020.8,73.9801722845239,41.656354371826176,NaN,NaN,21.1107457957485,12.87549848893937
2010-11-12T09:30:00-05:00,12.267356,12.307949,12.096863,12.129338,109316457,106743895.95,52.21217476924723,57.708631150735734,NaN,NaN,40.34803495506876,121.77858707706591,0.024508088912691267,0.14251183441777648,0.11800374550508522,-4239216567,-4137510664.6,66.71103911693103,44.927616467168875,NaN,NaN,18.232807801476167,13.64082839073034
2010-11-15T09:30:00-05:00,12.210525,12.340424,12.169931,12.182109,88079224,106325183.6,53.68282463711297,57.94251829524667,NaN,NaN,48.27938936041109,85.79671651381257,0.009655040017729169,0.13007254552724667,0.1204175055095175,-4151137343,-4156571568.4,64.50009188771469,48.05544622687506,NaN,NaN,16.4714643024085,14.045204949541505
2010-11-16T09:30:00-05:00,12.121219,12.137456,11.885777,11.979142,167179021,105647004.1,47.61354272941018,57.7213392132216,NaN,NaN,-15.909254697897204,55.41552399575444,-0.014211399614318707,0.10265325599161912,0.11686465560593783,-4318316364,-4178968431,61.90395580421882,51.04337543270559,NaN,NaN,12.87237872416819,13.877658345916746
2010-11-17T09:30:00-05:00,11.975083,12.007557,11.869539,11.898361,111485513,105271997.25,45.412899411234505,57.354797444332725,NaN,NaN,-38.91931874120136,24.33096140426637,-0.034646124013423735,0.07355700058915815,0.10820312460258188,-4429801877,-4253674452.2,54.084240215976614,53.50479388942277,NaN,NaN,9.26006704377023,13.2180024456101
2010-11-18T09:30:00-05:00,12.048151,12.145575,12.015676,12.064388,105242070,106001539.65,50.47888292729237,57.390275129606046,NaN,NaN,0.2073416271083621,6.8012385006979486,-0.03602901827178455,0.0631668517628512,0.09919587003463574,-4324559807,-4292606391.6,50.50383617876776,55.74208186594369,NaN,NaN,7.877587234172262,12.455085986833266
2010-11-19T09:30:00-05:00,11.999439,12.064388,11.950726,12.059923,53723950,106146427.85,50.343568169452375,57.41341392243662,NaN,NaN,-17.062071449119777,-4.680782780139779,-0.036196384610101565,0.05395038927200879,0.09014677388211036,-4378283757,-4320419829.6,48.05621508390335,57.49420577823256,NaN,NaN,6.755990211406602,11.6409294474866
2010-11-22T09:30:00-05:00,11.983201,11.99132,11.80459,11.885777,119742776,109314953.85,45.248854911936014,56.97472343947648,NaN,NaN,-56.867561781941006,-25.710173008610195,-0.04633925410875231,0.03222270624616996,0.07856196035492227,-4498026533,-4389797667.6,42.52055386960018,58.52615370175033,NaN,NaN,4.160940500645827,10.572359597937918
2010-11-23T09:30:00-05:00,11.755878,11.796471,11.690928,11.699047,104537603,111622101.55,40.514395548000586,55.819295213244324,NaN,NaN,-103.61408928368559,-43.25113992576787,-0.06290033469917297,-0.00006345801904394932,0.06283687668012902,-4602564136,-4446647222,38.59712418116674,58.818558305069,NaN,NaN,0.3680966556340667,9.114607749037368
2010-11-24T09:30:00-05:00,11.780234,11.885777,11.747759,11.877658,72369339,111379044.9,46.30201030691099,54.1971982825322,NaN,NaN,-72.13045792266237,-49.89336776206007,-0.05915749474704961,-0.01110999175368299,0.04804750299336662,-4530194797,-4466725806,37.28844866637119,58.04783057283929,NaN,NaN,-0.9596191672667013,7.675432475279644
2010-11-26T09:30:00-05:00,11.772115,11.837065,11.707165,11.73964,39067752,109765901.9,42.83393941991997,51.931559260965855,NaN,NaN,-91.9778380689449,-68.33040370127074,-0.06295644778626877,-0.030648056739469354,0.03230839104679942,-4569262549,-4515666354.4,34.24095164985475,56.09322275364588,NaN,NaN,-3.198027663129331,6.122081026935505
2010-11-29T09:30:00-05:00,11.682809,11.853302,11.658453,11.80459,101193934,112372801,44.92455527707408,50.14726174467773,NaN,NaN,-87.76536088091817,-82.4710615876304,-0.058186869098833346,-0.04042519532674227,0.017761673772091077,-4468068615,-4533623326,33.16977655366824,53.60001956596905,NaN,NaN,-4.347178868645896,4.626472470423876
2010-11-30T09:30:00-05:00,11.707165,11.828946,11.690928,11.73964,94476485,113047543.55,43.2222855094711,48.93494337567013,NaN,NaN,-91.1553817552791,-89.32862558229803,-0.056454024806572835,-0.052805857236124965,0.0036481675704478685,-4562545100,-4546527039.4,32.385742730650975,50.83931125179362,NaN,NaN,-5.804880804063433,3.136279145497118
2010-12-01T09:30:00-05:00,11.910133,11.983201,11.877658,11.977112,102278995,114799628,50.593611921762545,48.01956269374778,NaN,NaN,-37.88750731283201,-76.18330918812731,-0.03728684969400116,-0.04296039454705358,-0.005673544853052423,-4460266105,-4518067433.2,35.97998137974622,48.137294971649624,NaN,NaN,-4.742261556336266,2.0107733309494917
2010-12-02T09:30:00-05:00,12.031913,12.29983,12.015676,12.283593,139982312,115135761.6,58.145944573440524,47.96639215087606,NaN,NaN,31.771212252788775,-55.40297515303708,-0.0037079713388300404,-0.010308509026589974,-0.006600537687759933,-4320283793,-4476085232.4,40.96534305233954,45.77909288363645,NaN,NaN,-1.168434229069306,1.5566008223753778
2010-12-03T09:30:00-05:00,12.202406,12.348543,12.137456,12.324593,112027787,110484389.35,59.047806713617646,48.45465157547395,NaN,NaN,52.59226967679268,-26.488953603889563,0.020209697126620182,0.018661583720515296,-0.001548113406104887,-4208256006,-4403883923.8,48.40649926651154,44.471625751463634,NaN,NaN,1.9217495963135736,1.6087649329379772
2010-12-06T09:30:00-05:00,12.291712,12.348543,12.243,12.30389,64943461,103532700.05,58.36392465924967,48.78901586276943,NaN,NaN,69.77557792876992,5.019234158048053,0.03283429940060451,0.039494760844650756,0.006660461444046243,-4273199467,-4364910094.2,51.928834797219864,43.573678816428284,NaN,NaN,4.165751990558084,1.974048798312278
2010-12-07T09:30:00-05:00,12.478442,12.478442,12.291712,12.324187,132058245,104594638.5,58.86690622165888,49.592827540787205,NaN,NaN,97.56885221893631,42.76408095289114,0.0402605122629534,0.056986101772737996,0.016725589509784596,-4141141222,-4280629318.6,58.52330610968073,43.332203838247,NaN,NaN,6.129535556531004,2.567689763772096
2010-12-08T09:30:00-05:00,12.332305,12.527154,12.316068,12.523095,119802589,103059806.6,63.51810358314527,50.8860564102094,NaN,NaN,123.95603555730723,75.13278952691898,0.05534595590297439,0.08590803438850259,0.030562078485528194,-4021338633,-4192843824.2,64.05449889441604,44.044365172421244,NaN,NaN,9.313438040642225,3.5313680890392574
2010-12-09T09:30:00-05:00,12.608341,12.705765,12.543391,12.67735,95743387,100343961.95,66.66607995912645,52.042284769626114,NaN,NaN,168.27905522113528,102.43435812058829,0.07146545835606932,0.11989390143061485,0.048428443074545524,-3925595246,-4113906114.8,68.1655968093454,45.30591950317679,NaN,NaN,13.042184351618246,4.890056126550541
2010-12-10T09:30:00-05:00,12.722003,12.80319,12.640816,12.790606,69726315,100148860.75,68.79511723947107,53.360252560341735,NaN,NaN,174.91966013893833,126.89983621301742,0.08460873325091418,0.15418935963818825,0.06958062638727407,-3855868931,-4043428699.8,71.31951156692956,46.96758353767866,NaN,NaN,16.842213409734168,6.597507167005345
2010-12-13T09:30:00-05:00,12.851902,12.876258,12.746359,12.782487,62231046,97794590.2,68.45756241952877,55.01801738231264,NaN,NaN,159.49436317336904,144.84359326193723,0.08725886481960338,0.1786542074117783,0.09139534259217491,-3918099977,-3972408801.8,74.10374105626299,49.223525479583145,NaN,NaN,19.80126509843255,8.483758300066373
2010-12-14T09:30:00-05:00,12.786952,12.835665,12.624579,12.669231,85939177,97687587.85,63.75792619939234,56.67826957169776,NaN,NaN,120.33109277090112,149.39604137233022,0.07628469483708397,0.18675121113852988,0.11046651630144591,-4004039154,-3944988388.2,75.10846956625134,51.83147872137489,NaN,NaN,20.9965513412699,10.271300163095448
2010-12-15T09:30:00-05:00,12.61646,12.722003,12.543391,12.567748,101594767,94408375.15,59.79663886037022,57.64217161123057,NaN,NaN,87.82004327325498,142.16884291551975,0.057923817819075546,0.18287128857529034,0.12494747075621479,-4105633921,-3961847445.8,73.22729682974852,54.398539304473275,NaN,NaN,20.8688613104251,11.785237469856828
2010-12-16T09:30:00-05:00,12.596163,12.673291,12.519035,12.583985,108252010,94246700,60.222469743130844,58.88420949145992,NaN,NaN,75.49816155716748,123.61266418272619,0.04327619873573402,0.17904271917588233,0.1357665204401483,-3997381911,-3976204778.8,71.58301998024001,57.06582989950079,NaN,NaN,20.881336193164486,13.084680144615064
2010-12-17T09:30:00-05:00,12.559629,12.61646,12.494679,12.608341,76250670,92797130,60.89162882735272,60.02471474505125,NaN,NaN,64.99956268377856,101.62864469169423,0.03214333058621563,0.17594568367291785,0.14380235308670222,-3921131241,-3989257240.8,70.04319543569811,59.6996455339315,NaN,NaN,21.0701518400509,14.225461815391611
2010-12-20T09:30:00-05:00,12.632616,12.665172,12.575866,12.61646,49914789,92606671.95,61.12639076614568,61.30357940624229,NaN,NaN,67.81551396716631,83.2928748504537,0.022687575014826572,0.17216182185523543,0.14947424684040886,-3871216452,-3979880535.8,70.53357367283618,62.42449060123044,NaN,NaN,21.288682056361562,15.234493278387319
2010-12-21T09:30:00-05:00,12.665172,12.843783,12.665172,12.835665,59331705,89586118.4,66.90307017855858,62.468540710299145,NaN,NaN,91.46155011936592,77.51896632014666,0.028197993260215715,0.18472173841567852,0.1565237451554628,-3811884747,-3941449654.4,72.51912464125168,65.03442940562368,NaN,NaN,23.137425775948273,16.36348363518174
2010-12-22T09:30:00-05:00,12.884377,13.006157,12.860021,12.977742,87952662,88756871.35,70.0134142056175,63.3162171125975,NaN,NaN,115.52583919789909,83.06012550507549,0.03781365637560144,0.2037908156249646,0.16597715924936315,-3723932085,-3865109287.2,75.98138773255981,67.53557545421084,NaN,NaN,25.696669702660053,17.696795930535785
2010-12-23T09:30:00-05:00,12.957445,12.962804,12.835665,12.884377,36282281,86952518.45,65.6474178031842,63.7876179047094,NaN,NaN,97.41212402747563,87.44291799913712,0.03438679511769796,0.2089606531464856,0.17457385802878764,-3760214366,-3817675778.2,77.84880891095757,69.63859757167128,NaN,NaN,26.601587838958253,18.968909060310423
2010-12-27T09:30:00-05:00,12.819427,12.998031,12.811309,12.998031,29756251,86486943.4,68.24350893109883,64.49330249555577,NaN,NaN,100.98342239495183,94.63968994137177,0.03609786847212357,0.2196961936189421,0.18359832514681854,-3730458115,-3779541153,79.24587728269597,71.58981489206244,NaN,NaN,28.1535504095675,20.281000681632865
2010-12-28T09:30:00-05:00,12.998031,13.038632,12.965564,12.999654,42043460,83529419.7,68.28037332440032,65.16569300289443,NaN,NaN,113.35367999927466,103.74732314779344,0.03370777137131656,0.22573303936096423,0.19202526798964767,-3688414655,-3742980793.6,80.51470654321383,73.16062920874336,NaN,NaN,29.42122618038448,21.586747181454523
2010-12-29T09:30:00-05:00,13.014276,13.022387,12.957445,12.973683,31054626,80358326.75,66.94124195647889,65.41020288670398,NaN,NaN,108.03110388390117,107.0612339007005,0.027034621476796722,0.22581854483564356,0.19878392335884684,-3719469281,-3724497700.4,81.14238112179088,74.38119222498442,NaN,NaN,30.117339409255234,22.805403213997483
2010-12-30T09:30:00-05:00,12.973683,12.973683,12.884377,12.933089,45404234,77514588.7,64.80193487853276,65.27704966666158,NaN,NaN,85.23097670301034,101.00226140172273,0.017031931543133566,0.2200738377877638,0.20304190624463023,-3764873515,-3732685986.4,79.91422183390823,75.22037972673891,NaN,NaN,30.137998147619584,23.8529167759435
2010-12-31T09:30:00-05:00,12.900614,12.965564,12.884377,12.949326,27097343,71870340.25,65.27989212994855,65.02596215883854,NaN,NaN,79.55725332354378,97.43128726093637,0.009054710387059128,0.21436029422845415,0.20530558384139502,-3737776172,-3728198347.6,80.09206725507015,75.84699084732038,NaN,NaN,30.278146094704102,24.770806678623586
2011-01-03T09:30:00-05:00,13.127938,13.265956,13.095463,13.233481,113633502,71950626,72.3548441910263,65.30433942823122,NaN,NaN,157.03992018087737,108.64258681812149,0.019842456273807457,0.23010865418365434,0.21026619790984688,-3624142670,-3706935258.6,80.95262933593945,76.33619715301155,NaN,NaN,32.54705131585218,25.881698769656243
2011-01-04T09:30:00-05:00,13.282193,13.298431,13.103582,13.213176,65808486,71993877.25,71.23776212749286,65.83861342309555,NaN,NaN,145.7856125770843,115.12897333368342,0.022351057602398805,0.23820501991284537,0.21585396231044657,-3689951156,-3707242558.8,80.89820212497767,76.74974947863485,NaN,NaN,34.07379233639381,27.05199785061875
2011-01-05T09:30:00-05:00,13.168531,13.395855,13.152294,13.371499,119722595,71377094.75,74.53860842514442,66.89161124915084,NaN,NaN,162.23976281951838,125.97070512080684,0.030887625559699178,0.25446349426007053,0.22357586870037136,-3570228561,-3677394414.8,82.1533124790024,77.38732202501014,NaN,NaN,36.45116738961735,28.39473635618998
2011-01-06T09:30:00-05:00,13.379618,13.403966,13.274083,13.283817,82465951,69510262.85,69.76351263574074,67.57311431290869,NaN,NaN,151.90705952589593,139.30592168538396,0.026985041686384048,0.2573071708083514,0.23032212912196737,-3652694512,-3654958614.2,83.05460996597813,78.20672130970571,NaN,NaN,37.019540774323566,29.626851273066208
2011-01-07T09:30:00-05:00,13.330905,13.347143,13.006157,13.164472,219395183,75692852.65,63.77486424720882,67.77905970004126,NaN,NaN,91.44851701008365,141.68417442269194,0.013408255269433844,0.2470824482087597,0.23367419293932584,-3872089695,-3681821318.8,77.97688393385407,78.77341334528828,NaN,NaN,35.659189857240456,30.488613927948244
2011-01-10T09:30:00-05:00,13.095463,13.17665,13.014276,13.131591,107101659,77561619.85,62.190873629078716,67.85509419025077,NaN,NaN,62.85330045975389,122.84685047846725,-0.000033045944504067615,0.23363288550869576,0.23366593145319983,-3979191354,-3752831055.6,66.41735926875347,78.47939803071094,NaN,NaN,34.07549994648336,31.001026216310404
2011-01-11T09:30:00-05:00,13.217244,13.282193,13.127938,13.184777,61667449,77533440,63.758858700621666,67.63050765611241,NaN,NaN,85.17952043193024,110.72563204943643,-0.007192142247459288,0.2246757536438757,0.231867895891335,-3917523905,-3798345605.4,60.251945780571376,77.60317096923379,NaN,NaN,33.19418377141973,31.31433443846888
2011-01-12T09:30:00-05:00,13.339016,13.412092,13.310365,13.406409,100844342,78278698.25,69.4453283078354,67.58993009198511,NaN,NaN,128.912611744793,104.06020183449134,0.0007278399857331974,0.2327776958735015,0.2320498558877683,-3816679563,-3847635805.8,54.36616211079577,76.05922628196492,NaN,NaN,34.15660317357264,31.720372829197988
2011-01-13T09:30:00-05:00,13.428322,13.444567,13.31466,13.359735,74749050,76936412.4,67.05902665780577,67.69075929588665,NaN,NaN,113.6759377303059,96.41397747537333,0.0005595969564562153,0.23274935208333858,0.23218975512688236,-3891428613,-3895382626,49.338272731307285,74.02275941198991,NaN,NaN,34.21059760366178,32.07611922554996
2011-01-14T09:30:00-05:00,13.355261,13.606933,13.339016,13.574466,113426257,77195124.75,71.85133276984953,67.94846099865455,NaN,NaN,140.41379675465856,106.20703342428833,0.012011611580828307,0.24720426960291775,0.23519265802208944,-3778002356,-3876565158.2,51.2517252895877,72.02317712676788,NaN,NaN,35.825130240999755,32.611692227757075
2011-01-18T09:30:00-05:00,13.537932,13.558229,13.428322,13.493279,75522475,77158715,67.83317749609151,67.91651843948965,NaN,NaN,125.84018405968192,118.80441014427393,0.011234472716451449,0.24923574891765377,0.23800127620120232,-3853524831,-3851431853.6,53.76358267335733,70.11238256463528,NaN,NaN,35.860215855655355,33.075767031742544
2011-01-19T09:30:00-05:00,13.387744,13.436367,13.152294,13.192888,144628987,81894424.9,55.4722100658173,67.09730187587097,NaN,NaN,42.24609127633685,110.21772431315526,-0.011181616548476325,0.2240242555156069,0.23520587206408322,-3998153818,-3867557836.2,51.9152014543758,68.02472687410562,NaN,NaN,31.500051630202364,32.850664831522515
2011-01-20T09:30:00-05:00,13.192888,13.306549,13.144175,13.257837,115552746,84705476.95,57.28465353549439,66.56035320851107,NaN,NaN,27.633904943139996,89.96198295282466,-0.022644861803167826,0.20689979481012344,0.22954465661329126,-3882601072,-3880742138,50.38987685224032,65.91584508970077,NaN,NaN,28.671485699762712,32.25363924127112
2011-01-21T09:30:00-05:00,13.347143,13.428322,13.298431,13.364598,93392804,84977484.05,60.155602309154716,66.1943325070258,NaN,NaN,74.31569496256762,82.089934399277,-0.023922197985552007,0.19964190913135127,0.22356410711690328,-3789208268,-3860298069,52.71010640401725,63.959990743197,NaN,NaN,27.29552106462166,31.54533664460691
2011-01-24T09:30:00-05:00,13.387744,13.415413,13.298431,13.349984,54905341,85908637.05,59.56543253480212,65.28080310300979,NaN,NaN,64.59100096591162,66.92537524152762,-0.026439589039581657,0.1905146208174262,0.21695420985700786,-3844113609,-3873520319.6,51.04724635963601,61.82389195917532,NaN,NaN,26.02960235541778,30.757374603294178
2011-01-25T09:30:00-05:00,13.282193,13.363388,13.160421,13.322787,84987754,88670212.2,58.416815264271904,64.3650211842083,NaN,NaN,25.826601580814565,46.92265874575414,-0.030345013156676426,0.17902294341116232,0.20936795656783874,-3929101363,-3888635626,49.13878879725125,59.55536243576629,NaN,NaN,24.66297648763391,29.886746301056995
2011-01-26T09:30:00-05:00,13.359321,13.395855,13.298431,13.310609,68261312,89981104.8,57.87862124035108,63.1750220995802,NaN,NaN,46.71430922796194,47.816302336079154,-0.03388806080538004,0.1670078805611137,0.20089594136649375,-3997362675,-3888477397.4,49.16021605517019,57.19871269120684,NaN,NaN,23.39539061566943,28.959409774573057
2011-01-27T09:30:00-05:00,13.31466,13.436449,13.298431,13.427112,88305861,92843666.55,61.530093054324894,62.58692070090763,NaN,NaN,69.01718804909858,56.09295895727087,-0.028728886948596655,0.16498483268074793,0.19371371962934458,-3909056814,-3893768545.8,48.425526458735945,54.72520672640383,NaN,NaN,23.326014578480677,28.154639032274147
2011-01-28T09:30:00-05:00,13.436449,13.533873,13.17665,13.192888,139326503,97539780,51.8064656875226,61.73203508950148,NaN,NaN,10.601473684670793,43.350114701691496,-0.04070288049408735,0.1428351190117354,0.18353799950582275,-4048383317,-3945603555.6,41.83017800202527,52.14329915984463,NaN,NaN,20.179108098290186,27.015277470276438
2011-01-31T09:30:00-05:00,13.217244,13.339016,13.217244,13.31466,77885001,100079162.9,55.72397542085393,61.27011378891399,NaN,NaN,-11.21079881499267,28.18975474551064,-0.039976311768547684,0.13356760979513815,0.17354392156368584,-3970498316,-3970880497,39.03803675897979,50.18763326628937,NaN,NaN,18.75220836607954,25.834839026819736
2011-02-01T09:30:00-05:00,13.395855,13.629828,13.387744,13.590712,78692401,98332107.85,63.05556969925047,61.21987886024461,NaN,NaN,170.57076146287088,57.13858672192191,-0.02139046132080974,0.14680584491267368,0.16819630623348342,-3891805915,-3963421407.4,40.30433627835933,48.76280401613137,NaN,NaN,19.986933411603356,24.99942393893168
2011-02-02T09:30:00-05:00,13.55011,13.590712,13.468923,13.485161,57424011,97912884.1,59.0305954568983,60.47596937089197,NaN,NaN,135.13681209457138,74.8230872952438,-0.01688931885112796,0.14708465766957346,0.16397397652070142,-3949229926,-3953794857.6,41.97939213250924,47.87803473196805,NaN,NaN,19.63174205848445,24.232612241724933
2011-02-03T09:30:00-05:00,13.485161,13.517627,13.363388,13.489228,63656398,95109574.25,59.138825293574286,59.91024070201828,NaN,NaN,81.34648785810472,77.28894725704504,-0.014418096955616272,0.1459513553261811,0.16036945228179736,-3885573528,-3949098200.4,42.822368794899724,47.41261302222465,NaN,NaN,19.389894821758542,23.54079546744402
2011-02-04T09:30:00-05:00,13.47705,13.493279,13.379618,13.483131,76695490,94821051.2,58.887672250412315,58.984264950629914,NaN,NaN,70.47461140812179,89.26357480173523,-0.013964516460761633,0.1429138067058453,0.15687832316660694,-3962269018,-3931875340.6,45.92500496985752,47.032132999386775,NaN,NaN,19.123105772404575,22.90969693958124
2011-02-07T09:30:00-05:00,13.533873,13.712484,13.525754,13.680018,61832815,86942932.8,64.17819670131178,58.723194893860004,NaN,NaN,176.81841843097266,126.86941825092829,-0.0018135393165648883,0.15461139902090082,0.1564249383374657,-3900436203,-3917862918,48.37927010247591,46.647539244323816,NaN,NaN,20.538481016976903,22.57095180778062
2011-02-08T09:30:00-05:00,13.688128,13.80179,13.647535,13.777434,59947745,84585237.1,66.47682989822327,59.50923916760329,NaN,NaN,204.11713847255265,133.57869365286464,0.010688291716108828,0.16978530298260175,0.15909701126649292,-3840488458,-3907599426.6,50.163453557453515,46.52241439454366,NaN,NaN,22.443324049763742,22.552719270921067
2011-02-09T09:30:00-05:00,13.688128,13.753078,13.582585,13.680821,68816790,84942704.15,62.21306007572199,59.86126820619097,NaN,NaN,140.47779873614687,134.64689098117975,0.010347826256162096,0.17203179408669556,0.16168396783053346,-3909305248,-3899614491,51.56602960251838,46.6064253052778,NaN,NaN,22.7410217625301,22.579619626865213
2011-02-10T09:30:00-05:00,13.61506,13.704366,13.590712,13.680018,53698882,82585431.15,62.17736400465539,60.005679755869586,NaN,NaN,115.51845007261025,141.48128342408086,0.008066691494454797,0.17176733219860196,0.16370064070414717,-3963004130,-3915100611.4,48.703222582048596,46.32021931799432,NaN,NaN,22.96899620450739,22.635244852242668
2011-02-11T09:30:00-05:00,13.631289,13.910012,13.598822,13.867543,90954679,83395712.6,66.94693102932632,60.5329296483356,NaN,NaN,158.44857976648268,159.07607709575302,0.016689031034834184,0.1845619294976899,0.16787289846285572,-3872049451,-3897056698,52.0439753774424,46.39141424783764,NaN,NaN,24.64254163427336,22.92200153538991
2011-02-14T09:30:00-05:00,13.854562,13.899214,13.809901,13.874858,43153470,79882073.25,67.12110538431136,61.15466465690985,NaN,NaN,160.61780947246922,155.83595530405233,0.02015484087176095,0.19306644955255692,0.17291160868079597,-3828895981,-3882748653.6,54.57051602754186,46.77939476428696,NaN,NaN,26.038762604242343,23.367253116654542
2011-02-15T09:30:00-05:00,13.850502,13.923562,13.809901,13.856591,60697382,79140818.6,66.18320269281789,61.74784904637176,NaN,NaN,136.08177022704254,142.2288816549503,0.018528433875479478,0.1960721510251453,0.17754371714966583,-3889593363,-3892569634.6,52.52497477143524,47.01973467259161,NaN,NaN,26.930641472043153,23.876308595995773
2011-02-16T09:30:00-05:00,13.907333,13.947918,13.850502,13.931689,44105977,74114668.1,68.15339085619667,62.22094174650546,NaN,NaN,133.68162290937494,140.86964648959594,0.019711689096648444,0.20218332852047638,0.18247163942382794,-3845487386,-3879806062.2,54.89149735070687,47.481589736303825,NaN,NaN,28.254179897362498,24.501718781905307
2011-02-17T09:30:00-05:00,13.882985,13.947918,13.850502,13.915452,43672509,70520656.25,67.2412267840964,63.32342468197502,NaN,NaN,115.76766275844196,140.91948902676228,0.01672024471807934,0.2033719453214271,0.18665170060334776,-3889159895,-3865037215.2,57.529595070655475,48.60297666977741,NaN,NaN,29.114428003334652,25.1606772421095
2011-02-18T09:30:00-05:00,13.931689,13.964164,13.882985,13.946709,39709234,67836477.75,68.12563589705603,64.2092575731323,NaN,NaN,110.55484139744249,131.34074135295424,0.014261843270706287,0.20447900469173064,0.19021716142102435,-3849450661,-3860517457.2,58.33271598274411,49.981168042903434,NaN,NaN,30.081390885634235,25.863636334041605
2011-02-22T09:30:00-05:00,13.728722,13.80179,13.485161,13.519665,125882616,71385341.5,48.75784470639875,63.18799150221433,NaN,NaN,-1.5503605183922617,98.90710735478193,-0.01701378849895413,0.1689499257973317,0.18596371429628583,-3975333277,-3889804916.4,51.53244140662077,50.78317555206496,NaN,NaN,24.64775664848068,25.68993923610433
2011-02-23T09:30:00-05:00,13.509517,13.61506,13.290312,13.460805,142503031,74261105.35,46.7836240010005,62.313207826793054,NaN,NaN,-58.51396462838181,59.987960383697065,-0.04117656105363393,0.13449301297924343,0.17566957403287736,-4117836308,-3935453505.4,43.09888700560178,50.86313947157157,NaN,NaN,19.638815260773175,24.825492953914164
2011-02-24T09:30:00-05:00,13.428322,13.485071,13.265956,13.428322,98972199,75796649.7,45.68426780340454,61.35216800606664,NaN,NaN,-83.70144326809773,16.511347148202532,-0.05783731055661864,0.10337293583710405,0.1612102463937227,-4216808507,-4009717729.6,33.49500263128911,50.19689903131367,NaN,NaN,15.273333264482952,23.46089871256685
2011-02-25T09:30:00-05:00,13.525754,13.647535,13.509517,13.615872,61210430,74441878.15,52.608764595414605,60.90367460213823,NaN,NaN,-14.751863361485796,-9.592558075783007,-0.0547487383767751,0.09277432342275382,0.14752306179952893,-4155598077,-4063005366,28.574678506482456,48.95758999821545,NaN,NaN,13.59395912905678,22.051335914922554
2011-02-28T09:30:00-05:00,13.704366,13.753078,13.623179,13.680018,68239457,70887525.85,54.734303142970134,60.229110776542406,NaN,NaN,16.31952655572188,-28.439621044127126,-0.04719415356782994,0.0885303698397415,0.13572452340757143,-4087358620,-4110586957.8,25.03789338279954,47.29034880395285,NaN,NaN,12.888684652775066,20.74238573461577
2011-03-01T09:30:00-05:00,13.720595,13.720595,13.387744,13.387744,130847076,73535629.6,44.86132196212738,58.68514592396413,NaN,NaN,-73.73007326036665,-42.875563592522006,-0.05987470909856556,0.060881137034364485,0.12075584613293004,-4218205696,-4159161441.6,22.03892650314404,45.28145401435932,NaN,NaN,8.813026407469895,19.0381915450235
2011-03-02T09:30:00-05:00,13.371499,13.428322,13.257837,13.306549,82341537,73718086.4,42.564335879334195,57.281665624222136,NaN,NaN,-136.87933895174413,-58.548638457194464,-0.07096648766544161,0.032047736551128025,0.10301422421656964,-4300547233,-4195703626.6,20.08947075779541,43.0331283825934,NaN,NaN,4.780804290877176,17.001421937288313
2011-03-03T09:30:00-05:00,13.452694,13.606933,13.444567,13.578534,103515804,76022676.05,51.519155176653896,56.5203649936506,NaN,NaN,-46.14701781765757,-51.03775336710644,-0.0577801327627689,0.030789058263108515,0.08856919102587742,-4197031429,-4191748211,20.905027378403446,41.047543010904455,NaN,NaN,4.381536814775857,15.198581205500819
2011-03-04T09:30:00-05:00,13.558229,13.558229,13.31466,13.412092,129274844,79303598.35,46.71883866571444,55.07550125339261,NaN,NaN,-94.79350719135968,-67.04608213308123,-0.0579156589447052,0.016174617344995923,0.07409027628970112,-4326306273,-4225889850.2,19.09362311202601,38.69394642051758,NaN,NaN,2.356469878724661,13.363993873104224
2011-03-07T09:30:00-05:00,13.444648,13.509517,13.265956,13.322787,85392291,79738438.4,44.33203685295509,53.44771064401002,NaN,NaN,-116.57892800421398,-93.62577304506839,-0.061339272960575474,-0.002583814911018223,0.05875545804955725,-4411698564,-4290757839,16.21822088617442,35.95449676756276,NaN,NaN,-0.06010175367989881,11.446265926420779
2011-03-08T09:30:00-05:00,13.379618,13.639416,13.379618,13.61506,98175895,81555592.4,52.826236291046364,52.49364161531206,NaN,NaN,-38.37594647938279,-86.55494768887162,-0.04215310409098991,0.006064077935819867,0.048217182026809774,-4313522669,-4309821233.6,15.480406518937116,33.3084561780986,NaN,NaN,0.8839190495472622,9.937359229724562
2011-03-09T09:30:00-05:00,13.606933,13.680018,13.509517,13.61221,87256117,82921011,52.74172547359378,51.39280837369756,NaN,NaN,-12.99565960268591,-61.77821181905997,-0.028539316956810244,0.012543035830796967,0.04108235278760721,-4400778786,-4329867544.2,14.721954239063535,30.43920309869551,NaN,NaN,1.5696209119091407,8.741968041465217
2011-03-10T09:30:00-05:00,13.452694,13.460805,13.307369,13.339016,114727727,85216557.85,45.26611246108108,49.82315735062504,NaN,NaN,-98.50616862246105,-72.25004198002068,-0.03631952358756562,-0.004317051696849816,0.032002471890715804,-4515506513,-4393562561,12.6081992394231,27.2305319678932,NaN,NaN,-0.42285775787362556,7.432707212988239
2011-03-11T09:30:00-05:00,13.257837,13.468923,13.257837,13.428322,108088654,87936046.45,47.867443735754,48.37614362481776,NaN,NaN,-84.01070272813966,-70.09348108737667,-0.03388453707703904,-0.010353199455582995,0.023531337621456046,-4407417859,-4409784878.2,12.13049422960107,23.930373271240125,NaN,NaN,-1.1349900592822635,6.208750459806739
2011-03-14T09:30:00-04:00,13.322787,13.363388,13.192888,13.306549,86418544,87709239.7,44.74470220080955,48.089490588704244,NaN,NaN,-110.38746371796047,-68.85518823012598,-0.03856785037007433,-0.024678475341136874,0.01388937502893746,-4493836403,-4426212446,11.649160363456886,21.0815674824427,NaN,NaN,-2.740225028294565,4.930325390077981
2011-03-15T09:30:00-04:00,12.965564,13.217244,12.916852,13.152294,127457213,91924426.85,41.08804529864249,47.68266353853581,NaN,NaN,-165.9158382346465,-94.36316658117872,-0.04945229047762819,-0.04792598806809778,0.0015263024095304115,-4621293616,-4487766635.4,10.041368391629817,18.720316152873274,NaN,NaN,-5.280246427490592,3.4716722732824707
2011-03-16T09:30:00-04:00,13.168531,13.184777,12.819427,12.908327,214809641,99630039.8,36.06765971418489,46.99576296073441,NaN,NaN,-187.25144101114736,-129.214322862871,-0.06926539488384972,-0.08505544119528174,-0.01579004631143202,-4836103257,-4574831529.6,8.297038972631455,16.9204616058263,NaN,NaN,-9.191326914668043,1.6626723892895403
2011-03-17T09:30:00-04:00,13.087344,13.103582,12.908733,13.062988,120396516,103444566.75,40.99010446426443,46.16585866565226,NaN,NaN,-153.03949842609669,-140.1209888235981,-0.06803879988473083,-0.10083854616734556,-0.03279974628261473,-4715706741,-4614871575.2,7.639757558542442,15.425110109544871,NaN,NaN,-10.759694910203285,-0.11195151063800601
2011-03-18T09:30:00-04:00,13.200998,13.31466,13.152294,13.209125,207766405,111649261.55,45.27746963836246,45.49037055818028,NaN,NaN,-74.24069176960018,-138.1669866318902,-0.0540781366203734,-0.10039741705808147,-0.046319280437708076,-4507940336,-4634976070.6,7.325941637182865,14.159970699143676,NaN,NaN,-10.627822276473406,-1.6142187629002058
2011-03-21T09:30:00-04:00,13.355261,13.363388,13.200998,13.270015,96068345,114467217.1,47.00517454249524,45.643502885349406,NaN,NaN,-46.789814558203254,-125.44745679993878,-0.03818485647970611,-0.09405035103734072,-0.05586549455763461,-4411871991,-4618583188.2,10.5522913940179,13.339496762777523,NaN,NaN,-9.974110037528895,-2.8084889449900183
2011-03-22T09:30:00-04:00,13.274083,13.282193,13.192888,13.200194,57001303,111023151.45,45.24131738490661,45.834715850033156,NaN,NaN,-62.95392551899319,-104.85507425680812,-0.030168041172703455,-0.09357554602351392,-0.06340750485081047,-4468873294,-4588099123.8,16.382105694277897,13.074684972526269,NaN,NaN,-9.974503157977146,-3.832205261131037
2011-03-23T09:30:00-04:00,13.160421,13.209125,13.006157,13.164472,79964684,107896234.1,44.32488641293587,45.32083950976759,NaN,NaN,-94.14447374089022,-86.23368080275668,-0.025263418549796246,-0.09498677803805577,-0.06972335948825953,-4548837978,-4530646068,26.151191812349992,13.449411003522448,NaN,NaN,-10.240599160532016,-4.747690103902605
2011-03-24T09:30:00-04:00,13.200998,13.2416,13.079226,13.229422,76953837,106795316,46.44891737657811,45.30155941768642,NaN,NaN,-63.16737196316855,-68.25925551017106,-0.01608433413749269,-0.08982877716012538,-0.0737444430226327,-4471884141,-4481881548,33.27657977258794,14.462479336419728,NaN,NaN,-9.85640439029032,-5.477506430529422
2011-03-25T09:30:00-04:00,13.249727,13.31466,13.200998,13.265956,55675593,106518574.15,47.658535687669186,45.53916647730886,NaN,NaN,-26.448198545974034,-58.700756865445825,-0.0064840659423088115,-0.08184952545051871,-0.0753654595082099,-4416208548,-4463535190.4,35.78684504071343,15.860238204601085,NaN,NaN,-9.200903916129068,-6.009420357043657
2011-03-28T09:30:00-04:00,13.274083,13.31466,13.217244,13.221717,39297069,105071454.75,46.29487666898082,45.07264079001846,NaN,NaN,-23.674038774541355,-54.07760170871344,-0.002263035495855742,-0.07819425387802958,-0.07593121838217384,-4455505617,-4472261915.6,35.11020023393259,17.26236632710076,NaN,NaN,-9.010997364679179,-6.43821707242016
2011-03-29T09:30:00-04:00,13.200998,13.257837,13.119819,13.249727,46950866,100876644.25,47.32261323259456,44.685561344232795,NaN,NaN,-39.44859062987306,-49.376534730889446,0.002981039860742718,-0.07220491855624545,-0.07518595841698816,-4408554751,-4460198207,36.88672902524084,18.845564526113428,NaN,NaN,-8.580184490903083,-6.744212417917721
2011-03-30T09:30:00-04:00,13.31466,13.403966,13.274083,13.355261,75908507,100554992.75,51.11818644917781,45.103566629096846,NaN,NaN,30.078580858706044,-24.53192381097019,0.013532043028687019,-0.05827090463112938,-0.0718029476598164,-4332646244,-4416959860.2,42.91874213503617,21.010603304371504,NaN,NaN,-7.173247326278806,-6.805503119112162
2011-03-31T09:30:00-04:00,13.274083,13.339195,13.257837,13.306549,61010733,98429739.2,49.35062683702838,45.209508279187865,NaN,NaN,15.605636349752878,-8.777322148385904,0.016981763079203266,-0.05057574381081231,-0.06755750689001558,-4393656977,-4401314427.4,44.968288702283616,23.356160052420258,NaN,NaN,-6.429475399824961,-6.751784873499704
2011-04-01T09:30:00-04:00,13.395855,13.47705,13.363388,13.420211,80976471,96014820.55,53.399663426052435,45.82771979527665,NaN,NaN,84.16962584452037,13.346242729712975,0.02612332089260609,-0.03490335577425796,-0.06102667666686405,-4312680506,-4380608819,47.64738152904843,25.927461564248226,NaN,NaN,-4.6539138158791085,-6.452089008125333
2011-04-04T09:30:00-04:00,13.420211,13.47705,13.347143,13.401132,47204187,94105415.35,52.63896940641863,46.65278580297494,NaN,NaN,74.83657755685778,33.048365995992796,0.02982243593493846,-0.023748631748190974,-0.053571067683129435,-4359884693,-4361484634.2,50.06538047718757,28.786319570359492,NaN,NaN,-3.360599265901053,-6.0104476163790075
2011-04-05T09:30:00-04:00,13.371499,13.436449,13.339016,13.395855,47416438,91567442.5,52.416558461780575,47.82056428494606,NaN,NaN,73.85384163775242,55.70885244951789,0.030729259595040997,-0.015159493189328188,-0.045888752784369186,-4407301131,-4361233910.2,50.097921709256575,31.772096908689857,NaN,NaN,-2.327997516496759,-5.484383316395829
2011-04-06T09:30:00-04:00,13.452694,13.566356,13.412092,13.55011,81881798,91298726.55,58.00264381983288,49.035745667486665,NaN,NaN,154.73099935581013,80.63933614893872,0.03994931326337044,0.004047888794843857,-0.03590142446852658,-4325419333,-4359788528,50.29900169082076,34.81918577528116,NaN,NaN,0.17101794059015005,-4.6764688511121175
2011-04-07T09:30:00-04:00,13.541983,13.598822,13.444567,13.485161,60967967,88610738.55,55.071119349472184,49.73529207542308,NaN,NaN,140.98107363704062,105.71442360639625,0.03981646825278885,0.013869160847459483,-0.025947307405329367,-4386387300,-4358334592.6,50.51501016093523,37.90411924126348,NaN,NaN,1.5448136534610293,-3.787714207601668
2011-04-08T09:30:00-04:00,13.55011,13.574466,13.330905,13.363388,73348058,86873708.75,49.97156840661878,49.947177351431904,NaN,NaN,87.35178216999186,106.35085487149055,0.030111246787027753,0.011691751078455326,-0.018419495708572427,-4459735358,-4387745563,46.145948513013124,40.44652332119171,NaN,NaN,1.3416785307040444,-3.054943816415138
2011-04-11T09:30:00-04:00,13.379618,13.460805,13.330905,13.363388,49668897,85036226.4,49.97156840661878,50.28505242441135,NaN,NaN,60.018478673856755,103.38723509489037,0.022617647707025276,0.009852563925209168,-0.012765083781816108,-4459735358,-4407715696,43.4010621316445,42.37644878100361,NaN,NaN,1.1745934638054798,-2.4507242049550495
2011-04-12T09:30:00-04:00,13.282193,13.395368,13.225354,13.31466,78944717,82610601.6,47.912577114941406,50.54131604598317,NaN,NaN,14.144231625128738,91.44531309236562,0.01374182022181646,0.004412191495454465,-0.009329628726361994,-4538680075,-4433991484.8,40.02735645002072,43.36760339798009,NaN,NaN,0.47907064843711694,-2.032182083041883
2011-04-13T09:30:00-04:00,13.420211,13.420211,13.168531,13.215214,94781952,76609217.15,43.93401754806127,50.361680343946254,NaN,NaN,-23.755818128322204,55.74794959553915,0.0011968996323497814,-0.007833504185924767,-0.009030403818274548,-4633462027,-4495600023.6,33.4598481566901,43.38069399684453,NaN,NaN,-1.2473045280768464,-1.9200567180468777
2011-04-14T09:30:00-04:00,13.111692,13.136048,13.030514,13.095463,72511668,74214974.75,39.662937403254766,49.790566180773794,NaN,NaN,-153.5327251631737,-3.154810164503709,-0.01428865760610976,-0.026891225825911746,-0.012602568219801987,-4705973695,-4559517302.6,28.27628771855028,42.844225616690025,NaN,NaN,-4.038979991169381,-2.222760042778664
2011-04-15T09:30:00-04:00,13.152294,13.192888,13.071115,13.103582,64390427,67046175.85,40.08820005712479,49.34723213706979,NaN,NaN,-119.33372052347389,-44.49191070319686,-0.022612639014102688,-0.04086836698743035,-0.01825572797332766,-4641583268,-4595886884.6,25.824716686215794,42.180976791853105,NaN,NaN,-6.222917393915271,-2.7942110929410364
2011-04-18T09:30:00-04:00,12.957445,12.973683,12.843783,12.92497,103281323,67406824.75,34.35207249616967,48.42076494161087,NaN,NaN,-208.54535904759894,-98.20467824748799,-0.037876723978161025,-0.06560163294602894,-0.027724908967867917,-4744864591,-4652912731.2,22.52679981843532,41.15526756279557,NaN,NaN,-10.006145585913222,-3.82448744907992
2011-04-19T09:30:00-04:00,12.98992,12.998031,12.876258,12.965564,72306039,68172061.55,36.57338506857302,47.38185055728196,NaN,NaN,-163.01196005040038,-133.6359165825938,-0.042615019312057204,-0.08099368310793942,-0.038378663795882215,-4672558552,-4679688426.6,21.160388425533114,39.60109944068821,NaN,NaN,-12.510586660153935,-5.065358764947637
2011-04-20T09:30:00-04:00,13.062988,13.071115,12.949326,12.998031,78520571,68099855.9,38.36956116206138,46.59748872335574,NaN,NaN,-123.66805201974178,-153.6183633608777,-0.04092908225783548,-0.08954001661817657,-0.048610934360341085,-4594037981,-4671803617.4,22.648333037534556,38.00681689320613,NaN,NaN,-14.09671406066752,-6.355552378621906
2011-04-21T09:30:00-04:00,13.062988,13.095463,12.981801,13.071115,54391860,66971757.05,42.32871039663695,45.806706364111776,NaN,NaN,-94.22343502148881,-141.75650533254074,-0.032619572698217116,-0.08938540023311248,-0.05676582753489536,-4539646121,-4638538102.6,28.757334028477672,36.657527786022506,NaN,NaN,-14.348405918204833,-7.497388598562324
2011-04-25T09:30:00-04:00,13.046759,13.103582,13.038632,13.05487,36996484,66037801.6,41.6876541166958,45.024469557703,NaN,NaN,-76.71926805130377,-133.23361483810672,-0.026220555920796224,-0.08954152243589064,-0.06332096651509442,-4576642605,-4625549970,31.047095437947306,35.2990788546482,NaN,NaN,-14.73252382101838,-8.530979344627475
2011-04-26T09:30:00-04:00,13.103582,13.160421,13.062988,13.136048,61934053,67169650.8,46.0820371747733,44.57200375148819,NaN,NaN,-48.82786746497037,-101.29011652158101,-0.015077375827280748,-0.08216768629919535,-0.0670903104719146,-4514708552,-4579518762.2,38.58135595454334,34.47646701502583,NaN,NaN,-13.837884523940039,-9.289108655957842
2011-04-27T09:30:00-04:00,13.168531,13.249727,13.070384,13.217244,69815295,68312872.25,50.13018295963042,44.00968511861658,NaN,NaN,-23.80704177152022,-73.44913286580498,-0.0015092768833913917,-0.06897690657615385,-0.06746762969276246,-4444893257,-4533985703.2,44.98501509822625,34.096896544126224,NaN,NaN,-11.887844961105081,-9.660356699550304
2011-04-28T09:30:00-04:00,13.200998,13.347143,13.192888,13.322787,53821227,67208508.25,54.873022173554055,43.99553532033672,NaN,NaN,21.44685163259531,-44.426152135337574,0.014424660658849509,-0.049436803869200574,-0.06386146452805008,-4391072030,-4493392513,49.990975447943015,34.05946549319821,NaN,NaN,-8.737438538652897,-9.528511247993531
2011-04-29T09:30:00-04:00,13.31466,13.31466,13.2416,13.298431,30540712,65685007.2,53.60602557074137,44.255139403488336,NaN,NaN,20.76414280820179,-21.42863656939946,0.02268344923338015,-0.0355071529863249,-0.05819060221970505,-4421612742,-4469785837.2,52.687172595561044,34.52669578480877,NaN,NaN,-6.485557810156271,-9.09380361401678
2011-05-02T09:30:00-04:00,13.347143,13.363388,13.225354,13.2416,51187938,64195580.55,50.66634486931202,44.30476629368071,NaN,NaN,21.221161859139862,-1.8405505873107373,0.023574484981544755,-0.0287224959927741,-0.052296980974318855,-4472800680,-4449017452.2,54.98648892944192,35.354226270365736,NaN,NaN,-5.378135980908228,-8.56299395214413
2011-05-03T09:30:00-04:00,13.209125,13.330905,13.200998,13.298431,85393750,66105058.7,53.41737408184682,44.69796607703109,NaN,NaN,24.99541044807454,12.924104995298245,0.02700075871389066,-0.01854603258195553,-0.04554679129584619,-4387406930,-4423557127.8,57.70043735036468,36.616589191818875,NaN,NaN,-3.640787604662081,-7.859821616789551
2011-05-04T09:30:00-04:00,13.306549,13.31466,13.152294,13.184777,112605476,69364510.6,47.68990826219965,44.96624398518383,NaN,NaN,2.4436174685803556,18.17423684331836,0.02089496496154742,-0.019428085093911918,-0.04032305005545934,-4500012406,-4434580957.6,56.12264417090258,38.23536033569119,NaN,NaN,-3.7705777995384477,-7.2756439286108225
2011-05-05T09:30:00-04:00,13.119819,13.152294,12.973683,13.014276,103447596,70442800.5,40.64861251264938,45.03664935014058,NaN,NaN,-70.12578903331034,-0.14029128986275907,0.005459265187670419,-0.03349896857087131,-0.03895823375854173,-4603460002,-4477058552,50.40334959395316,39.815864755362824,NaN,NaN,-6.1591136220991425,-7.116139599109154
2011-05-06T09:30:00-04:00,13.152294,13.209125,13.038632,13.079226,102457900,72517297.15,44.038257655203175,45.3187963214319,NaN,NaN,-32.69071062590938,-10.831261976684994,-0.0000015840478814477255,-0.03896021381839354,-0.03895862977051209,-4501002102,-4492936424,48.41715992511726,41.429610700998644,NaN,NaN,-7.07207877002959,-7.10984519495493
2011-05-09T09:30:00-04:00,13.038632,13.079226,12.981801,13.046759,47938177,71246803.1,42.724697271443006,45.91684094823713,NaN,NaN,-66.35228592838368,-28.3459515341897,-0.0051410452161847475,-0.04538493629074303,-0.04024389107455828,-4548940279,-4508164343.8,46.52364798293888,43.14367128417747,NaN,NaN,-8.214967870560654,-7.2677198628986055
2011-05-10T09:30:00-04:00,13.071115,13.192888,13.062988,13.168531,69345545,72230635.5,48.88317969316136,46.796111992850584,NaN,NaN,2.7220038622843763,-32.800632851347736,0.000045242608285797625,-0.04018733781420103,-0.04023258042248683,-4479594734,-4526601904.6,44.266344433041645,44.794096713285235,NaN,NaN,-7.2892185760351556,-7.270791107632398
2011-05-11T09:30:00-04:00,13.136048,13.152294,12.973683,12.98992,97223151,73144557.2,41.78604529029089,47.040146573438406,NaN,NaN,-60.18265590961559,-45.325887526986925,-0.007738208346861841,-0.04990534085606413,-0.04216713250920229,-4576817885,-4541963000.4,42.419683983346324,46.206336066557505,NaN,NaN,-8.834308719836272,-7.494150766518666
2011-05-12T09:30:00-04:00,12.957445,13.006157,12.843783,12.98992,78924379,72351678.55,41.78604529029089,47.00138478012798,NaN,NaN,-114.31942324743737,-54.16461436981233,-0.011826645248631397,-0.05695043906999153,-0.045123793821360135,-4576817885,-4536634577,43.30323750464095,47.24532917199774,NaN,NaN,-10.03531360627917,-7.857174029341595
2011-05-13T09:30:00-04:00,12.98992,13.010209,12.786952,12.80319,82289647,72840577.5,35.53129616807237,46.56164492665488,NaN,NaN,-146.0241122575662,-76.83129469614369,-0.02527451335571332,-0.07671693551600178,-0.051442422160288465,-4659107532,-4568255663,39.43588996308903,47.844528780936436,NaN,NaN,-13.226326481498246,-8.624195808221117
2011-05-16T09:30:00-04:00,12.746359,12.933089,12.722003,12.786952,89966068,74119359.55,35.040108795597774,45.77293575671377,NaN,NaN,-153.25984264405062,-94.21280603927707,-0.03294572528420352,-0.09262457876554286,-0.05967885348133935,-4749073600,-4608282327.2,35.15585075997649,47.59984983846737,NaN,NaN,-15.891836810662893,-9.66243023714137
2011-05-17T09:30:00-04:00,12.73824,12.892496,12.730122,12.884377,98771970,73893891.9,40.36667949618169,45.07554265218172,NaN,NaN,-134.501430539934,-121.65749291972077,-0.02926530633234664,-0.09626048639677265,-0.06699518006442601,-4650301630,-4642423706.4,31.96873459030914,46.67011551647329,NaN,NaN,-16.478938975414646,-10.636217199751838
2011-05-18T09:30:00-04:00,12.876258,12.949326,12.827546,12.941208,60190877,73288133.8,43.28798548079571,44.24804003127041,NaN,NaN,-92.78285892693368,-128.1775335231844,-0.021186751397503617,-0.09347861931130552,-0.0722918679138019,-4590110753,-4645082280,31.72752818849743,45.36558356937003,NaN,NaN,-16.059339649320094,-11.410948978261588
2011-05-19T09:30:00-04:00,12.98992,12.998031,12.892496,12.941208,64401955,72582203,43.28798548079571,43.51103716770287,NaN,NaN,-68.71759309846652,-119.05716749339021,-0.014353553993789459,-0.09023381040603873,-0.07588025641224927,-4590110753,-4647740853.6,31.471805228764666,43.850200186027436,NaN,NaN,-15.723883812779501,-12.027082526049861
2011-05-20T09:30:00-04:00,12.900614,12.957445,12.746359,12.762596,89483685,74336794.25,36.72957414947502,42.51555354485736,NaN,NaN,-117.74779568360736,-113.40190417859844,-0.020025015980051908,-0.10091152638731415,-0.08088651040726225,-4679594438,-4651838234.8,31.056348080915853,42.140904411132716,NaN,NaN,-17.4743970047712,-12.805270308724339
2011-05-23T09:30:00-04:00,12.608341,12.673291,12.583985,12.583985,93647919,77169366,31.577406505477228,40.95555586083096,NaN,NaN,-181.54131266247387,-119.0581981822831,-0.033191143927747996,-0.12237544031694725,-0.08918429638919925,-4773242357,-4656671986.2,30.544083530482354,40.2011648525697,NaN,NaN,-20.774434936947095,-13.943722398470447
2011-05-24T09:30:00-04:00,12.624579,12.640816,12.494679,12.567748,79612864,78053306.55,31.14963745354042,39.77410794592674,NaN,NaN,-166.00606854870398,-125.35912578403709,-0.039926614445631683,-0.13909256444623885,-0.09916595000060717,-4852855221,-4697182704.4,26.586140584936174,38.09141459642923,NaN,NaN,-23.501800626296315,-15.309162145302714
2011-05-25T09:30:00-04:00,12.502798,12.648935,12.502798,12.575866,85773889,78851236.25,31.64818991286002,39.131220617370346,NaN,NaN,-141.09708152963924,-135.0219703045782,-0.040633108941736454,-0.14995733617777773,-0.10932422723604128,-4767081332,-4732576820.2,23.69692331580896,36.18381271941893,NaN,NaN,-25.533218466964325,-16.7697416198258
2011-05-26T09:30:00-04:00,12.543391,12.689528,12.519847,12.640816,84699215,80395135.65,35.66226237876714,38.53293524048206,NaN,NaN,-115.4652647647194,-144.37150463782876,-0.033804225914556174,-0.1515795096292365,-0.11777528371468032,-4682382117,-4751031093,22.334087109307845,34.32073608971826,NaN,NaN,-26.077573584785835,-18.099431900534377
2011-05-27T09:30:00-04:00,12.681409,12.786952,12.673291,12.730122,62009119,81968556,40.809490678148464,38.39613476953245,NaN,NaN,-68.39026024086552,-134.4999975492804,-0.020978905884086754,-0.14399891606978876,-0.12302001018570201,-4620372998,-4739186805,25.303355788155756,32.80500093294803,NaN,NaN,-25.005417524249978,-19.086001275350892
2011-05-31T09:30:00-04:00,12.868139,12.900614,12.770715,12.860021,80193567,83418837.45,47.40113644280142,38.290274537363885,NaN,NaN,-21.196011388525584,-102.43093729449075,-0.0024290941816243056,-0.1260563779127324,-0.12362728373110808,-4540179431,-4692574219.8,35.71888542208477,32.194468146451115,NaN,NaN,-21.98363630676848,-19.499949136981975
2011-06-01T09:30:00-04:00,12.811309,12.819427,12.413492,12.42567,148951571,86596728.5,33.833406037986904,37.722228876485026,NaN,NaN,-125.37353723114741,-94.30443103097943,-0.017267274194663257,-0.14521137647443716,-0.1279441022797739,-4689131002,-4659829376,41.85274591791759,32.15397257034906,NaN,NaN,-24.02839974335793,-20.14687065217854
2011-06-02T09:30:00-04:00,12.441908,12.527154,12.348543,12.437848,165970689,89264989.15,34.40034956854669,37.19467918207473,NaN,NaN,-153.51616558580673,-96.78824784221293,-0.02371876544934068,-0.15759255909144976,-0.13387379364210908,-4523160313,-4611045172.2,49.57304649370338,32.60181606956781,NaN,NaN,-25.342429273354373,-20.889093312346514
2011-06-03T09:30:00-04:00,12.299912,12.494679,12.283593,12.356661,119779728,90081595.75,32.40677689783627,36.97149923420073,NaN,NaN,-148.940765736298,-103.48334803652865,-0.030479721153347378,-0.1719734450837933,-0.14149372393044593,-4642940041,-4603156757,50.71260361351235,33.407295616026616,NaN,NaN,-27.071508682254503,-21.772295508047655
2011-06-06T09:30:00-04:00,12.29983,12.324187,12.088744,12.121219,145523298,92234865.65,27.440379604825807,36.42866143485987,NaN,NaN,-185.35140815793267,-126.87557761994208,-0.04685494699118847,-0.2000624076694315,-0.15320746067824303,-4788463339,-4636774825.2,45.947195979178204,34.17810598882674,NaN,NaN,-30.39020981419383,-23.003426123211394
2011-06-07T09:30:00-04:00,12.206465,12.251118,12.080626,12.092804,97857184,94730816,26.90448581876757,35.46707617218743,NaN,NaN,-167.3181260393403,-156.10000055010502,-0.055079023303202634,-0.22205623980724631,-0.16697721650404368,-4886320523,-4706003043.6,38.023446863216144,34.610585436891526,NaN,NaN,-33.11555974709116,-24.448016640908502
2011-06-08T09:30:00-04:00,12.064388,12.137456,11.958845,11.983201,102267840,96376930.75,24.88566694919082,34.15262484850137,NaN,NaN,-176.12038081455992,-166.2493692667875,-0.06281868959109754,-0.24550057849291562,-0.18268188890181808,-4988588363,-4765894515.8,32.75987604742497,34.684324569672064,NaN,NaN,-36.03630669788275,-26.10348664904768
2011-06-09T09:30:00-04:00,12.007557,12.169931,11.975083,12.121219,73395395,95185542.95,31.82323158264532,33.33371385577634,NaN,NaN,-140.3465581253444,-163.61544777469504,-0.05390324073176661,-0.25006093981652633,-0.19615769908475972,-4915192968,-4844301046.8,27.410347985520062,34.394220480868874,NaN,NaN,-36.171746377382746,-27.541809467381263
2011-06-10T09:30:00-04:00,12.064388,12.145575,11.869539,12.040032,181676948,100323171.4,30.064216496092683,32.85761688053474,NaN,NaN,-137.57133191853484,-161.3415610111424,-0.048882345530659815,-0.2572606309980845,-0.20837828546742468,-5096869916,-4935087021.8,22.77322190610984,33.80256861123988,NaN,NaN,-36.849788059783776,-28.871520694867336
2011-06-13T09:30:00-04:00,12.088744,12.194287,12.015676,12.161813,117741766,102095777.35,35.79691264261561,33.159010176044625,NaN,NaN,-95.76875270007632,-143.42502991957113,-0.03350132839247297,-0.2502549459580159,-0.21675361756554293,-4979128150,-4973219984,21.154391487130425,33.13187632242902,NaN,NaN,-35.549510582327784,-29.82551925021883
2011-06-14T09:30:00-04:00,12.275474,12.332305,12.194287,12.222703,105009580,102847952.95,38.51090548335867,33.684815035317364,NaN,NaN,-57.48153522057089,-121.45771175581726,-0.016242650930842817,-0.23705693122909643,-0.22081428029825362,-4874118570,-4970779593.4,21.53878442016611,32.771350882088306,NaN,NaN,-33.637008207056354,-30.37001767262419
2011-06-15T09:30:00-04:00,12.096863,12.145575,11.877658,11.958845,188841661,107351437.5,32.16558923370306,33.721772129663286,NaN,NaN,-107.53489450145604,-107.74061449319647,-0.019399459148390863,-0.24506360423374218,-0.22566414508535132,-5062960231,-4985653967,20.870897354623537,32.569491884860774,NaN,NaN,-34.031000155062436,-30.89301517011537
2011-06-16T09:30:00-04:00,11.950726,12.104982,11.893896,12.023795,166012036,112642495.45,35.00446656610677,33.674786714473264,NaN,NaN,-94.09979808346542,-98.4912624848207,-0.014158839476759916,-0.2433626944313012,-0.2292038549545413,-4896948195,-4982005012.4,21.51386518337921,32.51090460443731,NaN,NaN,-33.414738596555296,-31.253261373892503
2011-06-17T09:30:00-04:00,12.1131,12.137456,12.031913,12.089556,100495931,114447194.25,37.84091641906927,33.462745695967605,NaN,NaN,-67.98591646648188,-84.5741793944101,-0.003845569647741104,-0.23401081701421766,-0.23016524736647656,-4796452264,-4921921482,31.398453286803985,32.946268711483604,NaN,NaN,-32.016167247360876,-31.36224792724513
2011-06-20T09:30:00-04:00,12.031913,12.153694,11.99132,12.080626,66123256,113279172.8,37.60094578452212,32.76273207751909,NaN,NaN,-64.58250743586025,-78.3369303415669,0.0043486600829591715,-0.2247294222627776,-0.22907808234573676,-4862575520,-4898610956,34.827784506922086,32.88261864611484,NaN,NaN,-30.973667917797147,-31.30673649732399
2011-06-21T09:30:00-04:00,12.153694,12.275474,12.081194,12.251118,95621831,113377868.4,44.79849440656425,33.54595267527461,NaN,NaN,-26.211862355712054,-72.08299576859511,0.022225542871375098,-0.20129615375651788,-0.22352169662789298,-4766953689,-4877177979.8,37.901554361123154,32.60039067777238,NaN,NaN,-27.798331114532044,-30.80553572835371
2011-06-22T09:30:00-04:00,12.202406,12.332305,12.161813,12.17805,106290258,114711738.1,42.53410162031895,34.12693496468692,NaN,NaN,-16.28518477937969,-53.83305382417984,0.029640102568887966,-0.18647156841678303,-0.216111670985671,-4873243947,-4839234723,43.02465224279952,32.13264823127925,NaN,NaN,-25.844519957180545,-30.09681918961469
2011-06-23T09:30:00-04:00,12.031913,12.088744,11.910133,12.05627,127317723,116788929.8,38.99621259100634,34.59760894277049,NaN,NaN,-74.82442718300308,-49.97797964408738,0.026932155541364577,-0.1824464765589653,-0.20937863210032986,-5000561670,-4859957418,41.03357725368726,31.44128920557746,NaN,NaN,-25.247909910010595,-29.404117863956962
2011-06-24T09:30:00-04:00,12.064388,12.088744,11.918252,11.983201,91584790,117133208.55,37.00721080262055,35.28095402832726,NaN,NaN,-78.4898290512768,-52.078762161046356,0.021068810853915515,-0.18304261853293546,-0.20411142938685098,-5092146460,-4919096257.2,35.924193534522274,30.725360459530606,NaN,NaN,-25.351137994775506,-28.825120739788183
2011-06-27T09:30:00-04:00,11.966964,12.145575,11.966964,12.104982,61332223,117099363.75,42.290352082029,36.37994447570307,NaN,NaN,-47.57709364513598,-48.67767940290151,0.025921941973821805,-0.17170900191957372,-0.19763094389339553,-5030814237,-4952744000.6,33.37764116232948,30.393517195181555,NaN,NaN,-23.82239123726452,-28.110445096570515
2011-06-28T09:30:00-04:00,12.161813,12.161813,12.080626,12.161813,58679029,116023636.85,44.62440262233749,37.789854166642115,NaN,NaN,-8.912833004971443,-45.21787353275339,0.03303350475023156,-0.15633906295560607,-0.18937256770583763,-4972135208,-4993780304.4,30.534769783604418,30.234581033480087,NaN,NaN,-21.85984159201486,-27.21750173877685
2011-06-29T09:30:00-04:00,12.275474,12.42973,12.243,12.413492,111681604,114160138.5,53.578595970080066,39.3438087657446,NaN,NaN,140.81163721502813,-13.798509133871837,0.05354726298403356,-0.12243848897579568,-0.17598575195982924,-4860453604,-4991222235.8,30.92970106951455,30.485963396622555,NaN,NaN,-17.101118708885007,-25.772304163078015
2011-06-30T09:30:00-04:00,12.454086,12.510917,12.348543,12.462204,92759087,110499558.4,55.092170373454614,41.131519756984744,NaN,NaN,190.38694553242686,39.243765409214156,0.06831096776694415,-0.09059704225114906,-0.1589080100180932,-4767694517,-4944648805.2,37.8569005790563,31.56336901611873,NaN,NaN,-12.794597615688494,-23.918346084879513
2011-07-01T09:30:00-04:00,12.437848,12.713884,12.437848,12.689528,77761158,108398629.9,61.41483162465463,42.961371112844674,NaN,NaN,255.79072970446506,106.09987716036252,0.0899396186996696,-0.04648348664350621,-0.1364231053431758,-4689933359,-4864206185,47.62714202728563,33.45427976898696,NaN,NaN,-6.809449939323691,-21.474218064085825
2011-07-05T09:30:00-04:00,12.657053,12.665172,12.519035,12.575866,101032115,106174070.75,57.08700555416308,44.28823540361641,NaN,NaN,187.89708730498634,153.194713350387,0.09277135476298434,-0.020458911889445375,-0.11323026665242972,-4790965474,-4816236432.4,52.430118002358284,35.6608035962864,NaN,NaN,-3.28010401825404,-18.875058914681283
2011-07-06T09:30:00-04:00,12.486561,12.519035,12.413492,12.510917,66291184,104595770.75,54.714324127739275,45.89885932461901,NaN,NaN,118.33816802830954,178.6449135570432,0.08657040963357907,-0.005017254610455879,-0.09158766424403494,-4857256658,-4793260722.4,54.57869014342456,38.06850308120075,NaN,NaN,-1.1725944049010995,-16.346135413284113
2011-07-07T09:30:00-04:00,12.665172,12.746359,12.648935,12.713884,55956288,102280193.15,60.271363511587964,47.70363767786767,NaN,NaN,170.87399001245285,184.65738411652814,0.09193348045937347,0.023329186330181884,-0.06860429412919158,-4801300370,-4781430075.6,55.688524859232906,40.50955020090459,NaN,NaN,2.5111365690565375,-13.652239415806878
2011-07-08T09:30:00-04:00,12.519035,12.55151,12.462204,12.55151,76625903,102441718.55,54.50868890868007,48.894192855697,NaN,NaN,92.32690717351161,165.04537644474507,0.0807387673039193,0.03231916500070753,-0.04841960230321176,-4877926273,-4803476426.8,53.085447641797856,42.0586212262613,NaN,NaN,3.7067870218154866,-11.17237849614654
2011-07-11T09:30:00-04:00,12.381017,12.389136,12.153694,12.210525,107776801,98746711.2,44.81773636351112,49.40967789705336,NaN,NaN,-2.159273566554277,113.45537579054121,0.04817024455399876,0.011793203389286688,-0.03637704116471207,-4985703074,-4862630369.8,46.76851074569838,42.91153024331675,NaN,NaN,1.2524653586601815,-9.397400802602723
2011-07-12T09:30:00-04:00,12.161813,12.332305,12.145575,12.161813,79813546,96850300.2,43.62452652158319,49.325823048126146,NaN,NaN,-17.240473607917743,72.4278636079604,0.022454718135057034,-0.008308643495890777,-0.03076336163094781,-5065516620,-4917540599,41.79657005142502,43.18974564976689,NaN,NaN,-1.0449089583072495,-8.204187681989085
2011-07-13T09:30:00-04:00,12.234881,12.348543,12.153694,12.169931,105985638,96899103.1,43.89261902827408,49.42286000583722,NaN,NaN,-12.876648090607224,46.184900384177034,0.005958146429549126,-0.023315678594011402,-0.02927382502356053,-4959530982,-4937995463.8,40.08693546203655,42.97990873685524,NaN,NaN,-2.7407188378793967,-7.423692132830558
2011-07-14T09:30:00-04:00,12.275474,12.283593,12.072507,12.080626,150864291,95000234.6,41.55165770281936,49.60539179953816,NaN,NaN,-44.5551338918614,3.0990756033141933,-0.010126273597344894,-0.04193166702024165,-0.031805393422896754,-5110395273,-4999814444.4,35.377204746464926,42.57588212919651,NaN,NaN,-4.874522567233525,-7.059525052030982
2011-07-15T09:30:00-04:00,12.17805,12.17805,11.958845,12.05627,132483042,93323784.9,40.91080874524902,49.88422022401162,NaN,NaN,-75.9469103458514,-30.55568790055841,-0.020941219787580352,-0.05798191815737219,-0.03704069836979184,-5242878315,-5072804852.8,30.779110006802384,42.2083761629308,NaN,NaN,-6.788160788962198,-7.020758728735442
2011-07-18T09:30:00-04:00,11.99132,12.008369,11.755878,11.893896,137218855,95159931.1,36.832384747376096,49.494365414393556,NaN,NaN,-132.7204420553045,-56.66792159830845,-0.036646681562443204,-0.08284905032284584,-0.04620236876040264,-5380097170,-5151683672,26.735073455147017,41.733907040989195,NaN,NaN,-9.726363273873526,-7.407273663755168
2011-07-19T09:30:00-04:00,11.934489,12.072507,11.893896,12.040844,134654878,98586512.2,42.42623472799666,49.33735342194064,NaN,NaN,-89.02383714084108,-71.02459430489313,-0.034770384894886854,-0.0896653498790112,-0.05489496498412435,-5245442292,-5187668806.4,25.11393119822432,41.34670428489062,NaN,NaN,-10.552275146882375,-7.8565595899161975
2011-07-20T09:30:00-04:00,12.104982,12.234881,12.096863,12.17805,118608112,99735826.25,47.13372221633047,48.877005296672806,NaN,NaN,-29.753696782923956,-74.40000404335647,-0.022515004163042314,-0.08303872018792724,-0.060523716024884926,-5126834180,-5221129446,23.67629412498647,40.828603788852895,NaN,NaN,-9.795741414371532,-8.133585564838388
2011-07-21T09:30:00-04:00,12.307949,12.510917,12.295771,12.470323,189373687,103889997.7,55.48367667680881,48.90497003262668,NaN,NaN,53.08316896399163,-54.87234347218587,0.005550667999024032,-0.053585381026104884,-0.059136049025128916,-4937460493,-5186542490,28.2485253107683,40.142291269689466,NaN,NaN,-6.285602931419307,-7.869588045778519
2011-07-22T09:30:00-04:00,12.494679,12.502798,12.381017,12.437848,60358707,100542046.9,54.45451312190961,48.40780442528774,NaN,NaN,51.4044669752211,-29.402068007971366,0.02131736583763732,-0.032489341728082266,-0.053806707565719585,-4997819200,-5137530667,34.25861280503079,39.18739632524269,NaN,NaN,-3.8506689215202496,-7.295456742313052
2011-07-25T09:30:00-04:00,12.312009,12.389136,12.243,12.348543,78521773,99888896.05,51.61894807356728,48.01722889095947,NaN,NaN,8.412420962160956,-1.1754954044782768,0.024873444063543096,-0.02271490248629071,-0.04758834654983381,-5076340973,-5076779427.6,40.87005777028252,38.36167773723728,NaN,NaN,-2.715786133028052,-6.641218083843766
2011-07-26T09:30:00-04:00,12.324187,12.397255,12.267356,12.332305,113110699,102477819.85,51.09793273256507,47.7589152198756,NaN,NaN,6.080098116895828,17.8452916470691,0.02519600061023538,-0.01609334578703958,-0.04128934639727496,-5189451672,-5065581303.6,42.02738253324851,37.46515576508185,NaN,NaN,-1.956340780810841,-5.971949897696206
2011-07-27T09:30:00-04:00,12.275474,12.275474,12.023795,12.040032,152065685,107147152.65,42.73649265242826,46.50642444422134,NaN,NaN,-76.25222903680749,8.545585196292404,0.005801603851019417,-0.03403734158350069,-0.03983894543452011,-5341517357,-5108517939,38.88474383789887,36.26488569212942,NaN,NaN,-3.942788542909234,-5.68206970415521
2011-07-28T09:30:00-04:00,12.064388,12.186169,12.015676,12.048151,80115092,105568827.05,43.01544718572771,45.6854786068676,NaN,NaN,-78.13430052521625,-17.69790870154917,-0.005777218292841321,-0.047060468300571756,-0.041283250007730435,-5261402265,-5173306293.4,34.67174418226104,34.94962115930536,NaN,NaN,-5.428273692894855,-5.645813131118016
2011-07-29T09:30:00-04:00,11.918252,12.133397,11.877658,12.011617,98177195,105839732.45,42.02341405249056,45.48588415608042,NaN,NaN,-94.70789620560733,-46.92038133771486,-0.01468689138411431,-0.05964186423787332,-0.04495497285375901,-5359579460,-5245658345.4,30.67476397149892,33.80006781829111,NaN,NaN,-6.9350514604661075,-5.829990035310601
2011-08-01T09:30:00-04:00,12.202406,12.202406,11.869539,11.975083,91944670,106548908.05,41.00500262742312,45.29877530649755,NaN,NaN,-85.65398277482608,-65.73366208511226,-0.02142305937693581,-0.07173379707492877,-0.05031073769799296,-5451524130,-5320694976.8,27.175754781224995,32.755723870419686,NaN,NaN,-8.474397259783407,-6.207762495949574
2011-08-02T09:30:00-04:00,11.893896,11.934489,11.642216,11.649523,142287568,108611680.7,33.26793672575904,44.53986942774647,NaN,NaN,-168.1873869537429,-100.58715909924001,-0.044839932041470854,-0.10636065274983153,-0.06152072070836068,-5593811698,-5401566982,23.99846463017049,31.60654738242925,NaN,NaN,-12.453669012861734,-7.100034855508453
2011-08-03T09:30:00-04:00,11.666572,11.723403,11.471723,11.707165,150573899,112825816.45,35.58541849398816,44.113709484258536,NaN,NaN,-180.89058871738516,-121.51483103535554,-0.05292714039009612,-0.12767964619598082,-0.0747525058058847,-5443237799,-5421911070.4,23.261679198958788,30.74115270046453,NaN,NaN,-14.984122583340698,-8.22633310234163
2011-08-04T09:30:00-04:00,11.569148,11.601622,11.090144,11.1145,228977309,121476867.5,25.70205867372907,43.02737019343567,NaN,NaN,-257.3289004958108,-157.35375102947447,-0.09236250915061085,-0.19020564224414827,-0.09784313309353741,-5672215108,-5504073639,20.52145454508522,30.008463024627588,NaN,NaN,-21.362733949013876,-10.10296179472338
2011-08-05T09:30:00-04:00,11.228162,11.293112,10.692328,10.903414,220450249,128668084.8,23.227643788917092,42.05560298211717,NaN,NaN,-269.4139363470937,-192.2949590577717,-0.12481703716497902,-0.2538644295497612,-0.12904739238478216,-5892665357,-5610690818.4,17.620727829696605,29.357438337095413,NaN,NaN,-27.422632029593714,-12.577200399704855
2011-08-08T09:30:00-04:00,10.546191,10.789752,9.774915,9.869904,320299121,139294200.8,15.406759645358477,40.125640476214436,NaN,NaN,-307.9012557089638,-236.74441364459926,-0.20339548452593037,-0.3832917480421951,-0.17989626351626475,-6212964478,-5762978888,14.473693845290626,28.597421383314437,NaN,NaN,-37.340434337271276,-16.11480524792863
2011-08-09T09:30:00-04:00,10.172731,10.635497,9.774915,10.635497,203900565,145498551.75,33.318052170292475,39.138806901497446,NaN,NaN,-203.91928096600245,-243.89079244705118,-0.19148616902986318,-0.4192539748035937,-0.22776780577373054,-6009063913,-5846029331,13.099657313583194,27.841947325357058,NaN,NaN,-36.46163660414084,-19.02149544167323
2011-08-10T09:30:00-04:00,10.383817,10.391936,9.856102,9.896695,333334785,156866009.1,27.308933308511854,37.12632523233338,NaN,NaN,-189.44261585827357,-245.60119787522885,-0.21905572145789587,-0.5015874575961004,-0.2825317361382045,-6342398698,-6025861510.8,10.725333978858515,26.590290801649218,NaN,NaN,-38.7556668980232,-21.840662792580368
2011-08-11T09:30:00-04:00,10.042832,10.651734,9.937857,10.448767,342334373,166439513.2,36.52204729074488,35.84543481582161,NaN,NaN,-128.69539395386047,-219.8744965668388,-0.18704478671060143,-0.5163377195264562,-0.3292929328158548,-6000064325,-6091431354.2,10.012721406917052,24.858441416069663,NaN,NaN,-36.03174125141838,-23.86795971527151
2011-08-12T09:30:00-04:00,10.659853,10.814108,10.30263,10.375699,167186411,168174681.65,35.87397846972962,34.72079412983321,NaN,NaN,-97.02920693476527,-185.39755068437313,-0.15883668441746623,-0.5278387883376876,-0.36900210392022137,-6167250736,-6146348430,9.446604248796831,22.61390902167783,NaN,NaN,-34.4615606368282,-25.381331275493896
2011-08-15T09:30:00-04:00,10.505598,10.716684,10.505598,10.708565,140331117,168330294.75,41.00939597157294,34.00018436119092,NaN,NaN,-73.54338815227332,-138.52597717303505,-0.10822305869007104,-0.5042809272828102,-0.3960578685927391,-6026919619,-6109139458.2,13.03439143369937,20.542981085995745,NaN,NaN,-31.222597380176747,-26.21579786187716
2011-08-16T09:30:00-04:00,10.546191,10.67609,10.408173,10.497479,128368374,168015969.55,38.88285254865536,33.72492435377857,NaN,NaN,-74.47692603438321,-112.63750618671119,-0.08068641846379931,-0.4969158916724883,-0.41622947320868897,-6155287993,-6138384274.2,12.611456944476359,18.666317736465565,NaN,NaN,-29.571368166363758,-26.69516504823239
2011-08-17T09:30:00-04:00,10.578666,10.702476,10.473123,10.562429,118066094,167988868.65,39.91527950748357,33.50348380533256,NaN,NaN,-63.059726861839046,-87.36092838742431,-0.05125762853849569,-0.48030150888180856,-0.42904388034331287,-6037221899,-6077348914.4,18.55141254955707,17.51486547698671,NaN,NaN,-27.972674609296188,-26.87766641409865
2011-08-18T09:30:00-04:00,10.197087,10.205206,9.937289,10.050951,208486659,168944517.25,34.913524260053066,32.995634534444164,NaN,NaN,-96.35316118301805,-80.89248183325579,-0.05885504345082221,-0.5026126846568406,-0.4437576412060184,-6245708558,-6126477761,17.51916952228278,16.575180159185557,NaN,NaN,-28.377148076668508,-27.091878080180056
2011-08-19T09:30:00-04:00,9.880458,10.197087,9.823627,9.847983,155635990,173708381.4,33.13889909520809,32.43376999642881,NaN,NaN,-96.4246017969484,-80.77156080569242,-0.06943896718118431,-0.5305563501824988,-0.4611173830013145,-6401344548,-6173296523.4,16.572783173024916,15.817825044314123,NaN,NaN,-29.29923059694433,-27.407214154003523
2011-08-22T09:30:00-04:00,10.107781,10.1159,9.701846,9.726203,127517952,176158190.35,32.08511972808128,32.34928306802325,NaN,NaN,-98.21478799181584,-85.70584077360091,-0.07600045606705907,-0.5561179530851383,-0.48011749701807926,-6528862500,-6273685099.6,14.734774731635824,15.156132908704507,NaN,NaN,-30.36766230988066,-27.83013531912883
2011-08-23T09:30:00-04:00,9.734321,10.042832,9.588185,10.041208,170600810,179032695.9,37.61151816192605,32.494004472875964,NaN,NaN,-88.28932380497906,-88.46832032772008,-0.051648977926889994,-0.5446787194266918,-0.4930297414998018,-6358261690,-6314279839,14.055913100679973,14.498578187398877,NaN,NaN,-29.485672006112267,-28.066640560126462
2011-08-24T09:30:00-04:00,10.042832,10.335105,9.99412,10.310749,162054200,179532121.65,41.96334585815705,33.65552498604939,NaN,NaN,-53.91499013801289,-86.63937298295485,-0.011982083461102078,-0.5080073458261793,-0.49602526236507727,-6196207490,-6346076957.2,13.530088283177818,13.99919488297692,NaN,NaN,-27.361495309225305,-27.96590552428344
2011-08-25T09:30:00-04:00,10.684209,10.822227,10.140256,10.278274,234764797,187264606.9,41.58695986320417,34.966904705641326,NaN,NaN,-28.61981129513709,-73.09270300537867,0.01595816713070991,-0.4760775534516899,-0.4920357205823998,-6430972287,-6383129703,12.92338597040414,13.663670464456027,NaN,NaN,-25.788406853319135,-27.654834285574253
2011-08-26T09:30:00-04:00,10.172731,10.456886,9.99412,10.36758,121277800,188419637.15,43.098444194133435,36.944882173410974,NaN,NaN,-40.96864898509606,-62.001512443008195,0.04281911744654204,-0.43851182377422226,-0.4813309412207643,-6309694487,-6364799690.8,14.955044056634662,13.698052622409174,NaN,NaN,-24.05916382045828,-27.141167076271973
2011-08-29T09:30:00-04:00,10.55431,10.814108,10.546191,10.797871,119802825,189812544.9,49.8339478023007,38.12458900426871,NaN,NaN,35.29519904745807,-35.29951503515341,0.08925876052452753,-0.3697574905651049,-0.4590162510896324,-6189891662,-6297005523.2,22.186386579163326,14.347104712807754,NaN,NaN,-20.446155977793982,-26.184736919346545
2011-08-30T09:30:00-04:00,10.724803,10.814108,10.570547,10.724803,107113365,188053834.75,48.77805447001008,39.658097658661426,NaN,NaN,48.13452397594611,-8.014745478968383,0.11320887188348056,-0.3175051612352817,-0.4307140331187623,-6297005027,-6284754190.6,23.453086482617437,15.25622989164768,NaN,NaN,-17.806527310770413,-24.987849832407097
2011-08-31T09:30:00-04:00,10.822227,10.944008,10.753218,10.862821,107241228,185887201.2,50.89455134182356,40.68470509088134,NaN,NaN,96.76466595413011,22.121185739460213,0.1350204655082488,-0.2619384512334513,-0.3969589167417001,-6189763799,-6283465452.4,23.593986727807362,16.226320271711273,NaN,NaN,-14.981486869088368,-23.55836940907585
2011-09-01T09:30:00-04:00,10.854702,10.895295,10.603022,10.61926,123534240,180615047.75,47.18895093350794,41.492917409722644,NaN,NaN,77.69437542412908,43.384023083313444,0.12968905857283847,-0.234847593525652,-0.36453665209849045,-6313298039,-6259930602.8,26.263297776991678,17.427512666582334,NaN,NaN,-13.588533731730923,-22.13410716945515
2011-09-02T09:30:00-04:00,10.30263,10.359461,10.156494,10.18085,131682481,176176659.35,41.352528105642335,41.51742684787046,NaN,NaN,-31.650401088090234,45.247672662714606,0.09489403031980176,-0.24591911419873824,-0.34081314451854,-6444980520,-6286987809.4,25.17440029857947,18.29465615693091,NaN,NaN,-14.107590578581691,-20.98746194218751
2011-09-06T09:30:00-04:00,9.823627,10.026594,9.815508,10.002238,138714720,167097439.3,39.22402891019727,41.54179658798059,NaN,NaN,-100.98126430859139,17.992379991504734,0.05981920664147389,-0.2660391362166976,-0.3258583428581715,-6583695240,-6365748525,22.27878645654478,18.985179693507227,NaN,NaN,-15.183200849553641,-20.158281786096957
2011-09-07T09:30:00-04:00,10.213325,10.497479,9.831746,10.481242,141141828,163959502.45,47.089527455282074,42.05424286996621,NaN,NaN,-16.911370363794653,4.983201123556581,0.06823886956372799,-0.24055975590351153,-0.3087986254672395,-6442553412,-6394858202,21.30347274068194,19.181755421444716,NaN,NaN,-13.661859419773883,-19.230221448050802
2011-09-08T09:30:00-04:00,10.335105,10.456886,10.221443,10.253918,104996179,152542572.15,44.16810762281077,42.715284538734615,NaN,NaN,-10.436015334407688,-16.456935134150978,0.05824692837973611,-0.2359899649925694,-0.2942368933723055,-6547549591,-6466415360.4,19.09098204505915,19.29402774450017,NaN,NaN,-13.31087949130243,-18.38460116851532
2011-09-09T09:30:00-04:00,10.132138,10.197087,9.888577,9.92917,158651941,143358450.55,40.31976676828692,43.22820365824025,NaN,NaN,-82.51733622871303,-48.4992774647194,0.030888615890064752,-0.2556261235097246,-0.28651473939978933,-6706201532,-6544996059,17.00266887201387,19.324733865856526,NaN,NaN,-14.232422599883051,-17.791432801567854
2011-09-12T09:30:00-04:00,9.758677,10.059069,9.74244,10.042832,144748316,142236545.8,42.2174128322246,43.951938879964764,NaN,NaN,-87.90130245793483,-59.74945773868831,0.02198746684725672,-0.25903040584071846,-0.2810178726879752,-6561453216,-6568290598.2,16.428948784021784,19.44574629816981,NaN,NaN,-14.405474225030495,-17.30772443349109
2011-09-13T09:30:00-04:00,10.107781,10.221443,9.99412,10.107781,121388655,141289422.7,43.326352015481035,44.36014129807584,NaN,NaN,-44.02720873258246,-48.35864662348653,0.021962659477439417,-0.2535645483411759,-0.27552720781861534,-6440064561,-6539564462.4,20.013283804748085,19.871272777031812,NaN,NaN,-14.224745643191886,-16.867298892019775
2011-09-14T09:30:00-04:00,10.213325,10.351343,9.977882,10.229562,124718469,141106927.45,45.440675722702714,44.60852200268624,NaN,NaN,-20.24406915404433,-49.025186381536464,0.031079499674805278,-0.2366778332251087,-0.267757332899914,-6315346092,-6514122998.4,23.1567446703815,20.558891090403506,NaN,NaN,-13.473212410854027,-16.382429394710382
2011-09-15T09:30:00-04:00,10.343224,10.497479,10.286393,10.48936,128548363,141631040.9,49.74779030367815,45.1914384627201,NaN,NaN,47.6149719896213,-37.41498891673067,0.05418531367675189,-0.20002569080397414,-0.25421100448072603,-6186797729,-6441972626,31.391475903561755,21.878040371343335,NaN,NaN,-11.568487209947149,-15.694723368315634
2011-09-16T09:30:00-04:00,10.497479,10.586785,10.310749,10.477182,97932861,136103351,49.55032590484329,45.65228715634223,NaN,NaN,51.3138357387233,-10.648754523243403,0.0673675282725194,-0.17000159414007676,-0.23736912241259617,-6284730590,-6357678437.6,39.54292045261934,23.63431725677081,NaN,NaN,-10.065311825128182,-14.890521719288856
2011-09-19T09:30:00-04:00,10.262037,10.286393,10.107781,10.197087,127893638,134716233.4,45.11477211521391,45.31520317869318,NaN,NaN,-25.543553771931244,1.8227952139573147,0.05638740827985589,-0.1668848620627763,-0.2232722703426322,-6412624228,-6327912640,42.156384364131455,25.060745669982822,NaN,NaN,-9.980708011638319,-14.189119761053064
2011-09-20T09:30:00-04:00,10.245799,10.335105,10.164612,10.164612,68193538,131750012.7,44.61609279750368,45.01792020208558,NaN,NaN,-25.556137977954485,5.5170093648829095,0.04651241270823531,-0.16513175445733808,-0.21164416716557338,-6480817766,-6336063281,41.625756072108175,26.35879349780359,NaN,NaN,-10.04693794888842,-13.5973795021724
2011-09-21T09:30:00-04:00,10.188969,10.209265,9.661253,9.661253,147652111,130602577.75,37.66633978829902,44.0730479482624,NaN,NaN,-140.34762156104983,-18.50370111651819,0.007691023293254634,-0.20203038804900508,-0.20972141134225972,-6628469877,-6398688038,37.69931177530421,27.366316715481933,NaN,NaN,-12.207654207868217,-13.398847317271802
2011-09-22T09:30:00-04:00,9.433929,9.506998,9.206606,9.385217,251587687,135079252.1,34.493235542117006,43.16621113459161,NaN,NaN,-234.62180454445988,-74.95105642333442,-0.03274863022126634,-0.25065719911884266,-0.21790856889757632,-6880057564,-6537340005,30.777297988812094,27.688745302040534,NaN,NaN,-15.055760867482851,-13.635549253016237
2011-09-23T09:30:00-04:00,9.320268,9.523235,9.30403,9.482642,146787283,130680376.4,36.52567847441164,42.82143616093227,NaN,NaN,-180.6637718381467,-121.34657793870842,-0.048174617562151884,-0.2781268408502662,-0.2299522232881143,-6733270281,-6627047943.2,27.286416784687248,27.839603622476805,NaN,NaN,-16.803101734546193,-14.088056750377659
2011-09-26T09:30:00-04:00,9.612541,9.921051,9.531354,9.904814,136892379,131461105.35,44.553699161198466,43.20212689314665,NaN,NaN,-87.5876740029653,-133.75540198491524,-0.02627947322405777,-0.2628015648181865,-0.23652209159412874,-6596377902,-6663798678,25.986053372045603,28.104408402155435,NaN,NaN,-15.88349770121261,-14.344548314782651
2011-09-27T09:30:00-04:00,10.132138,10.229562,9.864221,9.953526,173112700,134126599.1,45.41160954283938,43.082275613686456,NaN,NaN,-31.070975061215517,-134.85836940156744,-0.005913394720341969,-0.2439138349945562,-0.23800044027421424,-6423265202,-6652288165.2,27.15695299377647,28.52251413451933,NaN,NaN,-14.887216987154165,-14.422072410835725
2011-09-28T09:30:00-04:00,9.969764,10.026594,9.653134,9.665312,126481451,135095003.4,41.33626463358871,42.880001114456306,NaN,NaN,-76.60372995065269,-122.10959107948801,-0.00906168092390422,-0.24932754142909452,-0.2402658605051903,-6549746653,-6636543520.4,28.815823355295564,29.217145656679072,NaN,NaN,-15.250720248557261,-14.540450673367372
2011-09-29T09:30:00-04:00,9.921051,10.002238,9.669372,9.937289,127027410,136084312.5,46.23929124558232,43.302824291405976,NaN,NaN,-48.53133097144636,-84.89149636488531,0.008987457303537838,-0.229031538875768,-0.23801899617930583,-6422719243,-6545075856.2,37.69310247784848,30.69503377138155,NaN,NaN,-14.057950264638574,-14.471522043548973
2011-09-30T09:30:00-04:00,9.758677,9.831746,9.580066,9.588185,118609806,135838090.8,41.450443312203106,43.24804075426159,NaN,NaN,-94.14224172273073,-67.58719034180213,-0.00027985784339584763,-0.23836881848355063,-0.23808896064015478,-6541329049,-6506687609.8,41.017659451353786,32.45137024761954,NaN,NaN,-14.529239326057898,-14.479767369621676
2011-10-03T09:30:00-04:00,9.515116,9.693728,9.141656,9.157894,197542483,139131090.9,36.44087000963079,42.756220610986574,NaN,NaN,-160.34910159705984,-82.13947586062105,-0.03136331560396041,-0.2772931051451053,-0.2459297895411449,-6738871532,-6535186335.8,39.33948102044641,33.83181290588371,NaN,NaN,-16.600798032756085,-14.782771750069449
2011-10-04T09:30:00-04:00,9.036113,9.55571,8.889976,9.523235,275953657,145993037.75,42.765698813285724,42.56515083174251,NaN,NaN,-136.9506430113652,-103.31540945065099,-0.02364440384806188,-0.27548529435122227,-0.2518408905031604,-6462917875,-6543116870.4,38.86297867144146,34.953686763102276,NaN,NaN,-16.248287095093108,-14.99213108507283
2011-10-05T09:30:00-04:00,9.498879,9.718084,9.312149,9.661253,148623163,146367104.5,44.992664077052865,42.225498958412125,NaN,NaN,-74.11987576542471,-102.81863861360539,-0.006462889128084903,-0.2599195019132665,-0.2534566127851816,-6314294712,-6496026482.2,43.25794892304398,35.80129197877958,NaN,NaN,-15.24998035104359,-15.028966694497223
2011-10-06T09:30:00-04:00,9.612541,9.977882,9.482642,9.961645,171595984,149697094.75,49.59004688906719,42.22833617157097,NaN,NaN,-14.377780965887325,-95.98792861249358,0.02612597799232716,-0.22079914029477266,-0.24692511828709982,-6142698728,-6440022379.2,48.04180371674982,36.40835506907461,NaN,NaN,-12.920578535885397,-14.727768386124104
2011-10-07T09:30:00-04:00,10.018476,10.018476,9.588185,9.604422,189815098,151255252.6,44.79537426141158,42.20552203915652,NaN,NaN,-28.297124806998024,-82.81890522934704,0.024636513462270387,-0.21612947645926184,-0.24076598992153223,-6332513826,-6398259334.6,51.33662721129519,37.06408670101488,NaN,NaN,-12.494367355344233,-14.408711096012695
2011-10-10T09:30:00-04:00,9.839864,10.099663,9.831746,10.099663,121708135,150103243.55,51.759100639878554,42.715736885040435,NaN,NaN,36.83794304069405,-43.381496301796254,0.056211600423611174,-0.17050148939201826,-0.22671308981562943,-6210805691,-6292646166.4,58.50308435573553,38.2696101498454,NaN,NaN,-9.74808761368266,-13.742907741394118
2011-10-11T09:30:00-04:00,9.969764,10.172731,9.92917,10.091544,118279862,149947803.9,51.64408485502709,43.71414724694959,NaN,NaN,50.76854720623608,-5.837658258276005,0.07460431259201714,-0.133457699075608,-0.20806201166762514,-6329085553,-6265879702,60.10655660229045,39.87012763748728,NaN,NaN,-7.661289862555573,-12.874105187274326
2011-10-12T09:30:00-04:00,10.205206,10.521835,10.188969,10.347283,156548235,151539292.2,55.03360269374928,45.18131632920904,NaN,NaN,114.64768861623868,31.91585461805667,0.10043915408116966,-0.08251306906616307,-0.18295222314733273,-6172537318,-6237528223.2,61.790718700444515,42.085371974032455,NaN,NaN,-4.840698504738528,-11.726475661197783
2011-10-13T09:30:00-04:00,10.197168,10.221443,9.965704,10.107781,143494500,152286599.05,51.39991511749182,46.24376180371477,NaN,NaN,62.882805672103366,47.36797194565481,0.09775022817402351,-0.06076443792980335,-0.15851466610382686,-6316031818,-6272194841.2,58.53662193252268,44.31752948459213,NaN,NaN,-3.6021341622783116,-10.565855447066431
2011-10-14T09:30:00-04:00,10.253918,10.310181,10.059069,10.229562,149172197,154848565.85,53.09576261129193,46.853909193007155,NaN,NaN,96.16965593815549,72.26132809468552,0.10015755989356187,-0.03331771623687452,-0.1334752761304364,-6166859621,-6239064000.2,60.66845824870758,46.79484411863941,NaN,NaN,-2.077493977116327,-9.353232379930702
2011-10-17T09:30:00-04:00,10.148375,10.172731,9.888577,9.912933,108222074,153864987.65,48.36990296786593,47.06521586622334,NaN,NaN,46.03001407100838,74.09974230074837,0.07742634952283385,-0.03669233922689408,-0.11411868874972793,-6275081695,-6251919201,59.39245569127558,49.097380025603634,NaN,NaN,-2.202440879885754,-8.331690737067138
2011-10-18T09:30:00-04:00,9.99412,10.513717,9.921051,10.383817,226604160,161785518.75,54.81154227561009,48.02773569779629,NaN,NaN,121.12932555370384,88.17189797024194,0.09021116516733164,-0.0013547322905633763,-0.09156589745789502,-6048477535,-6195797597.4,63.04654782270047,51.54243177327542,NaN,NaN,-0.24513306075236718,-7.176468211879314
2011-10-19T09:30:00-04:00,10.391936,10.562429,10.197087,10.237681,163100397,162557933.05,52.61746777059833,48.483319735297435,NaN,NaN,118.84565304135388,89.011490855265,0.08500415227438457,0.014689292885085692,-0.07031485938929888,-6211577932,-6203605720.2,62.2078239158197,53.29348330455907,NaN,NaN,0.664880497935402,-6.05627553904864
2011-10-20T09:30:00-04:00,10.237681,10.43253,10.107781,10.391936,152319952,157594546.3,54.6797057793967,49.428267054382694,NaN,NaN,103.05165015954329,97.04525975275297,0.08776968022808504,0.03939724089580743,-0.04837243933227761,-6059257980,-6152250952.6,65.46222368215868,55.03952360675942,NaN,NaN,2.039577300940199,-4.899725133335949
2011-10-21T09:30:00-04:00,10.538073,10.67609,10.48936,10.659853,210883831,160799373.7,58.09139475790058,50.97473310783054,NaN,NaN,158.74203186264927,109.55973493765173,0.10244086723515256,0.07967864471166308,-0.022762222523489473,-5848374149,-6088553858.2,69.02511253981908,57.15992585814318,NaN,NaN,4.254618514581659,-3.591961755062005
2011-10-24T09:30:00-04:00,10.692328,10.919651,10.67609,10.895295,125200241,160214766.8,60.878543085874014,52.2685076987297,NaN,NaN,182.42873868292114,136.83947986003426,0.12149924072946439,0.129111828388341,0.007612587658876624,-5723173908,-5978172300.8,74.02562571114777,59.671543503836496,NaN,NaN,6.980279042855342,-2.0816416410738126
2011-10-25T09:30:00-04:00,10.757277,10.765396,10.499509,10.570547,169907674,160054515.5,55.40517752267328,53.012258659131156,NaN,NaN,115.89112381596652,135.7918395124868,0.10628140784860385,0.14046434746963143,0.034182939621027586,-5893081582,-5947093110.2,75.23776504521157,61.955816083991316,NaN,NaN,7.651112971525601,-0.6912481249881821
2011-10-26T09:30:00-04:00,10.74104,10.822227,10.538073,10.757277,167777166,162119301.25,57.75696263950511,53.59560978416244,NaN,NaN,119.08464849817305,135.83963860385066,0.10277675102526729,0.1626538784026117,0.05987712737734441,-5725304416,-5849838407,78.60280276153694,64.1387445871904,NaN,NaN,8.92228265117484,0.682113414463678
2011-10-27T09:30:00-04:00,11.276874,11.504198,11.106382,11.398655,286624390,170099150.25,64.65234629424977,55.01396492936517,NaN,NaN,197.24389496604329,154.67808756515063,0.13557773014889563,0.22934929006346394,0.09377155991456831,-5438680026,-5725722816.2,81.97018081455704,66.32685555885196,NaN,NaN,12.385058070646927,2.353962651061285
2011-10-28T09:30:00-04:00,11.333705,11.447367,11.244399,11.406774,167523509,172544835.4,64.73082859392647,55.94051692608288,NaN,NaN,174.15533966335192,157.76074912529117,0.14869277795724828,0.27963753236112865,0.13094475440388037,-5271156517,-5610279289.8,84.42534896038234,68.1784458877553,NaN,NaN,15.11192372578128,4.176528518878427
2011-10-31T09:30:00-04:00,11.130738,11.203806,10.944008,10.956186,135927929,169464107.7,57.14734193518563,56.333606717522784,NaN,NaN,111.4491332593129,143.56482804056952,0.11916904288412042,0.2799060580090309,0.16073701512491048,-5407084446,-5547061397.4,85.58310416460984,69.99819928506382,NaN,NaN,15.076812285225333,5.733711914070842
2011-11-01T09:30:00-04:00,10.420351,10.716684,10.416292,10.440648,264111012,168871975.45,49.93859435014322,55.96967755012235,NaN,NaN,23.25924259695774,125.03845179676776,0.06005126011045678,0.23580109026298146,0.17574983015252468,-5671195458,-5502684172.6,86.35016637040484,71.75244554720385,NaN,NaN,12.608593845864267,6.715837904327045
2011-11-02T09:30:00-04:00,10.700447,10.781634,10.562429,10.749159,141970847,168539359.65,53.70231766264315,56.13413487477601,NaN,NaN,45.42724545909894,110.30697118895293,0.03793556651294627,0.22316928829370752,0.18523372178076125,-5529224611,-5463468211.6,87.00800889631995,73.78611604461794,NaN,NaN,11.810958076542006,7.443712214643468
2011-11-03T09:30:00-04:00,10.887177,10.976482,10.55431,10.935889,137722719,166845696.4,55.86515748691223,56.33194879446318,NaN,NaN,60.789824443553016,83.01615708445487,0.032313165017251594,0.22562517805232574,0.19331201303507414,-5391501892,-5454032584.8,87.16824968132985,75.67895828980524,NaN,NaN,11.856375953860232,8.074092748817291
2011-11-04T09:30:00-04:00,10.80599,10.822227,10.651734,10.785693,114156049,163062743.95,53.69242105282589,56.712128657674604,NaN,NaN,41.75863295230292,56.536815742245075,0.015747696621004004,0.21299663381132916,0.19724893719032516,-5505657941,-5500932869.6,81.76967598543408,77.27733116795943,NaN,NaN,11.21800292212107,8.523222773574973
2011-11-07T09:30:00-05:00,10.757277,10.850643,10.647675,10.846583,101509256,162052800,54.46559633855491,56.687418233599224,NaN,NaN,42.11740727663815,42.67047054571013,0.006626838318981004,0.20553248508905142,0.19890564677007042,-5404148685,-5500345717.4,81.78488540052109,78.61578385208945,NaN,NaN,10.928570097317673,8.86684381982393
2011-11-08T09:30:00-05:00,10.952126,11.082025,10.80599,11.049551,140484698,163163041.8,57.0404463156385,57.003345272530666,NaN,NaN,77.4231387669353,53.50324977970564,0.011702229996535501,0.21353343426573979,0.20183120426920428,-5263663987,-5418839423.2,83.80478582058049,80.15842398814381,NaN,NaN,11.432665393398203,9.23338975890597
2011-11-09T09:30:00-05:00,10.732921,10.757277,10.416292,10.448767,144227681,162547014.1,48.32891008770145,56.54971700883815,NaN,NaN,-22.725974015082027,39.87260588486946,-0.025910750962255036,0.1694427655663855,0.19535351652864053,-5407891668,-5394572834.6,84.36083583099634,81.50832485591793,NaN,NaN,9.122232282503898,9.21751011941996
2011-11-10T09:30:00-05:00,10.627378,10.635497,10.416292,10.497479,175346200,164139599.1,49.00890931600437,55.900968048702715,NaN,NaN,-35.66504626297842,20.58163174356317,-0.04679986904236938,0.1368536802256788,0.18365354926804817,-5232545468,-5362781549.8,85.08340732389146,82.65534591192309,NaN,NaN,7.479412056477678,8.96921039614249
2011-11-11T09:30:00-05:00,10.67609,10.797871,10.667972,10.745099,114029113,162382444.9,52.43561735452424,55.29790192503487,NaN,NaN,13.250195423305373,14.879944237763661,-0.04331124153497162,0.12951449734933362,0.17282573888430525,-5118516355,-5285353232.6,86.69567303866303,83.5603492924599,NaN,NaN,7.104129488606252,8.702770266494456
2011-11-14T09:30:00-05:00,10.659853,10.67609,10.456886,10.531578,77770381,160859860.25,49.35556239699807,54.86578655891521,NaN,NaN,-48.83510350246046,-3.310557918056051,-0.0540562212174755,0.10525546236246086,0.15931168357993636,-5196286736,-5243780842.8,87.47824120132792,84.43466901789678,NaN,NaN,5.866515352507012,8.297590993067677
2011-11-15T09:30:00-05:00,10.448767,10.659853,10.416292,10.578666,111007998,155080052.15,50.052351674216176,54.31545720425172,NaN,NaN,-57.318089167867065,-30.258803505016523,-0.056404617933159734,0.08880591116348668,0.14521052909664642,-5085278738,-5208103793,88.12385581878782,85.11474423627185,NaN,NaN,5.052945422321285,7.834070197246764
2011-11-16T09:30:00-05:00,10.456886,10.55431,10.294512,10.318868,112340882,152542076.4,46.269858770114986,53.00242238109923,NaN,NaN,-111.83996727961897,-48.08160215792391,-0.07282328232230409,0.05418142619376631,0.1270047085160704,-5197619620,-5166049383.4,88.85340966273131,85.60640343971286,NaN,NaN,3.2464114951279397,7.178690382658361
2011-11-17T09:30:00-05:00,10.310749,10.351343,10.042832,10.1159,178612575,153856707.55,43.503824688037355,51.48620781639287,NaN,NaN,-175.50784147146115,-76.05016119962046,-0.09340748755914936,0.010245349067133702,0.10365283662628307,-5376232195,-5194786728.8,85.01038084314024,85.64819143133843,NaN,NaN,0.8944221339246599,6.280937775696403
2011-11-18T09:30:00-05:00,10.164612,10.205206,10.079366,10.148375,104757067,148550369.35,44.079840001384994,50.552814821121395,NaN,NaN,-160.18371306151138,-110.73694289658381,-0.1002851982663343,-0.021703661206634806,0.07858153705969949,-5271475128,-5225378483.4,80.9943530797639,85.32042349670657,NaN,NaN,-0.8837016389152544,5.257417859323309
2011-11-21T09:30:00-05:00,9.953526,9.977882,9.823627,9.896695,120416283,148311171.45,40.623059238571955,49.88741945600916,NaN,NaN,-189.90431625091014,-138.95078544627376,-0.11611694079075352,-0.06656463892874243,0.0495523018620111,-5391891411,-5264499418.4,76.04674920363112,84.58446512765131,NaN,NaN,-3.435723860987885,4.015540470707424
2011-11-22T09:30:00-05:00,9.904814,9.945408,9.791152,9.80739,81556781,143893626.8,39.44112616172243,48.86876292022911,NaN,NaN,-168.9296178734027,-161.27309118738089,-0.1261039237274516,-0.10807760279730338,0.018026320930148207,-5473448192,-5342133309.2,67.26544522864515,83.17428200853169,NaN,NaN,-5.912274893033835,2.5972811330301013
2011-11-23T09:30:00-05:00,9.701846,9.701846,9.523235,9.539472,101686999,140589118.45,36.052194815330374,47.4535513008304,NaN,NaN,-188.01252932302017,-176.5076035960611,-0.14301523847521416,-0.1607427271638695,-0.01772748868865534,-5575135191,-5417636423.4,60.00797109958285,81.23426210983548,NaN,NaN,-9.08560245267358,0.9282977636438612
2011-11-25T09:30:00-05:00,9.539472,9.718084,9.523235,9.563829,39127072,128214252.55,36.58566176174534,46.23163992289608,NaN,NaN,-158.02035785882904,-173.01010687353468,-0.14440180284205245,-0.19822974224122092,-0.05382793939916846,-5536008119,-5449591608.2,57.19532457612251,79.47895129488464,NaN,NaN,-11.565498942569478,-0.8565303372437587
2011-11-28T09:30:00-05:00,9.937289,9.945408,9.74244,9.847983,84405138,124058334,42.60151162157494,45.384205300254656,NaN,NaN,-99.61197387643504,-160.89575903651942,-0.1190763099142258,-0.20267332679195071,-0.08359701687772492,-5451602981,-5485617178.8,54.115794366782616,77.5025876496176,NaN,NaN,-12.105496567172972,-2.463525512947932
2011-11-29T09:30:00-05:00,9.839864,9.912933,9.766796,9.795212,78376528,121180763.95,41.80828351346082,44.29619367152768,NaN,NaN,-90.42129331432822,-140.99915444920302,-0.09956618854513141,-0.2080547525591392,-0.10848856401400778,-5529979509,-5513234798.4,51.81265689440423,75.21743558346216,NaN,NaN,-12.771955281937005,-3.936158337089228
2011-11-30T09:30:00-05:00,10.156494,10.448767,10.107781,10.400055,168903041,116420365.4,52.68308881564431,44.60720643780932,NaN,NaN,-1.681081300652297,-107.54944713465298,-0.04252946155004238,-0.16165039095156075,-0.11912092940151837,-5361076468,-5490760453.6,53.545307107628865,73.01632638893591,NaN,NaN,-10.027805938549141,-4.806393708726358
2011-12-01T09:30:00-05:00,10.343224,10.383817,10.221443,10.343224,84342015,113538923.8,51.70534940230448,44.79980930111646,NaN,NaN,1.3157522666959158,-69.68379081670973,-0.007091300280741328,-0.12798505475244504,-0.12089375447170371,-5445418483,-5464817112,55.532956272134356,70.90557988523898,NaN,NaN,-8.092064022075672,-5.275775182061975
2011-12-02T09:30:00-05:00,10.448767,10.67609,10.448767,10.481242,157829228,114544249.25,53.940988130044865,44.907335785082225,NaN,NaN,46.66582500578352,-28.746554243787227,0.02540254193783814,-0.08914057704940603,-0.11454311898724417,-5287589255,-5415133339.2,59.13870607559791,68.9372251021629,NaN,NaN,-5.803838329272121,-5.351212774520567
2011-12-05T09:30:00-05:00,10.67609,10.822227,10.603022,10.692328,124089600,115040926.8,57.20396861940785,45.46793622954006,NaN,NaN,80.64370721005074,7.304581973509935,0.0589526926420858,-0.04085225318463692,-0.09980494582672272,-5163499655,-5357512674,62.89640284167156,67.18137950504457,NaN,NaN,-2.856661118963108,-4.994848252298073
2011-12-06T09:30:00-05:00,10.631438,10.765396,10.570547,10.700447,69813600,113456144,57.32918426593422,45.98770998609135,NaN,NaN,77.29812754419751,40.848466145215085,0.07831891781862499,-0.0019062985534414878,-0.08022521637206648,-5093686055,-5270253983.2,67.73535778167533,65.7250582166794,NaN,NaN,-0.4208007585367677,-4.341412896046458
2011-12-07T09:30:00-05:00,10.611141,10.862821,10.538073,10.830346,112819934,112072905.8,59.37710850125226,46.92394210974401,NaN,NaN,95.0987901753422,60.20444044041396,0.09537293418149276,0.038990951354799464,-0.05638198282669329,-4980866121,-5194211913.8,71.25376751464418,64.46794092038748,NaN,NaN,2.2455778573996774,-3.4004142169827247
2011-12-08T09:30:00-05:00,10.716684,10.716684,10.375699,10.408173,150369670,112380005.25,50.83752533756874,47.44777787042483,NaN,NaN,46.27082342472406,69.1954546720196,0.07463438362860614,0.03691099670906439,-0.037723386919541746,-5131235791,-5131375375.4,73.79661314894499,63.66695751365923,NaN,NaN,2.184908871083503,-2.6025109186875492
2011-12-09T09:30:00-05:00,10.513717,10.692328,10.48936,10.635497,120942476,109659819.05,54.621975020532986,48.20078751464968,NaN,NaN,66.17870024517538,73.09802971989798,0.0725746077247353,0.052994872736377374,-0.01957973498835792,-5010293315,-5075916187.4,75.82888449820082,63.29799547211901,NaN,NaN,3.2829949983760867,-1.76172435910703
2011-12-12T09:30:00-05:00,10.481242,10.48936,10.294512,10.383817,120410824,109978904.6,50.030115389054615,48.87272009682702,NaN,NaN,27.118891810355215,62.39306663995886,0.051595974308711906,0.044915232897531965,-0.006680741411179943,-5130704139,-5069357084.2,76.06531722050059,63.29932175903826,NaN,NaN,2.8138918843868694,-1.1080648957507586
2011-12-13T09:30:00-05:00,10.473123,10.513717,10.107781,10.237681,149214470,113551109.05,47.5315190885966,49.450605305889454,NaN,NaN,8.56216804492279,48.64587474010393,0.026477076000194555,0.026415603589063252,-0.00006147241113130426,-5279918609,-5106603595,71.77201144187825,63.621219345697774,NaN,NaN,1.6637549513277856,-0.7120906318823952
2011-12-14T09:30:00-05:00,10.124019,10.318868,10.107781,10.197087,118026600,113902039.15,46.8318459841456,50.22058038937626,NaN,NaN,-5.001491170442283,28.625818470947024,0.0067550112863430396,0.008382291696797495,0.0016272804104544556,-5397945209,-5190019412.6,63.172379306607404,63.84724850334237,NaN,NaN,0.5235098145310416,-0.5355762823947614
2011-12-15T09:30:00-05:00,10.351343,10.36758,10.188969,10.205206,75891519,112079571,46.99988713890137,50.96445363060168,NaN,NaN,7.112582164017153,20.794170218805647,-0.005457205642515461,-0.00519422664268987,0.00026297899982559046,-5322053690,-5228182992.4,59.650884732692084,64.02264565738307,NaN,NaN,-0.3648182752311224,-0.5111822813713844
2011-12-16T09:30:00-05:00,10.229562,10.326986,10.148375,10.18085,122518078,109274846.15,46.52483960573176,51.24469134375574,NaN,NaN,-1.612996449569757,7.235830879856614,-0.014382251435467593,-0.0177148352945089,-0.003332583859041308,-5444571768,-5315038683,52.48065759897434,63.90585017396819,NaN,NaN,-1.2340884590822263,-0.6144545924729332
2011-12-19T09:30:00-05:00,10.205206,10.221443,9.912933,9.949467,81986722,108136328.9,42.16470875790454,51.27015028978743,NaN,NaN,-43.86289441280142,-6.960526364774703,-0.03395829582204339,-0.04578045363659555,-0.011822157814552158,-5526558490,-5394209553.2,46.94171573378801,63.557925805352745,NaN,NaN,-3.232014680645856,-0.9883917479262079
2011-12-20T09:30:00-05:00,10.140175,10.375699,10.132138,10.326986,126697091,108450369.3,50.34178088046274,51.10291400870303,NaN,NaN,9.587628524928204,-6.7554342687736195,-0.020247870229206148,-0.03713199560105984,-0.016884125371853693,-5399861399,-5418198111.2,45.37890996503049,62.974611723738576,NaN,NaN,-2.661169801197304,-1.2273600412506502
2011-12-21T09:30:00-05:00,10.326986,10.408173,10.237681,10.383817,98111687,109278114.6,51.45449873967387,51.08499610422941,NaN,NaN,20.9221019742139,-1.5707156398423805,-0.006812263266723122,-0.025399454455257597,-0.018587191188534476,-5301749712,-5398959011.8,46.905631343070695,62.35837422880546,NaN,NaN,-1.8694095576880363,-1.3190814007417053
2011-12-22T09:30:00-05:00,10.456886,10.627378,10.416292,10.598963,80006621,108194095.7,55.51808990568155,51.19764623106061,NaN,NaN,69.68452129488546,10.94367218633128,0.015865595957371432,0.0012448037581798133,-0.014620792199191619,-5221743091,-5378896892,48.52148562522893,61.600001339493396,NaN,NaN,0.02819417960800771,-1.1266134606917464
2011-12-23T09:30:00-05:00,10.651816,10.692328,10.578666,10.67609,37763740,108125929.1,56.910571918132234,51.176689323826636,NaN,NaN,91.36721671011476,29.53971481826818,0.03430329794803499,0.028258330235852114,-0.006044967712182872,-5183979351,-5326778408.6,52.56065487383889,60.86173362750534,NaN,NaN,2.011324265143922,-0.6783366427152224
2011-12-27T09:30:00-05:00,10.635497,10.724803,10.611141,10.6152,33297330,105570538.7,55.43515205017171,51.041401308415026,NaN,NaN,82.9346316746631,54.89922003576108,0.040230710063080266,0.044243419866667466,0.0040127098035871965,-5217276681,-5264922046.8,56.88455998906701,60.086676642319034,NaN,NaN,3.262822382198791,-0.1153139248703633
2011-12-28T09:30:00-05:00,10.627297,10.627378,10.440648,10.444708,52875342,104295479.4,51.415748990805206,50.47273277195453,NaN,NaN,25.34992080951685,58.05167849267881,0.030919952595210055,0.04266265054759977,0.01174269795238971,-5270152023,-5238980171.6,58.58927573548073,59.1820700866645,NaN,NaN,3.227624952776722,0.3622487719363632
2011-12-29T09:30:00-05:00,10.481242,10.61926,10.473123,10.611141,46431906,98171922.65,54.8567828143971,50.75982259172798,NaN,NaN,45.13163252027932,62.893584601891895,0.033977584492273644,0.05421467856773177,0.020237094075458123,-5223720117,-5223374252.6,59.62351338188959,58.16970581758911,NaN,NaN,4.181396404373096,0.9078412908558965
2011-12-30T09:30:00-05:00,10.578666,10.611141,10.546191,10.55431,34157251,95662684.45,53.46430621684799,50.677131962893334,NaN,NaN,42.07117235077479,57.37091481306976,0.030301568428611092,0.05811405461122199,0.027812486182610896,-5257877368,-5230601108,58.890023806685264,56.95978719676657,NaN,NaN,4.5926481578334135,1.4342422718526846
2012-01-03T09:30:00-05:00,10.781634,10.935889,10.773515,10.830346,103426666,92942556.35,58.918925863326244,51.31204699676988,NaN,NaN,134.36160543976064,65.96979255899893,0.043771466010159535,0.08252681869531031,0.038755352685150776,-5154450702,-5224695378.2,59.33033113102824,55.76443104751855,NaN,NaN,6.577439215899374,2.168984692430783
2012-01-04T09:30:00-05:00,10.749159,10.838464,10.67609,10.797871,69874950,90231823.85,58.056743628849844,52.06384874964511,NaN,NaN,104.01119500989171,70.18510522604467,0.0474937604966582,0.09812255330597353,0.05062879280931533,-5224325652,-5226105172.4,59.16741723633632,54.86410288997984,NaN,NaN,7.966417673987644,2.9971894040817633
2012-01-05T09:30:00-05:00,10.700447,11.000839,10.651734,10.944008,89988160,91240551.85,60.83419830717303,53.0640167727185,NaN,NaN,129.5385895559376,91.02283897532881,0.05620167006047962,0.12088088038491485,0.06467921032443523,-5134337492,-5198942266.2,61.368460443326555,54.73525154260263,NaN,NaN,9.968215623521989,3.993050292573224
2012-01-06T09:30:00-05:00,10.952126,10.952126,10.80599,10.874999,83930540,89796082.15,58.85231262937076,53.91061859346631,NaN,NaN,127.87734295851511,107.57198106297596,0.05371977348466707,0.13182892718026906,0.078109153695602,-5218268032,-5197851849.2,61.45827648511074,54.864350953489684,NaN,NaN,11.10543907439014,5.009105832832784
2012-01-09T09:30:00-05:00,10.919651,10.984601,10.862821,10.93183,69230256,85739111.45,60.00781331709024,54.87368814427763,NaN,NaN,125.34907452014731,124.22756149685047,0.05226280490739407,0.14343765982984458,0.0911748549224505,-5149037776,-5176083930.8,63.2929965021124,55.636660875142404,NaN,NaN,12.382015172923113,6.062378595702831
2012-01-10T09:30:00-05:00,11.106382,11.171331,11.057669,11.130738,86085604,83996267.85,63.835679302606266,56.42161461175632,NaN,NaN,159.9276841237398,129.3407772336463,0.060472522761959066,0.16676550837489934,0.10629298561294027,-5062952172,-5157784224.8,64.80960908182959,56.91293897143111,NaN,NaN,14.62094822298452,7.285031399600215
2012-01-11T09:30:00-05:00,11.082025,11.268756,11.041432,11.256578,80986483,82025050.8,66.04967442309965,57.543607007658984,NaN,NaN,153.0940999193651,139.157358215541,0.06950990724977271,0.19318036967515617,0.12367046242538346,-4981965689,-5109312232.2,68.5197876934671,58.56585880917658,NaN,NaN,17.191358735486205,8.7002210190125
2012-01-12T09:30:00-05:00,11.309349,11.36618,11.163212,11.30123,94163627,79272508.65,66.82575058347473,58.64155356793048,NaN,NaN,151.51217623988208,143.55207555232988,0.07325264689126137,0.2152362710394602,0.14198362414819882,-4887802062,-5060005146.2,71.77922619381557,60.34254415565836,NaN,NaN,19.558158451721486,10.251354937970925
2012-01-13T09:30:00-05:00,11.073907,11.228162,11.025195,11.215984,95065485,78124452.9,63.82606163025479,59.23498011968571,NaN,NaN,109.4052400461099,139.85765496984885,0.06502386062645854,0.223263449931272,0.15823958930481347,-4982867547,-5012925049.2,74.49471498744484,62.19777482438807,NaN,NaN,20.77298977796183,11.754445629398196
2012-01-17T09:30:00-05:00,11.228162,11.341824,11.090144,11.130738,89078379,78783795.9,60.88291112229631,59.51871863426886,NaN,NaN,104.41878728514152,135.6715975228477,0.04957471789267162,0.220207986670653,0.17063326877798138,-5071945926,-4997506679.2,75.33186112825032,63.82428955684603,NaN,NaN,21.016437151711795,13.077587275442996
2012-01-18T09:30:00-05:00,11.106382,11.317468,11.057669,11.30123,118555768,78585680.4,64.41695704419944,60.16027613384226,NaN,NaN,103.30352183032036,124.3467650641638,0.04661747609566927,0.22890511389756796,0.1822876378018987,-4953390158,-4975594276.4,76.51179365858911,65.22623481895474,NaN,NaN,22.22653160533554,14.384579322570502
2012-01-19T09:30:00-05:00,11.414892,11.447367,11.358061,11.406774,131454622,81059075.4,66.43840463528674,61.23332296559094,NaN,NaN,134.82574461990765,120.6930940042723,0.04739385901171736,0.24152996156654538,0.19413610255482802,-4821935536,-4943588245.8,78.15537738704455,66.62381350835217,NaN,NaN,23.84076912893226,15.73546358062218
2012-01-20T09:30:00-05:00,11.36618,11.496079,11.333705,11.479842,114896325,80469037.1,67.80212391340856,62.15799018694891,NaN,NaN,127.7323032362452,115.93711940354493,0.04828914364858222,0.2544975321155558,0.2062083884669736,-4707039211,-4907435675.6,79.8689425095215,68.0699155888973,NaN,NaN,25.594582418525142,17.143909128894034
2012-01-23T09:30:00-05:00,11.487961,11.601622,11.447367,11.520435,99384285,80532667,68.56628807113748,63.23670317654101,NaN,NaN,131.25936215757753,120.30794382583845,0.04702948192175058,0.2649952408691618,0.21796575894741124,-4607654926,-4832393151.4,82.87230603102786,69.78293574777892,NaN,NaN,27.280285301855844,18.59196286788858
2012-01-24T09:30:00-05:00,11.406774,11.520435,11.349943,11.504198,80700092,80567340.55,67.87239596822621,63.87623675546244,NaN,NaN,103.8920539296606,120.20259715474228,0.04075122757447208,0.26890479341550133,0.22815356584102925,-4688355018,-4755674969.8,85.2887008180889,71.63710501114039,NaN,NaN,28.515052015640553,20.009547031853145
2012-01-25T09:30:00-05:00,11.439248,11.560217,11.398655,11.528554,103825962,83870451.65,68.38917161706539,64.61426732604926,NaN,NaN,102.09438117057343,119.9607690227929,0.03415420320278223,0.270846319844507,0.2366921166417248,-4584529056,-4681902749.4,87.16402779681493,73.63686290831744,NaN,NaN,29.699858605988123,21.39387725672957
2012-01-26T09:30:00-05:00,11.585385,11.642216,11.36618,11.430318,104276773,87419423.8,63.92304967130941,64.83489956634472,NaN,NaN,91.02270845227495,111.20016178926635,0.01980182749350559,0.2614444010086068,0.24164257351510118,-4688805829,-4655276808,87.76999538422622,75.52268683266742,NaN,NaN,29.589897042655057,22.564737226147496
2012-01-27T09:30:00-05:00,11.36618,11.512317,11.349943,11.471723,103609021,89956107.75,64.96166213948075,65.27128167420972,NaN,NaN,78.31970190840174,101.31764152369767,0.010207353085614324,0.2544017648721191,0.24419441178650475,-4585196808,-4630908327.4,88.31375120346783,77.44093502683579,NaN,NaN,29.758718825970053,23.592448883265003
2012-01-30T09:30:00-05:00,11.341824,11.390536,11.268756,11.36618,71762898,91222657.35,60.20382951851813,65.28528283145457,NaN,NaN,46.859732169606524,84.43771552610346,-0.005303145444950308,0.23756547998031685,0.24286862542526716,-4656959706,-4640769283.4,86.63515321767319,79.10823193509013,NaN,NaN,28.63963570348259,24.313475571867517
2012-01-31T09:30:00-05:00,11.439248,11.455486,11.333705,11.410833,82635850,93646587.3,61.48894838710364,65.11765919463294,NaN,NaN,58.06413059939101,75.27213086004954,-0.014111362544375394,0.22522942224479792,0.2393407847891733,-4574323856,-4617963051,87.23925963056358,80.71034983142827,NaN,NaN,28.005262867729293,24.84087375699063
2012-02-01T09:30:00-05:00,11.512317,11.674691,11.512317,11.593504,87968448,92873676.4,66.2854348918486,65.134499228115,NaN,NaN,111.11496401409202,77.07624742875326,-0.00941682921782866,0.22756974826688747,0.23698657748471613,-4486355408,-4598328321.4,87.75253648265495,82.08411760208456,NaN,NaN,28.747249262968655,25.398927400701776
2012-02-02T09:30:00-05:00,11.634097,11.699047,11.569148,11.650334,65698813,92664869.55,67.63593208514206,65.19236933537697,NaN,NaN,118.77561035525193,82.62682780934867,-0.004514544484219257,0.23134339687944205,0.2358579413636613,-4420656595,-4544698474.6,89.04829442861849,83.31762247599906,NaN,NaN,29.75388843141141,26.021064690803154
2012-02-03T09:30:00-05:00,11.845183,11.966964,11.828946,11.962904,106898197,93510371.4,73.84221316069414,65.90780873040835,NaN,NaN,199.02441126573515,106.76776968081535,0.01659198784495619,0.25659792616985655,0.24000593832490036,-4313758398,-4490410792.6,90.18078342435638,84.43805593577845,NaN,NaN,32.71046212773398,26.976692896078987
2012-02-06T09:30:00-05:00,11.893896,11.918252,11.837065,11.906074,55314530,92079570.9,71.16994514106747,66.6425968746063,NaN,NaN,176.01827495627282,132.5994782381486,0.02313652782624312,0.26892659810770425,0.24579007028146113,-4369072928,-4432833437,91.21802416947772,85.5727818672947,NaN,NaN,34.305066676500296,28.023603436139172
2012-02-07T09:30:00-05:00,11.861421,11.942608,11.812709,11.902014,56222557,91429185.95,70.9723403377837,67.11083853843374,NaN,NaN,159.91935738893372,152.97052359605715,0.023525742809091033,0.2751972487928249,0.2516715059837339,-4425295485,-4403027762.8,91.70642503243211,86.65811267971205,NaN,NaN,35.530796673784685,29.096059612945673
2012-02-08T09:30:00-05:00,11.918252,11.99132,11.877658,11.99132,66180841,90433947.8,72.76372117854226,67.562646862952,NaN,NaN,157.67697922211107,162.28292663766095,0.02594129611219892,0.28409812612398255,0.25815683001178363,-4359114644,-4377579610,92.10989301285449,87.65486379584131,NaN,NaN,37.10267049380774,30.23986116735454
2012-02-09T09:30:00-05:00,12.040032,12.064388,11.877658,11.942608,95917070,91180477.15,70.21826285798302,67.73522821613588,NaN,NaN,135.50602938763475,165.6290104441375,0.02063317993607805,0.28394830493188117,0.2633151249958031,-4455031714,-4384454633.8,90.8243919959446,88.43739590201439,NaN,NaN,37.69988251929887,31.305578503346588
2012-02-10T09:30:00-05:00,11.812709,11.845183,11.763996,11.824887,79616923,90453141.95,64.35875194055393,67.43468992109419,NaN,NaN,77.14912197556708,141.25395258610388,0.006311257230788236,0.2712041965342884,0.26489293930350016,-4534648637,-4428632681.6,82.82520810780393,88.43403176464126,NaN,NaN,36.512257058072144,32.04938972545024
2012-02-13T09:30:00-05:00,11.958845,11.975083,11.897955,11.934489,57938044,88596769.9,67.11055325923208,67.38027258473747,NaN,NaN,101.98671549288757,126.44764069342682,0.0015832722336898142,0.2668720295956124,0.2652887573619226,-4476710593,-4450160214.6,79.16626414153036,87.9967148591728,NaN,NaN,36.27780102257434,32.653448482182256
2012-02-14T09:30:00-05:00,11.877658,11.885777,11.707165,11.820827,99263359,89106018.9,61.78314837707858,66.90841378188126,NaN,NaN,54.66920274689986,105.39760976502005,-0.011135365179471612,0.25136955088758306,0.26250491606705467,-4575973952,-4480295908,74.22311185917269,87.07236372076977,NaN,NaN,34.466040373513565,32.91239018094387
2012-02-15T09:30:00-05:00,11.853302,11.910133,11.715284,11.747759,93585248,87857492.9,58.56462363764202,66.52566906519074,NaN,NaN,43.684797012427815,82.59917332308339,-0.025579662737898246,0.2305303376446819,0.25611000038258014,-4669559200,-4542384819.2,65.19137056473365,85.45960480509173,NaN,NaN,31.973047479100703,32.77819836639485
2012-02-16T09:30:00-05:00,11.723403,11.934489,11.682809,11.93043,96136691,86091596.35,63.6612610489008,66.43278327300645,NaN,NaN,56.39422582238339,66.77681261003313,-0.023969409945022835,0.22614823795130157,0.2501176478963244,-4573422509,-4566062978.2,62.088510813765986,83.58637334868446,NaN,NaN,31.29846425137596,32.56680777853501
2012-02-17T09:30:00-05:00,11.966964,12.023795,11.942608,12.007557,75720753,84132817.75,65.58598860510659,66.81722320776278,NaN,NaN,94.36909596876066,70.22080740867185,-0.019061828508689788,0.22629036226046217,0.24535219076915196,-4497701756,-4558673602,62.685402221489696,81.87567684895706,NaN,NaN,31.32472424660576,32.38936727397369
2012-02-21T09:30:00-05:00,12.015676,12.072507,11.950726,11.995379,78536179,83090412.45,65.00056429465204,67.0680529154448,NaN,NaN,90.91351684073594,68.00616767824151,-0.018000599591050492,0.22285144128033885,0.24085204087138934,-4576237935,-4578579070.4,59.947337620241754,79.92625384821979,NaN,NaN,31.174904590269453,32.215872604873084
2012-02-22T09:30:00-05:00,11.942608,11.983201,11.837065,11.841124,91949381,83652876.9,57.945117872685195,66.47231598550455,NaN,NaN,47.15431770650509,66.50319067016257,-0.02843181650396298,0.2053122702414356,0.2337440867453986,-4668187316,-4597021743.2,57.443786430797616,77.76134313022999,NaN,NaN,28.88591234638135,31.740163996517122
2012-02-23T09:30:00-05:00,11.845183,11.950726,11.80459,11.950726,64009538,81662055.7,61.17017023503684,66.01047585335418,NaN,NaN,48.76263613506852,67.5187584946907,-0.02861591500753241,0.19797419298598307,0.22659010799351548,-4604177778,-4583945458.8,58.75889629385789,75.5978146920328,NaN,NaN,27.902581260091335,31.191937891313437
2012-02-24T09:30:00-05:00,11.975083,11.99132,11.877658,11.910133,63127525,79604593.3,59.35468505492083,64.97565241722751,NaN,NaN,55.13395622177155,67.26670457456832,-0.03188754002242092,0.18673068296548934,0.21861822298791025,-4667305303,-4602722017.6,56.079013809561665,73.16197400526174,NaN,NaN,26.55478711841015,30.52948778089868
2012-02-27T09:30:00-05:00,11.80459,12.031913,11.755878,11.999439,76191390,78233711.75,62.02501429015326,64.32244307073364,NaN,NaN,52.910088081492965,58.974902997114796,-0.028560333983743746,0.18291780550823056,0.2114781394919743,-4591113913,-4621404449,53.46611364755746,70.46540896798173,NaN,NaN,26.186894202633816,29.909117269717985
2012-02-28T09:30:00-05:00,12.019735,12.064388,11.942608,12.031913,64524438,77871788.75,62.9775030414248,63.75138326385087,NaN,NaN,96.8674187494776,60.165683378863136,-0.02483331681156309,0.18043649347752044,0.20526981028908353,-4526589475,-4611474757,54.674896573025926,67.82029979230985,NaN,NaN,26.154601193830075,29.372757830305428
2012-02-29T09:30:00-05:00,12.040032,12.145575,11.950726,11.983201,115694778,79524735.15,60.52515012303085,62.87719961702862,NaN,NaN,113.7715713570793,73.48913410897799,-0.02617558286772398,0.17255033170442857,0.19872591457215255,-4642284253,-4606294144.4,55.32690773466644,65.1929437010107,NaN,NaN,25.437153306821553,28.810528612664875
2012-03-01T09:30:00-05:00,12.015676,12.153694,12.007557,12.1131,81611430,79206884.25,64.4955549573697,62.46843476698482,NaN,NaN,163.44115078183128,96.42483703833054,-0.01916661743815226,0.17476764277446222,0.19393426021261448,-4560672823,-4597593153.4,56.45977538914449,62.73832822909641,NaN,NaN,25.954235476347943,28.40248673604817
2012-03-02T09:30:00-05:00,12.1131,12.145575,12.05627,12.068448,58881367,78866011.95,62.18036123423757,62.31283543081936,NaN,NaN,155.9142799638832,116.58090178675286,-0.018386435892034453,0.1709512153475714,0.18933765123960586,-4619554190,-4588042930.8,57.72692093675606,60.94559343116441,NaN,NaN,25.725548104679337,28.02006693156691
2012-03-05T09:30:00-05:00,12.040032,12.040032,11.958845,12.023795,63582967,76700250.45,59.865994577471085,61.79536695355073,NaN,NaN,66.37812738525828,119.27450964750592,-0.021509391229377756,0.16245091220288366,0.1839603034322614,-4683137157,-4606447579.6,54.43883340487015,59.17934837854582,NaN,NaN,24.881559221184375,27.571708687226547
2012-03-06T09:30:00-05:00,11.837065,11.869539,11.690928,11.727462,115453676,79707207.75,47.28725590787664,60.75994606289345,NaN,NaN,-147.2100771124068,70.45901047512905,-0.042927652045838705,0.13030073837496303,0.17322839042080174,-4798590833,-4660847851.2,46.083420765377966,57.16937044327478,NaN,NaN,19.91943441660016,26.478526648565634
2012-03-07T09:30:00-05:00,11.780234,11.893896,11.751818,11.877658,82940155,81043087.65,52.710785622947284,60.34181477612954,NaN,NaN,-74.58397497989492,32.78790120773421,-0.04609599686442775,0.11560839434026704,0.1617043912046948,-4715650678,-4675521136.2,44.116568303122996,55.66402742458831,NaN,NaN,17.46261709256258,25.190539569136625
2012-03-08T09:30:00-05:00,11.958845,12.015676,11.893896,11.99132,84346331,81951362.15,56.36926443291913,59.82095787498799,NaN,NaN,31.285721662456368,6.356815383859223,-0.03988601045314305,0.11184687813826599,0.15173288859140904,-4631304347,-4689647441,42.24713390766582,54.24678621700972,NaN,NaN,16.62943600474269,23.967524774223207
2012-03-09T09:30:00-05:00,12.031913,12.153694,12.007557,12.088744,91239829,81717500.1,59.27736651195621,59.37034201119154,NaN,NaN,115.16099605042466,-1.793841398832484,-0.02906876840377612,0.11539692808668889,0.144465696490465,-4540064518,-4673749506.6,45.06829815753852,52.9884216410132,NaN,NaN,16.892154522777066,22.956757595445186
2012-03-12T09:30:00-04:00,12.088744,12.096863,11.966964,12.05627,69333681,81203338,57.892232097531,58.862603997111464,NaN,NaN,73.29610305580152,-0.4102462647238383,-0.024154378772092394,0.11427272302534952,0.13842710179744191,-4609398199,-4659001715,47.624269038799845,52.10820245662449,NaN,NaN,16.674318054816315,22.059266232498203
2012-03-13T09:30:00-04:00,12.153694,12.535273,12.137456,12.519035,226725500,89642710.8,69.00654109980456,59.652705656191415,NaN,NaN,272.80582076953823,83.59293331166516,0.008462645622850373,0.14900540882600488,0.1405427632031545,-4382672699,-4575818088.2,59.16557253281136,52.2311871781969,NaN,NaN,20.63994106426137,21.856505494178656
2012-03-14T09:30:00-04:00,12.543391,12.583985,12.405374,12.535192,160643098,92711697.75,69.31111053852266,60.23420139215468,NaN,NaN,277.3314339090351,153.97601508945118,0.0282125391988525,0.17580843720172012,0.14759589800286763,-4222029601,-4477093872.8,68.13894088159792,52.901190363035475,NaN,NaN,23.722778978274942,22.123115991906698
2012-03-15T09:30:00-04:00,12.583985,12.778834,12.479254,12.754478,162956966,96180283.65,73.16541504591818,61.22068210579736,NaN,NaN,268.26785652119173,201.37244206119826,0.05176115854885943,0.21229734618894192,0.16053618764008248,-4059072635,-4362647530.4,74.99802651637293,54.252548413521986,NaN,NaN,27.745649102172017,22.926335007658885
2012-03-16T09:30:00-04:00,12.770715,12.795071,12.689528,12.762596,102244270,96485662.6,73.29910950864003,62.025974621403556,NaN,NaN,224.08728894077544,223.1577006392684,0.0628620654983032,0.23911376951296148,0.17625170401465828,-3956828365,-4246000299.8,79.77677015191637,56.131881020976195,NaN,NaN,30.860447823512594,24.059779695637985
2012-03-19T09:30:00-04:00,12.762596,12.965564,12.713884,12.827627,139132422,99656246.05,74.3994422445376,62.841827421625894,NaN,NaN,188.08962293769397,246.1164046156469,0.06906783891956145,0.2625865026641101,0.19351866374454865,-3817695943,-4087659848.6,84.1933128165362,58.240339324084076,NaN,NaN,33.73309310707097,25.441681611556984
2012-03-20T09:30:00-04:00,12.746359,12.92497,12.722003,12.888436,108895581,101174216.15,75.41949177182322,63.90570896796821,NaN,NaN,151.42680152220942,221.84060076618115,0.07145326283003015,0.28283524228208634,0.2113819794520562,-3708800362,-3952885381.2,86.8297951816407,60.490545570296526,NaN,NaN,36.400321707509065,27.007201625264425
2012-03-21T09:30:00-04:00,12.941208,12.949326,12.80319,12.831605,93405890,101247041.6,72.51157939367683,64.47828214199015,NaN,NaN,129.0220975249449,192.17873348936308,0.0636487514054824,0.2909429187089092,0.2272941673034268,-3802206252,-3868920711.4,88.1553011264003,62.754511694386224,NaN,NaN,37.743789869888985,28.540999945925076
2012-03-22T09:30:00-04:00,12.713884,12.754478,12.608341,12.661113,130539835,104573556.45,64.47958594762937,64.64251247866098,NaN,NaN,79.79278646305681,154.48371947773612,0.0424678634435679,0.2803789966078867,0.23791113316431878,-3932746087,-3843655401.8,88.52940134228264,64.95468886620957,NaN,NaN,36.447350039955005,29.670478530786493
2012-03-23T09:30:00-04:00,12.640816,12.786952,12.558817,12.770715,91024030,105968381.7,67.00949063032559,65.15276219672202,NaN,NaN,76.22576428943424,124.91141454746787,0.03179141083641951,0.27765039670984315,0.24585898587342364,-3841722057,-3820634140.2,88.87421447420397,67.41435894259054,NaN,NaN,36.12468816738089,30.592508478871405
2012-03-26T09:30:00-04:00,12.892496,12.973683,12.843783,12.971409,95062096,106911917,71.07241641649894,66.85170223305218,NaN,NaN,105.61042506357857,108.41557497264478,0.03399943166901831,0.2883582754596965,0.2543588437906782,-3746659961,-3806426943.8,89.09213661185746,70.48641007448194,NaN,NaN,37.148446747196076,31.529071088632072
2012-03-27T09:30:00-04:00,12.957445,12.998031,12.835665,12.851902,104621498,108916770,65.87026578682685,67.79166510190073,NaN,NaN,89.7696422807011,96.08414312434311,0.02365547138506363,0.28392818302200773,0.2602727116369441,-3851281459,-3834923163.2,85.4757317920083,73.44063603797375,NaN,NaN,36.325923270667985,32.21433568606577
2012-03-28T09:30:00-04:00,12.851902,12.916852,12.73824,12.884377,129786946,109621378.4,66.58599843669495,68.52143181645614,NaN,NaN,73.60856279914857,85.00143617918384,0.015631640578244455,0.27981226235974965,0.2641806217815052,-3721494513,-3818780815.4,85.82670394648721,76.55346246931812,NaN,NaN,35.88450715249265,32.73864589555533
2012-03-29T09:30:00-04:00,12.786952,12.819427,12.640816,12.754478,126659982,111873806,61.069265611186765,68.64942460925832,NaN,NaN,49.349303442914746,78.91273957515541,-0.0009153125665997686,0.2630364810732555,0.26395179363985527,-3848154495,-3801862497,86.20300723636896,79.49165597494888,NaN,NaN,33.79404180679378,32.889416740017964
2012-03-30T09:30:00-04:00,12.835665,12.842972,12.701706,12.823487,73733440,112616409.65,62.83109330347479,69.00220040968289,NaN,NaN,54.4403838481906,74.55566348690667,-0.009241044989073965,0.25240048740351284,0.2616415323925868,-3774421055,-3788402296.6,86.50988251481526,82.26919979466426,NaN,NaN,32.588749246660456,32.84646424096689
2012-04-02T09:30:00-04:00,12.770715,12.981477,12.746359,12.92497,110266875,114950605.05,65.31686601261693,68.73865218916949,NaN,NaN,68.11825116851296,67.05722870789354,-0.009883949857454055,0.24928659507076922,0.2591705449282233,-3664154180,-3771901140.4,86.89471478003048,84.24985281232277,NaN,NaN,32.30808840387045,32.76955340709597
2012-04-03T09:30:00-04:00,12.892496,12.916852,12.73824,12.851902,129139827,115634912.6,62.096767005703235,68.22334193682524,NaN,NaN,55.09086206987773,60.12147266572887,-0.016794614636476024,0.23817727663262822,0.25497189126910424,-3793294007,-3760303650,87.1717016150914,85.60933572185802,NaN,NaN,31.117224939451642,32.53350648314678
2012-04-04T09:30:00-04:00,12.705765,12.73824,12.592104,12.648853,104262544,116701032.05,54.113064686103606,66.86245976826706,NaN,NaN,4.149312959747403,46.22962269784863,-0.03552832687047819,0.2105614826810065,0.24608980955148468,-3897556551,-3795516057.6,81.53684419834063,86.07639412771286,NaN,NaN,27.521789513874957,31.817546916107947
2012-04-05T09:30:00-04:00,12.583985,12.697647,12.559629,12.6124,71696069,116068518.95,52.80058914695589,65.39827974243248,NaN,NaN,-20.85125979692077,32.189510049881584,-0.04997770028252524,0.18361768419832813,0.23359538448085337,-3969252620,-3819735682.6,77.81116298746201,85.93599361596613,NaN,NaN,24.212163696885405,30.731063599076155
2012-04-09T09:30:00-04:00,12.372899,12.486561,12.340424,12.421611,109245253,116968790.15,46.45044343177978,63.40192268437835,NaN,NaN,-118.34508793109607,-2.367584305975754,-0.07071972676625915,0.14519572602302944,0.2159154527892886,-4078497873,-3880551046.2,69.25404510212532,84.86890306493676,NaN,NaN,19.2372060872712,29.08908395453259
2012-04-10T09:30:00-04:00,12.405374,12.462204,12.137456,12.153694,145619687,120783090.45,39.30228253745403,60.82212202478055,NaN,NaN,-209.6651042607731,-57.92425539183296,-0.0990794791960262,0.09206610379425584,0.19114558299028203,-4224117560,-3992543722.2,56.854366439372576,82.7278010119176,NaN,NaN,12.276507622025784,26.687287335603045
2012-04-11T09:30:00-04:00,12.324187,12.393196,12.291712,12.344483,91501329,114021881.9,45.70945481249813,58.90768455469636,NaN,NaN,-162.3840091667188,-101.41922963915228,-0.10122784211030164,0.06461078035240497,0.16583862246270661,-4132616231,-4060408167,50.90632000551101,80.06715950328267,NaN,NaN,8.591612718498032,24.1021909617309
2012-04-12T09:30:00-04:00,12.381017,12.592104,12.340424,12.575866,107719216,111375687.8,52.287395658526314,58.036813819760425,NaN,NaN,-90.04609340819273,-120.25831091274031,-0.08401346016782757,0.06082179725292214,0.1448352574207497,-4024897015,-4085876259.8,48.84124395934447,77.23229111878709,NaN,NaN,7.78260211296538,21.77082112619297
2012-04-13T09:30:00-04:00,12.55151,12.55151,12.259237,12.283593,114119708,108933824.9,44.88885270579659,56.45676825372265,NaN,NaN,-129.25192078029838,-141.9384431094158,-0.08879231010889269,0.03384486978463386,0.12263717989352654,-4139016723,-4119829080.4,46.15323558673836,74.18079262682525,NaN,NaN,4.368143228887889,19.284724283720816
2012-04-16T09:30:00-04:00,12.397255,12.454086,12.267356,12.372899,138228021,110733012.45,47.34074032968996,54.76164853323629,NaN,NaN,-111.13448414316228,-140.49632235182906,-0.08255172052681392,0.019447529235009142,0.10199924976182306,-4000788702,-4104287246.2,47.57552853682327,71.21532062146568,NaN,NaN,2.5759270117147937,16.897753244862812
2012-04-17T09:30:00-04:00,12.486561,12.583985,12.421611,12.535273,81859174,107869350.05,51.56044260945009,53.7395183062808,NaN,NaN,-50.27171263779433,-108.61764402723331,-0.06488032062221842,0.020898848984050034,0.08577916960626845,-3918929528,-4043249639.8,52.84358184939612,68.88445276842194,NaN,NaN,2.571757593513238,14.851182437527159
2012-04-18T09:30:00-04:00,12.454086,12.559629,12.437848,12.454086,65448251,105696983.55,49.427729632535744,52.51392767741229,NaN,NaN,-54.34451140845006,-87.00974447557955,-0.056366292885123875,0.015321303499863603,0.07168759638498748,-3984377779,-4013601949.4,55.19855612418846,66.69672792397203,NaN,NaN,1.8695570432632171,12.996664524060883
2012-04-19T09:30:00-04:00,12.527154,12.527154,12.307949,12.393196,131363080,107594843.05,47.829796963996536,51.568251345470124,NaN,NaN,-72.66886352903039,-83.5342984997471,-0.05261447071186256,0.005919507995159279,0.05853397870702184,-4115740859,-4031770718.2,53.43735236189426,64.3563240043667,NaN,NaN,0.8062170324742497,11.255172025262793
2012-04-20T09:30:00-04:00,12.454086,12.456115,12.324187,12.328246,68931666,104514434.6,46.11714889975085,50.37439817377556,NaN,NaN,-77.77995917453602,-73.23990617859462,-0.05218336413820738,-0.006695226465737392,0.04548813767246999,-4184672525,-4040901878.6,52.530208496340094,61.92920443161847,NaN,NaN,-0.5800844819719422,9.564421095657831
2012-04-23T09:30:00-04:00,12.133397,12.2499,12.1131,12.243,91267537,104526609.95,43.89553066151765,48.844302791554185,NaN,NaN,-119.38279774487222,-74.88956889893662,-0.05503252395075607,-0.023302517265975098,0.03173000668478097,-4275940062,-4095932150.6,47.31695984066881,59.102221935949785,NaN,NaN,-2.397170979715656,7.855622227747333
2012-04-24T09:30:00-04:00,12.251118,12.381017,12.251118,12.381017,76196750,103583342.65,48.24284122426184,47.85473666430836,NaN,NaN,-70.0574858888678,-78.8467235491513,-0.04541478018852753,-0.025038468550878434,0.02037631163764909,-4199743312,-4152094907.4,42.66339114291181,55.923056902222676,NaN,NaN,-2.6547199373859693,6.354144775585433
2012-04-25T09:30:00-04:00,12.470323,12.519035,12.372899,12.486561,91439131,102924224.3,51.34750096316913,47.65719639838448,NaN,NaN,-23.11228089044757,-72.6002774455508,-0.030456042336907803,-0.017693741283485664,0.012762301053422138,-4108304181,-4176880187.8,40.75830124603238,53.01030383420066,NaN,NaN,-1.94141048309013,5.169065452917495
2012-04-26T09:30:00-04:00,12.445967,12.62263,12.437848,12.592104,58632322,99366493.1,54.29968446820312,47.76427463561642,NaN,NaN,19.664373725717756,-54.13362999460118,-0.012864482955185613,-0.003318302640559878,0.009546180314625735,-4049671859,-4163666387.8,42.23915514788864,50.46944613137399,NaN,NaN,-0.45311083164398264,4.365897412265856
2012-04-27T09:30:00-04:00,12.648935,12.657053,12.510917,12.600222,58458738,95956430.9,54.52823608287185,48.341259824980135,NaN,NaN,41.62571894508747,-30.25249437067647,-0.0007330157946512407,0.008629910571311683,0.009362926365962924,-3991213121,-4124974507,46.459463871702155,48.84126175777234,NaN,NaN,0.8200729969994256,3.859351067227794
2012-04-30T09:30:00-04:00,12.55151,12.571807,12.445967,12.527154,71061150,95822816.4,52.007131553250375,49.248749040394166,NaN,NaN,15.729641228427228,-3.2300065760165806,0.0021607896229212976,0.012063913394614545,0.009903123771693247,-4062274271,-4082241348.8,50.740333345189555,48.40454510818783,NaN,NaN,1.2113109477571438,3.48105962158913
2012-05-01T09:30:00-04:00,12.527154,12.754478,12.510917,12.657053,103888238,95503884.55,55.90990803594777,49.97735284206914,NaN,NaN,94.10421343378715,29.602333288514405,0.012060864456922785,0.024979204342846728,0.012918339885923943,-3958386033,-4033969893,55.10688956975078,48.70458579134782,NaN,NaN,2.6753382622996287,3.3659565702620586
2012-05-02T09:30:00-04:00,12.567748,12.592104,12.462204,12.55557,69642972,92529041.8,52.3296295813928,49.98036955084532,NaN,NaN,50.66386378257837,44.357562223119594,0.011039607106034223,0.026717848768466723,0.0156782416624325,-4028029005,-4017914857.8,56.488412400307276,49.25081210855945,NaN,NaN,2.9221945380324783,3.3025619942292614
2012-05-03T09:30:00-04:00,12.567748,12.575866,12.405374,12.454086,104454378,92538633.5,48.95363358589632,50.27071104228101,NaN,NaN,21.16828778943346,44.65834503586273,0.003201381005561006,0.019679967919383756,0.01647858691382275,-4132483383,-4034477162.6,54.621033376564164,49.85565480783272,NaN,NaN,2.167438710227523,3.140401525086156
2012-05-04T09:30:00-04:00,12.356661,12.393196,12.210525,12.259237,95146779,93711169,43.19203243447585,49.97437476405143,NaN,NaN,-99.21425259197599,16.490350728450046,-0.014464329053500874,-0.0016018244030533424,0.012862504650447531,-4227630162,-4081760570.8,49.58176199829463,49.99895719793783,NaN,NaN,-0.2628759036696147,2.6542190352639032
2012-05-07T09:30:00-04:00,12.17805,12.368839,12.17805,12.328246,101935117,93345662.2,45.632590444209036,49.550956752248496,NaN,NaN,-86.49519336065137,-3.9546161893656744,-0.020491881683959216,-0.01275234745450149,0.007739534229457726,-4125695045,-4094444725.6,48.294569276060486,49.674027728413854,NaN,NaN,-1.565246310860629,2.0514382715318273
2012-05-08T09:30:00-04:00,12.23894,12.307949,12.137456,12.247059,101027110,91116033.35,43.27698616383397,49.11161793305551,NaN,NaN,-124.22611061631513,-47.620680999386124,-0.02844734112911578,-0.027819642181937,0.0006276989471787819,-4226722155,-4148111950,43.18602527559742,48.81598981065735,NaN,NaN,-3.3558049127791376,1.2789749594874038
2012-05-09T09:30:00-04:00,12.096863,12.202406,12.015676,12.1131,116191784,92350556.1,39.64084909293344,48.52669308512243,NaN,NaN,-174.67693059740992,-92.68883987538378,-0.040497085396323344,-0.0499936577982254,-0.009496572401902055,-4342913939,-4211088936.8,38.09376942096711,47.72001960059112,NaN,NaN,-6.005035647753933,0.23840201559578444
2012-05-10T09:30:00-04:00,12.267356,12.291712,12.133397,12.161813,79975109,90963350.75,41.563605696668915,48.201439999188004,NaN,NaN,-110.62143282451525,-119.04678399817354,-0.04273137923053145,-0.06291079644006636,-0.020179417209534915,-4262938830,-4237180026.2,36.18984908612892,46.55285107129032,NaN,NaN,-7.6472935529300266,-0.8881259227650458
2012-05-11T09:30:00-04:00,11.902014,12.137456,11.885777,12.023795,123125308,91413630.75,37.88159548443744,47.77187320082514,NaN,NaN,-174.86585246075188,-134.17710397192872,-0.0505157562408273,-0.08332411251056904,-0.03280835626974174,-4386064138,-4268866821.4,33.969339206393755,45.59944959741353,NaN,NaN,-10.183975903104804,-2.2161044913850114
2012-05-14T09:30:00-04:00,11.853302,11.910133,11.772115,11.776174,112947264,90149592.9,32.34529867776389,46.63633444750385,NaN,NaN,-211.77803007195544,-159.2336713141895,-0.06825021973760823,-0.11812113094175203,-0.0498709112041438,-4499011402,-4343530092.8,29.392954173678348,44.65156124246829,NaN,NaN,-14.293013993855046,-3.941377277452159
2012-05-15T09:30:00-04:00,11.788352,11.861421,11.690928,11.715284,122218759,92167572.15,31.14011163905768,45.192949495781605,NaN,NaN,-194.11001492566126,-173.21045217605874,-0.07921924255888209,-0.1488949644027464,-0.06967572184386432,-4621230161,-4422431694,25.485513978458698,43.56064786621302,NaN,NaN,-18.01201629607118,-5.951468565826305
2012-05-16T09:30:00-04:00,11.796471,11.853302,11.536673,11.544791,143309584,96060638.8,27.994785443565732,43.31402813687894,NaN,NaN,-189.8924032951812,-176.253546715613,-0.09218685466058117,-0.1849092901695908,-0.09272243550900962,-4764539745,-4506756855.2,22.103562145920222,42.122391223215274,NaN,NaN,-22.250730507253763,-8.2799345574588
2012-05-17T09:30:00-04:00,11.528554,11.544791,11.30123,11.309349,190136194,98999294.5,24.338783168390435,41.15763864298741,NaN,NaN,-211.2239508478593,-196.3740503202818,-0.10966214110784651,-0.22980011189381777,-0.12013797078597126,-4954675939,-4645104277,17.9054202517639,40.08281667893397,NaN,NaN,-27.2294761524271,-10.987011928168558
2012-05-18T09:30:00-04:00,11.349943,11.349943,11.138856,11.180262,151457588,103125590.6,22.59636962868676,39.05686993409001,NaN,NaN,-196.53949950552013,-200.70877972923546,-0.12200939727735904,-0.2726497173826701,-0.15064032010531103,-5106133527,-4789118154.8,14.762265200405068,37.51295466859222,NaN,NaN,-31.91695458945515,-13.977003736923784
2012-05-21T09:30:00-04:00,11.228162,11.358061,11.122619,11.284993,106622528,103893340.15,27.15297701362944,37.00280343249584,NaN,NaN,-154.30232561265126,-189.21363883737462,-0.11529543722907451,-0.2947596166416542,-0.17946417941257967,-4999510999,-4889218074.2,13.047786148230372,34.50873299562648,NaN,NaN,-34.29471738208149,-16.8795342576606
2012-05-22T09:30:00-04:00,11.358061,11.561029,11.293112,11.374299,121518154,106159410.35,30.88906519008009,35.47133454740207,NaN,NaN,-108.70624034372773,-172.13288392098792,-0.09770783885369566,-0.30159897797969926,-0.2038911391260036,-4877992845,-4940570611,12.261066007441926,31.349636824707527,NaN,NaN,-35.07022680751764,-19.47820462192589
2012-05-23T09:30:00-04:00,11.268756,11.439248,11.163212,11.414892,137096845,108442296.05,32.581605077524316,34.301903939661216,NaN,NaN,-105.13745429603061,-155.18189412115782,-0.07711287952977988,-0.30028223853822844,-0.22316935900844856,-4740896000,-4935841862,12.78256776741597,28.36117499548266,NaN,NaN,-35.18719900037261,-21.722346675989705
2012-05-24T09:30:00-04:00,11.471723,11.487961,11.30123,11.423011,99940946,110507727.25,32.935375660463095,33.56928559866031,NaN,NaN,-84.23585839045202,-129.78427562967636,-0.057609245388935665,-0.29518091574461813,-0.23757167035568247,-4640955054,-4873097685,19.6102884093671,26.22035545341641,NaN,NaN,-35.18060552467649,-23.64495508294496
2012-05-25T09:30:00-04:00,11.406774,11.475782,11.349943,11.382417,51423168,110155948.75,32.03037413886648,32.59769871970726,NaN,NaN,-76.08339455916372,-105.69305464040508,-0.042789492194404866,-0.29105853559868855,-0.24826904340428368,-4692378222,-4790346624,27.654255153940113,24.74604730183639,NaN,NaN,-35.421369600723644,-25.327300014056203
2012-05-29T09:30:00-04:00,11.496079,11.55291,11.439248,11.544791,90379238,111121853.15,39.22415226222797,32.308210583878264,NaN,NaN,-53.56146317690007,-85.54488215325485,-0.01863191128822994,-0.2715589325145711,-0.25292702122634114,-4601998984,-4710844221,34.44145264045379,24.121434970754702,NaN,NaN,-33.53873387294054,-26.50036199389682
2012-05-30T09:30:00-04:00,11.414892,11.43113,11.275656,11.275656,104923438,111173613.15,32.99138293715828,31.833248715608615,NaN,NaN,-76.88729583482368,-79.18109325147404,-0.017383371587413987,-0.2746562357106086,-0.2572728641231946,-4706922422,-4676630136.4,37.17314728229029,24.055676246563504,NaN,NaN,-33.72328035858995,-27.53220747456727
2012-05-31T09:30:00-04:00,11.30123,11.471723,11.187569,11.374299,110425698,113212749.45,36.946141123064855,31.503429817494037,NaN,NaN,-68.13002176076087,-71.77960674442008,-0.007048872622792246,-0.2660839549016849,-0.25903508227889266,-4596496724,-4647750281.2,39.466004133482436,24.289687321374466,NaN,NaN,-32.632368467394166,-28.26080190211397
2012-06-01T09:30:00-04:00,11.155094,11.171331,10.944008,10.952126,124082131,114194137.1,29.045290236698122,30.87226515694122,NaN,NaN,-118.76576761770501,-78.68558858987068,-0.02478241652088775,-0.2900131029300024,-0.2652306864091146,-4720578855,-4663675041.4,38.62884893675851,24.62250944497195,NaN,NaN,-34.38172993693493,-29.135220192802677
2012-06-04T09:30:00-04:00,11.000839,11.000839,10.797871,10.846583,97069806,114290288.45,27.464066635082887,30.523605725321154,NaN,NaN,-135.21003881712895,-90.51091744146372,-0.03891577320774686,-0.31387540291879823,-0.27495962971105137,-4817648661,-4688729129.2,37.28870782159216,25.186491848394365,NaN,NaN,-36.31028498422977,-30.160229448720834
2012-06-05T09:30:00-04:00,10.822227,11.049551,10.814108,11.025195,123967886,115391926.9,34.01123419135851,30.728685907628364,NaN,NaN,-114.85195592785969,-102.76901599165565,-0.031828903204929926,-0.3147457587172138,-0.28291685551228385,-4693680775,-4707065487.4,36.29623301513979,25.958686065300157,NaN,NaN,-35.653768007937984,-30.945020671466143
2012-06-06T09:30:00-04:00,11.138856,11.358061,11.090144,11.345883,120107977,116345970.25,43.816623601807855,31.858817204645653,NaN,NaN,-47.292722044072384,-96.8501012335054,-0.002673608739886979,-0.2862588664371426,-0.2835852576972556,-4573572798,-4680395562.6,38.845774133048444,27.154558350095034,NaN,NaN,-31.505091072370984,-31.025030728738262
2012-06-07T09:30:00-04:00,11.520435,11.561029,11.309349,11.341824,114346503,116253706.2,43.728055765756324,33.24376524731464,NaN,NaN,-6.873764909327725,-84.59884986321876,0.01806687675229146,-0.2610016617568913,-0.2790685385091828,-4687919301,-4698680078,37.73086364905892,28.570661449901824,NaN,NaN,-28.402035918682778,-30.65031718444462
2012-06-08T09:30:00-04:00,11.30123,11.479842,11.220043,11.477406,74662514,115988076.45,47.54234535544561,35.025620656368844,NaN,NaN,1.4415155361769236,-60.55739323244238,0.04131625680718126,-0.22742321750020622,-0.2687394743073875,-4613256787,-4677215664.4,39.91113465302303,30.367009267945967,NaN,NaN,-24.589553271949452,-29.78449376837388
2012-06-11T09:30:00-04:00,11.625978,11.634097,11.252518,11.268756,126907332,116177177.65,42.74095515453481,36.13904766643351,NaN,NaN,11.855161788414819,-31.144353111333622,0.04285714229039378,-0.21516804644439524,-0.258025188734789,-4740164119,-4661718756,41.5036267964361,32.39956931424638,NaN,NaN,-22.92262842849338,-28.804227291248097
2012-06-12T09:30:00-04:00,11.293112,11.447367,11.195687,11.435189,105272085,115793418.7,47.31188733034615,37.312106390738236,NaN,NaN,12.184490106007457,-5.7370639045601965,0.05455002887761498,-0.1898376526377703,-0.24438768151538529,-4634892034,-4649961007.8,42.74348488356437,34.57688494825512,NaN,NaN,-20.018988628691144,-27.549193196597102
2012-06-13T09:30:00-04:00,11.382417,11.548851,11.341824,11.398655,118560005,115610481,46.435584804087135,38.30167637120701,NaN,NaN,57.77882677188385,15.277245858631066,0.058915822321174816,-0.17074290361391675,-0.22965872593509157,-4753452039,-4685936856,39.953094111206845,36.51763682995447,NaN,NaN,-17.993299948721234,-26.184065589757694
2012-06-14T09:30:00-04:00,11.423011,11.593504,11.390536,11.532613,127633813,114826692.45,50.086156776652075,39.5267321652205,NaN,NaN,103.7213202284189,37.396262886180395,0.06920639368831397,-0.14315073382469912,-0.21235712751301308,-4625818226,-4673516641,41.37599080588615,38.072329858277264,NaN,NaN,-15.151721900029324,-24.60801649122507
2012-06-15T09:30:00-04:00,11.544791,11.650334,11.463604,11.642216,104565391,110548152.3,52.91375116389547,41.01840195272258,NaN,NaN,134.41848260354246,63.991656299653506,0.08095903774799257,-0.11115833032802236,-0.19211736807601493,-4521252835,-4655115850.6,43.511658170486996,39.20500150231633,NaN,NaN,-11.910270765074076,-22.794052816060642
2012-06-18T09:30:00-04:00,11.569148,11.674691,11.520435,11.577266,83730153,107161780.55,51.06753564099862,41.86435790834906,NaN,NaN,127.26252280061944,87.07312850209442,0.08168790092864761,-0.0900074919152054,-0.17169539284385302,-4604982988,-4628079624.4,46.590389442439445,40.072782702458156,NaN,NaN,-9.782513353788765,-20.935261464307516
2012-06-19T09:30:00-04:00,11.650334,11.828946,11.642216,11.772115,79651333,105813220.8,56.02462869847507,43.509589748443105,NaN,NaN,182.11269255239023,121.05876899137097,0.0918626456003209,-0.0568670858434519,-0.1487297314437728,-4525331655,-4606167548.6,49.01572235655705,40.91868092204864,NaN,NaN,-6.386233921786324,-18.85682895823306
2012-06-20T09:30:00-04:00,11.796471,11.877658,11.682809,11.796471,108503361,105162481.15,56.61625771037037,44.91459807610779,NaN,NaN,172.68128046105008,144.03925972920422,0.09633467035628078,-0.028311393498421822,-0.1246460638547026,-4416828294,-4538842799.6,55.67565958290394,42.076513454150174,NaN,NaN,-3.463854232161917,-16.657832568794326
2012-06-21T09:30:00-04:00,11.820827,11.877658,11.512317,11.532613,88892320,102752254.9,48.935364008435506,46.33531763123189,NaN,NaN,99.14067539663839,143.12313076284812,0.07838519946195208,-0.026664564527262513,-0.10504976398921459,-4505720614,-4514823277.2,57.79393783592163,43.44544837551897,NaN,NaN,-3.17533674527267,-14.731761736862662
2012-06-22T09:30:00-04:00,11.61786,11.682809,11.577266,11.638156,55292261,100519820.65,51.75483875671894,48.070372782777326,NaN,NaN,85.23929340824876,133.28729292378938,0.07071896350159104,-0.016651059612225794,-0.08737002311381684,-4450428353,-4500658380.8,59.03720378446416,44.998912372866975,NaN,NaN,-2.075148037223571,-12.923674065485649
2012-06-25T09:30:00-04:00,11.471723,11.479842,11.341824,11.398655,62814430,101089383.75,45.601764001816235,48.898267769238586,NaN,NaN,-0.8975181557581366,107.65528473251386,0.04771885191827485,-0.02772145821597327,-0.07544031013424812,-4513242783,-4482310339.8,60.65398387734075,46.73875172016704,NaN,NaN,-3.075366600472341,-11.516772999055176
2012-06-26T09:30:00-04:00,11.443308,11.520435,11.358061,11.455486,65866486,99863746.15,47.20571391835364,49.140345648991854,NaN,NaN,15.149573992972542,74.26266102063032,0.03511592305446713,-0.031545406316164204,-0.06666132937063134,-4447376297,-4466719268.2,62.025571484574044,48.394451530990295,NaN,NaN,-3.3950490817321697,-10.35652672515189
2012-06-27T09:30:00-04:00,11.512317,11.634097,11.447367,11.593504,69336972,98084422.85,50.985487531727934,49.65873363227554,NaN,NaN,53.76981921935594,50.4803687722915,0.03479154162924182,-0.023171902334079064,-0.057963443963320885,-4378039325,-4458961474.4,62.72191467710771,50.17952660442235,NaN,NaN,-2.5130747821492836,-9.23603359043723
2012-06-28T09:30:00-04:00,11.471723,11.593504,11.382417,11.585385,86012233,96863749.6,50.755284188686055,49.888229263221284,NaN,NaN,35.8408829789226,37.82041028874834,0.032774701575552456,-0.016995066993880314,-0.04976976856943277,-4464051558,-4450627663.2,63.49630343934235,51.86418151773088,NaN,NaN,-1.8712383545816231,-8.183919985315
2012-06-29T09:30:00-04:00,11.869539,11.893896,11.780234,11.881717,76439173,94481601.7,58.17753129042133,50.99084184435604,NaN,NaN,146.94813851880167,50.16217931085892,0.04915743872261893,0.01167702983384089,-0.03748040888877804,-4387612385,-4438064469.6,64.68721229776418,53.520151910682884,NaN,NaN,1.0558984495855377,-6.863945923186352
2012-07-02T09:30:00-04:00,11.942608,11.975083,11.812709,11.954786,75615849,93408903.85,59.786996452204235,51.8819210673459,NaN,NaN,160.9362476162743,82.5289324652654,0.0618537014243363,0.03983671789164234,-0.022016983532693962,-4311996536,-4397815220.2,68.25988027553299,55.342751581537776,NaN,NaN,3.9452615223176495,-5.319773430971495
2012-07-03T09:30:00-04:00,11.934489,12.05627,11.910133,12.023795,39760217,89198520.4,61.30167789426555,52.9437848595015,NaN,NaN,176.53157311361724,114.80533228939434,0.07117371747981857,0.06695016331707926,-0.004223554162739316,-4272236319,-4362787224.6,71.00884031129834,57.56101916725861,NaN,NaN,6.785923149095508,-3.5903882052476375
2012-07-05T09:30:00-04:00,11.966964,11.966964,11.824887,11.845183,54106751,85898459.1,55.47717685135315,53.32885772198016,NaN,NaN,113.03519806979745,126.65840805948264,0.06192418387269141,0.07318167567812495,0.011257491805433537,-4326343070,-4352447973.6,71.78560431870682,59.733134418174366,NaN,NaN,7.51068725095693,-2.0045202829326993
2012-07-06T09:30:00-04:00,11.690928,11.788352,11.682809,11.747759,55180203,82940144.1,52.544567636066176,53.30248746999234,NaN,NaN,49.8080469904487,129.45184086178784,0.04656058287382249,0.06945822039771166,0.022897637523889163,-4381523273,-4335942316.6,73.0280140681003,61.841445553718174,NaN,NaN,7.236834412639799,-0.684326754993771
2012-07-09T09:30:00-04:00,11.715284,11.772115,11.666572,11.731521,45938389,81503937.85,52.05069198649893,53.37271292324236,NaN,NaN,37.696624782768744,107.60153811458129,0.03324516810258091,0.0644540976521153,0.031208929549534387,-4427461662,-4343912172,71.39325560587642,63.61307885110653,NaN,NaN,6.872766571194293,0.39525800589023796
2012-07-10T09:30:00-04:00,11.816768,11.853302,11.593504,11.642216,79180420,79117592.25,49.30585710004458,52.89280066621161,NaN,NaN,20.656319706172514,79.54555253256092,0.017172795118765703,0.05267492344799152,0.035502128329225814,-4506642082,-4382841281.2,63.87210879452441,64.67424931096134,NaN,NaN,5.77898776903264,1.164362257767724
2012-07-11T09:30:00-04:00,11.650334,11.780234,11.634097,11.73964,98045785,78756277.25,52.26330389557545,52.58187539372626,NaN,NaN,24.155523310334512,49.070342571904376,0.012092422761848645,0.050617656781536624,0.03852523401968798,-4408596297,-4410113276.8,59.16936896858086,64.92379998136684,NaN,NaN,5.666410567408488,1.807512016287833
2012-07-12T09:30:00-04:00,11.634909,11.690928,11.569148,11.61786,66902021,76173378.05,48.45775633595211,52.54776055997745,NaN,NaN,-27.40490693947314,20.98232157005027,0.00015129670429062797,0.03871435490005126,0.038563058195760634,-4475498318,-4439944326.4,54.44709969805723,64.68474011437652,NaN,NaN,4.470433298451208,2.1879293423111723
2012-07-13T09:30:00-04:00,11.674691,11.958845,11.674691,11.938548,96025678,74592971.3,57.27939239574647,52.9423715341937,NaN,NaN,85.73885335094366,28.168482842149256,0.012772885940050868,0.054529165620824216,0.04175627968077335,-4379472640,-4439534199.8,54.50086363338613,64.36071581787095,NaN,NaN,6.130724545023638,2.7511857998415246
2012-07-16T09:30:00-04:00,11.950726,11.966964,11.861421,11.918252,61578863,72443644.9,56.61891225002734,53.72931069478021,NaN,NaN,104.72018089195204,41.573194063985916,0.018338350428915885,0.0646792177169182,0.04634086728800232,-4441051503,-4442252168,54.04561713500522,63.88868962198984,NaN,NaN,7.256349342654154,3.3947805916719003
2012-07-17T09:30:00-04:00,11.999439,11.999439,11.796471,11.983201,77811452,72147709.85,58.27691216777417,54.520110569738826,NaN,NaN,99.38645959264035,57.319222041279474,0.024587761723323207,0.07707556944215632,0.052487807718833115,-4363240051,-4413571761.8,58.02955380527186,63.60325978775398,NaN,NaN,8.678250929750385,4.149562068540256
2012-07-18T09:30:00-04:00,11.942608,11.999439,11.885777,11.92637,68232303,71576758.35,56.251039557986594,54.8962214287573,NaN,NaN,93.38421638224865,71.16496065566231,0.023110497576199575,0.08137592968908258,0.05826543211288301,-4431472354,-4418146973.2,57.177975066445114,63.20726410127808,NaN,NaN,9.287645255739797,4.8835739524259045
2012-07-19T09:30:00-04:00,11.942608,11.975083,11.80459,11.849243,61082035,69205692.05,53.531288694570314,55.09450746489188,NaN,NaN,60.544643917895456,88.75487082713603,0.015519826776968976,0.07766521558409423,0.06214538880712525,-4492554389,-4421558187.4,56.51208972530818,62.70839169313278,NaN,NaN,9.035196016568861,5.476662818732041
2012-07-20T09:30:00-04:00,11.763996,11.772115,11.658453,11.670631,69181125,68220132.3,47.77091086202309,54.35117743429201,NaN,NaN,-21.141740397908208,67.37875207736565,-0.0020166018062503857,0.05962463654931227,0.06164123835556266,-4561735514,-4458010762.2,49.83334796745394,61.647401383824906,NaN,NaN,7.090573487871526,5.707221485751968
2012-07-23T09:30:00-04:00,11.455486,11.609741,11.439248,11.577266,72875982,69099318.35,45.04241623528104,53.29799313308321,NaN,NaN,-89.7905055973986,28.476614779495527,-0.01942268949232185,0.037362876490160346,0.056785565982482196,-4634611496,-4496722760.8,43.89975865499427,59.90739269664357,NaN,NaN,4.6277895604706805,5.5530169249974985
2012-07-24T09:30:00-04:00,11.605682,11.609741,11.439248,11.540732,55650367,68741115.2,43.98377242555512,52.060999885318175,NaN,NaN,-101.85581954088993,-11.771841047210529,-0.032163536259902786,0.016581145657603713,0.0487446819175065,-4690261863,-4562127123.2,36.08271654961485,57.41266957080903,NaN,NaN,2.2856944460043067,5.086256570855614
2012-07-25T09:30:00-04:00,11.609741,11.650334,11.520435,11.585385,55310490,68213315.4,45.6646975658039,51.360108507778946,NaN,NaN,-82.88224494239489,-47.02513331213924,-0.036057932282186234,0.0036722665647737074,0.03973019884695994,-4634951373,-4602822927,32.23632539363551,54.587721076161074,NaN,NaN,0.7772015758890836,4.470677285860395
2012-07-26T09:30:00-04:00,11.763996,11.795659,11.690928,11.759937,69336440,68213288.8,51.75882164968761,51.3039837944662,NaN,NaN,-8.049893746806598,-60.744040845079645,-0.025831359653185705,0.007440999280477811,0.033272358933663516,-4565614933,-4617435035.8,30.960164505747315,51.582874678850146,NaN,NaN,1.1776709271204913,4.0002478060404085
2012-07-27T09:30:00-04:00,11.845183,12.05627,11.788352,11.983201,85480897,68186722,58.21439028620307,51.744247958730774,NaN,NaN,84.29248084671801,-39.65719659615441,-0.004122570344321799,0.028119146003261264,0.03224171634758306,-4480134036,-4601114740.2,34.09819400760212,48.91894170754483,NaN,NaN,3.565464060649777,3.9381358424131756
2012-07-30T09:30:00-04:00,11.958845,12.031913,11.92637,11.958845,45267858,66628156.25,57.31334973874579,52.316211718638,NaN,NaN,92.54163532287559,-3.190768412099561,0.007851905581529137,0.04205659832449449,0.03420469274296535,-4525401894,-4579272819.8,38.14996338881226,47.08164560713682,NaN,NaN,5.224876212333044,4.121955895258871
2012-07-31T09:30:00-04:00,11.918252,11.954786,11.877658,11.902014,57498919,65722309.75,55.16768075035813,52.523667208265344,NaN,NaN,61.54160799260296,29.488717094599018,0.011007005935402062,0.047963450162217924,0.03695644422681586,-4582900813,-4557800609.8,41.929786155283914,45.850246834758465,NaN,NaN,5.990711339950798,4.388920958786289
2012-08-01T09:30:00-04:00,11.950726,11.99132,11.845183,11.845183,99713402,68719969,53.02966689732711,52.850232248363554,NaN,NaN,57.437343966892165,57.55263487645643,0.00844380977333642,0.04751120644348639,0.03906739667014997,-4682614215,-4567333178.2,40.739463635820925,44.87112997317016,NaN,NaN,6.028982218702073,4.623215424488544
2012-08-02T09:30:00-04:00,11.73964,11.837065,11.642216,11.755878,78140589,69921660.9,49.76580353550908,52.313547329775176,NaN,NaN,-18.79698744179667,55.403216137458415,0.00033920314989353134,0.03949140060751688,0.03915219745762335,-4760754804,-4606361152.4,36.207454668254606,43.5644579042322,NaN,NaN,5.130179030311876,4.69563879674902
2012-08-03T09:30:00-04:00,11.934489,12.096863,11.918252,12.031913,98913392,72108320.35,58.307498919457466,52.434160663305896,NaN,NaN,112.63657062484641,61.0720340930841,0.012500576862201636,0.05477791853537539,0.042277341673173756,-4661841412,-4642702627.6,32.57371377603555,42.030750521448645,NaN,NaN,6.971764620830786,5.0207996287607015
2012-08-06T09:30:00-04:00,12.104982,12.169931,12.064388,12.080626,50887181,72355759.95,59.6126342746368,52.529569385224654,NaN,NaN,137.54793920564964,70.0732948696389,0.02219110480832419,0.07001622268357899,0.0478251178752548,-4610954231,-4659813095,30.99642376029159,40.09981266109292,NaN,NaN,8.868873685960947,5.5705244940750225
2012-08-07T09:30:00-04:00,12.1131,12.226762,12.104982,12.129338,43974252,70595451.55,60.929737176173454,52.863762072237996,NaN,NaN,142.94303860851977,86.35358099282226,0.02977431917434438,0.08504301684318527,0.05526869766884089,-4566979979,-4656628928.2,31.659617326941373,38.27707282255694,NaN,NaN,10.823924045445333,6.321010144270781
2012-08-08T09:30:00-04:00,12.080626,12.17805,12.072507,12.129338,32407947,67313559.65,60.929737176173454,53.392222678066794,NaN,NaN,119.5491796230314,98.77594812405012,0.03246263785006029,0.09584699498141624,0.06338435713135596,-4566979979,-4633502081,36.43790418414058,36.843202426759255,NaN,NaN,12.410961344569658,7.191003172884907
2012-08-09T09:30:00-04:00,12.1131,12.186169,12.088744,12.121219,32572288,65597073,60.54804762579352,54.30487530405039,NaN,NaN,114.54011508923546,125.44336863025656,0.03134988009905208,0.10257170725517106,0.07122182715611898,-4599552267,-4601261573.6,42.47617628059343,36.317690163412074,NaN,NaN,13.626577125432924,8.110370880391766
2012-08-10T09:30:00-04:00,12.080626,12.153694,12.048151,12.129338,21717486,61881663.4,60.81241880424392,55.431304058976316,NaN,NaN,94.68447591240627,121.85294968776853,0.028877832389810135,0.10731911764338165,0.07844128525357151,-4577834781,-4584460247.4,45.3877699134846,36.423976681875665,NaN,NaN,14.716907489653904,9.054161824572072
2012-08-13T09:30:00-04:00,12.104982,12.153694,12.05627,12.137456,20188620,59812151.25,61.09315782387698,56.6534030159993,NaN,NaN,88.07510959771075,111.95838376618073,0.025617514655287818,0.11046317857268129,0.08484566391739347,-4557646161,-4573798633.4,47.21363565419919,37.21904233220312,NaN,NaN,15.71384169597986,10.005544663344613
2012-08-14T09:30:00-04:00,12.210525,12.226762,12.096863,12.121219,28355633,57339360.3,60.16475195203022,57.68912118644404,NaN,NaN,91.6994190010766,101.7096598446921,0.020421369083241894,0.11037237527144583,0.08995100618820394,-4586001794,-4577602996.4,46.61474720137494,38.24607246132736,NaN,NaN,16.347897199138036,10.911595025600816
2012-08-15T09:30:00-04:00,12.129338,12.202406,12.106605,12.161813,24660637,55160777,61.73055872220319,58.40138812019516,NaN,NaN,85.7912738552451,94.95807869113483,0.017864551884428356,0.11228169604373939,0.09441714415931103,-4561341157,-4576475232,46.830057992740464,39.379636281826876,NaN,NaN,17.291863694782773,11.823061978341096
2012-08-16T09:30:00-04:00,12.202406,12.275474,12.129338,12.243,40129794,54113164.95,64.71758012481746,58.86590168009618,NaN,NaN,96.71837379382757,91.39373043205326,0.019645880660147774,0.11897449498449575,0.09932861432434797,-4521211363,-4560807051.2,49.85591947069951,40.50518810061954,NaN,NaN,18.915567376444287,12.83627703521298
2012-08-17T09:30:00-04:00,12.283593,12.291712,12.243,12.283593,29759010,52142059.2,66.14061208489092,59.49642041910655,NaN,NaN,107.45910456561347,93.94865616269469,0.021417503909930025,0.1261004942117605,0.10468299030183048,-4491452353,-4543530565.6,53.030047829534915,41.56805127495688,NaN,NaN,20.702954948963605,13.960088165748783
2012-08-20T09:30:00-04:00,12.275474,12.324187,12.251118,12.316068,31710318,50083776,67.2776715660421,60.36141976308398,NaN,NaN,110.24477464634543,98.38258917242163,0.022523285887261407,0.13283709766090723,0.11031381177364583,-4459742035,-4523949740.4,56.39876013907622,42.601549416656326,NaN,NaN,22.55094690066732,15.187353699308574
2012-08-21T09:30:00-04:00,12.36478,12.486561,12.307949,12.356661,50896483,49846081.8,68.69292197434909,61.48022369715697,NaN,NaN,138.51157977090242,107.74502132638679,0.02362050120638301,0.1398394382816246,0.11621893707524159,-4408845552,-4488518492,61.74525619755504,44.101963171065904,NaN,NaN,24.53965319710067,16.523396484707444
2012-08-22T09:30:00-04:00,12.316068,12.389136,12.267356,12.340424,57746880,49967901.3,67.43653432678103,62.7424187536764,NaN,NaN,116.40621270498231,113.86800909633423,0.02097423553506894,0.14243673149407776,0.12146249595900882,-4466592432,-4469568747,64.26884757157868,46.10634837844619,NaN,NaN,25.942662594715177,17.869005928994262
2012-08-23T09:30:00-04:00,12.316068,12.328246,12.202406,12.218643,50241974,49013178,58.75642039223859,62.77448457316076,NaN,NaN,74.38385831131833,109.40110599983238,0.009336974086057645,0.13313371356658088,0.12379673948052324,-4516834406,-4468693355.6,64.38572789318428,48.378635101099675,NaN,NaN,24.918215080000433,18.876035807709428
2012-08-24T09:30:00-04:00,12.169931,12.320127,12.153694,12.283593,34018510,46440058.65,61.595615844776496,62.91612611388503,NaN,NaN,70.04186862851009,101.9176588124117,0.004569830472655884,0.12950902757134308,0.1249391970986872,-4482815896,-4466966064.2,64.63157107124596,50.78114562331071,NaN,NaN,24.786162111567663,19.72033956540346
2012-08-27T09:30:00-04:00,12.324187,12.332305,12.243,12.275474,22614044,45307367.95,61.03004024469653,62.923290618779525,NaN,NaN,80.25594546120512,95.91989297538365,-0.00031486327766014344,0.12454561800161201,0.12486048127927216,-4505429940,-4476103645.2,62.186017687597975,52.96160279192903,NaN,NaN,24.52411146297518,20.406592693627992
2012-08-28T09:30:00-04:00,12.234881,12.332305,12.218643,12.259237,27839452,43824394.6,59.846541360842025,62.845919489113,NaN,NaN,65.43201904523649,81.30398083025045,-0.005534525616276459,0.11794232425892659,0.12347684987520305,-4533269392,-4500988413.2,55.97434588589177,54.35706291348269,NaN,NaN,23.990873760901334,20.918632846095612
2012-08-29T09:30:00-04:00,12.283593,12.316068,12.243,12.283593,22840208,39980734.9,61.06619333307846,62.88292989677621,NaN,NaN,64.71069170922448,70.96487663109889,-0.008087351720996436,0.1133676602239575,0.12145501194495394,-4510429184,-4509755763.6,53.930402473272046,55.17522192724545,NaN,NaN,23.83845597702914,21.335750436228974
2012-08-30T09:30:00-04:00,12.226762,12.259237,12.153694,12.218643,31565368,37651973.85,56.16671480111454,62.551093896552686,NaN,NaN,4.105071073929648,56.909119183621144,-0.014515700751183705,0.10331038600597431,0.11782608675715801,-4541994552,-4514787792.8,52.74003855129339,55.700383972803216,NaN,NaN,22.386800643564328,21.48590046584831
2012-08-31T09:30:00-04:00,12.291712,12.340424,12.214584,12.307949,64930001,35952804.3,60.82134036613818,62.531678363857054,NaN,NaN,63.52372070841658,55.60548959960245,-0.01315882602309923,0.10137755422828398,0.11453638025138321,-4477064551,-4513637523.8,52.995442150122585,56.113370151083465,NaN,NaN,22.34717693188866,21.60893996099693
2012-09-04T09:30:00-04:00,12.283593,12.340424,12.234881,12.307949,36203411,35218615.8,60.82134036613818,62.57857753629334,NaN,NaN,63.58378573797464,52.27105765495636,-0.012662762142190129,0.09870792757364555,0.11137068971583568,-4477064551,-4507964446,54.306999643146824,56.66281675406716,NaN,NaN,22.31443355282246,21.70972475982915
2012-09-05T09:30:00-04:00,12.307949,12.348543,12.267356,12.307949,32902489,34665027.65,60.82134036613818,62.51363336800298,NaN,NaN,70.58698183439046,53.30205021278715,-0.01270338131562182,0.0954914630713084,0.10819484438693022,-4477064551,-4496723477.8,56.87472685174631,57.38029310113901,NaN,NaN,22.286990965263563,21.792191360605496
2012-09-06T09:30:00-04:00,12.372899,12.608341,12.372899,12.600222,64510190,36270139.8,72.67977017623156,63.08236122881827,NaN,NaN,251.92843020435944,90.74559791181414,0.005602879926585341,0.1151984442951619,0.10959556436857656,-4412554361,-4477148513.2,60.98621671217167,58.175314332672734,NaN,NaN,26.23590435205663,22.427007502241374
2012-09-07T09:30:00-04:00,12.640816,12.754478,12.640816,12.730122,57788916,37530971.2,76.13685774638918,63.79637877606815,NaN,NaN,329.4462131515498,155.81382632733818,0.024073930287430906,0.1396879772278652,0.11561404694043428,-4354765445,-4439702691.8,67.39084549573346,59.20108559454406,NaN,NaN,30.879618079833936,23.63452329904031
2012-09-10T09:30:00-04:00,12.713884,12.754478,12.61646,12.624579,52736679,39081930.85,68.54722318053993,63.88706103424657,NaN,NaN,223.23458014821622,187.75599821529812,0.026599692714461498,0.14886366283351116,0.12226397011904966,-4407502124,-4425790206.4,69.40073826328697,60.12979831770197,NaN,NaN,32.0795334120711,24.840953315187566
2012-09-11T09:30:00-04:00,12.624579,12.73824,12.600222,12.730122,70496981,41597348.9,71.5964087390125,64.09445294600825,NaN,NaN,183.23609872908804,211.6864608135208,0.03240924224044378,0.1627755229196044,0.13036628067916062,-4337005143,-4397778324.8,73.0080952710504,60.93428682295164,NaN,NaN,34.14601821170032,26.170248300403674
2012-09-12T09:30:00-04:00,12.795071,12.843783,12.746359,12.778834,62729905,43316062.5,72.9021321509492,64.48485279059169,NaN,NaN,182.2866922640522,234.0264028994531,0.03627177084534003,0.17570599423583566,0.13943422339049563,-4274275238,-4357220462.2,77.19934029210766,61.85789344584657,NaN,NaN,36.22499704201945,27.606640977777356
2012-09-13T09:30:00-04:00,12.770715,13.152294,12.730122,13.111692,172721622,50719111.75,79.75183026456753,65.98452492432946,NaN,NaN,206.13173242623017,224.86706334382728,0.05676232752532068,0.2103871327971465,0.15362480527182582,-4101553616,-4295020313.2,81.85317725041465,63.10556839993445,NaN,NaN,40.96880071050577,29.5155209395957
2012-09-14T09:30:00-04:00,13.217244,13.347143,13.17665,13.217244,150508707,56238057.4,81.36082678811508,67.39632570599652,NaN,NaN,220.8679193268102,203.15140457887938,0.0719653505061196,0.24358149340447532,0.17161614289835572,-3951044909,-4214276206,85.88173198439455,64.62343703658793,NaN,NaN,45.2677873722347,31.765844715686985
2012-09-17T09:30:00-04:00,13.168531,13.217244,13.062988,13.095463,60356579,57767935.85,74.0496069424424,68.3262947558355,NaN,NaN,153.60844883136042,189.2261783155082,0.06838539765480281,0.2570978899668592,0.18871249231205642,-4011401488,-4135056078.8,88.56415023140838,66.5075893611458,NaN,NaN,45.93294221868206,33.78971578754342
2012-09-18T09:30:00-04:00,13.046759,13.079226,12.98992,13.030514,81798652,60272352.55,70.41531960464661,69.08120748753583,NaN,NaN,112.5251665085899,175.08399187140859,0.056691327798573554,0.25957665206027336,0.2028853242616998,-4093200140,-4086295078.2,89.84329491928989,68.92680000638852,NaN,NaN,45.14634457061475,35.41209132798218
2012-09-19T09:30:00-04:00,13.062988,13.111692,12.998031,13.022387,80760772,61765567,69.95267944205663,69.71595649531999,NaN,NaN,100.41787780517926,158.710228979634,0.044021545355548586,0.25791225595613554,0.21389071060058695,-4173960912,-4066232213,90.32291863822269,71.52626544674214,NaN,NaN,44.39278365450586,36.69504737462842
2012-09-20T09:30:00-04:00,12.900614,12.957445,12.835665,12.949326,81162156,62936330.8,65.76918973888968,70.40184756230393,NaN,NaN,65.10806958821587,130.50549641203114,0.027160105908456356,0.24784084298615738,0.22068073707770103,-4255123068,-4096946103.4,83.79893493647636,73.74475804568378,NaN,NaN,42.41834712491327,37.512661624669114
2012-09-21T09:30:00-04:00,13.006157,13.006157,12.843783,12.851902,42220394,62535251.8,60.56755976651757,70.38372037661675,NaN,NaN,56.4773127881125,97.62737510429159,0.006938628456250345,0.22935402264801397,0.22241539419176362,-4297343462,-4166205814,71.29358413877254,75.0517681877302,NaN,NaN,39.06985234404324,37.73511744172256
2012-09-24T09:30:00-04:00,12.762596,12.916852,12.762596,12.855961,46437621,63156207.35,60.706994186227874,70.37555279233743,NaN,NaN,39.82795351910926,74.87127604184136,-0.007868219020940731,0.21258012041558771,0.22044833943652845,-4250905841,-4214106684.6,64.16204906047156,75.75570028896769,NaN,NaN,36.46668738740999,37.553913148249336
2012-09-25T09:30:00-04:00,12.892496,12.933089,12.657053,12.661113,88613871,66456198.7,51.324785889610595,69.69722747258547,NaN,NaN,13.729598206220173,55.11216238136741,-0.0311809287109501,0.1814721785478408,0.2126531072587909,-4339519712,-4263370599,57.762508272213935,75.81911324757252,NaN,NaN,30.97630904110528,36.61425541865733
2012-09-26T09:30:00-04:00,12.624579,12.648935,12.543391,12.579926,64994346,68313943.4,47.99628133394874,67.93412112670812,NaN,NaN,-31.399591771081557,28.748668466115248,-0.05127821015467987,0.14855534456544106,0.19983355472012093,-4404514058,-4309481228.2,52.48573223508774,75.21193578492367,NaN,NaN,25.35314063968064,35.00552473594637
2012-09-27T09:30:00-04:00,12.657053,12.762596,12.61646,12.697647,57163673,70030116.65,52.7783449175308,66.26565592464681,NaN,NaN,-11.078817398224736,13.511291068827115,-0.05549587347627108,0.1304637128747821,0.18595958635105317,-4347350385,-4327926691.6,50.49838694825432,74.00533160296087,NaN,NaN,22.107598426793412,33.16296383463881
2012-09-28T09:30:00-04:00,12.648935,12.730122,12.600222,12.657053,56747784,71289237.45,51.03554980989197,65.01482211245767,NaN,NaN,-28.759122392717515,-3.535995967338896,-0.059516210043535744,0.1115643237966335,0.17108053384016925,-4404098169,-4349277633,48.22228357248512,72.49258483933217,NaN,NaN,18.94617942148157,31.131994632759202
2012-10-01T09:30:00-04:00,12.746359,12.868139,12.681409,12.713884,66063364,71345905.6,53.357640672128326,63.71205296482309,NaN,NaN,-7.888248403050791,-13.079236351770911,-0.05684902795888075,0.10001924889156832,0.15686827685044907,-4338034805,-4366703425.8,46.38469051696782,70.59091307118341,NaN,NaN,17.032674423642238,29.11780603145678
2012-10-02T09:30:00-04:00,12.795071,12.795071,12.681409,12.73824,54046150,72238042.55,54.356676217403034,62.387377540998365,NaN,NaN,-23.711763841640114,-20.567508761342964,-0.052072965032537555,0.09177707055977713,0.14385003559231468,-4283988655,-4355597214.4,47.75127148435433,68.48747958491532,NaN,NaN,15.761215444532068,27.209721661896108
2012-10-03T09:30:00-04:00,12.795071,12.900614,12.713884,12.851902,68084121,73997124.15,58.79246702504669,60.89028016674688,NaN,NaN,-1.2259903560663368,-14.53278847833992,-0.040407480455618316,0.0933406850227918,0.13374816547841012,-4215904534,-4317875309.6,52.207042078323596,66.36989850119453,NaN,NaN,15.973793194704225,25.60458902372584
2012-10-04T09:30:00-04:00,12.92497,13.062988,12.900614,13.042692,96005360,75571882.65,64.95000081776213,59.71807831172167,NaN,NaN,69.34560028316757,1.55209505793854,-0.020021138239735448,0.1087217426787408,0.12874288091847624,-4119899174,-4272385067.4,56.97247914292873,64.30495186966125,NaN,NaN,18.181506264311505,24.544148629523793
2012-10-05T09:30:00-04:00,13.136048,13.17665,12.998031,13.038632,76129508,76488912.25,64.72834466106292,59.05227386305171,NaN,NaN,88.77086681488564,25.058092899459172,-0.0076266567235943605,0.1192095600139833,0.12683621673757767,-4196028682,-4230771170,60.821025474219475,62.32330010129061,NaN,NaN,19.85255144488227,23.87392046028929
2012-10-08T09:30:00-04:00,12.973683,13.05487,12.957445,13.030514,36635934,75683875,64.25614788138886,58.61233302567615,NaN,NaN,57.51112278711266,38.13796713749186,-0.0011326472543484178,0.12542040766964213,0.12655305492399055,-4232664616,-4209697132.2,62.64329656782911,60.380443076186275,NaN,NaN,21.067673464876712,23.473028032373207
2012-10-09T09:30:00-04:00,13.038632,13.087344,12.908733,12.949326,90159143,76666983.1,59.57532288328116,57.8710932714779,NaN,NaN,38.290108818960576,50.538341669611995,-0.003337941223131524,0.12238062839507613,0.12571856961820765,-4322823759,-4217464153,61.50781107455496,58.32222110735286,NaN,NaN,20.768760407984036,23.086704086031897
2012-10-10T09:30:00-04:00,12.941208,12.998031,12.868139,12.941208,76987695,77379872.6,59.11163835822556,57.39555388714475,NaN,NaN,14.120492491343104,53.60763823909389,-0.006209420361035667,0.11795679416691307,0.12416621452794874,-4399811454,-4254245537,56.303089584407594,56.358232153633665,NaN,NaN,20.395440969119516,22.702237926472986
2012-10-11T09:30:00-04:00,13.071115,13.095463,12.98992,13.014276,75188944,72503238.7,61.9799831739073,57.49644127338687,NaN,NaN,59.04158996241729,51.54683617494386,-0.004152670395752095,0.11897537653325863,0.12312804692901072,-4324622510,-4295190204.2,51.11757968145808,54.91708897811121,NaN,NaN,20.874226061549827,22.441093374341104
2012-10-12T09:30:00-04:00,12.900614,12.981801,12.795071,12.835665,91325359,69544071.3,52.31833480750969,56.897251317764145,NaN,NaN,-9.548760131149265,31.88291078573688,-0.01516692117218768,0.10416939546377613,0.11933631663596381,-4415947869,-4339174041.6,46.195594966395966,53.633770828534374,NaN,NaN,18.349292259081416,21.856550357875435
2012-10-15T09:30:00-04:00,12.884377,12.998031,12.827546,12.981801,68719100,69962197.35,58.07658024306163,57.379522343010656,NaN,NaN,31.456441466379182,26.671974521590187,-0.01303727340718093,0.10303972487698765,0.11607699828416858,-4347228769,-4362086872.2,43.82807999324294,52.638454522893596,NaN,NaN,17.96416522837293,21.300495339375075
2012-10-16T09:30:00-04:00,13.046759,13.119819,13.022387,13.062988,94695495,70607039.5,60.90154064232455,58.3013265793232,NaN,NaN,103.38094046918171,39.69014085163441,-0.006896103194974634,0.10745686929045029,0.11435297248542492,-4252533274,-4348028775.2,45.66792375922231,52.15146820318892,NaN,NaN,18.547594283191913,20.90722375992034
2012-10-17T09:30:00-04:00,13.111692,13.2416,13.09181,13.229422,70486654,70093333.6,65.96473947504302,59.24321190485979,NaN,NaN,156.91117498604987,68.24827735057576,0.006893463282288043,0.12296980158828497,0.11607633830599692,-4182046620,-4304475808.4,51.02037838770054,52.188753306006504,NaN,NaN,20.767062345638433,20.88720070073721
2012-10-18T09:30:00-04:00,13.200998,13.306549,13.184777,13.257837,63490736,69209762.6,66.75626592189698,60.36612019857443,NaN,NaN,160.96507670001128,88.63297469809456,0.01593026276384049,0.13598916676079753,0.12005890399695704,-4118555884,-4263262483.2,55.488953789605816,52.70780117865799,NaN,NaN,22.7768776908157,21.157154556462707
2012-10-19T09:30:00-04:00,13.225354,13.225354,13.014276,13.079226,75582307,70877858.25,57.67639484204075,60.67460263928246,NaN,NaN,83.94445001201778,107.33161672672797,0.008266172046736048,0.1303916190553771,0.12212544700864106,-4194138191,-4218900547.6,59.74610511062176,53.66218793534755,NaN,NaN,21.53396846571095,21.210985114926743
2012-10-22T09:30:00-04:00,13.062988,13.111692,12.957445,13.079226,129520125,75031983.45,57.67639484204075,60.91172539818516,NaN,NaN,54.02206903529253,111.84474224051064,0.001915747676792437,0.1245201316046316,0.12260438392783916,-4194138191,-4188282432,62.41779586278167,54.70979681952093,NaN,NaN,20.568504736574265,21.119202203733533
2012-10-23T09:30:00-04:00,12.908733,12.916852,12.811309,12.860021,79664557,74584517.75,48.32148620664935,60.16379819687106,NaN,NaN,-31.43527210007391,84.88149972665953,-0.017271913711270362,0.10101449178875122,0.11828640550002158,-4273802748,-4192536326.8,61.804050549937465,55.39529742463621,NaN,NaN,16.514859940806566,20.461439023315396
2012-10-24T09:30:00-04:00,12.937148,12.965564,12.843783,12.860021,64780400,74573820.45,48.32148620664934,58.97604715322014,NaN,NaN,-29.049003273438444,47.68946407476186,-0.029471340465362872,0.08144722991831799,0.11091857038368086,-4273802748,-4210887552.4,59.1040728266002,55.54755411632703,NaN,NaN,13.376230220245294,19.449266337162523
2012-10-25T09:30:00-04:00,12.981801,13.006157,12.80319,12.892496,65070299,74969151.75,49.722627987702005,57.90421024798008,NaN,NaN,-31.354185094444635,9.225611715870679,-0.03451151324760056,0.06777917882418016,0.10229069207178072,-4208732449,-4228922865.4,56.49206781062612,55.23834285464179,NaN,NaN,11.242654803613952,18.2768932609413
2012-10-26T09:30:00-04:00,12.872199,12.900614,12.73824,12.827546,69530442,75608284.65,46.979207166071,56.670143054028806,NaN,NaN,-85.26243646055948,-24.61576557864479,-0.04093896733012446,0.05111698290912514,0.0920559502392496,-4278262891,-4245747805.4,54.09051448899691,54.627429849010916,NaN,NaN,8.626441908151705,16.89825735339993
2012-10-31T09:30:00-04:00,12.876258,12.916852,12.819427,12.908165,53090982,74959665.55,50.621065167577214,56.03055321719281,NaN,NaN,-56.82937615708223,-46.786054617119746,-0.03851582299977306,0.043911171489533274,0.08242699448930633,-4225171909,-4251954549,53.19216079274336,54.03345482888152,NaN,NaN,7.464532937597118,15.550582436856672
2012-11-01T09:30:00-04:00,12.92497,13.071115,12.900614,13.067048,72189508,75866833.45,56.903695792274526,55.8728430339106,NaN,NaN,19.743278082062638,-36.55034458069244,-0.025589909286076906,0.0504396078817102,0.07602951716778711,-4152982401,-4227790479.6,56.239360115711854,54.02890272397468,NaN,NaN,8.398445958655193,14.52884865425646
2012-11-02T09:30:00-04:00,13.144175,13.152294,12.961505,12.990009,66000064,75762630.6,53.35864477999896,55.25703314863142,NaN,NaN,29.637270860767092,-24.813089753851333,-0.02175632725490942,0.04883410809915034,0.07059043535405976,-4218982465,-4216826423,57.58848434159634,54.491110199698845,NaN,NaN,8.081435911045423,13.607789690940598
2012-11-05T09:30:00-05:00,12.949326,12.98992,12.827546,12.965564,54612822,73693003.7,52.246394738885876,55.25189457230115,NaN,NaN,-47.013330630902914,-27.94491886114298,-0.020416591997889214,0.04506969535669825,0.06548628735458746,-4273595287,-4229798990.6,55.411730365769394,55.14940558536838,NaN,NaN,7.495099120563724,12.734548180886758
2012-11-06T09:30:00-05:00,13.006157,13.152294,12.998031,13.111692,49379787,72355517.65,57.89635527369369,55.23902136020344,NaN,NaN,68.81412978031089,2.8703943870310953,-0.009778078807657187,0.05326368884501598,0.06304176765267316,-4224215500,-4218989512.4,56.874484936119664,56.08129165271671,NaN,NaN,8.736680197823993,12.163424183306363
2012-11-07T09:30:00-05:00,12.92497,12.941208,12.648935,12.673291,143957845,77721613.2,41.885201265629284,53.88071140472521,NaN,NaN,-147.88410482317198,-15.340551346186853,-0.031149949191067394,0.02410433116383892,0.055254280354906316,-4368173345,-4247589799.6,52.012547990792164,56.53447909782884,NaN,NaN,3.9200007184535424,10.98579225975596
2012-11-08T09:30:00-05:00,12.726062,12.835665,12.559629,12.566286,114177156,78922513.85,39.046798263057234,51.9580013181548,NaN,NaN,-177.73875805748946,-54.836958574097274,-0.05024504353970034,-0.00755202406971911,0.04269301946998123,-4482350501,-4313463419.6,42.91322953889056,55.95539703719957,NaN,NaN,-0.8856957800098498,9.289865396932274
2012-11-09T09:30:00-05:00,12.510917,12.722003,12.494679,12.583985,95086730,79827465.6,39.773788100693686,50.03068147378314,NaN,NaN,-176.01013071532847,-95.9664388893164,-0.05883926581284286,-0.030856062796072337,0.02798320301677052,-4387263771,-4347119680.8,39.145168538693994,54.787983804991576,NaN,NaN,-4.278736226769568,7.35149373640344
2012-11-12T09:30:00-05:00,12.640816,12.640816,12.559629,12.604282,41682693,78152153.05,40.64803623806237,48.81437014492754,NaN,NaN,-152.74839964300116,-117.11345269173603,-0.060101316692581126,-0.047143442848955885,0.01295787384362524,-4345581078,-4361516839,37.62329305374177,53.20778294378586,NaN,NaN,-6.655702910663097,5.3504656439653635
2012-11-13T09:30:00-05:00,12.510917,12.689528,12.486561,12.519035,64002187,76785994.45,38.1436389396811,47.419173294759,NaN,NaN,-146.870419670069,-160.25036258181203,-0.06330013425012747,-0.06616729396903409,-0.0028671597189066263,-4409583265,-4398590392,33.96175772089332,51.17520879079383,NaN,NaN,-9.417105323527254,3.2408126486092756
2012-11-14T09:30:00-05:00,12.543391,12.583985,12.259237,12.295771,84318307,77565954.8,32.496543722972376,46.28882026021064,NaN,NaN,-184.44844778406488,-167.5632311739906,-0.07620884103462096,-0.09812821101218283,-0.02191936997756187,-4493901572,-4423736037.4,31.70775140073026,49.025473137279036,NaN,NaN,-13.80465303628685,0.8057461221955435
2012-11-15T09:30:00-05:00,12.29983,12.421611,12.267356,12.324187,85812694,77121814.75,33.839102480986696,45.25436427980617,NaN,NaN,-165.2694328560458,-165.06936613370186,-0.07829149754067123,-0.11978374190340091,-0.04149224436272968,-4408088878,-4408883712.8,34.47402291323857,47.26618385775321,NaN,NaN,-16.8415725198604,-1.7152993980981623
2012-11-16T09:30:00-05:00,12.356661,12.421611,12.226762,12.405374,77935176,77494240.85,37.65434142067901,44.392343810733095,NaN,NaN,-138.05210283717483,-157.47776055807114,-0.069933255075207,-0.12890881320673842,-0.05897555813153142,-4330153702,-4397461699,36.60088589705016,45.84538514964064,NaN,NaN,-18.17981888475242,-4.067373610477342
2012-11-19T09:30:00-05:00,12.583985,12.657053,12.575866,12.63976,64239131,77531660.6,47.13277786498612,44.4033131463699,NaN,NaN,-47.38184778263874,-136.40445018599866,-0.045532817976040724,-0.11589158060158233,-0.07035876262554161,-4265914571,-4381528397.6,39.54856625249157,44.80667456131882,NaN,NaN,-16.214775753786277,-5.80271677380719
2012-11-20T09:30:00-05:00,12.608341,12.746359,12.567748,12.705765,49913015,76248196,49.46285880652832,44.32058412058068,NaN,NaN,-26.160307953513943,-112.26242784268763,-0.022998458850749443,-0.09910683618897842,-0.07610837733822898,-4216001556,-4342812055.8,46.105689477323054,44.3004980387888,NaN,NaN,-13.875015135082805,-6.955902253989421
2012-11-21T09:30:00-05:00,12.713884,12.730122,12.632697,12.705765,32315518,71387965.65,49.46285880652832,43.78909576445596,NaN,NaN,-15.498912626938617,-78.4725208112624,-0.006974876349609874,-0.08482697277524132,-0.07785209642563144,-4216001556,-4287232052.6,53.845490793191345,44.12950737289448,NaN,NaN,-12.033532938199574,-7.681278066019442
2012-11-23T09:30:00-05:00,12.80319,12.868139,12.770715,12.860021,25352137,68672344.65,54.855748861792826,43.89603177029837,NaN,NaN,37.059285779617994,-38.006777084129624,0.013988049529721575,-0.06036703451347947,-0.07435508404320104,-4190649419,-4243744160.8,58.82774636924978,44.21802608915544,NaN,NaN,-8.715271324755205,-7.82899138869598
2012-11-26T09:30:00-05:00,12.795071,12.819427,12.730122,12.811309,37346925,67300670.9,52.93473619947152,43.945199017483056,NaN,NaN,22.844111866206116,-5.827534143453435,0.023963123749222978,-0.044401179356672316,-0.0683643031058953,-4227996344,-4223312689.2,60.95999435902756,44.614330660102446,NaN,NaN,-6.567252479528142,-7.648742973100575
2012-11-27T09:30:00-05:00,12.786952,12.835665,12.681409,12.697647,61400332,67117172.55,48.653346020511414,43.284984070827186,NaN,NaN,8.026520791083737,5.2541395712910655,0.022328741473562577,-0.040453376263942076,-0.06278211773750465,-4289396676,-4228009110.2,60.188384413730795,44.8510377656461,NaN,NaN,-6.007423578523988,-7.414268773875348
2012-11-28T09:30:00-05:00,12.624579,12.762596,12.527154,12.746359,58606919,66570996.4,50.501103312893726,43.90040564563179,NaN,NaN,-12.794090462701337,7.927383069453586,0.02381489142513199,-0.033013503456089666,-0.056828394881221655,-4230789757,-4230966750.4,59.67609392840115,45.39843390404674,NaN,NaN,-4.998087104548368,-7.069099963971493
2012-11-29T09:30:00-05:00,12.811309,12.858397,12.746359,12.810903,48804483,66356671.45,52.918710430877375,44.8912565147618,NaN,NaN,40.52703224403333,19.13257204364797,0.028135106384514552,-0.021659511900578465,-0.04979461828509302,-4181985274,-4224163494,60.50874063582898,46.655256125256635,NaN,NaN,-3.4407107173440505,-6.550758643024716
2012-11-30T09:30:00-05:00,12.80319,12.851902,12.746359,12.795071,36558621,64575127.1,52.24465339353587,45.78203260710768,NaN,NaN,45.194067976488576,20.759528483022088,0.02881165143323603,-0.01378005399354798,-0.04259170542678401,-4218543895,-4229742389.2,59.425102790853174,48.103822857553716,NaN,NaN,-2.3462952097956085,-5.9501210097062724
2012-12-03T09:30:00-05:00,12.835665,12.876258,12.73824,12.746359,62779469,64414097.35,50.12892156422916,46.45923870183388,NaN,NaN,50.24790929939338,26.24028796965954,0.025004956794240203,-0.01133550943398376,-0.03634046622822396,-4281323364,-4240407793.2,57.311977562334235,49.51015746531032,NaN,NaN,-1.990907197449908,-5.384519036526791
2012-12-04T09:30:00-05:00,12.746359,12.778834,12.648935,12.713884,48593888,64113150.65,48.7126123838392,47.2141653764166,NaN,NaN,21.491051226494044,28.9331940567416,0.019567023649901844,-0.011881686665846658,-0.0314487103157485,-4329917252,-4248511908.4,55.69144863951913,51.06227824521216,NaN,NaN,-2.0690374451765874,-4.910878809191048
2012-12-05T09:30:00-05:00,12.754478,12.933089,12.722003,12.868139,57299853,64509153.95,55.18895158762946,48.83505165246354,NaN,NaN,102.68745773072634,52.02950369542714,0.025263802413714065,0.00013104270139407959,-0.025132759712319985,-4272617399,-4256877436.8,53.994254978669304,52.654171357922095,NaN,NaN,-0.2743827663526483,-4.248522231642705
2012-12-06T09:30:00-05:00,12.876258,12.916852,12.835665,12.908733,42634234,59442973.4,56.73720092957846,50.47063011307723,NaN,NaN,119.6767557588049,67.85944839838145,0.03032980752683523,0.01277949969622405,-0.017550307830611178,-4229983165,-4266477015,52.034604576514404,53.90849861958465,NaN,NaN,1.6721933935652158,-3.4027057137558594
2012-12-07T09:30:00-05:00,12.981801,13.014276,12.92497,13.010209,44565735,55962402.35,60.4187568783483,52.09665978862504,NaN,NaN,148.76367507736413,88.57336981855656,0.03855110681871743,0.030638575692785608,-0.007912531125931821,-4185417430,-4259851722,53.29450620688978,55.10090007028749,NaN,NaN,4.463468899008579,-2.2789664833609393
2012-12-10T09:30:00-05:00,12.973683,13.022387,12.933089,12.981801,59338997,54175015.7,58.90746235827707,52.93770868100297,NaN,NaN,129.50000616643575,104.42378919196503,0.03994235006188944,0.04201540645142998,0.0020730563895405407,-4244756427,-4252538334.6,54.708739918891,56.18376961788745,NaN,NaN,6.368324137181873,-1.0436392518548234
2012-12-11T09:30:00-05:00,13.038632,13.103582,12.998031,13.046759,58763792,55029070.65,61.291744211885806,53.78262906709993,NaN,NaN,143.00575728640368,128.72673040394696,0.04284707852887578,0.05563190455063527,0.012784826021759487,-4185992635,-4223753411.2,59.86050765979214,57.166256630920955,NaN,NaN,8.687900817825579,0.3465807580995197
2012-12-12T09:30:00-05:00,13.103582,13.217244,13.071115,13.103582,68572830,55257602.8,63.29788724611167,54.77084538421303,NaN,NaN,157.84219792117136,139.75767844203597,0.04593134569279573,0.07019900813775415,0.02426766244495842,-4117419805,-4192713892.4,64.54396552820037,57.93043339770731,NaN,NaN,11.246719771623155,1.9037434743171817
2012-12-13T09:30:00-05:00,13.103582,13.127938,12.998031,13.038632,50886807,53586027.8,59.50186663272682,55.10271093927974,NaN,NaN,119.78100356615451,139.77852800350587,0.04109050664861163,0.07563079575572296,0.03454028910711133,-4168306612,-4180378581.8,66.23029267666948,58.45918670538015,NaN,NaN,12.404155670927182,3.4038023595471816
2012-12-14T09:30:00-05:00,13.022387,13.046759,12.973683,12.98992,43056666,51448226.4,56.75290346138887,55.37543717227384,NaN,NaN,88.54726161986733,127.73524531200653,0.03247874699847561,0.07513872285520584,0.04265997585673023,-4211363278,-4185567751.4,64.83333738180755,58.73585406415015,NaN,NaN,12.629768574272083,4.72179753307931
2012-12-17T09:30:00-05:00,13.071115,13.265956,13.062988,13.257837,85138083,51808371.75,66.04461946120006,56.61767098946588,NaN,NaN,160.57372004408032,133.94998808753544,0.04208738748125771,0.09526921020830237,0.05318182272704466,-4126225195,-4161861505,68.13952636134246,59.30379277469384,NaN,NaN,15.866678151823436,6.313923335757043
2012-12-18T09:30:00-05:00,13.330905,13.468923,13.282193,13.452694,86585980,52925714.2,70.93564648567411,58.077281216093056,NaN,NaN,210.11195026693946,147.37122668364262,0.05785407677991933,0.1254994187019438,0.06764534192202448,-4039639215,-4132590821,71.67987799816693,60.16120592253426,NaN,NaN,20.44132676104117,8.332123825083347
2012-12-19T09:30:00-05:00,13.485161,13.501398,13.363388,13.371499,90757367,54967931.8,66.62887435245773,59.05657863906308,NaN,NaN,179.0203280854223,151.6068527164928,0.05890514099303856,0.14127676816332269,0.08237162717028412,-4130396582,-4135186176.4,70.9272918870686,60.90538815476566,NaN,NaN,22.695104560297715,10.383978215828256
2012-12-20T09:30:00-05:00,13.387744,13.558229,13.37758,13.558229,76342764,57169294.1,70.99092530246509,60.395598061129455,NaN,NaN,180.3303996271315,163.71673192868818,0.067641728815458,0.16692378818960663,0.09928205937414862,-4054053818,-4112335617.6,73.5594617079878,61.914985220275284,NaN,NaN,26.174505025699617,12.639767760095593
2012-12-21T09:30:00-05:00,13.2416,13.371499,13.225354,13.31466,72357121,59519543.3,59.97796222092921,61.09910096517946,NaN,NaN,99.10629630389492,165.8285388654937,0.053122621467112344,0.16568533620803905,0.1125627147409267,-4126410939,-4095345149.8,75.34675453391004,63.203183575387825,NaN,NaN,25.133327682477695,14.424562034721607
2012-12-24T09:30:00-05:00,13.249727,13.322787,13.2416,13.290312,29603498,59132371.95,58.99275856537752,61.83339712100362,NaN,NaN,82.36556537839604,150.18690793235686,0.03865750540215043,0.16088459649361475,0.12222709109146432,-4156014437,-4101302998.2,73.47127726576247,64.47317133440522,NaN,NaN,24.004478131627106,15.793121477136678
2012-12-26T09:30:00-05:00,13.31466,13.339016,13.2416,13.286261,36567411,57890725.9,58.819641327715544,62.09273210243834,NaN,NaN,75.16003589273706,123.19652505751635,0.0261917141623097,0.15496673379435144,0.12877501963204174,-4192581848,-4131891524.8,64.58296997790484,65.22950812006489,NaN,NaN,23.077292083145696,16.83371727799511
2012-12-27T09:30:00-05:00,13.31466,13.338943,13.062988,13.2416,54747129,57697736.4,56.83929487912463,62.10002452740593,NaN,NaN,44.406082505479404,96.27367594152778,0.012981206822781477,0.1450015281605186,0.1320203213377371,-4247328977,-4155278003.8,58.73274294478985,65.70794657494172,NaN,NaN,21.714924099324904,17.53103253818508
2012-12-28T09:30:00-05:00,13.152294,13.2416,13.119819,13.136048,39505181,57232771.3,52.35304503936848,61.52390225319308,NaN,NaN,23.235144571215162,64.85462493034451,-0.00391906568011216,0.12712148923759692,0.13104055491770908,-4286834158,-4201834071.8,49.18163402671515,65.41416999064354,NaN,NaN,19.158597561591268,17.763541827243106
2012-12-31T09:30:00-05:00,13.119738,13.322787,13.082879,13.306549,73624752,59086077.85,58.1053102356754,61.466605673007244,NaN,NaN,42.99899133386107,53.633163936337745,-0.004620081400509263,0.1252654531670725,0.12988553456758176,-4213209406,-4219193765.2,46.166863086642074,64.80403593119719,NaN,NaN,18.725153706086047,17.900914952792096
2013-01-02T09:30:00-05:00,13.639416,13.704366,13.590712,13.692196,86182447,60256226.75,67.62565117098877,61.919027598657465,NaN,NaN,179.53536590822367,73.06712404230328,0.018609676800817904,0.15314763056860414,0.13453795376778624,-4127026959,-4213396269.6,47.328080585689854,63.9088625687613,NaN,NaN,21.834154305325583,18.462806288868308
2013-01-03T09:30:00-05:00,13.696247,13.720595,13.623179,13.680018,59062027,60779633.7,67.10705133533477,62.19111074788769,NaN,NaN,166.7439582733229,91.38390851842044,0.030190360843838138,0.17227590482258393,0.1420855439787458,-4186088986,-4212097697.2,47.60072686216698,62.69863123547321,NaN,NaN,23.99251416209084,19.252764556471526
2013-01-04T09:30:00-05:00,13.704366,13.86674,13.671891,13.842383,54855304,60657406.25,70.36961733275831,62.96737865503279,NaN,NaN,180.21147268507661,118.54498655433989,0.04493266884727273,0.1982513800378367,0.15331871119056398,-4131233682,-4188878638.2,52.3501920732518,61.70719547808623,NaN,NaN,26.925214138181463,20.34882878243009
2013-01-07T09:30:00-05:00,13.818027,13.826146,13.728722,13.809901,44520822,60751735.65,68.8973255414833,63.834837375039534,NaN,NaN,153.97291013006983,144.6925396661108,0.04834671436908511,0.21375210415192036,0.16540538978283525,-4175754504,-4166662707.4,56.42032006727309,61.10626566990519,NaN,NaN,28.743695114810325,21.548095401341552
2013-01-08T09:30:00-05:00,13.785553,13.793679,13.704366,13.769323,51487651,61097831.45,67.01112371433882,63.903873393120875,NaN,NaN,122.98317483240494,160.68937636581958,0.04385459477678344,0.22022363325381455,0.17636903847703111,-4227242155,-4169469257.2,55.77219683961601,60.22288498978187,NaN,NaN,29.624278282908584,22.701835812993984
2013-01-09T09:30:00-05:00,13.80179,13.874858,13.704366,13.749018,59773313,61119547.25,66.03687608577881,63.55396122169979,NaN,NaN,113.43064187973263,147.46843156012136,0.03583635039693825,0.22116447647320392,0.18532812607626567,-4287015468,-4201466959,48.87824337763038,58.5941968026007,NaN,NaN,30.05029985542719,23.751616390484443
2013-01-10T09:30:00-05:00,13.86674,13.939808,13.80179,13.923562,75475058,61955110.55,70.06569910952462,63.79944870434742,NaN,NaN,126.97185811414762,139.51401152828632,0.038381458618268305,0.23330494934910107,0.19492349073083276,-4211540410,-4206557243.8,47.864627836518316,56.94686365613281,NaN,NaN,31.668160274925743,24.882551231118914
2013-01-11T09:30:00-05:00,13.891096,13.899214,13.80179,13.891096,52654262,61159182.15,68.43945532935723,63.61720084912543,NaN,NaN,105.51896183716877,124.57550935870476,0.03411567913045438,0.23756808964390075,0.20345241051344637,-4264194672,-4233149441.8,42.86376622704095,54.754313978922326,NaN,NaN,32.50547945168727,25.971540976914394
2013-01-14T09:30:00-05:00,13.874858,13.891096,13.769323,13.850502,47169738,60973328.7,66.36531055684034,64.07344001597622,NaN,NaN,88.55529691465806,111.4919867156224,0.025208119879850305,0.23496256036325924,0.20975444048340894,-4311364410,-4260271423,38.451193899155854,52.1189167907256,NaN,NaN,32.60674869133555,26.919427793260272
2013-01-15T09:30:00-05:00,13.785553,13.923562,13.761196,13.907333,51807348,61410862.8,67.83499558828323,64.7050283747552,NaN,NaN,86.6879897326533,104.23294969567205,0.020018113468257437,0.23477708231873073,0.2147589688504733,-4259557062,-4266734404.4,37.46154005568871,49.546792704291754,NaN,NaN,33.10401361763883,27.80294005388578
2013-01-16T09:30:00-05:00,13.895163,13.939808,13.834257,13.915452,71720329,60739975.1,68.04978484874617,65.3643243405431,NaN,NaN,87.21035679601091,98.98889267892773,0.014275954497637244,0.23260391197251984,0.2183279574748826,-4187836733,-4246898657.4,42.364557683612816,47.95976325469947,NaN,NaN,33.57246100332551,28.62715733237717
2013-01-17T09:30:00-05:00,13.923562,13.956045,13.86674,13.907333,69765060,59898929.1,67.56390557123106,66.13036796140786,NaN,NaN,83.08726063484946,90.21197318306811,0.007419921448598155,0.2276028592856303,0.22018293783703213,-4257601793,-4256110934,40.76603842035391,46.676427217239755,NaN,NaN,33.838705651576575,29.37166423511994
2013-01-18T09:30:00-05:00,13.899214,13.939808,13.826146,13.923562,70099400,58866030.75,68.05490357472185,67.25192928536167,NaN,NaN,73.50405893426424,83.8089926024872,0.0017620592647775157,0.22238551191800404,0.22062345265322653,-4187502393,-4240772478.2,44.51968572514855,46.343430909985,NaN,NaN,34.18887036452248,30.059836539320305
2013-01-22T09:30:00-05:00,13.899214,14.05347,13.899214,14.05347,52195351,57658660.1,71.74227724055709,68.22599835713893,NaN,NaN,94.91308022457495,85.08054926447058,0.004402493967332222,0.2261265701123918,0.22172407614505957,-4135307042,-4205561004.6,52.03421058545131,46.762527159899946,NaN,NaN,35.509784308633314,30.83840050636502
2013-01-23T09:30:00-05:00,14.045351,14.061597,13.972291,14.045351,46095438,56345575.95,71.18920935165865,68.48053822718678,NaN,NaN,96.65416842291569,87.07378500252305,0.0032871295852789917,0.2258329881266583,0.22254585854137932,-4181402480,-4189930088.2,54.95117419836891,47.30703384651988,NaN,NaN,36.472246061824286,31.643235585716344
2013-01-24T09:30:00-05:00,14.085953,14.199614,14.05347,14.118419,82595193,58995160.7,73.19217811974909,68.91519014035923,NaN,NaN,120.74502621244886,93.78071888581063,0.005049844981993512,0.22885816476887122,0.2238083197868777,-4098807287,-4172124199,58.0786810045863,48.055459142406974,NaN,NaN,37.86342503067616,32.53183407785346
2013-01-25T09:30:00-05:00,14.183369,14.191488,14.094063,14.183369,56387786,59986179.45,74.86494513797535,69.23628498358902,NaN,NaN,129.7767262918875,103.11861201721824,0.007994499159458851,0.23380144373620126,0.2258069445767424,-4042419501,-4129087740.6,64.49469843506742,48.922923882536665,NaN,NaN,39.54109666861075,33.5331573051045
2013-01-28T09:30:00-05:00,14.199614,14.207725,14.069707,14.12653,38294327,59163539.35,70.70691373029985,69.3655412827902,NaN,NaN,120.39411064151906,112.4966223586692,0.003735095489551671,0.230475813938682,0.22674071844913032,-4080713828,-4107730027.6,67.17930858161948,49.69142306213284,NaN,NaN,39.877635452364366,34.43951132614163
2013-01-29T09:30:00-05:00,14.094063,14.199614,14.077826,14.183369,46123896,59494475.1,72.36013094679389,69.74761322796556,NaN,NaN,127.8915854032713,119.09232339440845,0.002429764254724298,0.2297779237675357,0.2273481595128114,-4034589932,-4087586605.6,69.52011016661888,50.67341687120447,NaN,NaN,40.618657053808256,35.322246430094005
2013-01-30T09:30:00-05:00,14.150886,14.175258,14.085953,14.118419,39898486,57808161.8,67.66096900162793,69.86361986481192,NaN,NaN,107.06566140936727,121.17462199169879,-0.00473341137031752,0.2214313952999145,0.22616480667023203,-4074488418,-4066203793.2,71.81788132683086,52.3119624390045,NaN,NaN,39.96782981773701,35.98590119975729
2013-01-31T09:30:00-05:00,14.090004,14.134657,14.045351,14.110301,43726882,55685383.55,67.07464988087506,69.64997349133697,NaN,NaN,80.41524061568288,113.1086648723456,-0.011554990998922904,0.2117210679215784,0.2232760589205013,-4118215300,-4070085395.8,70.77483600227764,53.94840587941588,NaN,NaN,39.268049800577764,36.45477957130308
2013-02-01T09:30:00-05:00,14.18328,14.337624,14.18328,14.297031,71342613,56299412.85,72.8932998197467,69.96810524065049,NaN,NaN,147.15771581797213,116.5848627775625,-0.005343786077151441,0.216596326324062,0.22194011240121345,-4046872687,-4070976033,70.52175000540825,55.923976149299264,NaN,NaN,40.31258729015959,37.00589495971115
2013-02-04T09:30:00-05:00,14.199614,14.232081,14.102182,14.134657,61471930,56630244.15,62.54290424627954,69.69507621846758,NaN,NaN,81.76431306914655,108.85890326308802,-0.013556308051722754,0.20499472733656,0.21855103538828274,-4108344617,-4076502190.8,68.8759984022205,58.09717647094674,NaN,NaN,37.916870847664555,37.13603437227592
2013-02-05T09:30:00-05:00,14.207725,14.321387,14.183369,14.272675,58349913,57321698.7,66.85151222886473,69.6248274070805,NaN,NaN,118.05328087740095,106.89124235791394,-0.011177615400716379,0.20457901613738727,0.21575663153810365,-4049994704,-4079583145.2,67.92427037299584,60.27308577932582,NaN,NaN,37.25722629167577,37.15334750361876
2013-02-06T09:30:00-05:00,14.191488,14.305149,14.175258,14.297031,36934701,56594051.2,67.56064892132187,69.58988912655018,NaN,NaN,107.5847481642773,106.99505970889595,-0.009513416866036017,0.20386486045555863,0.21337827732159464,-4013060003,-4067297462.2,69.72100964452314,62.22711806224799,NaN,NaN,36.95693941146177,37.12528920473919
2013-02-07T09:30:00-05:00,14.329497,14.345743,14.144805,14.256437,62208934,56715832.25,65.06239350289977,69.41120969309796,NaN,NaN,94.5001441078495,109.81204040732925,-0.012507563702117613,0.19774382269394764,0.21025138639606525,-4075268937,-4058708189.6,70.9463344175903,64.38285349062201,NaN,NaN,35.9468661695674,36.956943056857504
2013-02-08T09:30:00-05:00,14.280793,14.305149,14.248319,14.28892,54978082,55690983.45,66.14132037973481,69.27452517917031,NaN,NaN,101.55254322229005,100.69100588819285,-0.01357240235820456,0.19328588344830955,0.2068582858065141,-4020290855,-4053391823.2,71.70945700649102,66.3249800107179,NaN,NaN,35.43089422036399,36.738936080215574
2013-02-11T09:30:00-05:00,14.288831,14.378226,14.264564,14.353853,35016364,54809088.55,68.25194047290594,69.02521541005237,NaN,NaN,119.6895992996361,108.27606313429075,-0.011270349980792904,0.19277034833052298,0.20404069831131588,-3985274491,-4028777798,74.98542015819832,67.96435212305697,NaN,NaN,35.60846622628107,36.57744038679636
2013-02-12T09:30:00-05:00,14.370099,14.483761,14.321387,14.463464,68274457,55864324.5,71.48348306284257,69.04623496085121,NaN,NaN,157.44117503493428,116.15364196579745,-0.004101739929280146,0.19891352339971569,0.20301526332899583,-3917000034,-4002178864,77.9560793984659,69.60755963734962,NaN,NaN,36.75052527444074,36.60216679931699
2013-02-13T09:30:00-05:00,14.499998,14.508117,14.378226,14.435049,49664956,55757204.9,69.50829904489002,68.78310074121842,NaN,NaN,151.1494684930751,124.86658603155699,-0.00305780436409947,0.1991930078738715,0.20225081223797098,-3966664990,-3992899861.4,78.89756554235838,71.09462281861906,NaN,NaN,37.10872883251815,36.674532804060014
2013-02-14T09:30:00-05:00,14.378226,14.491888,14.36198,14.482137,38629041,54102640.5,70.94123342088403,68.50283561856905,NaN,NaN,134.79486558711082,132.92553032740926,-0.0010820265137358454,0.20089827909580116,0.201980305609537,-3928035949,-3963453263.8,81.5854182303682,72.3153885182834,NaN,NaN,37.82600655005709,36.83902905348817
2013-02-15T09:30:00-05:00,14.512176,14.524354,14.370099,14.418803,78662170,54547496,66.42002000035498,68.19662892357299,NaN,NaN,118.29049350433132,136.27312038381754,-0.005670169428316607,0.19489259382414126,0.20056276325245787,-4006698119,-3960734716.6,81.81569810021789,73.360844912469,NaN,NaN,37.13053811661036,36.88067320536277
2013-02-19T09:30:00-05:00,14.467532,14.564948,14.451286,14.556821,54767172,53780884.6,70.78905370200872,68.08440912037405,NaN,NaN,151.57662301095635,142.6505251260816,-0.0012691949728587948,0.19897626953638436,0.20024546450924316,-3951930947,-3954066007.8,82.39721852433053,74.28063836659125,NaN,NaN,37.842007270021234,37.01800664317112
2013-02-20T09:30:00-05:00,14.54871,14.556821,14.329497,14.337624,67945380,54568386.05,57.90373658725022,67.38746394791849,NaN,NaN,80.83629585535776,127.32954929016628,-0.01425845627977712,0.18242239415952177,0.1966808504392989,-4019876327,-3974641266.4,74.48290619270792,74.47099728558247,NaN,NaN,34.07204677513334,36.59715523345144
2013-02-21T09:30:00-05:00,14.313268,14.313268,14.167131,14.223962,64637008,55495464.55,52.56106440966942,66.35077927140381,NaN,NaN,-25.131527172993238,92.07335015695261,-0.03069916685920665,0.15830689186529057,0.18900605872449722,-4084513335,-3998210935.4,66.59218394438285,74.17223642430427,NaN,NaN,29.081783389904786,35.52353068437335
2013-02-22T09:30:00-05:00,14.321387,14.402582,14.292971,14.402582,53334588,54032434.3,58.968302927270635,65.35613663622694,NaN,NaN,48.532302273806586,74.82083749429178,-0.029718605734372933,0.15185780155653106,0.181576407290904,-4031178747,-4018839495,60.54645126502683,73.4597150857056,NaN,NaN,27.053429463417288,34.31351622423677
2013-02-25T09:30:00-05:00,14.491888,14.491888,14.004757,14.012868,88148733,55620481.65,44.762869719533576,64.0861341700308,NaN,NaN,-74.01530570686629,36.35967765205225,-0.054072145080113765,0.1139862259407618,0.16805837102087556,-4119327480,-4041365367.2,54.705858635664214,72.44756224523728,NaN,NaN,19.285599838230265,32.16667102623584
2013-02-26T09:30:00-05:00,14.094063,14.12653,13.931689,14.085953,91557456,58283638.1,47.32559705870849,62.69142594359107,NaN,NaN,-142.64485507393928,-22.484617964926876,-0.0633699626694472,0.08884591768406658,0.15221588035351377,-4027770024,-4056533182.6,51.12930906642061,71.24792215191049,NaN,NaN,14.495192824065258,29.64217414021147
2013-02-27T09:30:00-05:00,14.061597,14.337624,14.05347,14.305149,77047763,59829831.45,54.19024570190941,61.73639714220447,NaN,NaN,-34.83611866418655,-45.619100868835744,-0.0532748429363033,0.08562232668313463,0.13889716961943793,-3950722261,-4042702369.4,54.077561817946226,70.13053302144071,NaN,NaN,13.220714281540424,27.296251303258465
2013-02-28T09:30:00-05:00,14.305149,14.402582,14.248319,14.280793,76787446,61674279.45,53.358142075010086,60.9003791830695,NaN,NaN,8.735150434520579,-38.84576534733298,-0.0469753041655418,0.08017803941251067,0.12715334357805247,-4027509707,-4031301643.8,56.41184826236973,69.09235543892495,NaN,NaN,11.980088748221052,25.108228081110262
2013-03-01T09:30:00-05:00,14.175169,14.36198,14.094063,14.321387,63726636,62674267.15,54.60916433844132,60.07665375154853,NaN,NaN,-32.86833332356038,-55.125892466806384,-0.03913297075595738,0.07823713013310574,0.11737010088906312,-3963783071,-4017822508.6,59.06142298938795,68.1889244377033,NaN,NaN,11.43790755365651,23.155325148616868
2013-03-04T09:30:00-05:00,14.280793,14.451286,14.264564,14.443159,44675921,61340932.55,58.228581914966846,59.36069956883859,NaN,NaN,52.05824093240683,-29.911183138951753,-0.025464969362301942,0.08553888918618568,0.11100385854848763,-3919107150,-3977778442.6,65.72678043112055,67.52759302862631,NaN,NaN,12.195263143273143,21.589602004996337
2013-03-05T09:30:00-05:00,14.532465,14.654254,14.508117,14.564948,81690654,62351868.75,61.53236347916619,58.64990531286171,NaN,NaN,159.54221308486652,30.5262304928094,-0.008802926640036929,0.10000020024844147,0.1088031268884784,-3837416496,-3939707737,70.62372190070343,67.00385320735757,NaN,NaN,13.923202152450042,20.494402026061152
2013-03-06T09:30:00-05:00,14.670499,14.719203,14.597423,14.662372,69088420,62888794.1,63.98618944313101,58.25546891273607,NaN,NaN,178.99759090932542,73.2929724075118,0.007327417642105136,0.11796239894110983,0.11063498129900469,-3768328076,-3903228900,74.39833893051332,66.68247987794005,NaN,NaN,16.14607475858819,19.873212416422156
2013-03-07T09:30:00-05:00,14.694855,14.784161,14.694855,14.767915,59007929,63992455.5,66.4807321249685,57.93686167731352,NaN,NaN,193.41788994569046,110.22952030974577,0.0227803592868335,0.13911043040754656,0.11633007112071306,-3709320147,-3839590988,79.37676937349511,66.52471924530627,NaN,NaN,18.80206824001359,19.720191819792362
2013-03-08T09:30:00-05:00,14.857221,14.871827,14.711084,14.808517,75282673,64646142.45,67.4157758576444,58.00798709569134,NaN,NaN,184.54066550488247,153.71132007543434,0.03280234539331939,0.1573330028623623,0.1245306574690429,-3634037474,-3773641868.6,83.05433672189194,66.6131934325687,NaN,NaN,21.232281042756306,19.93620456593007
2013-03-11T09:30:00-04:00,14.816628,14.946527,14.776034,14.922171,60934524,64943964.55,69.94332880178939,57.9475781742471,NaN,NaN,185.9351125077416,180.48669439050127,0.0434821895081014,0.17888339435416967,0.13540120484606827,-3573102950,-3704441028.6,85.89633041595819,66.86312999625639,NaN,NaN,24.093664707009825,20.530127443227176
2013-03-12T09:30:00-04:00,14.905933,14.922171,14.80039,14.840984,40278172,65207054.95,66.00462179346093,58.526212831833575,NaN,NaN,144.38289974336013,177.45483172220003,0.041481109060226146,0.18725259117135096,0.1457714821111248,-3613381122,-3659633953.8,87.37300395089859,67.78385126469858,NaN,NaN,25.29905120676017,21.211402266589033
2013-03-13T09:30:00-04:00,14.857221,14.897823,14.804449,14.881577,29854671,63286065.65,67.00509083296635,59.557929004926216,NaN,NaN,123.52070707964569,166.35945495626407,0.03931394197191859,0.19491390957602306,0.15559996760410447,-3583526451,-3622673628.8,88.4474940997614,69.34494484722562,NaN,NaN,26.5838296772815,21.97889189668796
2013-03-14T09:30:00-04:00,14.9384,15.003358,14.914052,14.979001,82845460,64945090.85,69.33743057333058,60.29858097964478,NaN,NaN,132.86428326242554,154.24873361961107,0.04069349870113645,0.20646684098052503,0.16577334227938859,-3500680991,-3580945797.6,89.53066323941351,71.41524570253895,NaN,NaN,28.380119723338755,22.893353014780928
2013-03-15T09:30:00-04:00,14.930289,14.995239,14.857221,14.97495,61545045,66090891.05,69.11864380516445,62.03827912861841,NaN,NaN,109.66056615759847,139.27271375015428,0.0376551084134803,0.21284222779623896,0.17518711938275866,-3562226036,-3566583510,89.88229225054741,73.92784810360203,NaN,NaN,29.778581086990897,23.876957025096637
2013-03-18T09:30:00-04:00,14.784161,14.897823,14.751678,14.832865,50797098,64697637.45,61.757978767405135,63.06916353638246,NaN,NaN,70.7946970031239,116.24463064923073,0.023112080948759495,0.20407722056870803,0.18096513961994853,-3613023134,-3574567546.8,88.11064400104712,76.56937202750393,NaN,NaN,28.893083216789208,24.59354648105272
2013-03-19T09:30:00-04:00,14.897823,14.914052,14.662372,14.74761,80107918,65964674.75,57.78177154434541,63.325701096556465,NaN,NaN,52.26900586677819,97.82185187391434,0.005694620041409942,0.18808341467171097,0.18238879463030103,-3693131052,-3590517532.8,84.52623670206732,78.74427737636972,NaN,NaN,26.966276689251977,24.9325079393669
2013-03-20T09:30:00-04:00,14.832865,14.881577,14.808517,14.84829,77506950,66442753.25,60.97701840385417,63.869906548616754,NaN,NaN,63.92762671395255,85.90323580077572,-0.0007584698480360419,0.18144070732025597,0.182199177168292,-3615624102,-3596937063,83.0616431454872,80.64783415373526,NaN,NaN,26.236224878031873,25.11875321631904
2013-03-21T09:30:00-04:00,14.767915,14.824738,14.666432,14.670499,70609255,66741365.6,53.30478423177119,63.776736540997454,NaN,NaN,28.616360947179988,65.0536513377266,-0.01777066271815836,0.15998584877059407,0.17775651148875243,-3686233357,-3634047536.2,74.97413083989716,81.78445614305734,NaN,NaN,23.169205963400895,24.840246465902162
2013-03-22T09:30:00-04:00,14.751678,14.784161,14.67861,14.755737,54365748,66792923.6,56.15318983188518,63.62849424934877,NaN,NaN,30.042130829740646,49.12996427215502,-0.023682890279914798,0.14815289863885894,0.17183578891877374,-3631867609,-3647975850.8,72.13524010827302,82.24220326285395,NaN,NaN,21.478883393260826,24.360051741239115
2013-03-25T09:30:00-04:00,14.816628,14.857221,14.638016,14.719203,61079670,65439470.45,54.615412966216184,63.13442635556663,NaN,NaN,24.83220644649085,39.937466160828414,-0.030045172351071986,0.13427932347993377,0.16432449583100575,-3692947279,-3663960679.8,68.91034373528584,82.11981910818125,NaN,NaN,19.640786459246264,23.685870986668707
2013-03-26T09:30:00-04:00,14.776034,14.824738,14.719203,14.812568,59827154,63852955.35,57.79625050677098,62.692287860112344,NaN,NaN,34.37351897128752,36.358368781730285,-0.027997688792821773,0.12932738483997852,0.1573250736328003,-3633120125,-3651958494.4,69.99501640035254,81.80529607031261,NaN,NaN,19.00989319766447,23.017874159668104
2013-03-27T09:30:00-04:00,14.711084,14.759788,14.662372,14.743559,39239858,61962560.1,54.742296921856415,61.85382820274719,NaN,NaN,0.9786937089111896,23.768582180722014,-0.031084976482343624,0.11846885302987076,0.14955382951221438,-3672359983,-3663305670.6,67.59395757153274,80.96366665588674,NaN,NaN,17.57768991480452,22.240704981830447
2013-03-28T09:30:00-04:00,14.735432,14.792271,14.702966,14.783341,31705410,59708458.3,56.17978045633095,61.051257102653366,NaN,NaN,10.10499121543589,20.066308234373192,-0.030215162177097354,0.1117848767908427,0.14200003896794006,-3640654573,-3654189913.8,68.52796456408585,79.92606864461486,NaN,NaN,16.79607645327805,21.46290090632296
2013-04-01T09:30:00-04:00,14.776034,14.832865,14.662372,14.711084,27335016,57888877.3,52.89359939595329,59.83341928795079,NaN,NaN,-23.35654591148584,9.386572886127896,-0.03399191087648368,0.09951015037233546,0.13350206124881914,-3667989589,-3661414309.8,66.88271596857938,78.56795332694495,NaN,NaN,15.185136745520433,20.566077454779744
2013-04-02T09:30:00-04:00,14.751678,14.816628,14.743559,14.796339,49317353,58120948.9,56.15256836999192,59.12970118627443,NaN,NaN,-0.5358306464113421,4.312965467547457,-0.030353529536693985,0.09556014932795165,0.12591367886464563,-3618672236,-3646559301.2,68.55449296654614,77.22377397091977,NaN,NaN,14.725640162301486,19.731729270139994
2013-04-03T09:30:00-04:00,14.808517,14.808517,14.499998,14.55277,109220461,59497439.25,46.29777986665826,57.650607545823846,NaN,NaN,-167.10806540890349,-35.98335140849072,-0.043173815958740105,0.0719464089162205,0.11512022487496061,-3727892697,-3665513815.6,64.10759125669897,75.4852094821296,NaN,NaN,11.117635054881404,18.501144382245908
2013-04-04T09:30:00-04:00,14.564948,14.694855,14.564948,14.682677,68158261,59450931.3,51.21540696340169,56.35617728797178,NaN,NaN,-138.55197433711484,-63.889485017695925,-0.04170524820605839,0.06298866461738761,0.104693912823446,-3659734436,-3662988706.2,64.43853446821834,73.69291456990138,NaN,NaN,9.642827625420374,17.23567055984226
2013-04-05T09:30:00-04:00,14.451286,14.662372,14.42693,14.638016,73573985,60179234.1,49.53596667224264,54.95741463562023,NaN,NaN,-179.04525655638952,-101.71953457206101,-0.042403155466609846,0.0516899684901837,0.09409312395679355,-3733308421,-3681519475.8,60.061828578652126,71.56288145048029,NaN,NaN,7.9303136161949315,15.906333853606926
2013-04-08T09:30:00-04:00,14.621771,14.792271,14.560888,14.784161,51488696,58989535.25,54.76346037192856,54.45780617880047,NaN,NaN,-53.51017963923871,-107.75026131761157,-0.0321489433110481,0.053906944817983415,0.08605588812903152,-3681819725,-3684285503,59.41314644735359,69.51306019664504,NaN,NaN,8.118617849801563,14.793802995920446
2013-04-09T09:30:00-04:00,14.824738,14.922171,14.767915,14.824738,62435532,59064585.65,56.122505981871896,54.33928721005236,NaN,NaN,57.96604432751125,-96.04988632282706,-0.02223152681778931,0.058266479606794874,0.08049800642458418,-3619384193,-3684427894.4,59.377594124713255,67.71672858397689,NaN,NaN,8.690412512992628,13.921890069787901
2013-04-10T09:30:00-04:00,14.881577,15.043951,14.881577,15.023654,82612595,61181306.8,62.12905784557573,54.42157574160391,NaN,NaN,165.1187592778176,-29.604521385482848,-0.002889599463356013,0.07688600709538917,0.07977560655874519,-3536771598,-3646203674.6,65.36854451472792,66.45293582463694,NaN,NaN,11.17973545261866,13.53015369590658
2013-04-11T09:30:00-04:00,15.035832,15.141294,14.987128,15.060188,60202209,62698683.7,63.12744467220795,55.12319434449224,NaN,NaN,193.7680317325442,36.859479828448954,0.010989239018447686,0.09351215533180479,0.0825229163133571,-3476569389,-3609570665.2,69.94350244403435,66.09360522493245,NaN,NaN,13.487230026164665,13.524021743086307
2013-04-12T09:30:00-04:00,14.962756,15.035832,14.914052,14.995239,56869695,61399895.45,60.09434776655506,55.404705625540096,NaN,NaN,134.23759237658928,99.51604961504471,0.014214912909771421,0.10029155745057139,0.08607664454079997,-3533439084,-3569596797.8,73.98247252130938,66.22555039729218,NaN,NaN,14.484374749031371,13.661215029649886
2013-04-15T09:30:00-04:00,14.970802,15.043951,14.662372,14.67861,88314946,62738390.5,47.989102176122444,54.93139771196197,NaN,NaN,9.592868490791284,112.13665924105071,-0.005499733825212405,0.07920197725928446,0.08470171108449687,-3621754030,-3557583658.8,75.06683550667933,66.66529980953457,NaN,NaN,11.27325512905212,13.320077900993063
2013-04-16T09:30:00-04:00,14.824738,14.922171,14.727322,14.905933,55197231,62958397.15,54.997992155629554,54.731522115451874,NaN,NaN,51.78141107644815,110.89973259083808,-0.003833173867329176,0.0799102437503354,0.08374341761766457,-3566556799,-3547018180,76.01370305549216,67.09520599918741,NaN,NaN,11.014555551763044,12.990717565388774
2013-04-17T09:30:00-04:00,14.763856,14.780093,14.508117,14.625838,97703681,63838185.3,46.65535995610397,54.15388376075527,NaN,NaN,-98.82536918144638,58.110906898985284,-0.021226146364433512,0.057210734662122675,0.07843688102655619,-3664260480,-3572515956.4,69.1852381843942,67.20886890010608,NaN,NaN,7.649174739674869,12.227640018858215
2013-04-18T09:30:00-04:00,14.621771,14.629897,14.410692,14.475642,76022496,63763962.6,42.897616566625565,53.205157768633455,NaN,NaN,-168.93303813475472,-14.42930707447449,-0.04131526680757361,0.026792797517089184,0.06810806432466279,-3740282976,-3625258673.8,57.64891964531796,66.43179426305123,NaN,NaN,3.596060344495837,10.994557208235019
2013-04-19T09:30:00-04:00,14.524354,14.686728,14.508117,14.67861,67022493,63584624.5,48.88858916185717,52.919085609055166,NaN,NaN,-83.15984616246574,-57.90879478228548,-0.03940890838612125,0.018846928842011224,0.058255837228132476,-3673260483,-3653222953.6,52.637351410864355,65.41426822321445,NaN,NaN,2.472427415637526,9.777110095006806
2013-04-22T09:30:00-04:00,14.711084,14.719203,14.54871,14.694855,53950864,63563880.3,49.34665515683658,52.43294895097264,NaN,NaN,-59.32082908748751,-71.69153429794123,-0.03564254916135171,0.013702650776442837,0.04934519993779455,-3619309619,-3652734071.4,52.714742952651456,64.28285750793626,NaN,NaN,1.778936375058238,8.634513849299868
2013-04-23T09:30:00-04:00,14.808428,14.970883,14.792271,14.958705,92204180,65120105.8,56.21097519009092,53.14103433121783,NaN,NaN,85.23296794284204,-65.00122292466247,-0.015025007012586071,0.03056394117206196,0.04558894818464803,-3527105439,-3644843799.4,54.02059302271922,63.56235763408057,NaN,NaN,3.6028037799852934,7.915698125112072
2013-04-24T09:30:00-04:00,14.979001,15.076434,14.962756,15.052062,46468621,64452179.15,58.36109738321344,53.65144078977581,NaN,NaN,133.58022111862715,-18.520104864647767,0.004227504575930803,0.05087332890456153,0.04664582432863073,-3480636818,-3608119067,59.611436319109345,63.21756490914421,NaN,NaN,5.779308351288283,7.610499585994388
2013-04-25T09:30:00-04:00,15.108901,15.230673,15.076434,15.141367,44383381,64709355.3,60.365938753258874,54.42501022413411,NaN,NaN,162.423249752411,47.751152712785384,0.02134696847172908,0.07332953491829208,0.051982566446563,-3436253437,-3547313159.2,66.807918609407,63.69942848276956,NaN,NaN,8.18789641771903,7.6929848476693365
2013-04-26T09:30:00-04:00,15.117019,15.149494,15.011484,15.072367,29451532,64596661.4,58.04068029078028,54.65909736119495,NaN,NaN,111.84100175967438,86.7513222972134,0.026080739481891303,0.08458349079892713,0.05850275131703583,-3465704969,-3505802056.4,70.65239888967064,64.50223222864935,NaN,NaN,9.410208765298087,7.938302550187729
2013-04-29T09:30:00-04:00,15.141367,15.165723,15.076434,15.141367,36938800,65076850.6,59.71192658785375,54.91548454733651,NaN,NaN,115.64174904433206,121.74383792357733,0.03155064036950972,0.09794105177892298,0.06639041140941326,-3428766169,-3467693366.4,73.66773544498366,65.52295660866866,NaN,NaN,10.921919812377674,8.364533587643436
2013-04-30T09:30:00-04:00,15.133257,15.190096,15.068307,15.181969,50588512,65140408.55,60.70377626659838,54.8136787202667,NaN,NaN,107.98293489941268,126.29383131489143,0.035310987651466605,0.11052914597374652,0.07521815832227992,-3378177657,-3437907810,75.76375308862032,66.26547150680383,NaN,NaN,12.449695699194686,8.9481281750079
2013-05-01T09:30:00-04:00,15.157613,15.17385,15.003358,15.011484,49952430,62177007,54.622882678682124,54.20621000644343,NaN,NaN,70.24042568772121,113.62587222871028,0.024251136148937244,0.10553207850845148,0.08128094235951423,-3428130087,-3427406463.8,76.4747455503778,66.73198887154265,NaN,NaN,11.974238134502714,9.380429597792874
2013-05-02T09:30:00-04:00,15.060188,15.165723,15.035832,15.141367,54045066,61471347.25,58.06905629058468,54.061546329588396,NaN,NaN,80.87727218546488,97.31667671532105,0.02359555765535662,0.11077538942871001,0.0871798317733534,-3374085021,-3414972780.6,77.32299733846799,66.97059778705398,NaN,NaN,12.610843271186715,9.841917265420566
2013-05-03T09:30:00-04:00,15.295631,15.376818,15.279402,15.303758,50426299,60313962.95,61.959025890200415,55.059398023451116,NaN,NaN,141.9060143704745,103.32967923748106,0.031516347994042196,0.12657526676590614,0.09505891877186394,-3323658722,-3386563531.2,79.17100362311945,67.26375265251399,NaN,NaN,14.37101111808629,10.48893067294424
2013-05-06T09:30:00-04:00,15.344335,15.482369,15.336224,15.466123,29358394,59207447.85,65.41387165042867,55.80338941593676,NaN,NaN,162.07654619304904,112.61663866722446,0.044323927855438566,0.15046382859116214,0.10613990073572357,-3294300328,-3359670363,80.76869686581847,67.60339506753729,NaN,NaN,16.978869572301196,11.416064801423806
2013-05-07T09:30:00-04:00,15.518903,15.596031,15.433641,15.547302,48674551,58519398.8,67.0263009015984,57.25845662632923,NaN,NaN,170.8793527848487,125.19592224431167,0.05424093416487741,0.17394106844182033,0.11970013427694293,-3245625777,-3333159987,82.21678173456293,68.53421960683507,NaN,NaN,19.625453622473955,12.5888346330024
2013-05-08T09:30:00-04:00,15.547302,15.693447,15.498598,15.673142,77988190,58288178.55,69.40728470002462,59.15200435014344,NaN,NaN,171.63799638487856,145.47543638374313,0.06455285373683378,0.20039120144798517,0.13583834771115139,-3167637587,-3281061487,84.66117660952328,70.46366653284971,NaN,NaN,22.60972980743829,14.020391086493241
2013-05-09T09:30:00-04:00,15.685337,15.685337,15.518903,15.563548,46540554,57605095.8,65.00490355227016,60.30316966374437,NaN,NaN,140.08007889440333,157.31599772553082,0.05939975255278021,0.21008803840212664,0.15068828584934643,-3214178141,-3249080111,85.93890017938072,72.84234858774374,NaN,NaN,23.78827628358782,15.415803257506752
2013-05-10T09:30:00-04:00,15.579785,15.628497,15.531073,15.628497,65675933,58045407.7,66.36642953256768,61.51886783343945,NaN,NaN,123.70590476413585,153.6759758042631,0.05582715248958589,0.2204722264613288,0.1646450739717429,-3148502208,-3214048808.2,87.19696130850213,75.30536418459022,NaN,NaN,25.166931825258665,16.808821624328456
2013-05-13T09:30:00-04:00,15.604141,15.709693,15.563548,15.67721,38786623,55568991.55,67.3911635004028,62.317452712747446,NaN,NaN,121.52344908368138,145.56535638238955,0.052269076545368665,0.22998141965345376,0.1777123431080851,-3109715585,-3177131859.6,88.37714464195004,77.75940358596385,NaN,NaN,26.6047099985795,18.208234249221462
2013-05-14T09:30:00-04:00,15.709693,16.042543,15.693447,15.945127,42094699,54913864.95,72.37613500521766,63.31852682860489,NaN,NaN,149.93340571308096,141.376166968036,0.06277657963907654,0.2561830676569308,0.19340648801785423,-3067620886,-3141530881.4,89.39261141132975,79.88663037826531,NaN,NaN,29.510102295358543,19.822786827241046
2013-05-15T09:30:00-04:00,15.945127,16.131857,15.904533,16.091272,58122014,52934781.6,74.65244701576502,64.33899170449818,NaN,NaN,155.3461371009931,138.1177951112589,0.07363500942141091,0.28545024979461786,0.21181524037320695,-3009498872,-3109903138.4,90.21086540896341,81.55826943537649,NaN,NaN,32.70547794796785,21.66317127305916
2013-05-16T09:30:00-04:00,16.058789,16.148094,15.945127,15.98572,46192971,51443305.35,70.15590391949985,65.2043648208353,NaN,NaN,136.29730403033025,137.36124013844432,0.06791363281048624,0.29670728138631475,0.2287936485758285,-3055691843,-3078205878.8,90.96323437671452,83.00904339873675,NaN,NaN,33.971397531200545,23.4214893099365
2013-05-17T09:30:00-04:00,16.058789,16.204933,16.05067,16.196806,59054479,51044904.65,73.58278748713316,66.19514059935526,NaN,NaN,143.2737538865579,141.2748099629287,0.07215258730177015,0.3189843827030412,0.24683179540127104,-2996637364,-3047832910,91.62728769889998,84.29186855973079,NaN,NaN,36.186671636534896,25.245086785164844
2013-05-20T09:30:00-04:00,16.180561,16.310468,16.164332,16.229289,40446081,50369665.5,74.07610056938628,67.15030662098296,NaN,NaN,143.53822608209248,145.67776536261096,0.07084979481301257,0.3353940389175367,0.26454424410452415,-2956191283,-3017128049.6,92.24749457984944,85.46927866624715,NaN,NaN,38.106079054824214,27.082371395116184
2013-05-21T09:30:00-04:00,16.261756,16.351062,16.221163,16.269867,44636013,47991257.15,74.71140164515617,68.58520083287397,NaN,NaN,136.52055979771575,142.9951961795379,0.06649696018845208,0.3476654443400893,0.2811684841516372,-2911555270,-2985914926.4,92.82901380968805,86.6374406847693,NaN,NaN,39.86041485258993,28.90780617475529
2013-05-22T09:30:00-04:00,16.30235,16.521563,16.034432,16.099382,118192419,51577447.05,67.25415352727296,69.24127920692312,NaN,NaN,112.04404202384775,134.33477716410883,0.04683949342447552,0.3397178509322316,0.2928783575077561,-3029747689,-2989964689.8,91.86617246169538,87.67623890785697,NaN,NaN,39.143369191789255,30.370029462903
2013-05-23T09:30:00-04:00,15.872059,16.083145,15.823354,16.001966,73752832,53045919.6,63.36234256840792,69.34151611250938,NaN,NaN,58.680024287667656,118.8113212155763,0.0231761928230218,0.32184859853653336,0.29867240571351156,-3103500521,-2999526425.4,89.50562314152857,88.41442601631478,NaN,NaN,37.36294378346406,31.36901722298315
2013-05-24T09:30:00-04:00,15.916711,16.026322,15.847702,16.018195,62142342,54680460.1,63.738804352753384,69.22186844838971,NaN,NaN,50.687022407935466,100.2939749198518,0.0054423176704666565,0.30547530280159485,0.3000329851311282,-3041358179,-3008470588.4,87.2472441116084,88.87717939101404,NaN,NaN,36.02215919138465,32.03375178989765
2013-05-28T09:30:00-04:00,16.2374,16.326706,16.107501,16.181381,58840829,55775561.55,67.36952183963501,69.24638422967806,NaN,NaN,87.17324685729598,89.0209790748925,0.001720578835372355,0.3021837086753436,0.30046312983997125,-2982517350,-3013735801.8,85.8736220748734,89.1383822724648,NaN,NaN,35.890439154101166,32.58470712764101
2013-05-29T09:30:00-04:00,16.091272,16.261756,16.058789,16.180561,59481010,56220186.45,67.33303853338862,69.09822378920406,NaN,NaN,73.10163712026562,76.33719453940247,-0.0034939260357950697,0.2960957222952274,0.2995896483310225,-3041998360,-3039824419.8,79.21841660078996,88.74961370041241,NaN,NaN,35.77352933349528,33.04025315704877
2013-05-30T09:30:00-04:00,16.204933,16.432257,16.17245,16.375418,68470351,57146082.5,71.3091695452018,69.54852850298488,NaN,NaN,99.51425971396822,73.83123807742658,0.0031248975902523624,0.3034957703188379,0.30037087272858554,-2973528009,-3028580483.8,79.93999688399472,88.32112060788484,NaN,NaN,36.842939299760246,33.583494034578976
2013-05-31T09:30:00-04:00,16.334824,16.399774,16.099382,16.107582,73904699,58139064.15,60.422644067909204,69.12397239836642,NaN,NaN,68.50316708439203,75.79586663677144,-0.012721456001376974,0.2844690527268643,0.29719050872824126,-3047432708,-3017366921.2,80.66118059894487,87.85427912863075,NaN,NaN,34.30865768510034,33.68708884179632
2013-06-03T09:30:00-04:00,16.17245,16.188688,15.872059,16.123738,123477128,61791605.6,60.81129029543021,68.65398145515408,NaN,NaN,28.832730435543112,71.42500824229296,-0.023665154655687748,0.2676090654086316,0.29127422006431936,-2923955580,-2993886401.4,82.11141957059698,87.40672733781982,NaN,NaN,32.41539838040539,33.50541877588333
2013-06-04T09:30:00-04:00,16.148094,16.2374,15.937008,15.977593,77288137,64188092.75,55.50183663119841,67.44867442843842,NaN,NaN,19.6185831257148,57.914075495976725,-0.041266010389276964,0.23969170707772314,0.2809577174670001,-3001243717,-2997631674.8,81.0671443058724,86.81205111600143,NaN,NaN,29.12900078424699,32.88021620564957
2013-06-05T09:30:00-04:00,15.945127,16.010076,15.656913,15.717803,108516072,67180168.8,47.55357835316473,65.51304095253842,NaN,NaN,-71.29687196456065,29.03437367901147,-0.06927528208762629,0.19436361485746723,0.2636388969450935,-3109759789,-3011183960.6,77.23922270541647,85.88550520860522,NaN,NaN,23.51057030745235,31.541695363049964
2013-06-06T09:30:00-04:00,15.701566,15.945127,15.604141,15.937008,87883133,67674915.95,53.59257510808257,64.32994603743718,NaN,NaN,-67.55307320876896,-4.379092905535961,-0.07161382070144168,0.17412162106829143,0.2457354417697331,-3021876656,-3020853690,74.5348653236114,84.71205027624072,NaN,NaN,20.70635694348026,29.993789874540006
2013-06-07T09:30:00-04:00,16.026322,16.2374,15.977593,16.213044,65568487,68626312.6,59.86046331864314,63.34978002540218,NaN,NaN,42.66433148574994,-9.54686002526438,-0.053949807048439574,0.17829818295918365,0.23224799000762322,-2956308169,-3002628782.2,76.22449540864683,83.61185082693692,NaN,NaN,20.491338617335952,28.63629683779657
2013-06-10T09:30:00-04:00,16.294239,16.310468,16.164332,16.221163,81274785,69406255.2,60.03145446166825,62.34659101770803,NaN,NaN,74.04901961352063,-0.5036021896688794,-0.04164943244636679,0.18018619944966474,0.22183563189603153,-2875033384,-2992844343,77.10287433242296,82.53009223783502,NaN,NaN,20.383308427761435,27.45729849350584
2013-06-11T09:30:00-04:00,16.058789,16.123738,15.928889,15.953237,87024553,71818151.7,52.13822853296836,60.73422150969462,NaN,NaN,-46.3172650674983,-13.690771828311501,-0.05087730837969284,0.15823899642141548,0.20911630480110832,-2962057937,-2985007187,77.81003171757777,81.4573078026843,NaN,NaN,17.591194331868422,26.047855041843352
2013-06-12T09:30:00-04:00,16.058789,16.066899,15.75027,15.782753,79081705,73667502,47.828809834172255,59.34669696018743,NaN,NaN,-115.77156913435226,-22.58571126226979,-0.06678045369738445,0.12564073767937778,0.19242119137676222,-3041139642,-2971283157.6,79.03130896365424,80.5405318385385,NaN,NaN,13.818894841755444,24.30086072754508
2013-06-13T09:30:00-04:00,15.774626,16.099382,15.734041,16.079077,85987973,75060799.95,54.81896031618238,58.736455370742746,NaN,NaN,-57.87148962020946,-20.649394544557886,-0.056091057213810774,0.12230736985949875,0.17839842707330952,-2955151669,-2957938160.2,80.17396368572521,79.87398473455254,NaN,NaN,13.018809192585397,22.689139079693696
2013-06-14T09:30:00-04:00,16.058789,16.099382,15.843237,15.872059,54656336,75483968.2,49.798978124119984,57.74075349726893,NaN,NaN,-69.85117623929933,-43.15249608956774,-0.061288594215277103,0.10178768430421314,0.16307627851949025,-3009808005,-2968638127.4,76.57102560511116,79.11139769837416,NaN,NaN,10.597437206219038,20.961753097768746
2013-06-17T09:30:00-04:00,15.993839,16.099382,15.937008,16.026322,56911613,75376824.9,53.235550951616595,56.73118414812477,NaN,NaN,-26.265001454190415,-63.21530030310995,-0.052975491360643806,0.09685691431868548,0.1498324056793293,-2952896392,-2984210729,71.53264320286918,78.08704206465958,NaN,NaN,9.825008655412816,19.370789606003612
2013-06-18T09:30:00-04:00,16.042543,16.17245,16.026322,16.127806,42169529,75462997.3,55.398674128314575,55.87872954776234,NaN,NaN,21.56856806310604,-49.638133676989085,-0.03987745839516996,0.09998558268536684,0.1398630410805368,-2910726863,-2973944514.2,72.80315596022066,77.62880916176177,NaN,NaN,9.923154570760156,18.02112745811169
2013-06-19T09:30:00-04:00,16.139976,16.156205,15.896415,15.91266,75473974,77004895.35,50.10709785012457,54.36429585525682,NaN,NaN,-36.228612432819524,-33.72954233668254,-0.04458264256776834,0.08413473787082637,0.1287173804385947,-2986200837,-2962956753.2,74.13375968437705,77.21407793321764,NaN,NaN,8.249741485347743,16.62521517628827
2013-06-20T09:30:00-04:00,15.766515,15.823265,15.506725,15.567607,126652276,77427888.2,43.01124053887549,53.12062417461156,NaN,NaN,-203.131143505767,-62.78147311379405,-0.06838863320061277,0.04323158893782875,0.11162022213844151,-3112853113,-2994497042,64.39461301719717,76.05218024880709,NaN,NaN,4.2920294970132655,14.86333150782041
2013-06-21T09:30:00-04:00,15.636608,15.644735,15.336224,15.518903,105524598,79016476.5,42.104878823925716,51.78445192664695,NaN,NaN,-219.7738586333548,-92.76600959260514,-0.08385051752875392,0.006807075227499126,0.09065759275625304,-3218377711,-3036210983.2,54.24469775815583,74.06170011934701,NaN,NaN,0.922721744247865,12.871815827310046
2013-06-24T09:30:00-04:00,15.328106,15.409293,15.084545,15.242851,96954024,80757060.6,37.30629922196402,50.4847706831302,NaN,NaN,-246.5555044897676,-136.82411019972056,-0.1075896460942302,-0.04382946486153472,0.06376018123269549,-3315331735,-3108698051.8,41.888789282874406,71.26324618913286,NaN,NaN,-3.600796680445262,10.518585469059287
2013-06-25T09:30:00-04:00,15.401174,15.604141,15.36058,15.527014,80258938,81827966.05,44.33857533305676,50.25512761026535,NaN,NaN,-134.68346299187561,-168.07451641071688,-0.09927551554213826,-0.06033421319497734,0.03894130234716092,-3235072797,-3173567238.6,34.348503457664506,68.199623385722,NaN,NaN,-5.026829361958345,8.297811921771054
2013-06-26T09:30:00-04:00,15.67721,15.742159,15.587904,15.685337,82281251,82967978.1,47.848516516853856,49.844837710891866,NaN,NaN,-70.54317556006136,-174.93742903616527,-0.07911140944548616,-0.059947959459696776,0.01916344998578938,-3152791546,-3206885380.4,31.238198433422312,65.10700432213706,NaN,NaN,-4.997178558996365,6.398527567375709
2013-06-27T09:30:00-04:00,15.790871,15.91266,15.766515,15.888304,52994336,82194177.35,52.02514014601066,49.28517176998955,NaN,NaN,-8.120372116862404,-135.93527475838434,-0.04954761732267737,-0.04277107166755734,0.0067765456551200365,-3099797210,-3204274199.8,31.75972537621665,61.93094931982062,NaN,NaN,-3.5722362246472628,4.9741327399438555
2013-06-28T09:30:00-04:00,15.831465,15.863932,15.701566,15.78682,63412102,81669547.5,49.874375103076844,48.559666101518744,NaN,NaN,-26.151380289540032,-97.21077908962141,-0.034958489460402434,-0.036921566170383,-0.001963076709980572,-3163209312,-3193240520,34.036405244119635,58.854772956370375,NaN,NaN,-3.1111417410928954,3.8190935283671767
2013-07-01T09:30:00-04:00,15.904533,16.2374,15.831465,15.839576,73565235,79173952.85,51.00824104085181,48.4789527092247,NaN,NaN,40.449705625650594,-39.809737066537764,-0.020597063303011927,-0.027709405838745482,-0.0071123425357335545,-3089644077,-3148102988.4,42.489410396681095,56.33187143344919,NaN,NaN,-2.39400519091927,2.9315079970405415
2013-07-02T09:30:00-04:00,15.847702,16.018195,15.782753,15.855821,74316489,79025370.45,51.37300496664905,48.73210950440161,NaN,NaN,14.20611722410094,-10.031821023342454,-0.009414307703251808,-0.018880227164798313,-0.009465919461546506,-3015327588,-3104153946.6,49.301747042767566,54.208331296242996,NaN,NaN,-1.7103476381091367,2.2683857634477302
2013-07-03T09:30:00-04:00,15.75027,15.847702,15.701566,15.807109,30848722,75142002.95,50.166840506427796,48.39981523227628,NaN,NaN,-22.236298758352724,-0.37044566300073567,-0.004934046632129003,-0.01563347775170776,-0.010699431119578755,-3046176310,-3082830899.4,52.25666594365715,52.21423860038099,NaN,NaN,-1.475791610580333,1.7335032814437212
2013-07-05T09:30:00-04:00,15.98572,16.091272,15.876361,16.091272,46612073,73078449.95,56.572355904199874,48.88362793085342,NaN,NaN,58.23476123395515,12.90058100716278,0.016364908562346722,0.009756704583354647,-0.006608203978992075,-2999564237,-3062784304.8,54.91703024505558,50.6675246460913,NaN,NaN,0.6574937713744962,1.5797876371481177
2013-07-08T09:30:00-04:00,16.196806,16.269867,16.156205,16.208985,58708610,72735456.1,58.92755587075819,49.2901997107921,NaN,NaN,123.48881675478654,42.8286204160281,0.03642921989559528,0.03892832089050202,0.0024991009949067444,-2940855627,-3018313567.8,60.213457054521776,49.85901134978078,NaN,NaN,3.159550715649808,1.8054680769340734
2013-07-09T09:30:00-04:00,16.310468,16.359172,16.196003,16.346994,93206882,73332060.95,61.55973563796586,49.730275532910056,NaN,NaN,151.30249287805265,64.99917786650852,0.055880089764689125,0.07234921320076815,0.016469123436079026,-2847648745,-2969914501.4,65.02881083294625,49.3037009835469,NaN,NaN,6.081423344510563,2.416318829445
2013-07-10T09:30:00-04:00,16.30235,16.334824,16.164332,16.253637,71097648,72535715.7,58.81393260606368,50.35219230119141,NaN,NaN,122.90980539697128,86.73991550108258,0.059034220034019536,0.09026189847860344,0.03122767844458391,-2918746393,-2950598262.4,66.75802612685845,48.77686287229557,NaN,NaN,7.750124181260769,3.1782910225615386
2013-07-11T09:30:00-04:00,16.472834,16.472834,16.286112,16.407901,74453437,72304302.3,61.842614285602735,51.69729042595764,NaN,NaN,144.22443899305011,120.03206305136317,0.06747656772519943,0.1155733881010832,0.04809682037588377,-2844292956,-2910221591.6,70.08755786513116,49.18350179000514,NaN,NaN,10.08750408407225,4.165321459920212
2013-07-12T09:30:00-04:00,16.448478,16.529673,16.407901,16.521563,53076990,70658753.15,63.94633513400994,53.257394448106524,NaN,NaN,149.98041178838457,138.38119316224905,0.07604598829702955,0.1431543057471707,0.06710831745014115,-2791215966,-2868551937.4,73.0838451187926,50.52915517290776,NaN,NaN,12.690945305609484,5.383267723590108
2013-07-15T09:30:00-04:00,16.627098,16.631157,16.495818,16.594623,32284853,69540179,65.27171948127986,55.25492446662908,NaN,NaN,147.90124179333753,143.26367816995926,0.08148138352579568,0.16896004685738575,0.08747866333159007,-2758931113,-2832167034.6,75.4009023345036,52.922877533738415,NaN,NaN,15.25581269422174,6.793631290823198
2013-07-16T09:30:00-04:00,16.594696,16.643335,16.456605,16.529673,44633096,68926253.15,63.0526054084594,56.59164090058641,NaN,NaN,123.11752046146576,137.62668368664188,0.07567431164771496,0.18207155289123378,0.10639724124351882,-2803564209,-2823350127.4,75.94137565974877,55.89379697674443,NaN,NaN,16.80624581395173,8.224004794127273
2013-07-17T09:30:00-04:00,16.56214,16.651446,16.521563,16.59869,46101508,69122852.1,64.43624748027159,57.77647882654482,NaN,NaN,118.03837686897998,136.65239798104363,0.07150207939849762,0.19577484049164084,0.12427276109314322,-2757462701,-2791093389,77.85809667134316,59.22378970802448,NaN,NaN,18.505740363643213,9.692824161200978
2013-07-18T09:30:00-04:00,16.651446,16.830065,16.643335,16.821946,57987057,68248506.25,68.54041161863177,58.95614107458919,NaN,NaN,129.92319630486242,133.79214944340606,0.07825345321257543,0.2220895776088625,0.14383612439628707,-2699475644,-2762129926.6,79.44184766928704,62.629655586100945,NaN,NaN,21.255440014207288,11.344626425916164
2013-07-19T09:30:00-04:00,16.813836,16.830065,16.72453,16.830065,40712114,63951498.15,68.68195704555554,60.29953978476624,NaN,NaN,119.4089022852391,127.67784754277697,0.07758971732060355,0.2408232710470415,0.16323355372643794,-2658763530,-2735639439.4,80.79489441669988,65.96954766985667,NaN,NaN,23.54535202498435,13.087587225783048
2013-07-22T09:30:00-04:00,16.838192,16.943727,16.813836,16.943727,32809489,60315742.7,70.67140036061039,61.704051164748996,NaN,NaN,124.78354086533705,123.05430735717687,0.07887179348340473,0.26182329558069384,0.1829515020972891,-2625954041,-2709044025,82.0707248388201,68.79678441572375,NaN,NaN,26.100158153041843,14.946525929677161
2013-07-23T09:30:00-04:00,16.992431,16.992431,16.865625,16.878769,37204478,57328265.4,68.01234878033974,62.892575722869765,NaN,NaN,118.84409586945105,122.19962243877394,0.06972738251191973,0.2701107302371888,0.20038334772526906,-2663158519,-2680962887,83.32995644166968,71.22737080135961,NaN,NaN,27.55008466045127,16.747034319787748
2013-07-24T09:30:00-04:00,16.943727,16.943727,16.72453,16.756997,45206193,55575628.15,63.21087723139445,63.82429263179595,NaN,NaN,91.70802515719302,116.93355209641652,0.050742556971561076,0.2638115439397204,0.21306898696815932,-2708364712,-2671143289.2,83.75949879269241,73.47757314771927,NaN,NaN,27.4879751550302,18.2814544391081
2013-07-25T09:30:00-04:00,16.716403,16.781353,16.618979,16.773234,46268570,53774994.1,63.58008308018762,64.32484457293792,NaN,NaN,69.34955126849115,104.81882308914228,0.03527692556001025,0.25716514391817213,0.2218882183581619,-2662096142,-2663667388.8,84.09550221842063,75.56174971724535,NaN,NaN,27.534083558951384,19.603258599085713
2013-07-26T09:30:00-04:00,16.692047,16.756997,16.586496,16.756997,37893317,53019943.15,62.90027492984402,64.60861022001549,NaN,NaN,58.738833009464706,92.6848092339874,0.020674972740662934,0.24773193428399054,0.2270569615433276,-2699989459,-2671912574.6,82.07855015356105,77.12354208146245,NaN,NaN,27.3962581409613,20.716544247925082
2013-07-29T09:30:00-04:00,16.72453,16.72453,16.570267,16.635224,35652978,51631986.95,57.90021350754994,64.34721578212864,NaN,NaN,41.65448587155606,76.0589982352312,0.0005976320123907697,0.22780400155881608,0.2272063695464253,-2735642437,-2693850253.8,76.80063348784253,77.96438655681219,NaN,NaN,25.92760498919069,21.460981496677313
2013-07-30T09:30:00-04:00,16.683929,16.732641,16.578312,16.627098,29583278,49432889.1,57.57133191363776,64.2584585898125,NaN,NaN,37.67949025232576,59.826077111806136,-0.01460776448845355,0.20894666393585837,0.22355442842431192,-2765225715,-2714263693,72.15133524083473,78.3496229220962,NaN,NaN,24.608068113836808,21.91056529912867
2013-07-31T09:30:00-04:00,16.635224,16.789463,16.610868,16.635224,56289149,48531522.1,57.82929345553873,63.971792816236494,NaN,NaN,41.0571478676877,49.69590165390507,-0.024891970000010727,0.1924394659242985,0.21733143592430923,-2708936566,-2714378063.8,72.12499061489214,78.49515383279342,NaN,NaN,23.550335667110353,22.144818208840338
2013-08-01T09:30:00-04:00,16.789463,16.919371,16.773234,16.899074,41981341,49088153.05,65.22286571426554,64.06297357196902,NaN,NaN,93.76918609806621,54.57982861982008,-0.015176111195166764,0.19836129693035076,0.21353740812551752,-2666955225,-2715349880.4,71.8848096260613,78.40950844045548,NaN,NaN,24.577919531853958,22.492404112127996
2013-08-02T09:30:00-04:00,16.886896,16.911252,16.838192,16.895015,38779311,48696514.95,65.03396642543396,64.04599121083717,NaN,NaN,96.21722177595055,62.07550637311724,-0.01049665798418542,0.20041658564528575,0.21091324362947117,-2705734536,-2716498895.8,71.58129569208972,78.13667939456877,NaN,NaN,25.37322739763819,22.903950295772308
2013-08-05T09:30:00-04:00,16.878769,16.919371,16.830065,16.858481,25908069,47056487.9,63.25810338201384,64.06066963751964,NaN,NaN,86.19071993198676,70.98275318520339,-0.011267785523470242,0.19682851172513338,0.20809629724860362,-2731642605,-2715698929.4,71.670977360369,77.83165094461307,NaN,NaN,25.57912638054641,23.286118307882894
2013-08-06T09:30:00-04:00,16.830065,16.846303,16.692047,16.708285,31144178,43953352.7,56.43525746761171,63.48917035090108,NaN,NaN,28.822240380472675,69.21130321083277,-0.022642769444284616,0.17979283544324787,0.20243560488753248,-2762786783,-2715211143,71.72956076210914,77.39389837966779,NaN,NaN,23.844255062488536,23.365852129969415
2013-08-07T09:30:00-04:00,16.635224,16.643335,16.513436,16.594623,47549937,42775967.15,51.87538843992492,62.298811552422016,NaN,NaN,-66.4925883438338,47.70135596852847,-0.037684627679168914,0.15532982028857134,0.19301444796774025,-2810336720,-2735491173.8,65.65090796986023,76.40883125828016,NaN,NaN,20.98887334411473,23.026283731990173
2013-08-08T09:30:00-04:00,16.683929,16.732641,16.513436,16.635224,53198250,41713207.8,53.32610323218391,61.201964851466904,NaN,NaN,-54.64316162910123,18.01888642309498,-0.044305697467987126,0.13763232613275633,0.18193802360074346,-2757138470,-2753527822.8,60.72224718925705,74.97507074203425,NaN,NaN,18.99330934420547,22.450144533735216
2013-08-09T09:30:00-04:00,16.594623,16.675802,16.545911,16.578385,25633226,40341019.6,51.00792491234067,59.79743089087621,NaN,NaN,-78.59276366287318,-16.943110664669767,-0.05141910429320559,0.11766414323423646,0.16908324752744205,-2782771696,-2768935254.8,56.79948754956612,73.16998236423038,NaN,NaN,16.637271894557593,21.619734156709843
2013-08-12T09:30:00-04:00,16.505317,16.563528,16.456605,16.513436,33424838,40398018.85,48.41778835206361,58.39781943171362,NaN,NaN,-129.5665315897603,-60.09456096901918,-0.05886856860842282,0.09549753676691353,0.15436610537533635,-2816196534,-2785846040.6,52.77000559309678,70.98712873218946,NaN,NaN,13.879050345883762,20.51392218373469
2013-08-13T09:30:00-04:00,16.554029,16.643335,16.432257,16.594623,37475970,40040162.55,51.71819328465007,57.576913435517596,NaN,NaN,-102.32325990056657,-86.32366102522703,-0.056677922523390045,0.0835187022210988,0.14019662474448885,-2778720564,-2789032796.8,52.02105411830039,68.7200969697329,NaN,NaN,12.383713348833663,19.352463778748827
2013-08-14T09:30:00-04:00,16.570267,16.651446,16.521563,16.529673,37441403,39607157.3,49.016200073778606,56.53663607791695,NaN,NaN,-93.82227856625511,-91.78959906971127,-0.057756820774229084,0.0680005987767025,0.1257574195509316,-2816161967,-2790197846.2,51.731982239987815,66.4084169712734,NaN,NaN,10.33696770483313,18.064535768189444
2013-08-15T09:30:00-04:00,16.407901,16.407901,16.229289,16.286112,76404744,40528041.65,40.476264241658185,54.93492102876082,NaN,NaN,-208.71237610822715,-122.60344196553645,-0.07209534571867852,0.03563823740258343,0.10773358312126195,-2892566711,-2817283494.4,45.41377487898337,63.78950445166071,NaN,NaN,5.677401968994607,16.294945225447325
2013-08-16T09:30:00-04:00,16.253637,16.367299,16.221163,16.257689,40254700,40505170.95,39.608991684770366,53.628405184276566,NaN,NaN,-187.5850108231211,-144.40189139758604,-0.0800991741874632,0.007609615386932944,0.08770878957439615,-2932821411,-2847293437.4,39.637456132224415,61.13499178340227,NaN,NaN,1.633825628951922,14.200499568805125
2013-08-19T09:30:00-04:00,16.221163,16.2374,16.034432,16.042543,47069506,41218171.8,33.71942450458174,51.924697512201135,NaN,NaN,-228.19345771552645,-164.12727662273926,-0.0954466271353851,-0.03159949434483522,0.06384713279054988,-2979890917,-2880032314,34.4843521629048,58.44449299212156,NaN,NaN,-4.008007093018448,11.599284331401757
2013-08-20T09:30:00-04:00,16.070967,16.2374,16.010076,16.196806,52489506,41982423.2,40.54573147006154,50.690157370381336,NaN,NaN,-176.47934291044334,-178.9584932247146,-0.09080002124986546,-0.04965289377178195,0.04114712747808351,-2927401411,-2909768483.4,30.59386959057032,55.47798434752714,NaN,NaN,-6.6071287764178805,8.99836817314181
2013-08-21T09:30:00-04:00,16.123738,16.261756,16.010076,16.083145,57630132,42603620.15,37.48261305781285,48.70871075206328,NaN,NaN,-156.11794132084242,-191.41762577563208,-0.09075644154079597,-0.07229842444791146,0.018458017092884513,-2985031543,-2943542398.6,26.884017147453335,52.26364202762658,NaN,NaN,-9.774935318283168,6.3164676743668124
2013-08-22T09:30:00-04:00,16.148094,16.29829,16.131857,16.269867,39799435,42280163.4,44.85328369405908,47.267233414107935,NaN,NaN,-98.62531126020495,-169.40021280602764,-0.07422364038510397,-0.07432153338849545,-0.00009789300339147974,-2945232108,-2954075478,25.831962592779846,48.99583252053302,NaN,NaN,-10.008630047841544,3.984310856908476
2013-08-23T09:30:00-04:00,16.30235,16.318595,16.204933,16.286112,31143311,41942663.1,45.45579295745179,45.9956398123535,NaN,NaN,-76.12100308503793,-147.107411258411,-0.05893266461601811,-0.07376372377341411,-0.014831059157396007,-2914088797,-2950328955.2,26.92732245694593,45.79985717028852,NaN,NaN,-9.998471836962871,1.9867704720697124
2013-08-26T09:30:00-04:00,16.310468,16.351062,16.180561,16.184628,36867045,42003366.45,42.34341389680823,44.98907955729611,NaN,NaN,-75.60467051893956,-116.58965381909361,-0.0526004894381333,-0.08058167095506263,-0.027981181516929333,-2950955842,-2944541940.2,28.679449665226684,42.724849234796906,NaN,NaN,-10.962038987201215,0.13694054931672284
2013-08-27T09:30:00-04:00,15.98572,16.042543,15.758397,15.790871,89744811,45011443.1,32.92387599237452,43.63540009675679,NaN,NaN,-156.52100810117207,-112.59798685723938,-0.07074775289782076,-0.11641587263920528,-0.04566811974138452,-3040700653,-2967201788.6,26.045924541330095,39.89592184704475,NaN,NaN,-15.303550436515362,-2.0688438772307176
2013-08-28T09:30:00-04:00,15.75027,15.920771,15.709693,15.819287,63190707,45356521,34.06382859514483,42.259523336968286,NaN,NaN,-145.7281141795089,-110.52002142897268,-0.07618360168596422,-0.1408976218488398,-0.06471402016287559,-2977509946,-2965697469.2,26.52826609877927,37.45349462629633,NaN,NaN,-18.236463829401796,-4.378503870398015
2013-08-29T09:30:00-04:00,15.782753,15.961364,15.766515,15.855821,33480631,44931485.5,35.57969379909267,41.15750682887914,NaN,NaN,-122.57561244935393,-115.31008166680246,-0.07267551620974948,-0.15555841542506244,-0.08288289921531296,-2944029315,-2965456910.6,26.61069715148801,35.29715245500504,NaN,NaN,-20.067575015544538,-6.61979974827609
2013-08-30T09:30:00-04:00,15.863932,15.896415,15.734041,15.782753,32476805,44616360.2,33.90102740189319,40.120595332438405,NaN,NaN,-127.49599267617295,-125.58507958502946,-0.07057434703449171,-0.1711008330084276,-0.10052648597393589,-2976506120,-2977940375.2,25.040641870953323,33.31648361770908,NaN,NaN,-22.090220662140325,-8.829859878828124
2013-09-03T09:30:00-04:00,15.969483,16.058789,15.823354,15.913464,52570505,45949482,39.408397124476544,39.241324178140296,NaN,NaN,-88.35804223270223,-128.135753927782,-0.056299599572643355,-0.17090098543974008,-0.11460138586709673,-2923935615,-2972536329.8,27.0472784640651,31.532642499549418,NaN,NaN,-22.08814692221184,-10.723900885025797
2013-09-04T09:30:00-04:00,15.928889,16.107501,15.888304,16.038492,38670920,46325819.1,44.19779293596982,38.89715223972538,NaN,NaN,-60.05627361856205,-108.84280703125998,-0.035377352539828294,-0.1588230765418821,-0.12344572400205381,-2885264695,-2941449138.2,37.42477245538263,30.510698943506192,NaN,NaN,-20.567488933402984,-12.13012774907968
2013-09-05T09:30:00-04:00,16.066899,16.17245,16.038492,16.075026,37295291,45813086.8,45.55212100347178,39.259713436997785,NaN,NaN,-30.700847234313372,-85.83735364222086,-0.016952208520575135,-0.14463598465277272,-0.12768377613219759,-2847969404,-2915541029.8,44.5092884511125,30.446092770086846,NaN,NaN,-18.924197966489395,-13.10070920870964
2013-09-06T09:30:00-04:00,16.164332,16.17245,15.896415,16.075026,48146663,45560507.45,45.55212100347178,39.68422267404788,NaN,NaN,-39.214780912108026,-69.16518733477169,-0.0033509538065063516,-0.1318724683903305,-0.12852151458382416,-2847969404,-2896329047.6,49.11035313066219,31.12272826997526,NaN,NaN,-17.599790308964,-13.743435080174548
2013-09-09T09:30:00-04:00,16.139976,16.261756,16.099382,16.261756,40349868,46296339.55,52.40013257256592,41.01855896461818,NaN,NaN,21.328555844978858,-39.400277630541325,0.018438090164440674,-0.10547390187827332,-0.123911992042714,-2807619536,-2862551730.8,56.01553351437562,32.660669795080324,NaN,NaN,-14.299241330388707,-13.822835973062285
2013-09-10T09:30:00-04:00,16.391655,16.477308,16.383528,16.452546,45398164,46895005.85,58.18673674329447,42.2786307698491,NaN,NaN,108.5296444767691,-0.022740288647095496,0.04443393970609269,-0.06836956741009814,-0.11280350711619083,-2762221372,-2830208882.2,61.41446614479167,34.8621409775247,NaN,NaN,-9.487508325302572,-13.203503451953754
2013-09-11T09:30:00-04:00,16.42413,16.480961,16.383528,16.472834,39946257,47018520.2,58.76084801070074,43.798504695055385,NaN,NaN,117.16669370446932,35.42185317595918,0.06072147483812425,-0.036901663568535525,-0.09762313840665977,-2722275115,-2797610966.2,65.95086207634253,37.65262990101682,NaN,NaN,-5.458983578692735,-12.097143470059322
2013-09-12T09:30:00-04:00,16.456605,16.480961,16.334824,16.355121,42290258,47260962.95,54.11790986560034,44.46026370730833,NaN,NaN,104.64912946786225,62.491848516394306,0.06112490912566587,-0.021217001999577434,-0.0823419111252433,-2764565373,-2780930160,68.02262982047954,40.666248988709654,NaN,NaN,-3.3825641249837073,-10.852203563619948
2013-09-13T09:30:00-04:00,16.375418,16.42413,16.326706,16.395723,36218862,45251668.85,55.4261652297245,45.1724331553278,NaN,NaN,97.67561857138503,89.86992841309291,0.061515325453148556,-0.0054477543088076175,-0.06696307976195617,-2728346511,-2757005581.4,70.7697601812997,43.797851683306355,NaN,NaN,-1.2891059478368712,-9.486046761365223
2013-09-16T09:30:00-04:00,16.594623,16.651446,16.545911,16.578385,49183716,45698119.65,60.83641412449858,46.493361743019975,NaN,NaN,159.48946331141903,117.50210990638095,0.07080284755840982,0.021540479686056102,-0.04926236787235372,-2679162795,-2731314233.2,73.41132073721315,46.992985331305384,NaN,NaN,2.281585237864927,-7.804956475760916
2013-09-17T09:30:00-04:00,16.602741,16.659572,16.574318,16.659572,42931602,45491224.45,62.98680210535434,48.640713608232815,NaN,NaN,146.8306766069237,125.16231633241186,0.07854276449651403,0.04891608774828882,-0.02962667674822521,-2636231193,-2706116197.4,75.72815739649047,50.54171624953113,NaN,NaN,5.9275395078337345,-5.843171335247394
2013-09-18T09:30:00-04:00,16.627098,16.907193,16.578385,16.805709,62884806,46010989.45,66.54739776592669,50.96096854900296,NaN,NaN,160.3853295325917,133.80604349803633,0.08887287567953826,0.08146441785119762,-0.007408457828340639,-2573346387,-2676330451.8,78.15166038592236,54.22910155575563,NaN,NaN,10.223366054312356,-3.5479517081674303
2013-09-19T09:30:00-04:00,16.878769,16.895015,16.708285,16.740759,49726227,45615794.2,63.61818463448828,52.96371789438836,NaN,NaN,142.49709326500488,141.37563625746486,0.08661131047387602,0.10085568026400438,0.014244369790128365,-2623072614,-2648031900,80.17680010348101,58.05525176661228,NaN,NaN,12.88551487542208,-1.2003136247975004
2013-09-20T09:30:00-04:00,16.716403,16.72453,16.56214,16.582445,54064379,46329041.4,57.028879986914376,54.61570736474702,NaN,NaN,89.05773265034183,139.65205907325623,0.07042040437332459,0.1022698752567841,0.03184947088345952,-2677136993,-2637789996.4,80.86799142503087,62.042919591903534,NaN,NaN,13.156241241001204,0.8506227846023147
2013-09-23T09:30:00-04:00,16.489007,16.505317,16.326706,16.346994,62308241,47887287.9,48.91439595046926,55.29470728088935,NaN,NaN,30.457723041240726,113.84571101922056,0.041264405827975324,0.08342997816842868,0.04216557234045335,-2739445234,-2649846484.2,77.44472146616565,65.64273694919643,NaN,NaN,10.675348206521845,2.254154987733676
2013-09-24T09:30:00-04:00,16.334824,16.391655,16.229289,16.245511,49591328,48523502.05,45.88396463351752,55.415148116428476,NaN,NaN,4.885981832469379,85.45677206432968,0.013966018994069636,0.059623096083040394,0.04565707708897076,-2789036562,-2680407558,69.42245733715001,67.92828586932266,NaN,NaN,7.643701801796429,3.024090246885498
2013-09-25T09:30:00-04:00,16.269867,16.383528,16.188688,16.334824,48209452,46446734.1,48.885333321359326,55.6532347105633,NaN,NaN,3.126869661697684,54.005080090150884,0.0014072973426872554,0.04741619876732983,0.046008901424642576,-2740827110,-2713903702.6,61.85902227500431,69.16755257102923,NaN,NaN,6.106866522358911,3.464486857667414
2013-09-26T09:30:00-04:00,16.359172,16.440367,16.261756,16.334824,35554618,45064929.65,48.885333321359326,55.891321304698124,NaN,NaN,8.346003893269355,27.174862215803795,-0.006957493309642293,0.03731203478758971,0.044269528097232,-2740827110,-2737454601.8,57.1449693040293,69.74145372626974,NaN,NaN,4.892679865433029,3.668514430205359
2013-09-27T09:30:00-04:00,16.2374,16.318595,16.202246,16.273934,60626987,46422247.45,46.831649899855826,55.49357254236168,NaN,NaN,-23.127106232347245,4.737894439265981,-0.01612511312880858,0.02411313668622128,0.04023824981502986,-2801454097,-2762318022.6,52.58857906049093,69.49667126527797,NaN,NaN,3.2748758233568958,3.6122803435127215
2013-09-30T09:30:00-04:00,16.083145,16.245511,16.066899,16.160272,49098087,47253311.55,43.18463008206577,54.42199349513107,NaN,NaN,-69.4099754677739,-15.235645262536957,-0.02864638229705488,0.004430271943711261,0.03307665424076614,-2850552184,-2784539412.6,48.84042551903138,68.59852550629509,NaN,NaN,0.7841680095387229,3.2082642958021506
2013-10-01T09:30:00-04:00,16.188688,16.310468,16.17245,16.273934,50451013,47147336.95,47.58079315137113,53.623418148036095,NaN,NaN,-45.552957989465554,-25.323433226923942,-0.028040690776595257,-0.00197420922997793,0.026066481546617327,-2800101171,-2786752334.4,48.46993431897194,67.34988780934006,NaN,NaN,-0.06172198011680451,2.7411233992422996
2013-10-02T09:30:00-04:00,16.168383,16.286112,16.123738,16.269867,46924458,47560013.85,47.43934729736838,53.14637796459096,NaN,NaN,-63.52323560322989,-38.65345427990946,-0.026688305295564464,-0.007293900072838255,0.01939440522272621,-2847025629,-2807992038.2,44.945783503450365,65.70154164383797,NaN,NaN,-0.78633247916603,2.2372011308982525
2013-10-03T09:30:00-04:00,16.229289,16.253637,16.018195,16.147291,57502979,48570398.25,43.26480161888681,52.277709135245416,NaN,NaN,-101.3468832781347,-60.59203171419026,-0.03244094026265397,-0.02115677010559125,0.011284170157062717,-2904528608,-2840732337.8,40.105161200745194,63.511213145226925,NaN,NaN,-2.6437311529862555,1.5399250903433228
2013-10-04T09:30:00-04:00,16.156205,16.286112,16.139976,16.277993,36610294,47993579.8,48.47168580817361,51.39451425550791,NaN,NaN,-69.27776922239576,-69.82216431219997,-0.026107752047352925,-0.02135051990212844,0.0047572321452244845,-2867918314,-2854025181.2,38.30152782758296,61.00337079453906,NaN,NaN,-2.7279429856942183,0.9302296509093885
2013-10-07T09:30:00-04:00,16.139976,16.196806,16.075026,16.091272,35899579,47771065.35,42.474479116359646,49.92934832772257,NaN,NaN,-114.39499032145123,-78.81916728293542,-0.032729089647998665,-0.03615412991477385,-0.0034250402667751817,-2903817893,-2864678323,36.87042562531283,58.22781852516923,NaN,NaN,-4.69288682221916,0.12692729760531019
2013-10-08T09:30:00-04:00,16.091272,16.115628,15.863932,15.888304,90503021,50026308.2,37.100891558820244,47.8260264557864,NaN,NaN,-158.29158048418077,-101.36689178187846,-0.04808522096926821,-0.06353156647836045,-0.015446345509092234,-2994320914,-2903522271.6,32.15298733534652,54.942199021556675,NaN,NaN,-8.214470916167215,-1.0647010186479076
2013-10-09T09:30:00-04:00,15.928889,16.010076,15.815228,15.941059,97040698,52881030.25,39.25212766330478,46.08559381498758,NaN,NaN,-149.48469356594944,-118.55918337442237,-0.0516819176052096,-0.08004874251560423,-0.028366824910394633,-2897280216,-2913573189,31.04610313325898,51.43286352368367,NaN,NaN,-10.363649564756223,-2.3931222395205243
2013-10-10T09:30:00-04:00,16.156205,16.407901,16.148094,16.395723,94126517,55472843.2,53.889293397759225,45.86133763004792,NaN,NaN,-6.371256609103806,-99.56405804061619,-0.021952796625889205,-0.05580782069275614,-0.03385502406686693,-2803153699,-2893298207.2,35.844068688715865,48.21686904251832,NaN,NaN,-7.039956358090019,-3.0569556850304522
2013-10-11T09:30:00-04:00,16.359172,16.505317,16.311605,16.489892,47857691,56054784.65,56.24106291341891,46.38467098454432,NaN,NaN,35.07269909209849,-78.69396437771734,0.004149937705682498,-0.02866760193476381,-0.03281753964044631,-2755296008,-2870773746,40.774507917578596,45.597568074762094,NaN,NaN,-3.6136519379079886,-3.1364837211558148
2013-10-14T09:30:00-04:00,16.383528,16.594623,16.359172,16.570267,45485508,55869874.25,58.200631248783125,47.264432885634726,NaN,NaN,64.17479179748449,-42.98000795393019,0.025721615272663183,-0.0006655205496173267,-0.02638713582228051,-2709810500,-2831972267.4,48.16465880545226,44.079153893926545,NaN,NaN,-0.24176535753101394,-2.722952526352272
2013-10-15T09:30:00-04:00,16.570267,16.61889,16.416011,16.448478,57203424,56583465.35,54.237273628466404,47.646714336142374,NaN,NaN,64.62425799358397,1.6031597416227554,0.03036223230500162,0.011565654558971517,-0.018796577746030104,-2767013924,-2786510869.4,55.215648953887055,43.60462722813245,NaN,NaN,1.2113312078489324,-2.160911992894957
2013-10-16T09:30:00-04:00,16.56214,16.813836,16.549962,16.793531,92881944,58083322.25,62.10996158840829,48.59133064093158,NaN,NaN,154.25560516246523,62.351219487305684,0.05387108393317379,0.04854227717043713,-0.005328806762736655,-2674131980,-2741881222.2,60.846341853329854,43.869010981653915,NaN,NaN,5.371049367925913,-1.0849175127776898
2013-10-17T09:30:00-04:00,16.683929,16.968075,16.683929,16.944539,65802456,58887133.7,64.9516566595338,49.88561683805144,NaN,NaN,203.7670360258305,104.37887801429254,0.0754675249459066,0.08900559941964659,0.013538074473739994,-2608329524,-2702916387.2,64.98554718667936,44.75450870495309,NaN,NaN,9.721838796560753,0.45890481712780207
2013-10-18T09:30:00-04:00,16.992431,17.016803,16.870659,16.977014,51541887,58761009.1,65.55003396527167,51.48314568685186,NaN,NaN,207.8136045066437,138.92705909720158,0.08699667800995288,0.1222839219861811,0.03528724397622822,-2556787637,-2663214713,68.62509709986617,46.167699532155574,NaN,NaN,13.281322763250614,2.2906788094310606
2013-10-21T09:30:00-04:00,16.98432,17.016803,16.927498,16.943727,35947824,57442988.25,64.33753269862632,52.68005565451294,NaN,NaN,168.87797442243695,159.86769562219206,0.08721641253412124,0.14430775964387976,0.05709134710975853,-2592735461,-2639799705.2,70.56816444525697,47.74614454117593,NaN,NaN,15.730491078553403,4.210651990734252
2013-10-22T09:30:00-04:00,17.016803,17.081737,16.951846,16.976202,38919019,56909372.8,65.01739446760936,53.935630452387294,NaN,NaN,148.33283712913993,176.60941144930325,0.08433409713223551,0.16250896852505292,0.07817487139281741,-2553816442,-2597160208.8,73.75562056124453,49.80399004530409,NaN,NaN,17.914073126099357,6.168283581500695
2013-10-23T09:30:00-04:00,16.895015,16.919371,16.797663,16.838192,44120265,56704913.45,59.7999688001944,55.1167138224807,NaN,NaN,96.54160845637313,165.06661210808483,0.06858640378720562,0.16390787612682445,0.09532147233961882,-2597936707,-2581921154.2,74.80578739320713,52.28260620190851,NaN,NaN,18.243796324259065,7.8933568304661765
2013-10-24T09:30:00-04:00,16.895015,16.895015,16.783383,16.86254,34289686,56641666.85,60.403665927500896,55.96899811671836,NaN,NaN,84.17892207463751,141.14898931784623,0.05580544687245308,0.16507828093018517,0.1092728340577321,-2563647021,-2572984653.6,75.42676853015632,54.934409109235176,NaN,NaN,18.684446714375717,9.434941099596111
2013-10-25T09:30:00-04:00,16.878769,16.935608,16.838192,16.935608,34547816,55337708.3,62.23646143574289,57.380568282388595,NaN,NaN,86.02788306016136,116.79184502854977,0.04853598643745863,0.1699428171045554,0.12140683066709676,-2529099205,-2567446967.2,75.82441773061169,57.71683711675653,NaN,NaN,19.573770666251196,10.88334532340398
2013-10-28T09:30:00-04:00,16.92749,16.935608,16.86254,16.895015,26430290,54204318.45,60.55939911536424,59.05617596499888,NaN,NaN,75.78352316290997,98.17295477664439,0.03773789953066961,0.16857920508043378,0.13084130554976417,-2555529495,-2560005774,76.37759068484128,60.87573735600615,NaN,NaN,19.859043791007874,12.165587961633108
2013-10-29T09:30:00-04:00,16.92749,16.959964,16.886896,16.943727,27126539,53038094.75,61.88664381183025,60.67292711846499,NaN,NaN,74.09948236149671,83.32628382311574,0.030907415631478752,0.1694755750891126,0.13856815945763384,-2528402956,-2554923076.8,76.76860762770846,64.14163053418112,NaN,NaN,20.457878351460316,13.350200874465566
2013-10-30T09:30:00-04:00,16.968083,16.992439,16.821946,16.874718,43661766,52874960.15,58.86449824723099,61.028298893427255,NaN,NaN,61.13727730757492,76.24541759335611,0.01933869023060608,0.16274152224589145,0.14340283201528536,-2572064722,-2549748679.8,77.18268932371865,67.09438915096703,NaN,NaN,20.16127076866076,14.323210859350594
2013-10-31T09:30:00-04:00,16.854421,16.870659,16.692047,16.696107,60196399,53009631.15,51.812100497901,60.71194443517597,NaN,NaN,27.246772512470393,64.85898768092268,-0.00163204182319579,0.14136277973629063,0.14299482155948642,-2632261121,-2563471499.8,73.4438685928023,69.42791491348301,NaN,NaN,17.84909758128816,14.826908962484532
2013-11-01T09:30:00-04:00,16.700166,16.765115,16.651454,16.739948,41093187,53233775.8,53.29133734931148,60.36128058521371,NaN,NaN,15.614887698742592,50.776388608638925,-0.013196362368153858,0.12649936859929412,0.13969573096744797,-2591167934,-2575885245.6,70.13416915480293,70.99716565272234,NaN,NaN,16.31997234652277,15.040203731632852
2013-11-04T09:30:00-05:00,16.765115,16.781353,16.700166,16.748066,23079160,52592754.85,53.57552161778268,60.314012584450595,NaN,NaN,15.974715939272224,38.81462716391137,-0.02050838684510975,0.1140602474110608,0.13456863425617055,-2568088774,-2578397101.4,69.4521520636394,72.01405873199037,NaN,NaN,15.128902146585252,15.052874933768909
2013-11-05T09:30:00-05:00,16.692047,16.724522,16.631157,16.659572,31936999,49664453.75,50.003972936315,59.44929910930107,NaN,NaN,-16.245966380117515,20.745537415588522,-0.030890655496393693,0.09595531488567843,0.12684597038207213,-2600025773,-2592721664.8,65.53806408115602,72.34918174826366,NaN,NaN,13.099043485468481,14.773756155440276
2013-11-06T09:30:00-05:00,16.740759,16.781353,16.700166,16.7367,35298971,46577367.4,52.948059864680275,58.59189933824011,NaN,NaN,-9.404047927613833,6.637272368550773,-0.032013022867821844,0.08682969179729483,0.11884271466511667,-2564726802,-2591254080.8,65.75102441546633,72.40385869317701,NaN,NaN,12.126097508353775,14.395519205856491
2013-11-07T09:30:00-05:00,16.789472,16.813828,16.545911,16.54997,55078830,44624983.05,45.900774483183014,57.1883808038052,NaN,NaN,-69.35044109956951,-12.682170353857206,-0.04403846414381818,0.06379463448534395,0.10783309862916213,-2619805632,-2588762983,66.13358547574518,72.22589357716838,NaN,NaN,9.127641610842058,13.642965263711572
2013-11-08T09:30:00-05:00,16.570267,16.935608,16.554029,16.935608,78756215,46169909.25,58.25744010321851,56.75408847556179,NaN,NaN,7.478664629644359,-14.309414967676853,-0.025639786240930912,0.0757833658279985,0.1014231520689294,-2541049417,-2578739279.6,67.69715110491387,72.0208211957153,NaN,NaN,10.40070864647345,13.179785746963269
2013-11-11T09:30:00-05:00,16.935608,16.976202,16.870659,16.939668,28844953,45337881.5,58.365259526301216,56.27893597975407,NaN,NaN,70.65070043305026,-3.3742180689212473,-0.013429327212873626,0.08463649305283738,0.098065820265711,-2512204464,-2567562417.6,69.39395063150648,71.70927334359115,NaN,NaN,11.414485477945432,12.927599994246435
2013-11-12T09:30:00-05:00,16.903133,16.918559,16.732641,16.781353,35320068,44243713.7,52.65402238256708,55.76851123563783,NaN,NaN,-15.96570943694871,-3.3181666802874865,-0.016069401338115713,0.07797906859306636,0.09404846993118207,-2547524532,-2557062169.4,70.9383997074743,71.4330313660388,NaN,NaN,10.41907719275975,12.569239594034052
2013-11-13T09:30:00-05:00,16.708285,16.9939,16.683929,16.92343,52445148,42221873.9,56.74475372143236,55.50716036377579,NaN,NaN,22.034690241768224,2.969580953588925,-0.008672163807382005,0.08320826517195457,0.09188042897933657,-2495079384,-2543132685.8,72.89262200989734,71.25202090030602,NaN,NaN,10.920414642181234,12.333693172340793
2013-11-14T09:30:00-05:00,16.92749,17.081745,16.888844,17.073626,43041510,41083826.6,60.61848557093976,55.39159065914699,NaN,NaN,125.1227212384626,41.864213421195345,0.005166392027613126,0.09833841901385298,0.09317202698623986,-2452037874,-2509579134.2,76.91886328680779,71.33019558289146,NaN,NaN,12.625290753227322,12.375349969610296
2013-11-15T09:30:00-05:00,17.089864,17.17105,17.057389,17.154813,45911177,40802291.1,62.569793455088714,55.53519025484161,NaN,NaN,185.96609680317113,77.5616998559007,0.017901033007770267,0.11554831824595269,0.09764728523818242,-2406126697,-2482594590.2,79.54958914260683,71.55676690130329,NaN,NaN,14.639950840560168,12.698864379745991
2013-11-18T09:30:00-05:00,17.219763,17.268475,17.106101,17.146694,52714126,41640606.2,62.23767920753527,55.56026421167768,NaN,NaN,189.67322206146758,101.36620418158417,0.023536090259991677,0.12706739806317202,0.10353130780318034,-2458840823,-2471921862,80.49643119045409,71.82304001292798,NaN,NaN,16.13742050511985,13.190086683370827
2013-11-19T09:30:00-05:00,17.154813,17.260356,17.122338,17.17105,35720486,41480679.55,62.874306809701096,55.84667910899697,NaN,NaN,174.78181505761705,139.51570908049732,0.026444702082597055,0.13658718540642667,0.11014248332382962,-2423120337,-2447041023,82.5274169016059,72.20480626849135,NaN,NaN,17.544784829965025,13.81218641859857
2013-11-20T09:30:00-05:00,17.211644,17.260356,17.065507,17.118279,39294754,41239404,60.4946317104443,56.466859909892925,NaN,NaN,131.84018786838328,161.47680860582034,0.02250961870942729,0.13827950671061373,0.11576988800118644,-2462415091,-2440508164.4,83.02718617240274,72.88932895274853,NaN,NaN,18.063217360532775,14.4194765531606
2013-11-21T09:30:00-05:00,17.17105,17.390255,17.162932,17.365087,45762438,41813041.6,66.81979954484325,57.43317863814519,NaN,NaN,173.55643558872057,171.1635514758719,0.03355845127935536,0.15771795210038064,0.12415950082102528,-2416652653,-2433431120.2,83.5752663599312,73.8494073245434,NaN,NaN,20.517304451618603,15.290594824368887
2013-11-22T09:30:00-05:00,17.382137,17.455205,17.349662,17.447086,34126817,41791991.65,68.6175789089785,58.50761130180204,NaN,NaN,177.13701072387153,169.39773426001202,0.04282550216031278,0.17769137852141625,0.13486587636110348,-2382525836,-2428710948,83.94759042348333,74.88479577881797,NaN,NaN,23.116597508006873,16.40859520774574
2013-11-25T09:30:00-05:00,17.503917,17.544511,17.438968,17.471442,34069785,42173966.4,69.1522212813089,59.87534332644446,NaN,NaN,163.11494472576763,164.086078792872,0.04671372309964622,0.19325803023566124,0.14654430713601502,-2348456051,-2406633993.6,85.59262024513686,76.31726407624517,NaN,NaN,25.387215216402332,17.691255208982398
2013-11-26T09:30:00-05:00,17.479561,17.544511,17.447086,17.455205,34328556,42534067.25,68.31664145517863,60.9730991543372,NaN,NaN,136.39260086028196,156.40823595340498,0.044329750218690706,0.2019564949093784,0.1576267446906877,-2382784607,-2398566847.6,86.15110843992868,77.77441293513532,NaN,NaN,27.02174047719883,19.02418167587046
2013-11-27T09:30:00-05:00,17.495799,17.528273,17.455205,17.503917,19697582,41335858.05,69.50705018699456,62.65926170460944,NaN,NaN,121.03047882187099,154.24629414410254,0.0421833165410708,0.21035589036702618,0.16817257382595538,-2363087025,-2378701234.4,87.44207130078696,79.29644763692401,NaN,NaN,28.739902908682314,20.412141851986437
2013-11-29T09:30:00-05:00,17.568867,17.568867,17.430849,17.438968,14801515,39066113.85,65.94913814609504,63.208668707672054,NaN,NaN,103.86422039685395,140.30785110572918,0.03294856363601506,0.2093582783709742,0.17640971473495914,-2377888540,-2370948411.8,87.91551614804591,80.74061656857631,NaN,NaN,29.2524369128917,21.675041146401476
2013-12-02T09:30:00-05:00,17.463324,17.560748,17.382137,17.430849,37846098,38903759.4,65.4977940368727,63.71813545842716,NaN,NaN,89.64096597968953,122.80864215689283,0.02330675196317289,0.20554315468892526,0.18223640272575237,-2415734638,-2377590172.2,84.96039068894854,81.8525051441079,NaN,NaN,29.561076863005276,22.801617677344876
2013-12-03T09:30:00-05:00,17.341543,17.382137,17.162932,17.252238,34163637,39457983.25,56.35966291999948,63.98282406824376,NaN,NaN,37.177528938791966,97.62115899949768,0.0029817214991542385,0.18596355459969516,0.18298183310054092,-2449898275,-2397878617,76.50119890507627,82.24984794393662,NaN,NaN,27.217398356699736,23.432443488681283
2013-12-04T09:30:00-05:00,17.179169,17.374018,17.146694,17.292831,53904394,40556353,57.80066288743469,64.05824615152963,NaN,NaN,33.46297389754246,77.03523360694979,-0.008991580619334333,0.171742357326373,0.18073393794570733,-2395993881,-2400520471.8,75.44777378518768,82.43235878502878,NaN,NaN,25.64527266573691,23.748561942546374
2013-12-05T09:30:00-05:00,17.219763,17.260356,17.11422,17.130457,45253897,41054099.3,50.6028453082569,63.342843275623714,NaN,NaN,-2.6110076382940317,52.30693631491677,-0.0280349070697557,0.1456903041085127,0.1737252111782684,-2441247778,-2416152622.4,69.36154006854836,81.89254998372452,NaN,NaN,22.031436071955824,23.503258246747723
2013-12-06T09:30:00-05:00,17.333425,17.413556,17.252238,17.365899,37393242,40169819.9,58.644624082652825,63.062474034735445,NaN,NaN,46.66882977187025,40.867858189920035,-0.02505972018878677,0.14240056094228493,0.1674602811310717,-2403854536,-2421345821.6,67.41588708679217,81.02585697973777,NaN,NaN,21.271631245524507,23.184454389430122
2013-12-09T09:30:00-05:00,17.42273,17.478749,17.406493,17.438968,27250170,37594517.65,60.77868236546112,62.95825997458729,NaN,NaN,74.63877649953935,37.86742029389,-0.018744869289450072,0.1440291945192591,0.16277406380870918,-2376604366,-2413519767.2,68.83465438056791,80.19287292188876,NaN,NaN,21.329761258391773,22.919498227853214
2013-12-10T09:30:00-05:00,17.398374,17.479561,17.374018,17.374018,37990045,38051772.25,57.917693066831646,62.604216135810894,NaN,NaN,57.35228109249615,41.90237072463084,-0.019433143396023672,0.1384826345636796,0.15791577795970327,-2414594411,-2406458994.4,70.09961248321643,79.3051726062895,NaN,NaN,20.48784448556647,22.57211912181225
2013-12-11T09:30:00-05:00,17.382137,17.390255,17.106101,17.138576,79310722,40251304.95,48.92682800474115,61.77794444254639,NaN,NaN,-35.081809576680506,28.193414029786236,-0.03531086919212101,0.11377719146955201,0.14908806066167302,-2493905133,-2426041244.8,62.52044817480685,77.84040560646123,NaN,NaN,16.69032329184618,21.73186257467424
2013-12-12T09:30:00-05:00,17.130457,17.218139,17.093923,17.138576,48746667,40066380.9,48.92682800474115,60.499875046824805,NaN,NaN,-77.62573126530455,13.190469304384134,-0.044770873397605104,0.09312446891466664,0.13789534231227174,-2493905133,-2436572715.8,58.83609969911241,76.0733222735456,NaN,NaN,13.740157334377667,20.590190397489014
2013-12-13T09:30:00-05:00,17.195407,17.236,17.11422,17.154813,89239792,42376295,49.55317540373066,59.13813193930711,NaN,NaN,-76.59720374357434,-11.462737398704784,-0.04857421570555295,0.07717757268033054,0.1257517883858835,-2404665341,-2436734876.8,58.778661558660694,74.27554164034397,NaN,NaN,11.548363691909906,19.29850086812057
2013-12-16T09:30:00-05:00,17.227881,17.29689,17.227881,17.260356,84121088,44286790.55,53.54154618647853,58.02308371824779,NaN,NaN,-31.060690291574318,-32.60263075692752,-0.04282268368731905,0.07222343377673468,0.11504611746405373,-2320544253,-2425522854.2,61.57201771238812,72.55978431657623,NaN,NaN,10.837321319992734,18.089760932673737
2013-12-17T09:30:00-05:00,17.260356,17.260356,17.130457,17.146694,33274706,43314819.55,49.044545553158436,56.64650543953206,NaN,NaN,-78.51411055142343,-59.77590908571143,-0.04527539580135714,0.0584518727123573,0.10372726851371444,-2353818959,-2413367763.8,64.38937983731611,71.00537513067532,NaN,NaN,8.855118820838761,16.770526345268742
2013-12-18T09:30:00-05:00,17.203525,17.560748,17.04927,17.544511,122103012,47633945.85,61.29713502549377,56.06008292799629,NaN,NaN,34.38760082992868,-45.88202700438959,-0.019997207315852666,0.07873075936889862,0.09872796668475128,-2231715947,-2360929926.6,73.43714162658905,70.00502301108976,NaN,NaN,11.27901301134516,15.986024440422517
2013-12-19T09:30:00-05:00,17.516095,17.568867,17.463405,17.520155,56266073,48482511.8,60.34048451581151,55.659464811547466,NaN,NaN,102.54910828216873,-9.847059094894936,-0.00555946888840933,0.09177863057423963,0.09733809946264896,-2287982020,-2319745304,78.13576745594854,69.3064695330828,NaN,NaN,12.818217263259529,15.53348055797066
2013-12-20T09:30:00-05:00,17.471442,17.593223,17.463324,17.540451,81229732,50255876.5,60.888268519155595,55.33021298885338,NaN,NaN,99.0883311286487,25.29004787954967,0.00418909283040525,0.10257446550065552,0.09838537267025027,-2206752288,-2280162693.4,81.51928775669396,69.06067646649318,NaN,NaN,14.201521476833637,15.3432006892368
2013-12-23T09:30:00-05:00,17.625698,17.666291,17.601342,17.625698,36451436,50372107.45,63.188137351945855,55.81796116256384,NaN,NaN,137.4765479080871,58.99749551948196,0.014623007011357728,0.11666413143444743,0.1020411244230897,-2170300852,-2250114013.2,83.59478485327541,69.56736117707884,NaN,NaN,16.071246999646544,15.447207305009622
2013-12-24T09:30:00-05:00,17.658173,17.666291,17.60946,17.658173,9113258,49124281.1,64.05527088077923,56.26471887637416,NaN,NaN,132.91040528519596,101.28239868680583,0.0215384092696089,0.12896413601010082,0.10742572674049192,-2161187594,-2211587740.2,85.7971758137309,70.30660417911763,NaN,NaN,17.851949912314915,15.790741963196092
2013-12-26T09:30:00-05:00,17.715003,17.715003,17.658173,17.698766,18363767,48326041.65,65.16001776027763,57.304516908661356,NaN,NaN,140.6522124607121,122.5353210129625,0.026354941009451932,0.14036940300230683,0.11401446199285489,-2142823827,-2193809316.2,86.68547470062201,71.54402808140861,NaN,NaN,19.65019747470734,16.34209275055484
2013-12-27T09:30:00-05:00,17.706885,17.715003,17.658173,17.690647,14714321,48076878.6,64.73148971847458,57.73929302550577,NaN,NaN,126.5797446471338,127.34144828595552,0.02643469653598969,0.147057832662842,0.12062313612685231,-2157538148,-2167720541.8,87.88310017549304,73.00597187345868,NaN,NaN,21.01153371605528,17.00915574562633
2013-12-30T09:30:00-05:00,17.690647,17.723122,17.633816,17.658173,20001602,48336882.95,62.94829027688406,57.89426501917884,NaN,NaN,108.65474219813096,129.25473049985197,0.021926822359264853,0.14803166407593338,0.12610484171666853,-2177539750,-2161878034.2,88.14037459211656,74.38495188856929,NaN,NaN,21.690334440702287,17.67789555920861
2013-12-31T09:30:00-05:00,17.690647,17.755597,17.682529,17.747478,22784613,47583808.7,65.74312858231627,58.45322469885632,NaN,NaN,116.05909726870345,124.97124037197526,0.02250149659350248,0.1542317124585466,0.13173021586504413,-2154755137,-2158768891.2,88.28295156974926,75.68376182332165,NaN,NaN,23.06134189762002,18.44695932183881
2014-01-02T09:30:00-05:00,17.715003,17.731241,17.601342,17.650054,43705107,48060882.2,60.391351130745235,59.27211920785661,NaN,NaN,81.32339199271141,114.65383771347834,0.01426379432411129,0.14955995877018324,0.13529616444607195,-2198460244,-2166223421.2,85.62502251769232,77.33408856209917,NaN,NaN,22.774753637409642,19.065215652634645
2014-01-03T09:30:00-05:00,17.67441,17.828665,17.666291,17.771834,30366811,46884003.05,64.3031155152072,60.370425458604174,NaN,NaN,102.96609495861837,107.11661421305959,0.014891076258421704,0.15391000976909908,0.13901893351067737,-2168093433,-2171277342.4,83.78333034765778,79.11603360842385,NaN,NaN,23.65917439273124,19.721495472648446
2014-01-06T09:30:00-05:00,17.857081,17.909852,17.755597,17.788072,42823629,46762489.65,64.80227406730774,61.45964679171682,NaN,NaN,113.48697396583088,104.49806007679902,0.014272491743204385,0.15685954818968284,0.14258705644647846,-2125269804,-2164823673.6,84.24921816083331,80.9353590800076,NaN,NaN,24.526925473074453,20.407985472709303
2014-01-07T09:30:00-05:00,17.885496,17.885496,17.73936,17.792131,58540537,47819854.4,64.93427052547455,62.273412815930826,NaN,NaN,99.32186664946941,102.63148496706671,0.012095684272973944,0.15770666178769588,0.14561097751472193,-2066729267,-2142661577,85.76194086702864,82.6632107339105,NaN,NaN,25.279805960367796,21.10395982808909
2014-01-08T09:30:00-05:00,17.828665,17.877377,17.779953,17.853021,44296442,48672168,66.93734459766938,63.55146989053875,NaN,NaN,98.79141846390964,99.17794920610794,0.012655577828186299,0.1614304497999548,0.1487748719717685,-2022432825,-2116197114.6,87.32713731830492,84.30162198255256,NaN,NaN,26.479880357367147,21.87194847512881
2014-01-09T09:30:00-05:00,17.909852,17.942327,17.807638,17.917971,35893866,48567359.05,68.9732970180086,64.09976717571838,NaN,NaN,104.88273540719923,103.88981788900551,0.015131687115358644,0.1676894808659668,0.15255779375060816,-1986538959,-2073812857.6,89.34697781483223,85.43803885314136,NaN,NaN,28.08972079769673,22.760201664067086
2014-01-10T09:30:00-05:00,17.909852,17.934208,17.804309,17.885496,44822244,46842935.15,66.75969804242186,64.55828242761912,NaN,NaN,94.95713450419372,102.28802579812057,0.01242711748645181,0.1680916906086729,0.1556645731222211,-2031361203,-2046466411.6,90.40911812163755,86.31470675783342,NaN,NaN,28.87182517203296,23.63329073663364
2014-01-13T09:30:00-05:00,17.86114,17.893615,17.585104,17.617579,52490595,47030131.55,51.94752930737013,63.91965819820587,NaN,NaN,30.367271548779172,85.66408531471023,-0.008436505630644964,0.14511894108391488,0.15355544671455984,-2083851798,-2038182810.4,90.7112316439587,86.97127417835235,NaN,NaN,24.95312623079104,23.82183866437041
2014-01-14T09:30:00-05:00,17.715003,17.784418,17.625698,17.763716,38603951,44498339.5,57.488155322052364,63.51251662464205,NaN,NaN,35.75057365009665,72.94982671483568,-0.013144978598294055,0.13712422346669229,0.15026920206498634,-2045247847,-2033886526.4,90.87183462594207,87.49106344782852,NaN,NaN,23.333519250883114,23.75207874815794
2014-01-15T09:30:00-05:00,17.844903,17.991039,17.836784,17.974802,75972991,44090934.65,63.95348056135192,63.505245887540106,NaN,NaN,134.38568737648865,80.0686804973515,-0.0033060369837127346,0.1461366558353454,0.14944269281905814,-1969274856,-2023254932.6,91.2739080192964,87.88225860536893,NaN,NaN,24.152680918198573,23.809307629592315
2014-01-16T09:30:00-05:00,17.92609,17.934208,17.820547,17.86114,57945321,45324465.4,58.77049145680589,63.048851151577836,NaN,NaN,96.90108896871683,78.472351209655,-0.005581954879190526,0.14246524922006998,0.1480472040992605,-2027220177,-2031391176.2,88.076542092357,87.98162056192142,NaN,NaN,23.020983981559873,23.69668996558768
2014-01-17T09:30:00-05:00,17.885496,17.917971,17.763716,17.804309,70701476,42754388.6,56.31306806612276,62.447535319267,NaN,NaN,61.89545464450969,71.8600152377182,-0.011692380578179729,0.13343172837653583,0.14512410895471556,-2097921653,-2044703266.2,82.95617162900564,87.62969709431516,NaN,NaN,21.304263103692854,23.354914699602705
2014-01-21T09:30:00-05:00,17.901734,17.917971,17.715003,17.820547,51129106,42497540.25,56.86801572799283,62.0132299943462,NaN,NaN,47.42857629489295,75.27227618694096,-0.015196140691555421,0.1261289330902713,0.1413250737818267,-2046792547,-2037291416,83.53027812983875,87.30040448986676,NaN,NaN,20.123731552477906,22.893317107156307
2014-01-22T09:30:00-05:00,17.853021,17.869259,17.779953,17.828665,22315024,39551804.85,57.16099778255886,61.40022065150638,NaN,NaN,46.49707901679571,77.42157726028077,-0.01736598477223883,0.11961759281652817,0.136983577588767,-2024477523,-2033137351.2,83.85845037996074,86.98436869059616,NaN,NaN,19.263569560897405,22.374781743405034
2014-01-23T09:30:00-05:00,17.747478,17.755597,17.455205,17.536392,64686051,40963535.6,45.24486763769104,60.31832897343107,NaN,NaN,-148.87320905728785,20.769797973525463,-0.03771668057344907,0.08983772687195568,0.12755440744540475,-2089163574,-2057115094.8,74.6163757947096,86.19803678181167,NaN,NaN,14.381040523031333,21.232818711923077
2014-01-24T09:30:00-05:00,17.447086,17.447086,17.138576,17.138576,86854681,44850606.75,34.65520469055579,58.20062105738454,NaN,NaN,-324.7246468835392,-63.55534919692574,-0.07504550865760913,0.03374752162339334,0.10879303028100247,-2176018255,-2086874710.4,65.03604609742214,84.85894504965198,NaN,NaN,5.54646065303876,18.991910417796745
2014-01-27T09:30:00-05:00,17.162932,17.244119,16.935608,17.033033,79396597,47902248.25,32.48299966245999,55.89210145703828,NaN,NaN,-307.32383608151775,-137.3992073421312,-0.10223583833314895,-0.01900176763543371,0.08323407069771524,-2255414852,-2118373350.2,56.733103889576974,82.89350831599083,NaN,NaN,-2.0791800873663395,15.981754631344877
2014-01-28T09:30:00-05:00,17.122338,17.276594,17.106101,17.260356,43564068,49344735.6,41.053204025075736,54.18631099272408,NaN,NaN,-186.02285831856128,-184.08949426482206,-0.10017044496996304,-0.041978985514738554,0.058191459455224484,-2211850784,-2151384997.6,49.587913566996434,80.30964922313137,NaN,NaN,-5.1813505719444475,12.95845388801783
2014-01-29T09:30:00-05:00,17.073626,17.227881,17.016795,17.057389,79381009,52313705.95,36.58761385612162,52.018473082613525,NaN,NaN,-177.68924687308726,-228.92675944279867,-0.1071081963742597,-0.07569378601260013,0.03141441036165957,-2291231793,-2204735851.6,40.672575905866694,76.97718055081437,NaN,NaN,-9.382022447551584,9.76695726865077
2014-01-30T09:30:00-05:00,17.211644,17.333425,17.154813,17.30095,56641110,54006530.8,44.402995613099186,50.263451553691425,NaN,NaN,-106.16681304822532,-220.38548024098614,-0.09058476107174192,-0.08181654097801783,0.008768220093724088,-2234590683,-2233821273.4,36.78926836667656,73.22305844737467,NaN,NaN,-9.844622981023562,6.965302947268723
2014-01-31T09:30:00-05:00,17.041151,17.260356,17.008676,17.097982,66012967,55121923.8,39.98085373613114,48.350676960384945,NaN,NaN,-121.28086107737073,-179.69672307975247,-0.08851247085529193,-0.10187236847539083,-0.013359897620098898,-2300603650,-2258738352.4,33.810995331392405,69.18033539092859,NaN,NaN,-11.874794231898257,4.273860493102012
2014-02-03T09:30:00-05:00,17.081745,17.122419,16.643335,16.667691,129572110,60082188.75,32.57431821830508,46.96687616830888,NaN,NaN,-160.27240969970345,-150.2864378033896,-0.10991199625773877,-0.15074989294227237,-0.040837896684533595,-2430175760,-2293690534,30.126682403559883,64.85286758804297,NaN,NaN,-16.629735686697362,1.2876324674163873
2014-02-04T09:30:00-05:00,16.748878,16.919371,16.692047,16.830065,67934952,61337754.9,37.294993963471676,45.524507499838826,NaN,NaN,-134.0707095159052,-139.8960080428584,-0.10682839508396491,-0.17437339053948975,-0.06754499545552484,-2362240808,-2323768538.8,27.36338404210308,60.316549689197316,NaN,NaN,-18.430008372974214,-1.5291733669251268
2014-02-05T09:30:00-05:00,16.805709,16.866599,16.692047,16.813828,58096971,61315576.6,37.015905945392305,43.60039502727029,NaN,NaN,-119.57336441147655,-128.27283155053627,-0.09971594518871649,-0.19218992694142045,-0.09247398175270397,-2420337779,-2349589736,25.224391809196305,55.5987271027616,NaN,NaN,-19.8574390250119,-4.147497032366093
2014-02-06T09:30:00-05:00,16.846303,17.081745,16.838184,17.073626,49261242,61563816.6,44.209788660761134,42.560344827552804,NaN,NaN,-74.50204410518356,-121.93987776192792,-0.0726079557014345,-0.1832339263794971,-0.1106259706780626,-2371076537,-2376886906.8,23.16300170433209,50.96204564647412,NaN,NaN,-18.4821723123462,-6.195307786648966
2014-02-07T09:30:00-05:00,17.146694,17.30095,17.089864,17.284712,63093122,62923779.4,49.27887463466152,42.05790243959128,NaN,NaN,-30.249963828360748,-103.73369831212592,-0.03733139280035862,-0.15729021167851087,-0.11995881887815225,-2307983415,-2378362859.8,23.053300305521176,46.683269123368085,NaN,NaN,-15.553667505477382,-7.532216317910168
2014-02-10T09:30:00-05:00,17.292831,17.317187,17.203525,17.30095,53275525,63346443.45,49.65780688763504,41.542887522422866,NaN,NaN,-16.979630869551197,-75.07514254609546,-0.011133840418097785,-0.13387611940077448,-0.1227422789826767,-2254707890,-2343269285.8,31.375468244966,42.9579255601629,NaN,NaN,-13.191242121330884,-8.3406485755417
2014-02-11T09:30:00-05:00,17.357781,17.528273,17.276594,17.479561,46270707,63035449.05,53.7507675365688,41.2992996477093,NaN,NaN,16.713377492028933,-44.91832514450863,0.018387486876874748,-0.09975792038658327,-0.11814540726345801,-2208437183,-2312508560.8,37.7325953281405,39.66322162789002,NaN,NaN,-9.86873902674929,-8.558947211428498
2014-02-12T09:30:00-05:00,17.503917,17.560748,17.414612,17.479561,47792242,63494863.6,53.7507675365688,41.906863926200565,NaN,NaN,32.3157342662836,-14.54050540895661,0.037004089582293356,-0.07189029528559132,-0.10889438486788468,-2208437183,-2270128441.6,45.25682085332724,37.56611056064842,NaN,NaN,-7.269706871256186,-8.37477001997531
2014-02-13T09:30:00-05:00,17.325306,17.552629,17.325306,17.544511,39806816,61686554.85,55.284002387662014,43.38034947599387,NaN,NaN,38.361645672474104,8.032232546574921,0.05187052655795142,-0.0440562266704454,-0.09592675322839682,-2168630367,-2229639207.6,51.310239969928844,36.58569583725604,NaN,NaN,-4.675020133716572,-7.846234321938348
2014-02-14T09:30:00-05:00,17.520155,17.585104,17.48768,17.568867,37442982,60661437.9,55.87475114093424,45.051188867313456,NaN,NaN,63.90543223015636,26.86331175827835,0.06089827144772028,-0.019803913918746474,-0.08070218536646676,-2131187385,-2194280001.6,55.8968131601896,36.52596078515694,NaN,NaN,-2.382790743772993,-7.06574238220044
2014-02-18T09:30:00-05:00,17.585104,17.633816,17.520155,17.601342,26184219,58435575.05,56.69622458583763,46.16854747879646,NaN,NaN,81.1485069443635,46.48893932106129,0.06617252408100646,0.002013469734791329,-0.06415905434621513,-2105003166,-2164339056.8,59.38562944349578,37.22579763347833,NaN,NaN,-0.24579274120512598,-6.091463862058252
2014-02-19T09:30:00-05:00,17.540451,17.650054,17.349662,17.357781,78955239,59826881.7,49.28537945134341,47.075530735598015,NaN,NaN,55.05969494086781,54.15820281082906,0.05105088222955663,-0.00034545155926934967,-0.05139633378882598,-2183958405,-2159443301.2,59.943609723450464,38.60230004902002,NaN,NaN,-0.40481162783690594,-5.279084971455203
2014-02-20T09:30:00-05:00,17.374018,17.447086,17.276594,17.406493,39186986,60670479.8,50.67405848122182,47.52346379760677,NaN,NaN,43.758839669896155,56.446823891551574,0.04247401507223826,0.0016961850514718435,-0.04077783002076642,-2144771419,-2146710148.4,61.42788180007171,40.362201008548254,NaN,NaN,-0.14560358981679541,-4.5457304883640015
2014-02-21T09:30:00-05:00,17.438968,17.503917,17.374018,17.438968,53131955,60092775,51.62507247276611,48.35519370736641,NaN,NaN,68.66614466790374,62.50772369063751,0.037315885169466344,0.005867026441066514,-0.03144885872839983,-2091639464,-2131311967.8,63.2035654198835,42.46167030058333,NaN,NaN,0.32970367691598906,-3.849239893324003
2014-02-24T09:30:00-05:00,17.447086,17.658173,17.434908,17.568867,51944712,58347276.55,55.33464324669525,49.98093120939427,NaN,NaN,95.43336963792912,68.81331117219206,0.0407032728680521,0.0194302323566653,-0.0212730405113868,-2039694752,-2113013441.2,65.25080310532053,44.97053606499476,NaN,NaN,1.7846191873161252,-3.0444028818039848
2014-02-25T09:30:00-05:00,17.560748,17.568867,17.42273,17.463324,49409667,56847930.05,51.85524354106736,51.02094903636539,NaN,NaN,67.33406809435155,66.05042340218968,0.034151123587575515,0.021415863973082594,-0.012735259614492922,-2089104419,-2109833691.8,65.60887510783635,47.702356855404275,NaN,NaN,2.0758049821764817,-2.312944615521061
2014-02-26T09:30:00-05:00,17.503917,17.520155,17.349662,17.438968,52262335,57282843.4,51.05738302552195,52.023911684946086,NaN,NaN,47.51707576516119,64.54189956704835,0.026815866935295824,0.02078457405462686,-0.006031292880668966,-2141366754,-2101315361.6,66.60175230060707,50.657882604790764,NaN,NaN,2.102684110331603,-1.6821405118278234
2014-02-27T09:30:00-05:00,17.414612,17.536392,17.357781,17.528273,47739898,55700787.85,53.86062443789712,52.71325709759865,NaN,NaN,54.312112368531054,66.65255410677533,0.02656676073047334,0.02717715803242271,0.0006103973019493695,-2093626856,-2091086449,67.80377798413201,53.84650948191933,NaN,NaN,2.886975433810863,-1.0294096624508682
2014-02-28T09:30:00-05:00,17.536392,17.715003,17.503917,17.617579,69304724,56333968.55,56.54127287864254,53.231999829311576,NaN,NaN,88.79339468385523,70.67800410996563,0.030711687699512578,0.03900000692634009,0.008288319226827514,-2024322132,-2077622982.6,69.36655841266642,57.15459934671542,NaN,NaN,4.304805122579448,-0.26737897887510886
2014-03-03T09:30:00-05:00,17.455205,17.503917,17.365899,17.479561,61125327,56089586.55,51.556018800864635,53.367586394542265,NaN,NaN,36.24009992620627,58.839350167621056,0.022816140856182422,0.03680849529705554,0.013992354440873121,-2085447459,-2086773524,66.98667302990337,59.69825683135381,NaN,NaN,4.166976147265565,0.36610032485927313
2014-03-04T09:30:00-05:00,17.682529,17.836784,17.645994,17.836784,61536439,52687803,61.112890331388215,53.89345230845794,NaN,NaN,142.36956004443397,73.84644855763754,0.039340876948781994,0.06316845062685061,0.02382757367806862,-2023911020,-2073734844.2,68.63781248143728,61.90577234230357,NaN,NaN,7.11890738625327,1.3307870479155584
2014-03-05T09:30:00-05:00,17.844903,18.023514,17.804309,18.023514,58734559,52227783.35,64.99981100757509,54.696955413529814,NaN,NaN,218.42578170634957,108.02818974587521,0.05933538854064635,0.09799680935387656,0.03866142081323021,-1965176461,-2038496785.6,72.62295668296196,63.860496330134616,NaN,NaN,10.933950420041311,2.7026675296478087
2014-03-06T09:30:00-05:00,18.023514,18.120938,18.015395,18.080345,53489260,51997397.8,66.11007561751282,55.470246358519155,NaN,NaN,242.24047609587703,145.61386249134443,0.07203145479267095,0.1287007393040689,0.056669284511397945,-1911687201,-2002108854.6,76.01257909017477,65.6249491244379,NaN,NaN,14.34585330535437,4.365979783320174
2014-03-07T09:30:00-05:00,18.194007,18.258956,18.087652,18.161532,81592710,53613971.2,67.68702907725249,56.313980496827604,NaN,NaN,226.6007803072395,173.1753396160213,0.08087761689188461,0.1577663056262537,0.0768886887343691,-1830094491,-1963263326.4,79.00154205312867,67.27528690250497,NaN,NaN,17.646961010543066,6.263262815780587
2014-03-10T09:30:00-04:00,18.120938,18.267075,18.051848,18.169651,29088553,51913742.75,67.84815112002129,57.110546677840716,NaN,NaN,177.18600386610888,201.3645204040018,0.08199963770973846,0.17938823587154218,0.09738859816180372,-1801005938,-1906375022.2,82.45037035551238,68.92276839622045,NaN,NaN,20.347813267252864,8.275341451705199
2014-03-11T09:30:00-04:00,18.194007,18.210244,18.007277,18.04787,55610727,52030502.85,62.79066359330056,58.07520983083765,NaN,NaN,126.2130014987917,198.13320869487333,0.06974468993751902,0.1845694605837025,0.11482477064618347,-1856616665,-1872916151.2,84.10402329291156,70.64851222261053,NaN,NaN,21.21243248608364,10.12349731375926
2014-03-12T09:30:00-04:00,17.934208,18.023514,17.885496,18.015395,39342267,51684080.85,61.4746891612848,58.84668345084214,NaN,NaN,80.91076303349709,170.63020496030285,0.05528808004918087,0.18393487070765957,0.1286467906584787,-1895958932,-1859072645.4,84.7445268989235,72.3139868725285,NaN,NaN,21.554662066508797,11.756520849866337
2014-03-13T09:30:00-04:00,18.072226,18.096582,17.771834,17.812428,70157333,52802335.4,53.874926562572554,59.00738731439976,NaN,NaN,52.08874765930875,132.5998592729892,0.029202936520843742,0.16515046130953337,0.13594752478868963,-1966116265,-1869958458.2,81.94829153941134,73.65289588106621,NaN,NaN,19.574212176428347,12.873333896518053
2014-03-14T09:30:00-04:00,17.747478,17.893615,17.682529,17.698766,54465888,53535289,50.136953477797135,58.63612375947846,NaN,NaN,12.50370196548071,89.78044360463744,0.002829356784258885,0.13948422076901323,0.13665486398475435,-2020582153,-1908055990.6,72.88435145155987,74.19814933436903,NaN,NaN,16.744962642158736,13.426423717323866
2014-03-17T09:30:00-04:00,17.844903,17.950446,17.828665,17.885496,46365892,53981434.5,55.588597099326236,58.90279187078266,NaN,NaN,43.394742284088295,63.02219128823331,-0.0031785955565697965,0.13268161953904212,0.1358602150956119,-1974216261,-1942698055.2,65.76169903925405,74.20906532947029,NaN,NaN,15.927211251141015,13.783679079297745
2014-03-18T09:30:00-04:00,17.934208,17.991039,17.897674,17.974802,44184093,54881428.2,57.95616372171356,59.39556192051064,NaN,NaN,56.00356307163226,48.98030360280141,-0.0023169478216632233,0.13296403031853288,0.1352809781401961,-1930032168,-1957381155.8,62.95351150121406,73.94847670094222,NaN,NaN,15.969771565311552,14.095978005871146
2014-03-19T09:30:00-04:00,17.991039,18.096582,17.836703,17.966683,70012453,54434288.9,57.65524229993171,59.6666060535131,NaN,NaN,53.94004102062301,43.586159200226604,-0.003406891948303209,0.13102236320481708,0.1344292551531203,-2000044621,-1978198293.6,59.10023464709924,73.32679503401131,NaN,NaN,15.916598933073804,14.35606670975724
2014-03-20T09:30:00-04:00,17.934208,18.291431,17.934208,18.250838,112280291,58088954.15,64.58580227957918,60.24121529643715,NaN,NaN,98.6689957859267,52.90220882555019,0.012997089497561759,0.15067561702507248,0.13767852752751072,-1887764330,-1962527906.6,61.03372722280509,72.73159280616407,NaN,NaN,18.07305933966749,14.887065656887275
2014-03-21T09:30:00-04:00,18.307669,18.388856,18.161532,18.185888,82750579,59569885.35,62.084532001835555,60.993251953649356,NaN,NaN,114.39969012046923,73.28140645654788,0.017197312241857804,0.159175167829833,0.14197785558797518,-1970514909,-1952514457.8,62.261436945148056,72.39407594296726,NaN,NaN,19.061788776900972,15.483454674032089
2014-03-24T09:30:00-04:00,18.242719,18.291431,18.072226,18.177769,68536624,60399480.95,61.762531372413136,61.03965488515114,NaN,NaN,89.44261669186245,82.49098133810271,0.01711589834046892,0.16337272851356133,0.1462568301730924,-2039051533,-1965481512.2,59.64088228488904,71.75143807178524,NaN,NaN,19.76191603964091,16.094663440547635
2014-03-25T09:30:00-04:00,18.2346,18.266994,18.074094,18.161532,42122454,60035120.3,61.08025227902207,60.75968640454021,NaN,NaN,80.27369218752978,87.34500716128221,0.013798023000513943,0.16350435892373483,0.14970633592322088,-2081173987,-1995709876,53.94117590305176,70.41702515893452,NaN,NaN,20.147496519215995,16.673639594643113
2014-03-26T09:30:00-04:00,18.267075,18.275194,17.974802,17.974802,62542676,60549137.35,53.72933654987402,59.87534789970887,NaN,NaN,45.810070366132585,85.71901303038413,-0.002286388603344125,0.14684835016904074,0.14913473877238487,-2143716663,-2024444284.4,49.13427388515231,68.49714621571863,NaN,NaN,18.32262285420932,16.909208631724
2014-03-27T09:30:00-04:00,17.934208,18.01296,17.779953,17.877377,81057998,62215042.35,50.32622652324748,58.635290574422804,NaN,NaN,-34.409668580560314,59.103280157086736,-0.019824998764649993,0.12435349031657239,0.14417848908122238,-2224774661,-2091846350.6,40.10591316769341,65.71888700961611,NaN,NaN,15.750057414008445,16.743615600621776
2014-03-28T09:30:00-04:00,17.92609,18.064108,17.885496,17.950446,48951588,61197385.55,52.743752650406364,57.556404969450305,NaN,NaN,-10.656111957803375,34.092119741432214,-0.02642995552612501,0.11114104467356611,0.13757100019969112,-2175823073,-2132907983.4,35.79123211385051,62.38609142092598,NaN,NaN,14.275285904905829,16.390997072662355
2014-03-31T09:30:00-04:00,18.080345,18.191571,18.064108,18.137176,41072894,60194763.9,58.32561180116837,57.237472698583716,NaN,NaN,58.9138424427907,27.98636489161786,-0.01852184870698667,0.11441868931595778,0.13294053802294445,-2134750179,-2152047712.6,33.95740239401388,58.80418992814757,NaN,NaN,14.649440871689931,16.142203329666295
2014-04-01T09:30:00-04:00,18.185888,18.226482,18.120938,18.169651,51682726,59702078.25,59.227609772067524,57.07696702792534,NaN,NaN,75.00762169776286,26.93315079366449,-0.011733769519677723,0.11827332612334729,0.130007095643025,-2083067453,-2152426405.8,33.92037020858302,55.173893021694674,NaN,NaN,15.219682793459805,16.010414681636796
2014-04-02T09:30:00-04:00,18.185888,18.250838,18.149354,18.210244,44591901,58994945.35,60.38190419658994,57.54175114464088,NaN,NaN,85.12768427804299,34.79667357604657,-0.0054587288521204536,0.12318368457787443,0.12864241342999488,-2038475552,-2131378183.6,37.969509291997845,52.03255143259371,NaN,NaN,16.02282613205868,16.01218774598278
2014-04-03T09:30:00-04:00,18.226482,18.250838,18.120938,18.177769,46658171,58653390.9,58.94418494874555,58.170839106851474,NaN,NaN,67.61268634382995,55.201144560924625,-0.004484786302931504,0.12303643055133051,0.12752121685426202,-2085133723,-2103449996,42.96362949864017,49.89535700738516,NaN,NaN,16.2983044389712,16.05306155926684
2014-04-04T09:30:00-04:00,18.275194,18.311728,17.982921,17.999158,60237716,57585641.2,51.65875858094985,57.89013635553887,NaN,NaN,22.759061276447447,61.884179207774785,-0.016200361417284384,0.10727076508265654,0.12347112649994092,-2145371439,-2097359669.2,44.02203815647661,48.34252408718677,NaN,NaN,14.403034160523498,15.817343359446363
2014-04-07T09:30:00-04:00,17.982921,17.98698,17.706885,17.723122,72939990,59778213.05,42.84508062642681,56.81077327730411,NaN,NaN,-123.80611563152175,25.3401875929123,-0.041435842556541994,0.07167632330426343,0.11311216586080543,-2218311429,-2114071919.2,41.733464215663254,46.82680642393314,NaN,NaN,9.719423079574614,14.946211890893256
2014-04-08T09:30:00-04:00,17.73936,17.788072,17.601342,17.747478,56332023,59814277.85,43.75689704583032,55.818034330582584,NaN,NaN,-146.91774627593577,-19.044886001827425,-0.054557696910817036,0.044915044722284136,0.09947274163310117,-2161979406,-2129854309.8,39.63777619421715,45.43663082015585,NaN,NaN,6.274301883826422,13.707367604169423
2014-04-09T09:30:00-04:00,17.804309,17.917971,17.715003,17.901734,44933515,60093840.25,49.27622434284443,54.72449304938725,NaN,NaN,-77.20439782153345,-51.51130242174272,-0.05098483283106889,0.03574170059426507,0.08672653342533396,-2117045891,-2145568377.6,37.6125413470196,43.76368897188546,NaN,NaN,5.0133316534760555,12.465362468356085
2014-04-10T09:30:00-04:00,17.917971,17.917971,17.479561,17.48768,94514238,61311685.5,38.38692762342767,53.03180702235811,NaN,NaN,-155.50329097387714,-96.13449788528413,-0.07328734988327541,-0.0048826539287603055,0.06840469595451511,-2211560129,-2170853658.8,34.5532627944541,41.78453367540731,NaN,NaN,-0.17328754563272847,10.659841037786254
2014-04-11T09:30:00-04:00,17.284712,17.487761,17.203525,17.276594,98116183,63494200.25,34.23354952221267,51.065451175915214,NaN,NaN,-241.03371339048311,-148.89305281867024,-0.0975189394578838,-0.053493978367839645,0.044024961090044154,-2309676312,-2203714633.4,31.021828927057854,39.74031557841937,NaN,NaN,-5.982526779988391,8.282359920961305
2014-04-14T09:30:00-04:00,17.479561,17.503917,17.236,17.414612,69288483,64640329.8,38.889366340407406,49.4803878945856,NaN,NaN,-181.44420443855608,-160.42067058007711,-0.09918810725240437,-0.07996017297546132,0.019227934276943057,-2240387829,-2208129913.4,30.569747813297653,38.07092785772265,NaN,NaN,-8.96090354508547,5.819036568668908
2014-04-15T09:30:00-04:00,17.455205,17.60946,17.325306,17.576985,103916131,67626931.7,43.91935759574111,48.77967511214754,NaN,NaN,-120.75352776391166,-155.1878268776723,-0.08484773668555923,-0.08683173658000598,-0.0019839998944467495,-2136471698,-2203028371.8,31.806324152136682,36.833217162507246,NaN,NaN,-9.619953563679323,3.613466549762018
2014-04-16T09:30:00-04:00,17.658173,17.723122,17.552629,17.715003,49392490,66595933.55,47.84871939541016,48.60271031730201,NaN,NaN,-67.66550283642134,-153.28004788064987,-0.06258553759899615,-0.08021592189319193,-0.017630384294195785,-2087079208,-2197035035.2,33.30908809373511,36.34772965722451,NaN,NaN,-8.80136307811734,1.8399194600649669
2014-04-17T09:30:00-04:00,17.73936,17.788072,17.658173,17.747478,58990803,63931459.15,48.75848417724876,48.31804828350504,NaN,NaN,-44.38310960434904,-131.05601160674425,-0.043117973722625394,-0.07152785144747753,-0.028409877724852137,-2028088405,-2160340690.4,41.76985427687472,36.77477409744052,NaN,NaN,-7.867938307864892,0.4530826360749871
2014-04-21T09:30:00-04:00,17.755597,17.771834,17.690647,17.731241,37707593,61679309.85,48.304756413995634,47.60227289870699,NaN,NaN,-38.98979184632567,-90.64722729791278,-0.029432966377844594,-0.06520108569715788,-0.035768119319313285,-2065795998,-2111564627.6,50.7195799835957,37.97207249669636,NaN,NaN,-7.262891011871221,-0.6491993136316141
2014-04-22T09:30:00-04:00,17.755597,17.901734,17.690647,17.853102,33052510,59905104.15,51.92089575413473,47.080364754568926,NaN,NaN,-10.912510719173504,-56.54088855403626,-0.01120956871680314,-0.04978008021531721,-0.03857051149851407,-2032743488,-2070035759.4,56.80663128949755,39.606805431047405,NaN,NaN,-5.6476549928972375,-1.3632644106695602
2014-04-23T09:30:00-04:00,17.836784,17.909852,17.812428,17.893615,32216630,59409812.95,53.09558407984669,46.5599133176587,NaN,NaN,11.340762712579567,-30.12203045873802,0.0037372130114401297,-0.03389899523421391,-0.03763620824565404,-2000526858,-2042846791.4,60.266918307976304,41.199477503617295,NaN,NaN,-3.9787401893970835,-1.736903807630635
2014-04-24T09:30:00-04:00,17.974802,17.974802,17.812428,17.885496,36940577,58129708,52.81707876784119,46.12226287616553,NaN,NaN,21.360651015209967,-12.316799688411752,0.012734641863829298,-0.02171790591586742,-0.03445254777969672,-2037467435,-2032924436.8,61.479723766889705,42.52205566563511,NaN,NaN,-2.6904844626974644,-1.8731296154973247
2014-04-25T09:30:00-04:00,17.840843,17.86114,17.706885,17.73936,35226456,55838130.9,47.942520147046416,45.85681727374386,NaN,NaN,-17.74316136002181,-6.988810039546311,0.008694524171883405,-0.02358439256484246,-0.032278916736725866,-2072693891,-2041845534,59.71486657036038,43.64297198091253,NaN,NaN,-2.923771864484637,-2.023221365352655
2014-04-28T09:30:00-04:00,17.73936,17.788072,17.463324,17.633816,54100832,56095593.1,44.73155264511048,45.9915652750784,NaN,NaN,-59.61725540376383,-11.114302751033948,-0.000734815439036772,-0.03319743603552183,-0.03246262059648506,-2126794723,-2054045279,57.292752913093075,44.754349745014665,NaN,NaN,-4.048918955623599,-2.3126067353913613
2014-04-29T09:30:00-04:00,17.67441,17.812428,17.658173,17.804309,34202240,55752060.4,50.499036524963124,46.47314666644503,NaN,NaN,-10.183035067551016,-10.968407620709451,0.004569997881715422,-0.026750123244340784,-0.031320121126056207,-2092592483,-2066015078,54.93820617821372,45.84723760101441,NaN,NaN,-3.3254165172188115,-2.457293847080997
2014-04-30T09:30:00-04:00,17.755597,17.869259,17.73936,17.828665,46803615,55508104.85,51.28118630208957,46.61635823496254,NaN,NaN,18.34832851050139,-9.56689446112506,0.009495267845092588,-0.019451036319690473,-0.02894630416478306,-2045788868,-2075067480,53.15892148244013,46.95769332497303,NaN,NaN,-2.509266240474158,-2.4647184747085915
2014-05-01T09:30:00-04:00,17.828665,17.885496,17.771834,17.86114,33636737,54960346.65,52.36201662430974,47.61457887788269,NaN,NaN,41.48939091525449,-5.541146481116155,0.014420950571362928,-0.010920115950579401,-0.02534106652194233,-2012152131,-2070004419.2,54.055196641108786,48.350688599734085,NaN,NaN,-1.5285072708684173,-2.3309740170171382
2014-05-02T09:30:00-04:00,17.869259,18.015395,17.808368,17.853021,34622475,54358561.85,52.051110782503066,48.88726182504629,NaN,NaN,79.8774303978175,13.982971870451706,0.016465197073176514,-0.004759570180471684,-0.021224767253648198,-2046774606,-2064820562.2,55.004506617989925,50.06373700622923,NaN,NaN,-0.795991620919446,-2.111690817574611
2014-05-05T09:30:00-04:00,17.690647,17.79619,17.625698,17.779953,23219904,52507671.25,49.21872602572871,49.62507323114067,NaN,NaN,9.593586969168111,27.825140345038097,0.01241383143062285,-0.005707477965369634,-0.018121309395992484,-2069994510,-2053460519.6,57.09657208904348,51.9585101687825,NaN,NaN,-0.9076734704811582,-1.9396883394184035
2014-05-06T09:30:00-04:00,17.731241,17.731241,17.528273,17.528273,73949778,52558160.65,40.9524753265635,49.41315306905655,NaN,NaN,-60.54067835761153,17.75361168702599,-0.00667266073352955,-0.026462135312904422,-0.019789474579374872,-2143944288,-2063730880.6,54.62382993116389,53.58833201014159,NaN,NaN,-3.4906869211877334,-2.1612595653854507
2014-05-07T09:30:00-04:00,17.617579,17.779953,17.568867,17.763716,50441039,52263611.45,49.49749194598878,49.53092253695502,NaN,NaN,-1.0759331574166213,13.868759353442389,-0.0030800732690361744,-0.02363956616567009,-0.020559492896633915,-2093503249,-2073273756.8,52.354983561798825,54.948753115003285,NaN,NaN,-3.1137691530114315,-2.2973323636177336
2014-05-08T09:30:00-04:00,17.73936,17.909852,17.73936,17.812428,35879393,51810905.35,51.075018741921525,49.696389291574505,NaN,NaN,63.834211453598385,18.33772346111117,0.002629276496230456,-0.017272897276345844,-0.0199021737725763,-2057623856,-2082368101.8,50.21441960434702,55.551936352679874,NaN,NaN,-2.3205100563665315,-2.3006434625818475
2014-05-09T09:30:00-04:00,17.804309,17.824606,17.690647,17.804309,29390279,48554707.4,50.79024798123858,49.87392440352043,NaN,NaN,34.427445919311275,9.247726565409923,0.005733264008763235,-0.012735593761622255,-0.01846885777038549,-2087014135,-2090416007.6,48.33122948664532,55.38133988861199,NaN,NaN,-1.7661645901722933,-2.224289337951911
2014-05-12T09:30:00-04:00,17.893615,17.991039,17.853021,17.982921,25658171,44931806.8,56.53205678874658,50.203293048849844,NaN,NaN,131.3322456423316,33.59545830004262,0.01894521369497873,0.0052126593483379224,-0.013732554346640807,-2061355964,-2088688298.4,48.775366556827855,54.80767812199273,NaN,NaN,0.4978821762225686,-1.8354076930698426
2014-05-13T09:30:00-04:00,17.991039,18.039751,17.942327,17.966683,29006375,42917701.4,55.893549545715565,50.403147724983334,NaN,NaN,153.63706270690582,76.4310065129461,0.025321994244519995,0.017919938459009188,-0.007402055785510808,-2090362339,-2077971908.6,51.556894408485654,54.1855335577434,NaN,NaN,2.1443940200976104,-1.266864591188778
2014-05-14T09:30:00-04:00,17.950446,17.966683,17.804309,17.836784,31452082,39294498.95,50.937177778602674,50.26886908289487,NaN,NaN,63.05204898448429,89.25660294132628,0.019769048390712758,0.01730925470288014,-0.002459793687832618,-2121814421,-2083634143,50.01164109199642,53.366384795251015,NaN,NaN,2.117716552991622,-0.7833529991630066
2014-05-15T09:30:00-04:00,17.755597,17.779953,17.503917,17.633816,49040995,39276924.2,44.32350468011178,50.01036797811382,NaN,NaN,-120.27981356746022,52.43379793711455,0.0023217252043159103,0.0004423628175622696,-0.0018793623867536407,-2170855416,-2106280455,44.29358870923357,52.26486494802767,NaN,NaN,-0.003096535361348157,-0.671887790048484
2014-05-16T09:30:00-04:00,17.641935,17.658173,17.520155,17.654113,41233366,38389052.35,45.09128694070121,50.03606328494173,NaN,NaN,-128.8542734532648,19.777454062599332,-0.007423186719127659,-0.011158345785663215,-0.0037351590665355558,-2129622050,-2114802038,42.33223596486934,51.196256594583126,NaN,NaN,-1.4747404023066542,-0.7865810203710797
2014-05-19T09:30:00-04:00,17.60946,17.763716,17.601342,17.747478,24689388,37738142.1,48.602408650027286,49.90058986530345,NaN,NaN,-57.54650631220299,-17.998296328307585,-0.007149584093807871,-0.012672139183795395,-0.005522555089987524,-2104932662,-2123517377.6,40.36365170540759,50.15521698938268,NaN,NaN,-1.6815305148927464,-0.9144309481598892
2014-05-20T09:30:00-04:00,17.715003,17.755597,17.576985,17.641935,24018175,37286425.35,45.09217654304933,49.45851773965772,NaN,NaN,-82.0551021703153,-65.1367293037518,-0.013288461868212514,-0.022133132425253166,-0.008844670557040652,-2128950837,-2131235077.2,38.64962976330804,49.11883900944468,NaN,NaN,-2.914103929294899,-1.2000985168934621
2014-05-21T09:30:00-04:00,17.706885,17.828665,17.698766,17.755597,39083243,37629756,49.33591659869336,49.24236773782798,NaN,NaN,-6.168699678355163,-78.98087903631969,-0.009105309920097846,-0.02022630795716296,-0.011120998037065113,-2089867594,-2124845711.8,40.88762359349164,48.17829807747203,NaN,NaN,-2.6900206807650124,-1.4129445403036835
2014-05-22T09:30:00-04:00,17.779953,17.869259,17.731647,17.836784,22568571,36911155.7,52.17899680250922,49.251502453542706,NaN,NaN,36.55117921314722,-47.6146804801982,-0.0007235232396591469,-0.012025402086639048,-0.0113018788469799,-2067299023,-2104134433.2,47.56487697469153,47.646895960093566,NaN,NaN,-1.6470289664967768,-1.4463851726169825
2014-05-23T09:30:00-04:00,17.86114,17.901734,17.820547,17.893615,20395424,36169604.1,54.11986951179301,49.60158413111873,NaN,NaN,74.17937769162342,-7.007950251220564,0.00829780527776712,-0.0009296222497710005,-0.00922742752753812,-2046903599,-2087590743,52.20872712122477,47.29776417667795,NaN,NaN,-0.20584216623342275,-1.2691647431336168
2014-05-27T09:30:00-04:00,17.934208,18.120938,17.934208,18.04787,28461703,34887647.65,58.98565327509536,50.88966827029957,NaN,NaN,167.4177741671824,37.98490584465651,0.023445532983780194,0.02007948870218712,-0.003366044281593072,-2018441896,-2070292589.8,56.54255926019234,47.434816271608554,NaN,NaN,2.567546444878803,-0.7210631448461283
2014-05-28T09:30:00-04:00,18.007277,18.064108,17.974802,18.015395,40471933,35201132.3,57.60065206350192,51.46846542155051,NaN,NaN,135.5296760910351,81.50186149692658,0.029668990619459937,0.03372019399273185,0.004051203373271913,-2058913829,-2056285188.2,59.72731818690794,47.9614116019735,NaN,NaN,4.434435756947342,0.015436698267224491
2014-05-29T09:30:00-04:00,18.055989,18.072226,17.976344,18.055989,18372183,33779560.7,58.899760732452684,52.02737556373131,NaN,NaN,126.76367425113368,108.08833628282437,0.03456811598030401,0.04726134834865192,0.012693232368347915,-2040541646,-2046419998.6,61.84793872587301,48.79237725351107,NaN,NaN,6.362826520207646,0.9222066728301418
2014-05-30T09:30:00-04:00,18.015395,18.11282,18.003217,18.096582,33541329,33774790.3,60.212583290328986,52.70039951438063,NaN,NaN,127.44928121072417,126.26795668233974,0.03830150373463063,0.0605701120366362,0.022268608302005576,-2007000317,-2034360257.4,64.32125266771867,49.93452176644488,NaN,NaN,8.35388696044423,1.98387528534644
2014-06-02T09:30:00-04:00,18.11282,18.161532,18.023514,18.145295,24998082,33293570.65,61.78989777324394,53.07595958470187,NaN,NaN,130.04447461193405,137.44097606640187,0.04153942194166478,0.07419288572908656,0.032653463787421774,-1982002235,-2021379984.6,66.81489920880745,51.22305981301485,NaN,NaN,10.488674464487694,3.1988465966523334
2014-06-03T09:30:00-04:00,18.096582,18.169651,18.064108,18.169651,19318097,33098480.3,62.588487262872725,53.55416942164167,NaN,NaN,123.5553549464148,128.66849222224835,0.04264796882970133,0.08596342482454844,0.04331545599484711,-1962684138,-2010228433,68.83044234665803,52.45688466574144,NaN,NaN,12.504876853460745,4.528279490482107
2014-06-04T09:30:00-04:00,18.11282,18.2346,18.11282,18.218363,24095902,30605786.5,64.20003321353391,54.50151623842248,NaN,NaN,131.13425091689018,127.78940718741937,0.0438208948402944,0.09809157454521511,0.05427067970492071,-1938588236,-1986163314.4,72.68587904004306,54.07647309060191,NaN,NaN,14.682446129750348,5.978874724663283
2014-06-05T09:30:00-04:00,18.250838,18.396974,18.169651,18.388856,38225919,29995030.5,69.20075575387304,56.278462743691136,NaN,NaN,161.20446359279887,134.6775650557524,0.052644587952011004,0.12007641464493446,0.06743182669292345,-1900362317,-1958127448.6,76.35522581873302,56.366590026994736,NaN,NaN,18.1964582584291,7.724243800915543
2014-06-06T09:30:00-04:00,18.437568,18.534992,18.405093,18.510636,36775666,30039844.15,72.189029504025,58.21401578392855,NaN,NaN,190.20709349432383,147.22912751247236,0.06257234356695102,0.14564725615161223,0.08307491258466121,-1863586651,-1929444715.4,79.40369670542695,59.01455150846313,NaN,NaN,22.21427990174958,9.794248958177548
2014-06-09T09:30:00-04:00,18.518755,18.616179,18.502517,18.591823,39763710,30558515.7,74.00014619655798,60.02813989439503,NaN,NaN,187.90274442446673,158.8007814749789,0.06993850936007022,0.170498049284749,0.10055953992467877,-1823822941,-1897808856.6,82.13895052549265,61.998501424183495,NaN,NaN,26.188651212171578,12.136306423033837
2014-06-10T09:30:00-04:00,18.543111,18.583704,18.510636,18.583704,26568428,30604028.55,73.48476528256737,62.05618194721775,NaN,NaN,156.65009475335273,165.41972943636648,0.06945426940138408,0.18737737667640886,0.11792310727502478,-1850391369,-1875350302.8,83.78523834748724,65.22247346591058,NaN,NaN,29.27421631793204,14.584579265162152
2014-06-11T09:30:00-04:00,18.510636,18.518755,18.405093,18.461924,25335941,30420506.85,66.05370094858722,63.250309400781596,NaN,NaN,111.59304156340619,161.51148756566965,0.05666305204760308,0.18875192233452864,0.13208887028692556,-1875727310,-1862778117.6,84.63880503985106,68.34755785493626,NaN,NaN,29.83850585426564,16.763711635034078
2014-06-12T09:30:00-04:00,18.453805,18.461924,18.315787,18.348262,37015588,30698682.15,59.9592586233977,63.806042387987915,NaN,NaN,79.15622742712311,145.1018403325345,0.03721752167602052,0.17861077238195122,0.1413932507059307,-1912742898,-1865254233.8,83.70421924555306,70.92893944571207,NaN,NaN,28.471604237974585,18.436267721168434
2014-06-13T09:30:00-04:00,18.396974,18.437568,18.29955,18.356381,34448791,29969071.95,60.24144712619898,64.24329793187405,NaN,NaN,68.76387206144557,120.81319604595885,0.022307516311787512,0.1692776460956651,0.14697012978387758,-1878294107,-1868195725,82.53825257102814,73.09533412069803,NaN,NaN,27.444987145842003,19.723227638978944
2014-06-16T09:30:00-04:00,18.323906,18.323906,18.218363,18.267075,41760924,29995449.85,55.599789212634946,64.00145049884117,NaN,NaN,37.089383652722326,90.65052389160996,0.004753618033791346,0.15291215232611677,0.14815853429232542,-1920055031,-1887442143,75.16094232292002,74.42521862517857,NaN,NaN,25.179179541387498,20.502649339323025
2014-06-17T09:30:00-04:00,18.242719,18.470043,18.2346,18.453805,30120516,30267006.25,62.164239253708296,64.32742101242734,NaN,NaN,63.196672959250215,71.95983953278945,0.004067921444856709,0.1532434360983963,0.1491755146535396,-1889934515,-1895350772.2,72.30121669760555,75.32335423308555,NaN,NaN,25.129850274524994,21.163678044351876
2014-06-18T09:30:00-04:00,18.445686,18.591823,18.372618,18.559348,38148378,30973516.4,65.2881003721487,64.78373098669134,NaN,NaN,91.14373381264997,67.86997798263823,0.008800395943310446,0.16017600958267764,0.1513756136393672,-1851786137,-1890562537.6,72.97173284889668,76.11791095615867,NaN,NaN,26.077093280829594,21.865594506705836
2014-06-19T09:30:00-04:00,18.567467,18.583704,18.470043,18.534992,28459880,30442348.25,63.97540632989878,65.05250406094632,NaN,NaN,90.56232302301368,70.15119710181634,0.008370882383928413,0.1618392166192777,0.15346833423534928,-1880246017,-1884063161.4,73.89546374930248,76.8017831762718,NaN,NaN,26.440309155229908,22.519125170780704
2014-06-20T09:30:00-04:00,18.543111,18.559348,18.478161,18.534992,30687011,30848270.25,63.97540632989878,65.20861181499309,NaN,NaN,82.6391679649248,72.92625628251218,0.006263714610477367,0.161297977498446,0.15503426288796862,-1880246017,-1884453543.4,73.73246329886663,77.2958948969903,NaN,NaN,26.732644529432193,23.121056507730916
2014-06-23T09:30:00-04:00,18.534992,18.591823,18.470043,18.575586,23908282,31023913.15,65.32311137453596,65.40394210868332,NaN,NaN,84.83085480509051,82.47455051298581,0.005791824866222761,0.16227404397074707,0.1564822191045243,-1856337735,-1871710084.2,75.62279156242434,77.78106269811647,NaN,NaN,27.355057821614785,23.725913838285756
2014-06-24T09:30:00-04:00,18.534992,18.616098,18.429449,18.453805,27777628,30989709.4,58.27923135163536,64.98102768997629,NaN,NaN,61.97779852399356,82.23077562593448,-0.0040059609526075235,0.1514747679137649,0.15548072886637243,-1884115363,-1870546253.8,75.79411856991959,78.00307980739338,NaN,NaN,25.840678279488195,24.028023044171817
2014-06-25T09:30:00-04:00,18.364499,18.494399,18.344203,18.470043,31636994,30547962.45,58.9153849592664,64.24635834750438,NaN,NaN,30.945975473336343,70.19122395807176,-0.010318241097868969,0.14258292749403623,0.1529011685919052,-1852478369,-1870684700.2,75.725937600573,77.95813064895337,NaN,NaN,24.77171718488413,24.134265064273578
2014-06-26T09:30:00-04:00,18.445686,18.470043,18.267075,18.405093,32922132,31275459.9,55.28424979218631,63.038874082373056,NaN,NaN,-2.7197591432548065,51.53480752481806,-0.019272684788042505,0.12881031260685205,0.14808299739489456,-1885400501,-1871715597,75.1836009002061,77.65669523429474,NaN,NaN,22.810213398084713,23.9451148262466
2014-06-27T09:30:00-04:00,18.348262,18.478161,18.348262,18.478161,22102908,30703538.85,58.39118230274779,61.923948089958046,NaN,NaN,18.513763017912634,38.70972653541563,-0.02056186599431578,0.12238066490199984,0.14294253089631562,-1863297593,-1868325912.2,75.79738472654,77.20372624865527,NaN,NaN,21.981102333183884,23.664541612951925
2014-06-30T09:30:00-04:00,18.437568,18.494399,18.413212,18.461924,46012212,31754245.35,57.436146080934535,60.77761814698427,NaN,NaN,24.561315647487177,26.655818703894965,-0.02263139998278424,0.11465328091783533,0.13728468090061957,-1909309805,-1878920326.2,69.97226427001272,76.21708524312137,NaN,NaN,21.027933456861987,23.287883304939076
2014-07-01T09:30:00-04:00,18.502517,18.656773,18.502517,18.575586,34944840,32535582.5,62.108239753995306,60.4957994902277,NaN,NaN,107.21004467104676,35.7022679333056,-0.016740123335096474,0.11635952673174899,0.13309965006684546,-1874364965,-1876970246.6,70.42283943540943,75.2016591285184,NaN,NaN,21.510722504813067,23.03400319063536
2014-07-02T09:30:00-04:00,18.567467,18.632416,18.551229,18.559348,21728245,32417199.65,61.07678847811811,60.57562305127916,NaN,NaN,105.04055963511888,50.521184765662106,-0.014419755666596618,0.1150749554835997,0.1294947111501963,-1896093210,-1885693214.8,65.67555706584193,73.91389754425333,NaN,NaN,21.621805884192785,22.83226071828642
2014-07-03T09:30:00-04:00,18.689247,18.729841,18.648654,18.705485,27241874,31867997.4,66.47318794138427,61.020747395220965,NaN,NaN,183.5961722081616,87.78437103594538,-0.00406394337128585,0.12441478193608901,0.12847872530737486,-1868851336,-1882383381.8,66.5957104918504,72.77514453859777,NaN,NaN,23.355389737308528,22.90699343528958
2014-07-07T09:30:00-04:00,18.681129,18.681129,18.567467,18.624298,30436945,31551061.35,61.3816934357498,61.43374055401489,NaN,NaN,107.91984460620704,105.66558735360427,-0.003712562909700845,0.12383802167024882,0.12755058457994967,-1899288281,-1889581519.4,62.661511161229946,71.88232802704849,NaN,NaN,23.295347361040516,22.962472567539713
2014-07-08T09:30:00-04:00,18.591823,18.60806,18.42133,18.461924,42259197,31675835.7,52.6893600488103,60.75696346795075,NaN,NaN,9.723197221927002,102.69796366849224,-0.014822889438385944,0.10902197278196724,0.12384486222035318,-1941547478,-1896029054,59.283197689738856,70.95246952648658,NaN,NaN,20.396844014942804,22.59595420288301
2014-07-09T09:30:00-04:00,18.48628,18.526873,18.445686,18.510636,23904816,31542655.1,54.7591780096444,60.00489758491472,NaN,NaN,10.557154684715607,83.367385671226,-0.01902997043482149,0.10005739917682632,0.11908736961164781,-1917642662,-1904684593.4,54.996532825425234,69.6685266676672,NaN,NaN,18.6859794428625,22.037386380022937
2014-07-10T09:30:00-04:00,18.307669,18.441627,18.2346,18.388856,31833252,31867520.65,48.98891223416938,58.93443372093405,NaN,NaN,-97.56139539096752,42.84699466600874,-0.029526716719643825,0.08217897371209304,0.11170569043173686,-1949475914,-1915361134.2,50.17691121023814,67.97434434344831,NaN,NaN,15.319144489704485,21.077637538548874
2014-07-11T09:30:00-04:00,18.364499,18.437568,18.275194,18.42133,26120271,31322754.8,50.48721892032809,57.97099176310758,NaN,NaN,-79.38330979731813,-9.748901735087202,-0.0335040192962847,0.06982566631138099,0.10332968560766569,-1923355643,-1926261995.6,45.766859498051616,65.97680121481866,NaN,NaN,13.068826363886481,19.933521656454246
2014-07-14T09:30:00-04:00,18.599942,18.60806,18.510636,18.534992,26282507,30914440.6,55.422542359144344,57.26380826200817,NaN,NaN,54.60928120049768,-20.41101441622907,-0.027928973158830972,0.06841846915912697,0.09634744231795794,-1897073136,-1925818966.6,45.97468225857817,63.8590791216868,NaN,NaN,12.67953066597304,18.897237229242645
2014-07-15T09:30:00-04:00,18.632416,18.705485,18.563408,18.664891,36342801,30643534.45,60.29370730664949,57.40769940165204,NaN,NaN,127.22687190018505,3.089720519422538,-0.015559089851295435,0.07689858000383865,0.09245766985513408,-1860730335,-1909655538,53.044395638787414,62.23409891232021,NaN,NaN,13.941949751816232,18.18933901818173
2014-07-16T09:30:00-04:00,18.681129,18.705485,18.575586,18.632416,32851048,30780061.05,58.5705501865341,57.38306834645688,NaN,NaN,108.98420898606157,22.775131379691732,-0.009905650998349488,0.08007560610719722,0.0899812571055467,-1893581383,-1904843282.2,54.935180063696386,60.74904480254331,NaN,NaN,14.417453031384062,17.65049816292492
2014-07-17T09:30:00-04:00,18.543111,18.624298,18.372618,18.388856,42061092,30975696.75,47.586178728840764,56.83320612764648,NaN,NaN,-46.92024873143949,32.90336071159734,-0.022206686601539072,0.062222898853622866,0.08442958545516194,-1935642475,-1902076594.4,56.0313893037516,59.38102968851084,NaN,NaN,11.040437346677837,16.706203760603906
2014-07-18T09:30:00-04:00,18.445686,18.616179,18.445686,18.599942,25843192,30844862.35,55.393961326367354,56.61911891504788,NaN,NaN,32.368091873730116,55.25364104580699,-0.016051339230284747,0.064365411417306,0.08041675064759075,-1909799283,-1899365322.4,57.13188370131534,58.047779615280504,NaN,NaN,10.957974474463752,15.885028148298169
2014-07-21T09:30:00-04:00,18.502517,18.575586,18.470043,18.551229,18276275,30224325.55,53.41641460675905,56.331995238321056,NaN,NaN,13.21788385459712,46.97536157662688,-0.015193743043844382,0.06142457184278527,0.07661831488662965,-1928075558,-1905565806.8,53.81460138161242,56.89366083753763,NaN,NaN,10.211680632894398,15.074549931811916
2014-07-22T09:30:00-04:00,18.599942,18.640535,18.567467,18.60806,16008971,29829360,55.41612562792297,55.85398708645875,NaN,NaN,70.81560708339858,35.69310861326959,-0.0109314301510062,0.06295402719787191,0.07388545734887811,-1912066587,-1915833057.2,48.76533460559979,55.346696206836945,NaN,NaN,10.280021259514909,14.389617264340915
2014-07-23T09:30:00-04:00,18.616179,18.681129,18.58752,18.648654,17636242,29322290.7,56.84128701282357,55.551451267509144,NaN,NaN,88.33510127579164,31.563287071215598,-0.005769836738794637,0.06667316142538482,0.07244299816417946,-1894430345,-1916002849.6,48.68398357237086,54.13301238587473,NaN,NaN,10.785798008508715,13.874785942079171
2014-07-24T09:30:00-04:00,18.697366,18.721722,18.656773,18.689247,25138735,28997377.75,58.27753740074388,54.96604765746339,NaN,NaN,115.42168207214564,64.03167323193261,-0.0003020841674114816,0.0720653929549151,0.07236747712232658,-1869291610,-1902732676.6,55.00209371465224,53.30489690178915,NaN,NaN,11.635792002692098,13.554929665023876
2014-07-25T09:30:00-04:00,18.616179,18.67301,18.567467,18.583704,44726579,29587600.1,53.310081823991645,54.38950397090924,NaN,NaN,47.8264646026044,67.12334777770748,-0.0042544351999077995,0.06704943312244183,0.07130386832234963,-1914018189,-1903576457.8,54.54225525456291,52.72495005131293,NaN,NaN,10.842644739430316,13.167460389939082
2014-07-28T09:30:00-04:00,18.567467,18.640535,18.470043,18.591823,51945757,31079742.55,53.637466053217196,54.45722582836688,NaN,NaN,8.997493090097294,66.27926962480751,-0.0066405958782639884,0.06300312347451964,0.06964371935278363,-1862072432,-1890375832.6,60.15470489446127,52.78720056593596,NaN,NaN,10.300422531696743,12.75788355304732
2014-07-29T09:30:00-04:00,18.616179,18.662212,18.48628,18.494399,35018081,30530036,49.181098858266026,54.058791603268425,NaN,NaN,-14.013661938972314,49.31341582033333,-0.014640384730134987,0.0513432384401149,0.06598362317024989,-1897090513,-1887380617.8,61.32159846004902,53.23899096840909,NaN,NaN,8.505499385606997,12.150400100555846
2014-07-30T09:30:00-04:00,18.567467,18.648654,18.457864,18.575586,49053243,31235456.15,52.70733750616814,54.32439340841119,NaN,NaN,-0.4830935643782356,31.549776852299363,-0.01430741966609557,0.04809934858763043,0.062406768253726,-1848037270,-1878102002.8,64.76413818676954,54.28093575244704,NaN,NaN,8.012875912134819,11.559325216495699
2014-07-31T09:30:00-04:00,18.445686,18.494399,18.185888,18.194007,61859459,33242016.85,39.00745827532884,53.50441050519696,NaN,NaN,-208.35969958108845,-33.20649947834746,-0.03826913596942015,0.014570348291950808,0.05283948426137096,-1909896729,-1886223026.6,59.75144453282664,55.27983468350241,NaN,NaN,2.557883352424715,10.273404950199843
2014-08-01T09:30:00-04:00,18.145295,18.218363,17.958564,18.039751,61052156,34932530.95,35.04213579760507,52.04866717937273,NaN,NaN,-279.10727246069155,-98.59324689100666,-0.06160772923019085,-0.02417017727636761,0.03743755195382324,-1970948885,-1897609165.8,53.49922198264274,55.81730180664987,NaN,NaN,-3.3714569823326594,8.324138959838058
2014-08-04T09:30:00-04:00,18.104701,18.210244,18.023514,18.185888,32251184,35023242.9,41.146060953615056,50.68097815415598,NaN,NaN,-187.50440544348874,-137.89362659772388,-0.06402151745180439,-0.04258934486093224,0.021432172590872146,-1938697701,-1912934219.6,46.45365269358799,55.34653445342134,NaN,NaN,-6.026742099562318,6.274013094209433
2014-08-05T09:30:00-04:00,18.096582,18.153413,17.92609,17.999158,49151909,35367878.5,36.434845286679646,49.099856375594946,NaN,NaN,-189.93181513591583,-173.07725723711255,-0.07429038480203899,-0.0714308084116766,0.0028595763903623977,-1987849610,-1931086039,39.772461084176115,54.26348309774132,NaN,NaN,-9.951926992623164,3.956021653233348
2014-08-06T09:30:00-04:00,17.942327,18.169651,17.942327,18.072226,45664230,36455849.2,39.3607253804359,48.512323993566035,NaN,NaN,-142.58680103956607,-201.49799873215014,-0.07219532833805885,-0.08738458403221117,-0.015189255694152314,-1942185380,-1949915661,34.26675349605435,52.70886625433438,NaN,NaN,-12.00675346287275,1.6756252080753344
2014-08-07T09:30:00-04:00,18.153413,18.194007,17.942327,17.991039,49033446,37315858.9,37.305971869018165,47.22032474661251,NaN,NaN,-129.22186847500575,-185.6704325109336,-0.07214027625339633,-0.10536460101089773,-0.033224324757501394,-1991218826,-1966180080.4,30.357623657414166,50.79641910834143,NaN,NaN,-14.334991233643374,-0.6116057121701948
2014-08-08T09:30:00-04:00,17.982921,18.177769,17.942327,18.169651,63022151,39160952.9,44.2065952543131,46.562480507152095,NaN,NaN,-97.59708255156525,-149.36839452910834,-0.0566225577892596,-0.10400252199407589,-0.04737996420481629,-1928196675,-1957629638.4,34.582698847198714,49.42271178445474,NaN,NaN,-13.965454752303177,-2.519298432189192
2014-08-11T09:30:00-04:00,18.202125,18.267075,18.169651,18.185888,28057761,39249715.6,44.80139407832094,45.804285396466234,NaN,NaN,-56.65004280415186,-123.19752200124097,-0.04245994294342273,-0.1004548928840947,-0.057994949940671975,-1900138914,-1949917881,38.222998720696246,48.669687792675916,NaN,NaN,-13.488004203049181,-4.086256399454904
2014-08-12T09:30:00-04:00,18.129057,18.275194,18.129057,18.226482,27095958,38787373.45,46.34155486052751,45.05430452844509,NaN,NaN,-49.57532843507544,-95.12622466107288,-0.028237926829313253,-0.09329235847731354,-0.06505443164800029,-1873042956,-1926956550.2,47.57695180654274,48.590614095116756,NaN,NaN,-12.631151565269427,-5.306955708856979
2014-08-13T09:30:00-04:00,18.267075,18.348262,18.250838,18.307669,27880666,38538854.35,49.38342081271159,44.41901048644279,NaN,NaN,-18.08718746722332,-70.22630194660434,-0.012069310361971924,-0.08014106960046519,-0.06807175923849326,-1845162290,-1907551932.2,53.92610772276055,48.51375795283879,NaN,NaN,-10.991377005578038,-6.119015894102844
2014-08-14T09:30:00-04:00,18.332025,18.42133,18.323906,18.42133,26975317,37784565.6,53.36895719330939,44.42321586996548,NaN,NaN,9.966510560009558,-42.38862613960127,0.006571735116774197,-0.05985709034252551,-0.0664288254592997,-1818186973,-1872945561.6,62.62088362497724,49.090802836439806,NaN,NaN,-8.361987566752093,-6.439440418767023
2014-08-15T09:30:00-04:00,18.502517,18.502517,18.222422,18.332025,49017660,38943289,50.035310492741594,44.165919044217226,NaN,NaN,1.7350261949956234,-22.5222043902891,0.012817462526017537,-0.05040699730177778,-0.06322445982779532,-1867204633,-1860747153.2,65.11959883291355,49.44543811775783,NaN,NaN,-7.133264711649693,-6.538558174893119
2014-08-18T09:30:00-04:00,18.42133,18.551229,18.413212,18.534992,30934068,39576178.65,56.661172055533065,44.70020998687916,NaN,NaN,51.35051674875855,-0.9220924797070055,0.029589536004660008,-0.0262375398219703,-0.05582707582663031,-1836270565,-1847973483.4,67.56473149146522,49.89137619143042,NaN,NaN,-3.8929540010882175,-6.1606147214924185
2014-08-19T09:30:00-04:00,18.575586,18.616179,18.551229,18.567467,24887490,40020104.6,57.629344587869994,45.05178192128643,NaN,NaN,78.4361784134431,24.68020888999671,0.041132257786599645,-0.004411753593380752,-0.0455440113799804,-1811383075,-1835641507.2,69.76810442304121,50.24880235116411,NaN,NaN,-0.9926976518439777,-5.422340854399784
2014-08-20T09:30:00-04:00,18.534992,18.677069,18.510636,18.616179,32690741,40772829.55,59.105106053696765,46.48732819116985,NaN,NaN,87.60494149412185,45.818634682265746,0.049734693356881604,0.01662435531612161,-0.033110338040759996,-1778692334,-1822347516,71.9780249071863,51.122129520761234,NaN,NaN,1.839857945334962,-4.384883883009106
2014-08-21T09:30:00-04:00,18.656773,18.867859,18.624298,18.835384,46057457,41818765.65,65.01095402980616,48.62795806489849,NaN,NaN,142.0402712815381,72.23338682657145,0.06681037013587418,0.05040262462908274,-0.016407745506791447,-1732634877,-1805237096.8,74.55604249773629,52.6261881289822,NaN,NaN,6.335236866359844,-2.8534380616706847
2014-08-22T09:30:00-04:00,18.835384,18.880037,18.746078,18.770434,30365257,41100699.55,62.147121751493216,50.128033836175504,NaN,NaN,139.62501626368694,99.81138484030973,0.07001539254755612,0.0711114951776537,0.0010961026300975799,-1763000134,-1784396197,77.2959222231847,54.829207381096246,NaN,NaN,9.142951580034005,-1.139668112855729
2014-08-25T09:30:00-04:00,18.85974,18.989639,18.85974,18.932808,33913046,40199064,66.1604744118763,52.25129305940384,NaN,NaN,159.54588606713668,121.45045870398535,0.07870625231757855,0.09947891802707076,0.020772665709492218,-1729087088,-1762959501.6,79.7154881139353,57.68228074036477,NaN,NaN,12.880397072684849,0.8631983422214962
2014-08-26T09:30:00-04:00,18.916571,19.030233,18.908452,18.973402,17026681,39299494,67.0996335577945,54.23264364350088,NaN,NaN,150.3836904311226,135.83996110752125,0.08242883686598769,0.12380871179197683,0.041379874925989144,-1712060407,-1743094968,81.66538076264949,61.06789697369299,NaN,NaN,16.189961585353814,3.0527359483832557
2014-08-27T09:30:00-04:00,19.022114,19.022114,18.900334,18.932808,21796942,37936678.95,65.15234783214967,56.221670498010276,NaN,NaN,128.5053038982311,144.0200335883431,0.07747315824078199,0.13822132272696663,0.06074816448618464,-1733857349,-1734127971,82.48391440560826,64.79120345570685,NaN,NaN,18.33853453224711,5.236421460363806
2014-08-28T09:30:00-04:00,18.843503,18.900334,18.802909,18.875977,25865276,36136969.8,62.42117245991944,57.52271172698216,NaN,NaN,93.34516148954668,134.2810116299448,0.06612511284040772,0.1434045555366943,0.07727944269628657,-1759722625,-1739545520.6,80.15561334609312,68.04641163419932,NaN,NaN,19.35819779634876,7.2538180797902285
2014-08-29T09:30:00-04:00,18.932808,18.989639,18.884096,18.965283,28019754,34485349.7,64.91047150672273,58.959074400439434,NaN,NaN,100.71929979070602,126.49986833534862,0.060540748507146025,0.1529553783302191,0.09241462982307308,-1731702871,-1733286068,80.82895248421946,71.08969404587954,NaN,NaN,20.955237109356496,9.211163655442553
2014-09-02T09:30:00-04:00,19.022114,19.054589,18.928749,19.038351,36373818,34691481.4,66.84558517081217,60.42364799403119,NaN,NaN,102.08514609634645,115.00772034119059,0.05768743357471809,0.16452392179147068,0.1068364882167526,-1695329053,-1726534461,81.55590977981831,73.51676247254207,NaN,NaN,22.874008063602023,11.162998570893905
2014-09-03T09:30:00-04:00,19.11142,19.127657,18.965283,19.005877,24165955,33442183.7,65.12656732718492,61.548158459350724,NaN,NaN,98.35247869621756,104.60147799420956,0.04982853777641846,0.16912216043727568,0.11929362266085722,-1719495008,-1728021381.2,80.82897521667437,75.43839586496449,NaN,NaN,23.995908377243428,12.996271400372407
2014-09-04T09:30:00-04:00,19.022114,19.143895,18.957165,19.022114,31167179,32717331.15,65.60287165738771,62.42200949249918,NaN,NaN,90.95266987832221,97.0909511902278,0.0422392700749169,0.17209271025450334,0.12985344017958644,-1688327829,-1718915477.2,81.89335810386609,76.81500118488512,NaN,NaN,25.05900782010681,14.719519460334464
2014-09-05T09:30:00-04:00,18.997758,19.054589,18.884096,19.04647,30022914,31766804.55,66.34541018327565,63.5870166132516,NaN,NaN,74.15123157884345,93.25216520808715,0.03563870576641745,0.17440182238760826,0.1387631166211908,-1658304915,-1698631935.2,84.02147142471101,78.1651349414421,NaN,NaN,26.154923581622956,16.353148620518535
2014-09-08T09:30:00-04:00,19.030233,19.127657,18.989639,19.054589,26782630,29954828.5,66.60421344218045,64.29723385515499,NaN,NaN,83.18078938015722,89.74446312597738,0.028886418851434642,0.1748711401854841,0.14598472133404947,-1631522285,-1678595818,85.79723153516716,79.4674563731351,NaN,NaN,27.1466885545337,17.895082896806414
2014-09-09T09:30:00-04:00,19.013995,19.013995,18.827265,18.85974,38451277,30474504.3,55.56141681440994,64.14952472847928,NaN,NaN,39.24231999112165,77.17589790493243,0.009374219602340805,0.1577024958369755,0.14832827623463468,-1669973562,-1673524719.8,86.2148056286488,80.6422207449642,NaN,NaN,24.95974034409442,18.904319674990415
2014-09-10T09:30:00-04:00,18.867859,18.981521,18.867859,18.957165,38589775,31049195.15,59.203556445345036,64.15655689931128,NaN,NaN,44.79248475303455,66.46389911629583,0.0015180943617862375,0.1502258941868675,0.14870779982508125,-1631383787,-1655902475.6,87.58122263668027,81.75673486849949,NaN,NaN,24.084682503119513,19.644371507580285
2014-09-11T09:30:00-04:00,18.892215,19.019922,18.875977,19.005877,36708599,31490591.8,60.92786035119027,63.86490735083872,NaN,NaN,50.76539323234053,58.426443787099494,-0.0017326083408324977,0.14654203939904065,0.14827464773987314,-1594675188,-1637171947.4,88.84668131746483,82.77749478419437,NaN,NaN,23.83568508167464,20.243130589593765
2014-09-12T09:30:00-04:00,19.005877,19.078945,18.916571,18.989639,43020180,32292834.95,60.01721638315801,63.71277125310049,NaN,NaN,58.146527654413084,55.225503002213415,-0.006067322511408735,0.14069049460061223,0.14675781711202096,-1637695368,-1633050038,89.10967367122586,83.62133417334019,NaN,NaN,23.377278258164104,20.6908659708181
2014-09-15T09:30:00-04:00,18.989639,19.027797,18.92469,18.981521,25709354,31127419.65,59.53811331740658,63.23974546063837,NaN,NaN,47.082600094976954,48.00586514517736,-0.010322213104216799,0.13385505073174997,0.14417726383596677,-1663404722,-1639426525.4,85.74147493843105,84.05176180366131,NaN,NaN,22.867406370920314,21.001800313689845
2014-09-16T09:30:00-04:00,18.932808,19.103301,18.92469,19.062708,39373583,31549395.4,62.74144044722286,62.92844595274039,NaN,NaN,75.85533891391906,55.32846892973684,-0.008581260550300424,0.13345068814809125,0.14203194869839167,-1624031139,-1630238040.8,86.53149705549734,84.39934153886472,NaN,NaN,23.27659092810339,21.326770401463207
2014-09-17T09:30:00-04:00,19.103301,19.249438,19.034292,19.143895,54921651,33051103.45,65.66850662136284,62.96531443768419,NaN,NaN,159.80758507619075,78.33148899436807,-0.0031539348518574706,0.13808953013356984,0.1412434649854273,-1569109488,-1617783181,87.53932382785003,84.760442211882,NaN,NaN,24.455605390164642,21.773746828420556
2014-09-18T09:30:00-04:00,19.241319,19.379337,19.216963,19.330625,63693213,34601227.05,71.26083767126524,63.59671909563747,NaN,NaN,280.07692331620257,124.1937950111405,0.011042124883120119,0.15504612108932747,0.14400399620620735,-1505416275,-1599931398.4,88.82954684829622,85.38000889061077,NaN,NaN,27.31186038413537,22.564905907808388
2014-09-19T09:30:00-04:00,19.354981,19.387456,19.152013,19.200725,62227165,35409712.45,63.510423307724835,63.496715652851904,NaN,NaN,194.4884350147346,151.46217648320481,0.009758322193622992,0.1562018989482361,0.14644357675461311,-1567643440,-1585921012.8,89.72844893499064,86.01568720852299,NaN,NaN,27.335030227246538,23.246352239156696
2014-09-22T09:30:00-04:00,19.160132,19.208844,19.04647,19.070826,39798507,35881374.95,56.85159259407361,62.78285904022772,NaN,NaN,73.13740458959273,156.67313738212795,-0.0011828366829203518,0.1449650309009627,0.14614786758388304,-1607441947,-1574728457.8,90.39352237565272,86.6469452510826,NaN,NaN,25.15771325011118,23.519403812150195
2014-09-23T09:30:00-04:00,19.030233,19.127657,18.932808,18.940927,39950982,36183271.75,51.08366621438927,61.77979467502803,NaN,NaN,-19.990104332899985,137.50404873276415,-0.017600789771647418,0.12414688036932375,0.14174767014097117,-1647392929,-1579400815.8,87.8366966496488,87.14749678200936,NaN,NaN,21.356149426610123,23.210367471358754
2014-09-24T09:30:00-04:00,18.981521,19.054589,18.900334,19.04647,44305281,37547201.75,55.07209254831228,61.027596167236936,NaN,NaN,-21.595534667009744,101.22342478412405,-0.021525360974418428,0.11484096892294815,0.13636632989736658,-1603087648,-1586196447.8,84.11028074536175,87.30584839925903,NaN,NaN,19.506497991117357,22.681243259895698
2014-09-25T09:30:00-04:00,18.981521,19.013995,18.729841,18.729841,66696006,39792154.95,43.58959320203355,59.40218066857678,NaN,NaN,-158.58411617428837,13.491216886025853,-0.04430656005804079,0.08098312982481559,0.12528968988285638,-1669783654,-1619069923.6,68.8857137641639,86.2247228520771,NaN,NaN,13.442270494292243,21.361390007666632
2014-09-26T09:30:00-04:00,18.786672,18.957165,18.754197,18.908452,49210915,40959436.9,49.931393360579506,58.211264948462436,NaN,NaN,-120.18761246113101,-49.44399260914726,-0.04600645664195699,0.06778161908041014,0.11378807572236713,-1620572739,-1629655783.4,64.81706302512822,84.72613938707433,NaN,NaN,10.856743650848186,19.860726242406855
2014-09-29T09:30:00-04:00,18.721722,18.884096,18.713603,18.843503,47212739,41919086.15,47.82584638277754,57.658724203345834,NaN,NaN,-153.60472827419255,-94.79241918190432,-0.049842462022472916,0.05148499819427599,0.1013274602167489,-1667785478,-1641724489.6,60.43452567197423,82.88469081874042,NaN,NaN,8.119797639820673,18.183450727751687
2014-09-30T09:30:00-04:00,18.880037,18.92469,18.766375,18.811028,40754586,42138124.55,46.76399382138068,56.77018401591981,NaN,NaN,-121.54223599687636,-115.10284551469961,-0.05263023340479071,0.03553966846076051,0.08816990186555122,-1708540064,-1653953916.6,56.28179028354633,80.64901707923084,NaN,NaN,5.647764352631205,16.39263838844876
2014-10-01T09:30:00-04:00,18.770434,18.811028,18.551229,18.583704,63295140,44094583.8,40.05921042234707,55.27956616385957,NaN,NaN,-205.67881309267142,-151.91950119983193,-0.06692970547154817,0.00450777002611602,0.07143747549766419,-1771835204,-1687703427.8,46.73718899985096,77.64119619940128,NaN,NaN,1.113765811944842,14.209942306091056
2014-10-02T09:30:00-04:00,18.591823,18.701425,18.461924,18.632416,69550754,46013762.55,41.97891482200653,53.99111605234875,NaN,NaN,-190.5129681263499,-158.30527159024422,-0.0699263675672827,-0.015970483961439186,0.05395588360584351,-1702284450,-1694203587,45.149081147893746,74.50115387630613,NaN,NaN,-1.8044553691661378,11.922171209625743
2014-10-03T09:30:00-04:00,18.802909,18.932808,18.73796,18.900334,62128917,47619062.7,51.230404510045034,53.39770828039436,NaN,NaN,-50.0599185948929,-144.2797328169966,-0.051532966215036904,-0.010460324162952617,0.04107264205208429,-1640155533,-1698120145.8,44.17507863567572,71.53212556896646,NaN,NaN,-1.1264660367770085,10.05808017442535
2014-10-06T09:30:00-04:00,19.030233,19.030233,18.815087,18.843503,40824952,48321178.8,49.42994228489131,52.44688698308496,NaN,NaN,-26.57336803895661,-118.87346076994943,-0.04130416843360233,-0.010557568489918623,0.030746599943683707,-1680980485,-1700759147.2,43.49421164856767,68.45803375418578,NaN,NaN,-1.1990692638778402,8.449915968953466
2014-10-07T09:30:00-04:00,18.79479,18.79479,18.518755,18.524113,63136876,49555458.75,40.7600839924993,50.66771393816614,NaN,NaN,-148.23692542307074,-124.21239865518831,-0.053390757917148986,-0.03599184745275252,0.017398910464396462,-1744117361,-1707874606.6,41.631050894210276,65.17887140178294,NaN,NaN,-4.420533262881021,6.611280364405682
2014-10-08T09:30:00-04:00,18.534992,18.875977,18.478161,18.875977,72370460,51244493,50.96416067153361,49.21795129532817,NaN,NaN,-78.29741811866461,-98.73611966038695,-0.035871050379230336,-0.027439902509641456,0.008431147869588878,-1671746901,-1687856946,48.33608836104513,62.286481509836435,NaN,NaN,-3.253584940254624,5.202013892311353
2014-10-09T09:30:00-04:00,18.85974,18.85974,18.457864,18.478161,110347320,54926429.05,42.12869607394122,47.69068506434362,NaN,NaN,-123.23136948011921,-85.27979993114081,-0.04847417028767218,-0.05216156499000135,-0.003687394702329169,-1782094221,-1703818900.2,43.996078418407386,59.01988361579476,NaN,NaN,-5.8747194818885555,3.6196234102827947
2014-10-10T09:30:00-04:00,18.437568,18.648654,18.323906,18.332025,76270098,56588924.95,39.424778609250865,46.445912636856285,NaN,NaN,-162.6908243888508,-107.80598108993237,-0.06312490642304994,-0.08259352773114159,-0.019468621308091655,-1858364319,-1747460657.4,34.796705875489025,55.048682437211646,NaN,NaN,-8.89674951390412,1.8315701353989495
2014-10-13T09:30:00-04:00,18.340143,18.453805,18.153413,18.169651,70645381,58835726.3,36.61291844752584,45.41228779636604,NaN,NaN,-189.63510079981216,-140.41832764210352,-0.07918342973761502,-0.11844790848011044,-0.03926447874249542,-1929009700,-1797066500.4,27.705429455373874,50.75359192333485,NaN,NaN,-12.290940348410354,-0.18593136228809382
2014-10-14T09:30:00-04:00,18.218363,18.388856,18.157473,18.242719,78120858,60773090.05,38.730613402263714,44.245039285934,NaN,NaN,-158.83508123931105,-142.5379588053516,-0.08007667899703408,-0.13936032748878802,-0.05928364849175394,-1850888842,-1818420796.6,25.31386619071837,46.55384802657461,NaN,NaN,-14.150021814456753,-2.1808014268836162
2014-10-15T09:30:00-04:00,17.982921,18.072226,17.495799,17.893615,134484384,64751226.7,33.049428909955495,43.49217040792842,NaN,NaN,-229.59266028347383,-172.79700723831343,-0.09817732249661573,-0.1820053016125236,-0.08382797911590786,-1985373226,-1881146061.6,19.884259852693262,43.053744175755284,NaN,NaN,-17.83401073865999,-4.4169741857088125
2014-10-16T09:30:00-04:00,17.585104,18.031633,17.568867,17.893615,101456967,66639414.4,33.049428909955495,42.286315804312416,NaN,NaN,-191.08283307552745,-186.36729995739506,-0.10361159401456199,-0.21334247163411035,-0.10973087761954836,-1985373226,-1921801862.6,17.294898917577953,39.659303882358834,NaN,NaN,-20.5964816612584,-6.72833239650161
2014-10-17T09:30:00-04:00,18.129057,18.210244,17.999158,18.120938,65835431,66819827.7,39.72626261638881,41.70777410671322,NaN,NaN,-112.71765077811624,-176.37266523524815,-0.0860785808968921,-0.2173291037406635,-0.1312505228437714,-1919537795,-1934036557.8,16.594566253278472,36.52787820959485,NaN,NaN,-20.67346645686845,-8.720494405125445
2014-10-20T09:30:00-04:00,18.080345,18.242719,18.080345,18.226482,60970553,67878430,42.58902969863988,41.40956238366031,NaN,NaN,-83.24427578376385,-155.09450023203848,-0.06264468902370204,-0.20955638412339894,-0.1469116950996969,-1858567242,-1919948066.2,20.582593191543765,33.9779355601661,NaN,NaN,-19.800646636383412,-10.303373295305153
2014-10-21T09:30:00-04:00,18.388856,18.591823,18.340143,18.567467,63026042,69032183,50.730815553337465,42.17181989301677,NaN,NaN,-8.182000491104954,-124.96388408239727,-0.021572609495333434,-0.1738774569688637,-0.15230484747353026,-1795541200,-1908878537.8,23.670782075619414,32.330335065578126,NaN,NaN,-16.21351926332162,-11.14767986216465
2014-10-22T09:30:00-04:00,18.599942,18.616179,18.396974,18.396974,56914297,69662633.8,47.13171490494141,42.53987704179782,NaN,NaN,-9.507067874200462,-80.9467656005426,-0.004190484643851439,-0.15754295327834456,-0.15335246863449312,-1852455497,-1882294992,30.645567456965594,31.294369801940398,NaN,NaN,-14.494681765270009,-11.625822991179701
2014-10-23T09:30:00-04:00,18.60806,18.697366,18.543111,18.575586,99631113,71309389.15,51.049729153014795,42.526971659152814,NaN,NaN,27.51404246703479,-37.22739049203016,0.019720652348751033,-0.1287016531985543,-0.14842230554730534,-1752824384,-1835785223.6,40.83241550154324,31.055608149502365,NaN,NaN,-11.771145050643746,-11.64658328538885
2014-10-24T09:30:00-04:00,18.60806,18.762316,18.575586,18.754197,32789474,70488317.1,54.66766706260404,42.901094857560864,NaN,NaN,54.746722898413616,-3.734515756724183,0.046425575177544365,-0.09039033657537487,-0.13681591175291924,-1720034910,-1795884646.6,47.90217844360811,31.37046292057668,NaN,NaN,-8.32277781563939,-11.171753932567498
2014-10-27T09:30:00-04:00,18.689247,18.786672,18.656773,18.778553,27342033,69494781.8,55.154419469054254,43.92926167731479,NaN,NaN,67.85690631108804,26.485720662246194,0.06353166565240857,-0.05740132968740852,-0.12093299533981709,-1692692877,-1762709773.6,52.93732794028473,32.17805413815343,NaN,NaN,-5.45806861397782,-10.355513172768973
2014-10-28T09:30:00-04:00,18.827265,18.989639,18.827265,18.981521,44630802,69688592.6,59.096014101556676,44.510108350887876,NaN,NaN,115.7631067399835,51.27474210846388,0.08497846349159172,-0.014709915975327448,-0.09968837946691916,-1648062075,-1733213948.6,56.92361036273232,32.791448566845375,NaN,NaN,-1.7571802804833347,-9.127179902442453
2014-10-29T09:30:00-04:00,19.013995,19.062708,18.884096,19.030233,55666834,69307177.3,60.00457838219829,45.786957087191944,NaN,NaN,120.01246282237922,77.17864824777982,0.09798371537383761,0.02279126475037785,-0.07519245062345976,-1592395241,-1681201897.4,62.89235493554482,34.14118260378376,NaN,NaN,1.5084769775738316,-7.607800348154413
2014-10-30T09:30:00-04:00,19.013995,19.226218,18.957165,19.135776,41943272,67926803.2,61.97533754034873,47.397711296556075,NaN,NaN,130.85061529928453,97.84596281422978,0.10841970994139129,0.06033218680327934,-0.048087523138111946,-1550451969,-1640727414.4,66.75298643650319,36.42377407242764,NaN,NaN,4.834248987219844,-5.830364728815233
2014-10-31T09:30:00-04:00,19.354981,19.379337,19.269734,19.354981,46907541,67165734.4,65.75008950484515,49.478937800650314,NaN,NaN,165.31972001637692,119.96056223782243,0.1237048045738197,0.10654348257916268,-0.01716132199465702,-1503544428,-1597429318,70.31140314571752,39.467057907452194,NaN,NaN,8.920061845385746,-3.7231609325008077
2014-11-03T09:30:00-05:00,19.403693,19.476761,19.346862,19.428049,60927021,68170837.85,66.92860949934175,51.49308037901302,NaN,NaN,164.9953527760338,139.3882515308116,0.13161988105632405,0.14736352932574803,0.015743648269423993,-1442617407,-1547414224,73.7997989676411,42.93033882008952,NaN,NaN,12.642606178020838,-1.385194202426287
2014-11-04T09:30:00-05:00,19.354981,19.444286,19.281912,19.436168,36723140,66850151.05,67.06422377918801,53.922708583958205,NaN,NaN,135.83709343815846,143.40304887044658,0.13005576977499267,0.17831336048816482,0.04825759071317216,-1405894267,-1498980662.4,76.65982621720414,46.985736417554584,NaN,NaN,15.709074265705702,1.0568441501639971
2014-11-05T09:30:00-05:00,19.60666,19.60666,19.452405,19.566067,30330604,64748158.25,69.2377225607395,56.50758670187135,NaN,NaN,139.78623460311948,147.35780322659463,0.13010757223643024,0.21089205600870997,0.08078448377227973,-1375563663,-1455614346.8,78.8826070894122,51.38485842982846,NaN,NaN,18.99378916695468,3.6192648668483804
2014-11-06T09:30:00-05:00,19.533592,19.60666,19.476761,19.598542,33212121,60891398.3,69.77474144486497,58.65390661819107,NaN,NaN,122.59105810651302,145.70589178804033,0.12465556900080002,0.23660394502327975,0.11194837602247973,-1342351542,-1413994261.4,80.7749314762986,55.96917023147275,NaN,NaN,21.879693084237427,6.227897469332531
2014-11-07T09:30:00-05:00,19.60666,19.655373,19.509236,19.60666,35480516,58851919.2,69.91612192870504,60.605841777481444,NaN,NaN,110.67337384185137,134.77662255313524,0.11420116790471796,0.2546998359033772,0.14049866799865923,-1306871026,-1374659581,82.381779045902,60.38339779249834,NaN,NaN,24.323934278245474,8.813045584891523
2014-11-10T09:30:00-05:00,19.60666,19.712204,19.582304,19.712204,37755619,57207431.1,71.76527229775908,62.10830297351156,NaN,NaN,107.48269824696357,123.27409164732119,0.10711660987571237,0.2743944303432997,0.16727782046758732,-1269115407,-1339959181,83.67784698425596,64.66961671454382,NaN,NaN,26.976271888662456,11.407792199715942
2014-11-11T09:30:00-05:00,19.720322,19.73656,19.647254,19.647254,47726606,55687718.5,68.95632987857658,63.66720404305693,NaN,NaN,98.21643790679816,115.74996054104913,0.09139091923870399,0.2815164695159673,0.19012555027726333,-1316842013,-1322148730.2,84.31560877441954,68.50319109436195,NaN,NaN,28.537208106939936,13.854851615033656
2014-11-12T09:30:00-05:00,19.582304,19.631017,19.532456,19.60666,23062172,50116607.9,67.18631587468465,64.81981738031907,NaN,NaN,80.60867538303545,103.9144486970323,0.07241954540673604,0.28064998203568337,0.20823043662894733,-1339904185,-1315016834.6,84.575508990957,71.62769777217723,NaN,NaN,29.420202902549768,16.07847322753596
2014-11-13T09:30:00-05:00,19.622898,19.663491,19.517355,19.598542,36154859,46851502.5,66.81694634157459,65.68762304310268,NaN,NaN,74.73521193924091,94.34327946357789,0.054315834649669104,0.2761252299410337,0.22180939529136462,-1376059044,-1321758335,83.1725173234909,74.14700769216884,NaN,NaN,30.0770211995369,18.078265794964665
2014-11-14T09:30:00-05:00,19.590423,19.631017,19.509236,19.533592,14082099,44263835.9,63.79503369639512,66.30480977362701,NaN,NaN,63.763973284112765,84.96139935203016,0.033954302487161525,0.26425227340031654,0.23029797091315501,-1390141143,-1338412358.4,79.65705841783571,76.05555986913679,NaN,NaN,29.898590042177943,19.76688354456656
2014-11-17T09:30:00-05:00,19.476761,19.557136,19.460524,19.533592,19919711,42211293.8,63.79503369639512,66.6404540304012,NaN,NaN,52.12709173486558,73.89027804961056,0.01731256531212283,0.25193867755330857,0.23462611224118574,-1390141143,-1362617505.6,74.7141957284817,77.32631596669032,NaN,NaN,29.74667520312818,21.19256806721822
2014-11-18T09:30:00-05:00,19.525474,19.663491,19.517355,19.598542,15639320,39841957.7,65.59942352160778,67.04008582607331,NaN,NaN,61.539290828480446,66.55484863394702,0.007980209359349955,0.24460137394037318,0.23662116458102322,-1374501823,-1374149467.6,72.40890131846233,78.00606927975583,NaN,NaN,30.04559338722746,22.457285970076683
2014-11-19T09:30:00-05:00,19.566067,19.590423,19.476761,19.557948,27180180,38355251.85,63.47030336582004,67.14686909932125,NaN,NaN,47.8282814423222,59.998769845804375,-0.0030353105508504896,0.2328270263924601,0.2358623369433106,-1401682003,-1386505031.2,69.91966210691041,78.23226039907065,NaN,NaN,29.785436130178077,23.504164564376882
2014-11-20T09:30:00-05:00,19.460524,19.581087,19.428049,19.557948,19810539,34364223.15,63.47030336582004,66.98402723224804,NaN,NaN,39.00697335552659,52.85312212906151,-0.011930820933549302,0.22094881077637396,0.23287963170992326,-1401682003,-1391629623,68.86226677129864,78.12875065804073,NaN,NaN,29.562307062118553,24.369613492625692
2014-11-21T09:30:00-05:00,19.777153,19.777153,19.631017,19.655373,25124847,33980991.8,66.4969545278773,66.95319473428628,NaN,NaN,83.30117536242638,56.76056254472424,-0.012786604410725877,0.21689637619651592,0.2296829806072418,-1376557156,-1388912825.6,69.12881392169871,77.79510886904484,NaN,NaN,30.095897391615967,25.187654049624303
2014-11-24T09:30:00-05:00,19.720322,19.833984,19.712204,19.785272,23052015,33766490.9,70.05902361810416,67.16710900849458,NaN,NaN,116.30863528666401,69.59687125508393,-0.0064568231621917604,0.2216119516545021,0.22806877481669385,-1353505141,-1381585625.2,69.87774193500672,77.31067427745931,NaN,NaN,31.53025523609685,26.093739933406095
2014-11-25T09:30:00-05:00,19.825865,19.825865,19.704085,19.769035,28881219,32979011.75,69.07048144578988,67.15516321456961,NaN,NaN,119.13100566762688,81.11521422291321,-0.005266428457209565,0.2214857392451819,0.22675216770239146,-1382386360,-1383162532.6,69.48704195490673,76.63956248213749,NaN,NaN,32.49382887967286,27.00803835430135
2014-11-26T09:30:00-05:00,19.769035,19.801509,19.744678,19.793391,10775673,30734453.7,69.75977000331879,67.15409382588774,NaN,NaN,130.7247668367883,97.69451130180643,-0.00475715044563968,0.22080572964534184,0.22556288009098152,-1371610687,-1377148269.4,70.17203948926063,75.88221305449193,NaN,NaN,33.49772169466169,27.935135974352825
2014-11-28T09:30:00-05:00,19.809628,19.898853,19.785272,19.809628,9627136,29118646.9,70.2359859333346,67.17694125478985,NaN,NaN,154.63426349172133,120.81996932904538,-0.005208773481383877,0.21905191323925166,0.22426068672063554,-1361983551,-1369208579,71.09458896627014,75.07598519166108,NaN,NaN,34.480062784790896,28.87012551870112
2014-12-01T09:30:00-05:00,19.704085,19.760916,19.622898,19.667551,33674075,28456973.6,61.160088028309374,66.41942809268629,NaN,NaN,48.383085130968546,113.83635128275382,-0.01633035363327226,0.2038477446790452,0.22017809831231747,-1395657626,-1373028673,69.97320831166044,74.09708242933281,NaN,NaN,32.95562495221274,29.453768294917065
2014-12-02T09:30:00-05:00,19.655373,19.874578,19.655373,19.854281,26783300,26749787.55,67.16541259370895,66.29150542948148,NaN,NaN,111.21981154389547,112.81858653420011,-0.012535729818918873,0.20450843603866886,0.21704416585758773,-1368874326,-1376102510,69.02970378221623,73.00523207274686,NaN,NaN,33.26255280036649,29.997880367124125
2014-12-03T09:30:00-05:00,19.874578,19.963883,19.833984,19.943587,17824939,25804877.5,69.5873542384072,66.46300816974737,NaN,NaN,171.9439958739664,123.38118457546803,-0.0057796393998821305,0.20981961660773507,0.2155992560076172,-1351049387,-1369835115.4,69.92029152532254,71.95843082520155,NaN,NaN,34.251492794733664,30.60553928535406
2014-12-04T09:30:00-05:00,19.92329,19.996358,19.842103,19.972002,20937658,25335230.2,70.33707205917716,66.7144457210047,NaN,NaN,162.20857082615473,129.6779453733413,-0.0013942729100785145,0.21385641487001905,0.21525068778009757,-1330111729,-1361535323.8,71.1052814431874,71.09648540517988,NaN,NaN,35.2837280871221,31.273851971320923
2014-12-05T09:30:00-05:00,20.077545,20.223682,20.053189,20.150613,37231776,25536212.95,74.57915234419997,67.48473991013361,NaN,NaN,226.83340552237053,144.11777377947112,0.010863617256320457,0.22883020935049814,0.21796659209417768,-1292879953,-1347714604.2,73.01189048291727,70.6218305526857,NaN,NaN,37.56428130449255,32.17248473320259
2014-12-08T09:30:00-05:00,20.126257,20.353581,20.118139,20.248038,52947070,26409540.65,76.54916942552109,68.39574960507117,NaN,NaN,219.5793734105895,178.35703143539533,0.02220741265344453,0.24572585791098334,0.2235184452575388,-1239932883,-1316569655.6,76.73708502811645,70.76632264551675,NaN,NaN,40.12397281926434,33.30841160263998
2014-12-09T09:30:00-05:00,19.988239,20.199326,19.931409,20.199326,55549628,27299241.1,73.4828581919162,68.95885208152178,NaN,NaN,139.08683966564104,183.93043705974443,0.023006873535835054,0.25227703717733263,0.22927016364149758,-1295482511,-1301891292.6,78.26011491999115,71.18426647419737,NaN,NaN,41.28958134917922,34.44857870928844
2014-12-10T09:30:00-05:00,20.142495,20.207444,19.907052,19.939527,63746038,28100212.7,59.73871103809819,68.69230977239879,NaN,NaN,90.81698528581592,167.70503494211434,0.003631924240716511,0.2338100689423932,0.2301781447016767,-1359228549,-1303527125,77.64997215812522,71.73643147785559,NaN,NaN,37.66388659002819,34.907908406536976
2014-12-11T09:30:00-05:00,19.996358,20.166851,19.955765,19.988239,71861757,30540191.95,61.203930420248184,68.53042599057223,NaN,NaN,86.38459502035136,152.54023978095367,-0.007692114260710398,0.2205630018757887,0.2282551161364991,-1287366792,-1294978137.6,78.58943511923243,72.43122921699371,NaN,NaN,35.25004888210969,34.956785617333075
2014-12-12T09:30:00-05:00,19.833984,19.955765,19.574186,19.598542,48349087,31149903.35,46.59470138245385,67.10883648018485,NaN,NaN,-37.219917874986386,99.72957510148228,-0.04133707933066308,0.17658376697317024,0.21792084630383332,-1335715879,-1303545322.8,75.17902622875005,72.86338723892594,NaN,NaN,27.273543163236635,33.85917955246215
2014-12-15T09:30:00-05:00,19.712204,19.744678,19.322506,19.41993,45962830,32743939.9,41.683574106343414,65.08201865791621,NaN,NaN,-115.17300480205778,32.77909945895283,-0.07364347694854681,0.12586650011814982,0.19950997706669663,-1381678709,-1331894488,65.11021463691782,72.52284957477674,NaN,NaN,18.937116703679795,31.727456288350385
2014-12-16T09:30:00-05:00,19.314387,19.622898,19.225082,19.2332,45524198,34024164.25,37.261799253403694,62.809969929888624,NaN,NaN,-157.15048107226028,-26.46836468862744,-0.10376755508727611,0.06980053320760149,0.1735680882948776,-1427202907,-1358238567.2,57.41478778788912,71.66054570570405,NaN,NaN,10.491981993652539,28.69381710339355
2014-12-17T09:30:00-05:00,19.322506,19.679729,19.281912,19.670798,53905036,35937450.05,50.51091789281921,61.4350519219958,NaN,NaN,-89.19512536173754,-62.47078681813814,-0.09086498203730217,0.05998686074824988,0.15085184278555205,-1373297871,-1361052431.6,56.644686954754974,70.69430623895366,NaN,NaN,8.436839687719438,25.799963186868677
2014-12-18T09:30:00-05:00,19.972002,20.142495,19.866459,20.126257,46211027,36888992.4,59.98322302454355,60.70271171422501,NaN,NaN,79.20276190615817,-63.907153440976785,-0.05032356481915998,0.08794738676160208,0.13827095158076205,-1327086844,-1368996442,54.42523639195158,69.5036381979309,NaN,NaN,10.898026220663267,23.671115048839333
2014-12-19T09:30:00-05:00,20.085664,20.142495,19.972002,20.036952,49136332,38355282.05,57.65309348407978,60.45221210392289,NaN,NaN,72.52608001522015,-41.95795386293547,-0.02923477184022899,0.10172748678047583,0.13096225862070482,-1376223176,-1377097901.4,52.17981939606146,68.23268184681667,NaN,NaN,11.724954428021563,21.964520674436795
2014-12-22T09:30:00-05:00,20.093783,20.17497,20.04507,20.17497,19486724,38073375.9,60.224721429153284,59.95644844931178,NaN,NaN,90.41300365207022,-0.8407521721098732,-0.006870161499377886,0.12237455674648245,0.12924471824586034,-1356736452,-1372109450,53.453244093414824,67.12007758333087,NaN,NaN,13.333714853952475,20.731548414367605
2014-12-23T09:30:00-05:00,20.248038,20.3617,20.207444,20.288631,22941862,38067868.25,62.25744431592547,59.4328834548488,NaN,NaN,125.73390351600669,55.73612474554352,0.0135829682675426,0.14622342858028858,0.13264046031274598,-1333794590,-1353427786.6,57.96745854947898,66.26630379934204,NaN,NaN,15.309004015467478,19.95689921452473
2014-12-24T09:30:00-05:00,20.353581,20.353581,20.248038,20.256156,9779038,37112759.2,61.29360970837741,58.7869218583631,NaN,NaN,112.7216579338511,96.11948140466124,0.0224088157307879,0.16065147997623086,0.13824266424544296,-1343573628,-1347482938,59.31949693952211,65.42446204908023,NaN,NaN,16.498691788631213,19.462869582254225
2014-12-26T09:30:00-05:00,20.321106,20.329225,20.248038,20.256156,18159649,37481958,61.29360970837741,57.83795452723292,NaN,NaN,99.47276599468782,100.17348222236717,0.02550564680452655,0.17012472275110113,0.14461907594657458,-1343573628,-1350780294.8,58.20123030555139,64.36655775069696,NaN,NaN,17.422240373437088,19.171351123851778
2014-12-29T09:30:00-05:00,20.239919,20.410412,20.199326,20.329225,22139486,38107575.5,62.79657024363167,56.85562601424082,NaN,NaN,99.26326406456204,105.52091903223554,0.029454260741818894,0.1814369018738482,0.1519826411320293,-1321434142,-1339822488,60.84302703075553,63.231267893742604,NaN,NaN,18.63450567758254,19.094658917241887
2014-12-30T09:30:00-05:00,20.29675,20.351308,20.239919,20.304869,20310383,37439390.9,61.933300312814836,56.030657594305005,NaN,NaN,88.96139624597501,105.23059755101652,0.027445194693194896,0.1862891344985229,0.15884393980532802,-1341744525,-1336824102.6,61.55897159352216,62.03832908470911,NaN,NaN,19.375543521123955,19.13478528922504
2014-12-31T09:30:00-05:00,20.377937,20.394174,20.053189,20.077545,29887594,37594605.6,54.41448800196438,55.650355948866874,NaN,NaN,48.46192794062192,89.77620243593955,0.0087917920708874,0.16983367989393727,0.16104188782304987,-1371632119,-1344391608.4,58.644578401522196,60.68080095923746,NaN,NaN,17.778091616655935,18.940971907429454
2015-01-02T09:30:00-05:00,20.183088,20.215563,19.92329,20.077545,40535352,38730126.25,54.41448800196438,55.165395776132314,NaN,NaN,14.531846307908012,70.13824011075093,-0.0048288677355090015,0.15500580315366363,0.15983467088917264,-1371632119,-1350003306.6,56.50812268909422,59.103564357084736,NaN,NaN,16.495281936586988,18.59158762588053
2015-01-05T09:30:00-05:00,19.947646,19.988239,19.60666,19.655373,50800347,40223260.7,43.13543359215365,54.9183052196823,NaN,NaN,-79.98416813702637,34.2468532844081,-0.04151210915408182,0.10794453444657037,0.1494566436006522,-1422432466,-1365775074.2,50.89607836384974,57.36906808102043,NaN,NaN,11.510593063576193,17.580016974122767
2015-01-06T09:30:00-05:00,19.655373,19.720322,19.265756,19.354981,57488207,41236082.25,37.22315435491315,54.59970380886586,NaN,NaN,-137.93944757672557,-13.1936890438494,-0.0828612042058563,0.04588013834333182,0.12874134254918812,-1479920673,-1397472380.4,41.891510033980026,55.71058918081059,NaN,NaN,5.067589107983372,15.792527278959996
2015-01-07T09:30:00-05:00,19.517355,19.60666,19.403693,19.557948,36308360,40404146.75,42.916327941354744,55.00359871514808,NaN,NaN,-101.03726103282628,-51.19342049960966,-0.0926551251464824,0.012922436116085123,0.10557756126256752,-1443612313,-1417845938,37.32103391731564,54.2753210471982,NaN,NaN,1.6864011164293382,13.777366398598474
2015-01-08T09:30:00-05:00,19.785272,19.898934,19.744678,19.850221,38018313,39527581,49.954614190008726,54.96386273637591,NaN,NaN,-24.121177098861637,-65.71004150750636,-0.07624698070284254,0.010268835384014352,0.08651581608685689,-1405594000,-1424638314.2,35.91420517886618,52.79457234892043,NaN,NaN,1.2979281753519305,11.994589509563253
2015-01-09T09:30:00-05:00,19.890815,19.894874,19.574186,19.582304,36321940,38156376.1,44.53406133284038,53.860351186968536,NaN,NaN,-53.38602651561588,-79.29361607221115,-0.07985226614143369,-0.013299516589935223,0.06655274955149847,-1441915940,-1438695078.4,33.130851034222005,51.27354482336832,NaN,NaN,-0.9599831558378531,10.14393627164881
2015-01-12T09:30:00-05:00,19.582304,19.631017,19.3631,19.41993,38378949,36482235.7,41.588664279844025,52.71289195809455,NaN,NaN,-90.6886697254574,-81.43451638989735,-0.08889507952619952,-0.04456609985625093,0.04432897966994859,-1480294889,-1450267563,31.000749351141096,49.760754105874014,NaN,NaN,-3.7867214968797636,8.153842304716157
2015-01-13T09:30:00-05:00,19.54983,19.679729,19.216963,19.354981,45812425,36355402.6,40.43662546105355,51.29945653180171,NaN,NaN,-94.7709891003854,-72.80082469462931,-0.09445194509973169,-0.07373595170471603,0.02071599339501566,-1526107314,-1459504891.2,29.377139437219313,48.04103234471719,NaN,NaN,-6.376715605679722,6.078048317516746
2015-01-14T09:30:00-05:00,19.04647,19.152013,18.827265,19.078945,71398029,37627162.55,35.88670629118501,49.41583238717739,NaN,NaN,-160.6125247381459,-84.71587743569324,-0.11078839015729935,-0.11776949430160855,-0.0069811041443091845,-1597505343,-1490283497.2,24.729683181898196,45.66690553274713,NaN,NaN,-10.13515138433041,3.761876931538581
2015-01-15T09:30:00-05:00,19.013995,19.11142,18.811028,18.843503,58072319,38254568.6,32.52507569327186,47.36093710038414,NaN,NaN,-164.5607477041016,-112.80379155674123,-0.13018175995931902,-0.16970830409345794,-0.03952654413413893,-1655577662,-1540280229.6,19.369287873698937,42.813319170902616,NaN,NaN,-14.422249068327567,1.1641446458434173
2015-01-16T09:30:00-05:00,18.79479,19.078945,18.721722,19.070826,89552476,40036940.6,38.513848308373596,45.73381128609815,NaN,NaN,-140.4649816335631,-130.2195825803307,-0.12064522671704914,-0.19033307753045037,-0.06968785081340123,-1566025186,-1565102078.8,17.35766417932345,39.89592159045776,NaN,NaN,-15.969633004821796,-1.2835378756801843
2015-01-20T09:30:00-05:00,19.127657,19.200725,18.92469,18.989639,39354070,39694092.75,37.24250709648589,43.90852106130203,NaN,NaN,-111.27569863594243,-134.3369883624277,-0.11288932413159278,-0.2107995059778922,-0.09791018184629943,-1605379256,-1590118952.2,15.599252870626685,36.66422343616284,NaN,NaN,-17.60526483887488,-3.6152131561365692
2015-01-21T09:30:00-05:00,18.981521,19.135695,18.85974,19.038351,49280533,39701302.8,38.55313405661229,42.238509185858994,NaN,NaN,-102.1632934975505,-135.8154492418607,-0.0981089152577163,-0.2205463259184448,-0.12243741066072851,-1556098723,-1596117234,15.201606350488149,33.35298306166042,NaN,NaN,-18.513166950434986,-5.7434922696077715
2015-01-22T09:30:00-05:00,19.152013,19.533592,19.022114,19.509236,97402642,43597098.7,49.526513470202566,41.889368147876,NaN,NaN,-45.66072611695222,-112.82508951762198,-0.052534790736039616,-0.18810589908077802,-0.1355711083447384,-1458696081,-1568355381.6,24.761240532597313,30.932744642451496,NaN,NaN,-15.638660622295916,-7.157087748563221
2015-01-23T09:30:00-05:00,19.492999,19.529533,19.29815,19.29815,34089410,44154476.1,45.5956052737305,41.25944795300216,NaN,NaN,-37.57093201215627,-87.4271263792329,-0.03345089133143783,-0.1773847225090357,-0.14393383117759787,-1492785491,-1535796947.4,34.138671728820924,29.33492671671769,NaN,NaN,-14.568886772711314,-8.215916180584378
2015-01-26T09:30:00-05:00,19.261616,19.403693,19.216963,19.395574,27604580,45045753.2,47.66039941532644,41.5826597975145,NaN,NaN,-38.572792581548775,-67.04868856883004,-0.012206332558560434,-0.1591917468757984,-0.14698541431723797,-1465180911,-1515628092.4,39.19444869471499,28.49909602606521,NaN,NaN,-13.04723023914766,-8.906103903236275
2015-01-27T09:30:00-05:00,19.127657,19.314387,19.11142,19.184488,35207499,45898145.7,43.783115570133404,42.05122845574453,NaN,NaN,-57.34763329160325,-56.2630754999622,-0.010381755991822172,-0.15996260930701567,-0.1495808533151935,-1500388410,-1494629923.2,44.01313282605449,28.65064051121339,NaN,NaN,-13.000928726694866,-9.491078878016074
2015-01-28T09:30:00-05:00,19.281912,19.281994,18.802909,18.835384,85456220,49063982.4,38.24207371793696,41.71735315407182,NaN,NaN,-95.95547733099092,-55.02151226665029,-0.029609219565778805,-0.186592377772417,-0.1569831582066382,-1585844630,-1500579104.6,42.97404577094305,29.054427072186776,NaN,NaN,-14.81243842031038,-10.251273098343832
2015-01-29T09:30:00-05:00,18.811028,19.030233,18.73796,18.989639,50439151,50570420.8,41.749995033295605,41.13130892859231,NaN,NaN,-100.960772069429,-66.08152145714564,-0.028833077799394258,-0.193024505455881,-0.16419142765648675,-1535405479,-1515920984.2,40.32980032044352,29.36982672515658,NaN,NaN,-15.139506555779313,-10.949592163691758
2015-01-30T09:30:00-05:00,18.770434,18.989639,18.67301,18.681129,64569125,52304497.35,37.19903061322991,40.607378162905846,NaN,NaN,-119.66744317633633,-82.50082368998167,-0.045026615153770516,-0.2204746965986999,-0.17544808144492938,-1599974604,-1537358806.8,36.91197694543801,29.639907147386303,NaN,NaN,-16.937392303341646,-11.804992183641742
2015-02-02T09:30:00-05:00,18.729841,19.005877,18.583704,18.981521,63021994,53428829.45,43.640939219647855,40.753969230034684,NaN,NaN,-93.5820194449777,-93.50266906266744,-0.03204619873926681,-0.2155058298690129,-0.1834596311297461,-1536952610,-1551713146.6,34.78619965810475,29.91029645502656,NaN,NaN,-16.274224610939438,-12.443453958969984
2015-02-03T09:30:00-05:00,19.054589,19.314387,19.054589,19.29815,66194669,54198545.55,49.518867845008636,41.40270082888863,NaN,NaN,1.3394834916922025,-81.76524570600836,-0.0003513209967911102,-0.18389878237573498,-0.18354746137894387,-1470757941,-1545787052.8,36.41429534976028,30.412950448779487,NaN,NaN,-13.687109117086235,-12.62111898155802
2015-02-04T09:30:00-05:00,19.257556,19.411731,19.216963,19.249438,37546024,53201436.4,48.67774207000701,42.31634624166163,NaN,NaN,22.937807702643518,-57.986588699281455,0.018097512296933627,-0.16092557100777682,-0.17902308330471045,-1508303965,-1530278919.8,40.594007310173495,31.54611645794201,NaN,NaN,-11.940618819075025,-12.523904672631877
2015-02-05T09:30:00-05:00,19.306269,19.474732,19.290031,19.444286,30281898,52900113.3,52.17696824431856,43.720052852450685,NaN,NaN,56.45514754060532,-26.503404777274604,0.04277904553035286,-0.12554927639176938,-0.16832832192212224,-1478022067,-1518802237.4,43.55122255132307,33.273397506343734,NaN,NaN,-9.367555783490337,-12.0729976884688
2015-02-06T09:30:00-05:00,19.622898,19.793391,19.54983,19.598542,83286431,55163519.2,54.804181414262594,44.8836480742999,NaN,NaN,132.91744678419218,24.013573214831098,0.06738527887435783,-0.08409672332917495,-0.15148200220353278,-1394735636,-1477754443.8,52.633277960821836,35.79308420502219,NaN,NaN,-6.417457592095449,-11.265063388986892
2015-02-09T09:30:00-05:00,19.509236,19.598542,19.452405,19.501117,37376102,55216227.3,52.83015427612957,45.99705144427445,NaN,NaN,100.54361780693603,62.838700665213835,0.07443913816622094,-0.0584330794957566,-0.13287221766197754,-1432111738,-1456786269.4,56.484748581422195,38.7134767557933,NaN,NaN,-4.591740825930338,-10.311731594264527
2015-02-10T09:30:00-05:00,19.647254,19.695966,19.510048,19.655373,39765631,55285561.4,55.5595955871139,47.21179869645313,NaN,NaN,125.73831260534686,87.71846648794477,0.0860137660820878,-0.0253550100593678,-0.1113687761414556,-1392346107,-1441103902.6,59.1594800758657,41.85332487903456,NaN,NaN,-2.234143077180537,-9.157790377538243
2015-02-11T09:30:00-05:00,19.631017,19.7092,19.525474,19.655373,36102021,54800041.2,55.5595955871139,47.64273313337537,NaN,NaN,120.28616606016115,107.1881381594483,0.08977486274657018,0.0008498022917571291,-0.08892506045481305,-1392346107,-1417912331,62.80092763700963,44.57044538649258,NaN,NaN,-0.3319264873580854,-7.896952678941077
2015-02-12T09:30:00-05:00,19.687847,19.874578,19.647254,19.850221,40659172,53263098.35,59.03234660103966,48.60250037104031,NaN,NaN,143.66129401752187,124.62936745483162,0.10067155558162477,0.036914384022217916,-0.06375717155940686,-1351686935,-1392645304.6,66.32392929899893,46.869392355791014,NaN,NaN,2.336331514208857,-6.435054937062516
2015-02-13T09:30:00-05:00,19.85834,19.915171,19.756856,19.833984,23283754,51523670.1,58.621248726481355,49.38541817897994,NaN,NaN,138.48273015649883,125.74242412929293,0.1017690768066994,0.0634541744489674,-0.03831490235773201,-1374970689,-1388692315.2,66.85284108835421,48.84499181247952,NaN,NaN,4.41774737634437,-4.884654606575817
2015-02-17T09:30:00-05:00,19.801509,19.947646,19.785272,19.898934,17879719,47940032.25,59.82643345984095,50.5313694568162,NaN,NaN,133.47457490364368,132.32861554863447,0.10161634559250296,0.08870552963289668,-0.012910815959606272,-1357090970,-1373688161.6,68.85249844865817,50.619232214094076,NaN,NaN,6.508723714351561,-3.2570291321576206
2015-02-18T09:30:00-05:00,19.874578,19.874578,19.728441,19.777153,36409300,47792793.75,56.50339152730435,51.83574930034245,NaN,NaN,101.4436624785819,127.46968552328148,0.08853964640459748,0.09776374204614058,0.009224095641543101,-1393500270,-1373918994.2,68.78374959711142,52.46278248739181,NaN,NaN,7.445363377989378,-1.7281159164223352
2015-02-19T09:30:00-05:00,19.728441,19.777153,19.647254,19.695966,21562939,46406914.05,54.33655355269682,52.73478919458539,NaN,NaN,72.52956758807454,117.91836582886415,0.07043677113041949,0.09727005955456747,0.026833288424147977,-1415063209,-1378462414.6,67.3581217310284,54.39337687386217,NaN,NaN,7.67409837501431,-0.38494244621710005
2015-02-20T09:30:00-05:00,19.663491,19.874578,19.541711,19.842103,40229781,43548271,57.49619708036358,54.184586799380654,NaN,NaN,74.85761154290313,104.15762933394039,0.06447931565442,0.10743243299217298,0.04295311733775298,-1374833428,-1383091713.2,65.8602970975341,56.461114027583314,NaN,NaN,8.729320743344324,0.9170951522916746
2015-02-23T09:30:00-05:00,19.817747,19.817747,19.687847,19.793391,23630570,43025329,56.1026763377005,55.07471087924156,NaN,NaN,70.45580880561171,90.55224506376298,0.05386490429190731,0.11028424770263712,0.05641934341072981,-1398463998,-1387790375,64.29747833549939,58.56906250454007,NaN,NaN,9.25570011383067,2.108324432511531
2015-02-24T09:30:00-05:00,19.842103,19.955765,19.801509,19.890815,33978548,43344027.4,58.28052563487578,55.70054357851778,NaN,NaN,86.94018328285233,81.24536673960469,0.05009131729008892,0.11903349002334096,0.06894217273325204,-1364485450,-1389269271,63.78444235417499,60.5240730048554,NaN,NaN,10.290528528939493,3.2772107320012402
2015-02-25T09:30:00-05:00,19.874578,19.972002,19.866459,19.890815,32678598,43217582.35,58.28052563487579,56.38645669029413,NaN,NaN,85.81512575474056,78.11965939483643,0.04447170381064569,0.12453180249655915,0.08006009868591346,-1364485450,-1383466307,64.96569900444295,62.26490812587466,NaN,NaN,11.157259785454837,4.402932025351754
2015-02-26T09:30:00-05:00,19.915171,19.92329,19.773094,19.842103,33500488,40619795.75,56.65072448248864,56.70601070730628,NaN,NaN,68.06854376223158,77.22745462966783,0.03477958007449526,0.12353457377903254,0.08875499370453728,-1397985938,-1380050852.8,65.67533985636281,63.84520221909178,NaN,NaN,11.499167614252508,5.41667996662329
2015-02-27T09:30:00-05:00,19.817747,19.85834,19.753609,19.769035,28954822,39545579.3,54.202202338558436,56.66301220189883,NaN,NaN,52.53724102534783,72.76338052615678,0.02140935023068366,0.11551668149289185,0.09410733126220819,-1426940760,-1390472319.2,61.57681632586959,64.48402638802376,NaN,NaN,11.181481082490809,6.2402229831757925
2015-03-02T09:30:00-05:00,19.777153,19.931409,19.73656,19.915171,27153660,37674806.05,58.102529609118506,57.03961043996947,NaN,NaN,69.81886664481172,72.63599209399679,0.020374935216659534,0.11957600028303261,0.09920106506637308,-1399787100,-1390736939.6,61.47191498997904,64.84025256006353,NaN,NaN,11.90813969890611,7.049925371137267
2015-03-03T09:30:00-05:00,19.85834,19.915171,19.760916,19.85834,31748090,36111110.85,56.10154368980925,57.078321018733426,NaN,NaN,61.8279374896746,67.61354293536124,0.01412727732696159,0.11686016172507507,0.10273288439811348,-1431535190,-1404146887.6,56.242899314041736,64.6319253627904,NaN,NaN,12.015125004521868,7.759239604477924
2015-03-04T09:30:00-05:00,19.777153,19.801509,19.659432,19.73656,47713314,35187043.1,51.97119206658387,56.82200648155271,NaN,NaN,3.86461773678822,51.223441331770765,0.0007624799804560045,0.10368598437368348,0.10292350439322748,-1479248504,-1427099498.4,48.619580379415915,63.61897198724798,NaN,NaN,11.002255023902473,8.222527521538574
2015-03-05T09:30:00-05:00,19.769035,19.85834,19.704085,19.817747,25126824,34566083.1,54.3824273695648,56.48986939359022,NaN,NaN,28.935014763333303,43.39673553199113,-0.0034114558085201613,0.09865918463257728,0.10207064044109744,-1454121680,-1438326646.8,45.37948352903201,62.12294014653607,NaN,NaN,10.758491315891737,8.584808063589026
2015-03-06T09:30:00-05:00,19.890815,20.020714,19.639135,19.67161,74391397,36771558.05,49.55937493640125,55.84259269429878,NaN,NaN,7.033934873526935,34.29607430162696,-0.016105444230483518,0.08193883515299305,0.09804427938347657,-1528513077,-1458641110.2,40.16389646108989,60.21658695887432,NaN,NaN,9.19097807540379,8.671403779562564
2015-03-09T09:30:00-04:00,19.687847,19.801509,19.679729,19.760916,26682631,33941368.05,52.341089948776094,55.30792530065129,NaN,NaN,-24.667499571718547,15.398801058320904,-0.018412066945635158,0.07502919570143263,0.09344126264706779,-1501830446,-1479049779.4,35.72195450977664,57.85011953466851,NaN,NaN,8.60065736109699,8.661297148353196
2015-03-10T09:30:00-04:00,19.590423,19.598542,19.338743,19.338743,49679922,34556559.05,40.86738816976016,54.19106791796957,NaN,NaN,-296.6181576722216,-56.29041797405834,-0.046686603145078304,0.0350830087157199,0.0817696118607982,-1551510368,-1503044815,31.334158122410443,55.175148715047,NaN,NaN,4.227723682844483,8.02792951042338
2015-03-11T09:30:00-04:00,19.395574,19.533592,19.371218,19.460524,36553161,34395935.55,44.637467659832694,53.498276068479264,NaN,NaN,-232.42135746006636,-103.54761301342926,-0.05493484480878849,0.013101055849812582,0.06803590065860107,-1514957207,-1510186555.6,30.147225781906414,52.517227575824,NaN,NaN,1.8141309227643725,7.140243997900665
2015-03-12T09:30:00-04:00,19.622898,19.898934,19.598542,19.882696,50448488,35113258.9,55.28148140766706,53.34008209185809,NaN,NaN,20.154127459624338,-105.30379047417105,-0.030903147098369013,0.02940696678563981,0.06031011388400882,-1464508719,-1512263963.4,29.79368901791156,49.9410412844224,NaN,NaN,3.372517050490223,6.601997291127745
2015-03-13T09:30:00-04:00,19.833984,19.874578,19.631017,19.744678,40941701,35127385.35,51.77674612194289,53.03108707644684,NaN,NaN,-14.249924426205629,-109.56056233411758,-0.023578372629783628,0.030837148096779288,0.054415520726562916,-1505450420,-1507651432,31.708629663438913,47.613266379275224,NaN,NaN,3.3988979056476847,6.144411664630593
2015-03-16T09:30:00-04:00,19.825865,20.004477,19.825865,19.988239,39700130,35948204.15,56.9621524509478,52.93691756330912,NaN,NaN,132.12835454420153,-78.20139151093355,-0.002703930541032705,0.05103560755027203,0.05373953809130474,-1465750290,-1500435400.8,34.70900905636756,45.53644971514611,NaN,NaN,5.253096571318026,6.017080937014512
2015-03-17T09:30:00-04:00,19.92329,19.988239,19.80159,19.939527,22260322,36167234.3,55.67276926479304,52.75064925116035,NaN,NaN,105.69583846966506,2.2614077174437908,0.006922890711355725,0.0623931514804994,0.05547026076914367,-1488010612,-1487735449.6,39.72797728400277,43.733755306543245,NaN,NaN,6.268261246980105,6.052963838438168
2015-03-18T09:30:00-04:00,19.890815,20.114079,19.817747,20.053189,58949871,37294262.85,58.058407273630394,52.85119802195619,NaN,NaN,148.96093813457557,78.53786683637217,0.019341817924962666,0.07964753317534701,0.06030571525038434,-1429060741,-1470556156.4,45.797674528877984,42.31392206886576,NaN,NaN,7.866954043930523,6.312105296365647
2015-03-19T09:30:00-04:00,20.053189,20.053189,19.777153,19.866459,42511724,38341702.1,53.01083997663486,52.76610071039022,NaN,NaN,74.284283943906,89.3638981332285,0.013645362792120225,0.07736241874053462,0.0637170559484144,-1471572465,-1471968905.6,45.39283488850665,41.15792339476841,NaN,NaN,7.587563644359697,6.494313631793369
2015-03-20T09:30:00-04:00,19.890815,20.077545,19.825865,20.061308,47478636,38704144.85,57.19299924618621,52.701134255895056,NaN,NaN,119.33296194874897,116.08047540821944,0.0212135343487162,0.09023397388430965,0.06902043953559345,-1424093829,-1455697587.4,50.78853998836914,40.394825180367704,NaN,NaN,8.71614882438429,6.811718659306357
2015-03-23T09:30:00-04:00,20.020714,20.118139,19.947646,19.947646,26432574,38844245.05,54.16455315790739,52.562777789330646,NaN,NaN,114.53370259745759,112.56154501887065,0.01696217965903371,0.09022316410938558,0.07326098445035187,-1450526403,-1452652810,51.749310338828714,40.07385453928106,NaN,NaN,8.676263233682178,7.078082169931474
2015-03-24T09:30:00-04:00,19.931409,19.931409,19.777153,19.785272,22629046,38276769.95,50.08449674049019,52.428013837466814,NaN,NaN,10.27584520332191,93.47754636560202,0.002378091659893694,0.07623359902521898,0.07385550736532528,-1473155449,-1449681777.4,52.7193146371237,40.366692700545904,NaN,NaN,7.343332326055929,7.115975049377825
2015-03-25T09:30:00-04:00,19.809628,19.85834,19.468643,19.468643,40594688,38672574.45,43.24388977011665,51.63240400893479,NaN,NaN,-118.82034072660569,39.921290593365754,-0.027767445291449963,0.03914620075101283,0.06691364604246279,-1513750137,-1466619656.6,46.927272130505585,40.477249029222584,NaN,NaN,3.8478288155965714,6.649097015980503
2015-03-26T09:30:00-04:00,19.387456,19.541711,19.309029,19.452405,40262296,39010664.85,42.92013295872862,51.158172439101044,NaN,NaN,-175.34555955476333,-10.004678106368104,-0.0468527786340965,0.008347672749842161,0.05520045138393866,-1554012433,-1483107650.2,42.08066275324153,40.61416090723342,NaN,NaN,1.0165885145274023,5.844452944344346
2015-03-27T09:30:00-04:00,19.452405,19.476761,19.354981,19.428049,30172006,39071524.05,42.40728020240138,50.44861460007427,NaN,NaN,-149.4707401779155,-63.765418531700995,-0.05841659075074356,-0.01782028705449079,0.04059630369625277,-1584184439,-1515125772.2,34.60620894054509,40.534464795145446,NaN,NaN,-1.4090093971095448,4.808244038422362
2015-03-30T09:30:00-04:00,19.574186,19.760916,19.562008,19.712204,43447648,39886223.45,49.92500720974339,51.095587388644496,NaN,NaN,-31.87904717601005,-93.04796848639452,-0.0448382704307348,-0.01545153434216573,0.029386736088569072,-1540736791,-1533167849.8,31.239004735859027,40.52766812467748,NaN,NaN,-1.2453690460895168,3.9434421692063797
2015-03-31T09:30:00-04:00,19.614779,19.67161,19.534404,19.574186,26147559,39606196.9,46.734073990146044,51.24534498366688,NaN,NaN,-61.576441269216865,-107.4184257809023,-0.04305304567049624,-0.02442957099955123,0.01862347467094501,-1566884350,-1551913630,28.17187058533115,40.38657132492211,NaN,NaN,-2.1011592395363885,3.0799276822431274
2015-04-01T09:30:00-04:00,19.525474,19.627931,19.41993,19.557948,32842355,38862648.95,46.35865872161607,50.608000506091805,NaN,NaN,-76.32964526747188,-98.92028668907554,-0.040883247469235294,-0.03248058466559911,0.008402662803636184,-1599726705,-1569108943.6,25.68106476269655,40.09281244954961,NaN,NaN,-2.897509849589425,2.226008034838477
2015-04-02T09:30:00-04:00,19.509236,19.687847,19.509236,19.655373,26487748,38930695.15,49.00547850323798,50.41005281904146,NaN,NaN,-39.62242530571336,-71.77565983926554,-0.03123926217937762,-0.03064641492058584,0.0005928472587917785,-1573238957,-1572954248.4,25.14564750710744,39.624028009811646,NaN,NaN,-2.80190566794306,1.507734648726829
2015-04-06T09:30:00-04:00,19.492999,19.73656,19.452405,19.687847,19443829,36183316.75,49.89298859231341,49.90511254342472,NaN,NaN,-33.182533982941145,-48.51801860027067,-0.021489975351341832,-0.02626962193038551,-0.00477964657904368,-1553795128,-1566876386.2,27.711052877746255,39.124173997052985,NaN,NaN,-2.4745734946023843,0.9388334853940844
2015-04-07T09:30:00-04:00,19.728441,19.740619,19.582304,19.582304,22359667,35967168.55,47.02823800680221,49.287646024996796,NaN,NaN,-27.15507750235845,-47.57322466554034,-0.020944703790984003,-0.030960526317773684,-0.010015822526789682,-1576154795,-1573959987,26.568203381660567,38.18419014688568,NaN,NaN,-2.9893456715112907,0.37766503440760224
2015-04-08T09:30:00-04:00,19.598542,19.73656,19.598542,19.655373,22791421,34622743.5,49.20281772437311,48.65510391433556,NaN,NaN,-22.234952667287104,-39.70492694515439,-0.014750576938794242,-0.028454043700282483,-0.013703466761488241,-1553363374,-1571255791.8,27.792500875160115,36.89810631447726,NaN,NaN,-2.828321337579811,-0.08033301873345683
2015-04-09T09:30:00-04:00,19.622898,19.704085,19.54577,19.683788,25610772,34075624.05,50.06136994979363,48.4444274838469,NaN,NaN,-35.59218472544359,-31.55743483674873,-0.008156657802632163,-0.023899289014778446,-0.015742631212146283,-1527752602,-1556860971.2,34.09183876866973,36.09089230591748,NaN,NaN,-2.4633917770067617,-0.42076998420107176
2015-04-10T09:30:00-04:00,19.695966,19.728441,19.647254,19.679729,18175631,32461981.2,49.93154499671053,47.92575218031293,NaN,NaN,-16.1638862945732,-26.8657270345207,-0.0037116448869559185,-0.020382187320841183,-0.016670542433885265,-1545928233,-1551398826.4,36.360557227672714,35.06032210872488,NaN,NaN,-2.19083509008005,-0.6736364278980687
2015-04-13T09:30:00-04:00,19.647254,19.817747,19.631017,19.752797,38134961,32321644.2,52.328222723215255,47.794585720692055,NaN,NaN,5.338201871270734,-19.16157986367832,0.004083984865630035,-0.01156556135184772,-0.015649546217477755,-1507793272,-1542198455.2,40.10071458808002,34.228279555099974,NaN,NaN,-1.332163787600496,-0.7677117649984154
2015-04-14T09:30:00-04:00,19.73656,19.801509,19.639135,19.752797,32518159,31962545.65,52.32822272321526,47.95485186231527,NaN,NaN,9.478207954169132,-11.834922772372806,0.008898719258612816,-0.004526147144211734,-0.01342486640282455,-1507793272,-1528526150.6,45.250235441460646,33.694773898266895,NaN,NaN,-0.6067076938294226,-0.744711183402845
2015-04-15T09:30:00-04:00,19.793391,19.907052,19.744678,19.825865,45789164,33138987.75,54.83555282683553,48.78282779493805,NaN,NaN,58.57700748422938,4.327469257930488,0.01623543693549922,0.006869429766549473,-0.009366007168949746,-1462004108,-1510254297.4,51.27848866262291,34.00557507913242,NaN,NaN,0.6731174198892449,-0.5421642400754036
2015-04-16T09:30:00-04:00,19.817747,19.92329,19.712204,19.854281,27855414,31584264.9,55.808982498891744,49.703459904949696,NaN,NaN,69.75264697492518,25.396435598004242,0.021881691842173628,0.01798610763376729,-0.003895584208406338,-1434148694,-1491533515.8,56.55638926934883,35.03955554456865,NaN,NaN,2.024003977048596,-0.1755687804862609
2015-04-17T09:30:00-04:00,19.760916,19.760916,19.517355,19.590423,49093703,31913363.85,45.91343790748758,49.95389974102728,NaN,NaN,-35.95899623256916,21.437413610405052,0.007470294745418679,0.005442284223367011,-0.0020280105220516677,-1483242397,-1478996348.6,59.704547935458976,36.832294044205355,NaN,NaN,0.5866183184507511,-0.06668490920954491
2015-04-20T09:30:00-04:00,19.663491,19.744678,19.651313,19.67161,19111425,30495003.3,48.914886237255864,49.88174824299245,NaN,NaN,13.07437904720048,22.984649045591,0.0032455587028791186,0.0020289378565472305,-0.001216620846331888,-1464130972,-1470263888.6,61.78195242647474,39.01393316496363,NaN,NaN,0.19371740308343266,-0.02948457888197669
2015-04-21T09:30:00-04:00,19.744678,19.769035,19.557948,19.574186,26730491,30509899.15,45.64172295360142,49.80372316895356,NaN,NaN,-14.683301281333483,18.152347198490475,-0.005778841931831475,-0.008440173261121231,-0.0026613313292897568,-1490861463,-1466877526.8,62.58744916909583,41.472188778089674,NaN,NaN,-1.0846607829539767,-0.18022403660654812
2015-04-22T09:30:00-04:00,19.590423,19.756856,19.525474,19.712204,26527141,30704803.9,50.67707566899296,50.112181522337615,NaN,NaN,20.240850101583415,10.485115721961288,-0.0022999758003118885,-0.0055363010796796175,-0.003236325279367729,-1464334322,-1467343569.6,62.39255216093479,44.094437877963834,NaN,NaN,-0.7384489432562369,-0.25997045184221795
2015-04-23T09:30:00-04:00,19.679729,19.793391,19.647254,19.744678,26310142,29990576.6,51.808229921735816,50.312378052230315,NaN,NaN,71.58269093084482,10.851124513145214,0.0021029984006933626,-0.0006075772785010258,-0.0027105756791943885,-1438024180,-1468118666.8,62.04649311247437,46.73021256406147,NaN,NaN,-0.12909763442482142,-0.24127433506830417
2015-04-24T09:30:00-04:00,19.704085,19.73656,19.639135,19.712204,23044812,29129702.4,50.559522587156245,50.35998762329052,NaN,NaN,34.83599769166377,25.0101232979918,0.0027047516651427686,0.0006703639022340724,-0.002034387762908696,-1461068992,-1463683985.8,63.30069150609193,49.27232960894331,NaN,NaN,0.0375921532925097,-0.20143626530247363
2015-04-27T09:30:00-04:00,19.73656,19.817747,19.60666,19.639135,29504134,29096308.8,47.76957923731655,50.41294056832726,NaN,NaN,14.918923726346607,25.379032233821025,-0.0017044143508622685,-0.004164905701486532,-0.0024604913506242635,-1490573126,-1468972416.6,60.72365052026659,51.712004404558016,NaN,NaN,-0.5894422703655853,-0.2568656945972039
2015-04-28T09:30:00-04:00,19.60666,19.752797,19.525474,19.752797,31767379,28512295.35,52.18920222878876,50.62625374721409,NaN,NaN,1.2533513982738986,28.5663627697425,0.00289742916155187,0.0011612951013155737,-0.001736134060236296,-1458805747,-1462561273.4,62.705848100598224,54.20581492066075,NaN,NaN,0.11028774106321715,-0.2044152037885723
2015-04-29T09:30:00-04:00,19.639135,19.833984,19.557948,19.744678,49922908,29701062.8,51.85168456894168,50.75413336286753,NaN,NaN,40.31593085959323,32.58137892134447,0.005127579888479056,0.004673340800362524,-0.0004542390881165318,-1508728655,-1471440140,58.31636850540672,55.936138473284814,NaN,NaN,0.5966223331765926,-0.08998126993640589
2015-04-30T09:30:00-04:00,19.687847,19.793391,19.517355,19.590423,42863426,30202116.35,45.792285512378605,50.458471971129526,NaN,NaN,-78.37255070582674,2.590330594010152,-0.00358345357289616,-0.004933556054236732,-0.0013501024813405717,-1551592081,-1494153720.2,48.88830105939192,56.83097731840762,NaN,NaN,-0.7091857313664537,-0.17843905014069844
2015-05-01T09:30:00-04:00,19.695966,19.785272,19.67161,19.760916,22578835,30006670.7,52.41169043462573,50.46443395051599,NaN,NaN,68.14120243230157,9.251371542137711,0.002037263555818459,0.0011964769634325023,-0.0008407865923859569,-1529013246,-1507742571,44.27633894191493,57.129236200824394,NaN,NaN,0.13217804168346795,-0.13406517988010325
2015-05-04T09:30:00-04:00,19.842103,19.963883,19.80703,19.955765,27384041,30403681.3,58.62934462996671,50.91451408671252,NaN,NaN,243.48566095296118,54.96471898746063,0.017895896706774207,0.0215290842910818,0.003633187584307595,-1501629205,-1509953786.8,43.55628554349978,57.008239779541476,NaN,NaN,2.9151089054615955,0.3015311180258537
2015-05-05T09:30:00-04:00,19.898934,20.012595,19.760916,19.777153,37739803,31172688.1,51.931237440499785,50.70706298768854,NaN,NaN,145.9597212632078,83.9059929604474,0.01546592460858726,0.02296559334504167,0.00749966873645441,-1539369008,-1526066439,38.62679273358897,56.10454721318191,NaN,NaN,3.090304273653819,0.699927283115563
2015-05-06T09:30:00-04:00,19.85834,19.890815,19.541711,19.679729,36647819,31865508,48.665380310647336,50.19680568852822,NaN,NaN,-17.974376156006798,72.2479315573274,0.006846370721532538,0.01605763213837008,0.009211261416837544,-1576016827,-1539524073.4,35.05797323705771,54.568946068018256,NaN,NaN,2.1591120028982895,0.9083822430845239
2015-05-07T09:30:00-04:00,19.598542,19.866459,19.598542,19.817747,39313984,32550668.6,53.159498629552246,50.71438145438998,NaN,NaN,40.64174675513247,96.05079104951923,0.009808912280047048,0.021472401766896354,0.011663489486849307,-1536702843,-1536546225.8,36.45698755393399,52.90840604076648,NaN,NaN,2.8553710703248973,1.1865235041188629
2015-05-08T09:30:00-04:00,19.92329,20.101901,19.92329,20.101901,40738192,33678796.65,60.773551237712304,51.56142895442258,NaN,NaN,263.2814121215606,135.07883298737107,0.029179287181932835,0.04813759846426535,0.018958311282332517,-1495964651,-1529936506.8,39.568863630408075,51.32175684104743,NaN,NaN,6.196855798650154,1.9022852604804759
2015-05-11T09:30:00-04:00,20.101901,20.142495,19.996358,20.028833,38377262,33690911.7,58.155701202093695,52.455284543600605,NaN,NaN,206.53130693597856,127.68796218397453,0.0349547680883833,0.06265177139281164,0.02769700330442834,-1534341913,-1536479048.4,37.60570064130995,49.53734623191987,NaN,NaN,7.943806914444003,2.765359782475265
2015-05-12T09:30:00-04:00,19.939527,20.004477,19.793391,19.955765,48789335,34504470.5,55.57751682843733,52.80531605498948,NaN,NaN,94.70197902524127,117.43641373638123,0.031826803575615,0.0674805077739471,0.035653704198332095,-1583131248,-1545231496.4,35.09704493739726,47.58766714452433,NaN,NaN,8.50578458689289,3.58542046882064
2015-05-13T09:30:00-04:00,19.955765,20.036952,19.91923,19.963883,29447644,33687394.5,55.81190380466076,53.0912927609127,NaN,NaN,114.80663388039275,143.99261574366113,0.028390866162410634,0.07114228690134539,0.04275142073893475,-1553683604,-1540764851.8,37.39240560822428,45.82666089422076,NaN,NaN,9.02014348150557,4.361809470632773
2015-05-14T09:30:00-04:00,20.061308,20.150613,20.020714,20.142495,26460954,33617671.5,60.722364610961414,53.81721004832735,NaN,NaN,158.5628448608459,167.57683536480383,0.03575783506651898,0.08744871457208347,0.051690879505564495,-1527222650,-1538868813.2,38.38849596520714,44.04721835558613,NaN,NaN,11.02846426070702,5.314188726357665
2015-05-15T09:30:00-04:00,20.150613,20.158732,19.988239,20.053189,28511756,32588574.15,57.294046282811635,54.49752912300557,NaN,NaN,119.32904008862326,138.78636095821636,0.03233026748607105,0.0921037138631533,0.059773446377082255,-1555734406,-1550822764.2,34.64590310009436,42.18452211128811,NaN,NaN,11.629899505949268,6.2164331234421795
2015-05-18T09:30:00-04:00,20.061308,20.183088,20.036952,20.166851,19853467,32625676.25,60.36144098117904,55.081260462462026,NaN,NaN,127.5583292055618,122.991765412133,0.035195828688779685,0.10376823223805687,0.06857240354927718,-1535880939,-1551130569.4,34.552491669429,40.173568080490305,NaN,NaN,13.090942352253595,7.1985058704152385
2015-05-19T09:30:00-04:00,20.207444,20.345462,20.191207,20.280513,32532239,32915763.65,63.20738636179448,55.89238201909437,NaN,NaN,161.68103086808927,136.3875757807026,0.04177536522827978,0.12079161008462691,0.07901624485634713,-1503348700,-1535174059.8,43.114854708547945,39.087745666428965,NaN,NaN,15.21218572797628,8.343317278638244
2015-05-20T09:30:00-04:00,20.321106,20.329225,20.191207,20.223682,37372185,33458015.85,60.854733999267026,56.96827119672925,NaN,NaN,133.20354792125667,140.0669585888754,0.039362159914742845,0.1282189447497757,0.08885678483503284,-1540720885,-1532581516,44.38789670055338,38.76628821222621,NaN,NaN,16.24984282492426,9.472820928107675
2015-05-21T09:30:00-04:00,20.183088,20.223682,20.154673,20.17497,23185766,33301797.05,58.833349877938126,57.426961156965845,NaN,NaN,97.90683058749916,127.93575573420605,0.03186740372419865,0.12869103949028116,0.09682363576608251,-1563906651,-1539918316.2,41.55376816128949,38.57181887075297,NaN,NaN,16.518959871935916,10.479412205797423
2015-05-22T09:30:00-04:00,20.134376,20.2318,20.134376,20.183088,16241464,32961629.65,59.077308650051236,57.45895858697189,NaN,NaN,87.42429183029157,121.55480608253973,0.025134642969507265,0.12824193947796658,0.10310729650845932,-1547665187,-1538304472.4,42.424594332470924,38.49098378425091,NaN,NaN,16.80644326735254,11.383273786019583
2015-05-26T09:30:00-04:00,20.150613,20.150613,19.939527,19.955765,54864465,34229646.2,50.12028960812454,57.329605170373654,NaN,NaN,21.752087573955727,100.39355775621851,0.004149847113389768,0.10829460540019653,0.10414475828680676,-1602529652,-1551634215,37.459960529486104,38.40763862681499,NaN,NaN,14.343631711322729,11.80618206106289
2015-05-27T09:30:00-04:00,20.012595,20.199326,19.988239,20.17497,31792073,34230880.9,56.90540664067359,57.91817847966124,NaN,NaN,57.134432823134865,79.48423814722763,0.003819124886181177,0.10891866439453324,0.10509953950835206,-1570737579,-1565111990.8,33.22615629238487,38.27679455933836,NaN,NaN,14.296675360847011,12.161966818174907
2015-05-28T09:30:00-04:00,20.126257,20.166851,20.028833,20.150613,21913446,32830407.8,55.993957155814755,58.120639802965705,NaN,NaN,49.97519873855092,62.83856831068648,0.0008990504864127974,0.10622335261636806,0.10532430212995526,-1592651025,-1575498018.8,30.376951954827035,37.84250630225929,NaN,NaN,13.979607110535461,12.421629717083558
2015-05-29T09:30:00-04:00,20.150613,20.150613,19.925725,19.972002,31540067,32264239.85,49.70667597271213,57.33014871260855,NaN,NaN,-2.222788190543754,42.812644555077895,-0.013337083598245425,0.08865294763214848,0.10199003123039391,-1624191092,-1587554907,27.435713836830388,36.97585274557516,NaN,NaN,11.693200416832772,12.317568388476303
2015-06-01T09:30:00-04:00,20.077545,20.101901,19.931409,19.988239,23075794,32289087.8,50.253523584347654,56.765707454198115,NaN,NaN,-15.443592068129448,22.239067775393686,-0.021454480921193536,0.075171930078902,0.09662641100009553,-1601115298,-1598244929.2,25.113896018205693,36.083580986782,NaN,NaN,10.030973819063066,11.99091202141727
2015-06-02T09:30:00-04:00,19.972002,20.093783,19.890815,20.020714,26442466,32242009.05,51.3919173851519,56.46673606539201,NaN,NaN,-22.258548089495754,13.436940642703387,-0.02422607487361053,0.06634381740808237,0.0905698922816929,-1574672832,-1592673565.2,28.5095805066088,35.61304781315426,NaN,NaN,8.991609934189746,11.56244029467048
2015-06-03T09:30:00-04:00,20.093783,20.248038,20.053189,20.191207,40922565,32401147.15,56.960441234739015,56.548774453254744,NaN,NaN,69.9124079959802,15.992535677272452,-0.014638528854121466,0.07227173121404107,0.08691026006816253,-1533750267,-1585276102.8,32.86265569484242,35.28949424791269,NaN,NaN,9.73928879569527,11.301990080531164
2015-06-04T09:30:00-04:00,20.134376,20.179029,19.980121,20.012595,37493365,32443424.45,50.44108413575806,55.81439727645451,NaN,NaN,-11.10805465802133,3.7758849979580007,-0.020052809700317503,0.06184424794276566,0.08189705764308317,-1571243632,-1580994624.2,35.317537369719346,35.07014006252071,NaN,NaN,8.34137492471968,10.87904505827238
2015-06-05T09:30:00-04:00,20.158732,20.256156,20.069426,20.126257,52433750,33099412.75,54.04560714033343,55.58236590913464,NaN,NaN,52.054746014367176,14.631391838940186,-0.01588817115938948,0.06203684369384632,0.0779250148532358,-1518809882,-1559918382.2,45.819966452305515,35.8682874448215,NaN,NaN,8.297801672233229,10.51029600312393
2015-06-08T09:30:00-04:00,20.158732,20.183088,19.996358,20.004477,28288748,32476940.55,49.86119861684213,54.83234859739629,NaN,NaN,-27.523183724007247,12.215473507764626,-0.020927114803814303,0.05176612134846792,0.07269323615228222,-1547098630,-1549115048.6,50.27666024888138,36.99144234335382,NaN,NaN,6.9383507780087035,10.000018113821755
2015-06-09T09:30:00-04:00,20.020714,20.142495,19.939527,20.053189,31181331,32117144,51.47944308027582,53.994638363002096,NaN,NaN,-41.17994230478936,8.431194664705904,-0.0205424374393455,0.04701518935310034,0.06755762679244584,-1515917299,-1537363942,54.64672472814278,37.81514734475345,NaN,NaN,6.322079454359167,9.474598305327099
2015-06-10T09:30:00-04:00,20.166851,20.410412,20.134376,20.337344,53999864,32377670.45,59.65886044130964,53.909218823148,NaN,NaN,161.6834226104958,26.78539758760902,-0.0017062623301367374,0.06542479887977493,0.06713106120991166,-1461917435,-1522997375.6,59.35045242416545,38.88390132501145,NaN,NaN,8.480204509965478,9.332542048846868
2015-06-11T09:30:00-04:00,20.426649,20.459124,20.345462,20.41853,60069525,33908764.5,61.64813010970697,54.11027455398864,NaN,NaN,216.94671802012417,72.39635212323813,0.01475841218561269,0.08557907644192753,0.07082066425631484,-1401847910,-1489118231.2,67.82499509413402,40.76041753450035,NaN,NaN,10.875310427791032,9.552937531553177
2015-06-12T09:30:00-04:00,20.369818,20.410412,20.264275,20.329225,42231411,34697287.35,58.24570393439607,54.05087421715613,NaN,NaN,134.61586041454652,88.908575003274,0.01795959589965604,0.09327015913088488,0.07531056323122884,-1444079321,-1474172119,70.72463070191381,42.78184870374627,NaN,NaN,11.77547976098346,9.870443564328932
2015-06-15T09:30:00-04:00,20.199326,20.312987,20.113349,20.239919,40702591,35306829.1,54.97796743790311,54.39785120499745,NaN,NaN,49.68120849342441,104.34945344676032,0.012638671826140008,0.09110890301390384,0.07847023118776383,-1484781912,-1461708775.4,72.91652778094482,45.31446065027904,NaN,NaN,11.509044076222526,10.104529351742302
2015-06-16T09:30:00-04:00,20.248038,20.369818,20.183088,20.353581,36249544,36126632.95,58.192766957674806,54.48980551335468,NaN,NaN,93.63088187166994,131.31161828205217,0.015179324824502433,0.09744438721839188,0.08226506239388945,-1448532368,-1448231789.2,75.08852892104836,48.304630123755,NaN,NaN,12.278598426202603,10.415110648093775
2015-06-17T09:30:00-04:00,20.41853,20.442887,20.280513,20.329225,55480808,37274061.4,57.24941190072862,54.57948085227711,NaN,NaN,118.564944952714,122.68792275049582,0.01367169372253245,0.09935467954705501,0.08568298582452256,-1504013176,-1456650937.4,71.24466411754155,51.22375242109175,NaN,NaN,12.622754491884972,10.730488340063946
2015-06-18T09:30:00-04:00,20.41853,20.54843,20.329225,20.515955,70177886,38914346.45,62.2958827281912,55.47870990623989,NaN,NaN,165.13038740237474,112.32465662694594,0.023145563917498307,0.11461494072139544,0.09146937680389713,-1433835290,-1463048413.4,68.38015769351624,54.14835555371217,NaN,NaN,14.495516349743024,11.268349484303814
2015-06-19T09:30:00-04:00,20.369818,20.394174,20.085664,20.085664,47099121,40110014.2,48.18157669178829,55.330713699628504,NaN,NaN,7.607447632293564,86.92297407049534,-0.00042380172056984133,0.09093962465318484,0.09136342637375468,-1480934411,-1470419431.4,65.13087241776492,57.006711010823544,NaN,NaN,11.252251471550968,11.266049768196265
2015-06-22T09:30:00-04:00,20.377937,20.475361,20.369818,20.394174,40702403,41333061.15,55.89700341778877,55.65250555910257,NaN,NaN,116.32839992769728,100.25241235734993,0.003681037444350943,0.09596472317919336,0.09228368573484241,-1440232008,-1461509450.6,67.16213750611257,59.76760793935953,NaN,NaN,11.360771731957245,11.279581477304976
2015-06-23T09:30:00-04:00,20.451005,20.499718,20.402293,20.434768,33562044,40267940.1,56.808286844337196,55.641637388359584,NaN,NaN,116.27318820501844,104.78087362401962,0.007810186541089295,0.10204641891120403,0.09423623237011473,-1406669964,-1453136969.8,68.99018221242659,62.3481455477584,NaN,NaN,11.760419725880375,11.34827265567289
2015-06-24T09:30:00-04:00,20.402293,20.434768,20.264275,20.264275,26556755,40006174.2,51.95289264435409,55.74962371040216,NaN,NaN,49.93972220183328,91.05582907384348,-0.0017507643838627351,0.09204777689028631,0.09379854127414905,-1433226719,-1438979678.4,71.84440182148066,64.95720729431278,NaN,NaN,10.409634969780118,11.214181557688208
2015-06-25T09:30:00-04:00,20.321106,20.329225,20.126257,20.142495,43737251,41097364.45,48.74792923869981,55.37121814599976,NaN,NaN,-11.522302525063019,55.725291088355924,-0.016278463731164858,0.07345046161019297,0.08972892534135783,-1476963970,-1447605414.4,67.75259804725283,66.52382383680902,NaN,NaN,8.238739712886854,10.789118437002301
2015-06-26T09:30:00-04:00,20.2318,20.264275,20.150613,20.207444,30755288,41058125.5,50.50174673238526,55.41697158282427,NaN,NaN,-13.092761394075612,51.5852492830821,-0.021203948303374562,0.06322398996213963,0.08442793826551419,-1446208682,-1440660268.6,69.27017872571099,67.88050372801112,NaN,NaN,7.068831289255238,10.257648844467006
2015-06-29T09:30:00-04:00,19.988239,20.077545,19.712204,19.720322,52943521,42551511.85,39.5660662372447,54.566016094036335,NaN,NaN,-194.83687892379234,-10.64780648721582,-0.05503630203429653,0.015632560722643518,0.07066886275694005,-1499152203,-1452444307.6,63.78520559448506,68.53325236132129,NaN,NaN,1.9346434080950714,9.068648067842444
2015-06-30T09:30:00-04:00,19.915171,19.963883,19.728441,19.793391,77428805,45100828.8,41.60859618514774,53.276711504310484,NaN,NaN,-182.782946101525,-70.45903334852451,-0.06933785367017789,-0.01600345433078232,0.05333439933939557,-1421723398,-1455454994.4,62.425189167479225,68.75287641441513,NaN,NaN,-1.3246091877462407,7.583897031329775
2015-07-01T09:30:00-04:00,20.101901,20.142495,19.972002,20.093783,52405881,45674994.6,49.208658212207624,52.388177797346245,NaN,NaN,-64.37389601120552,-93.32175699113228,-0.055982908172308596,-0.016644235875990177,0.03933867229631842,-1369317517,-1442673154,65.76279463068232,68.60557638131144,NaN,NaN,-1.4186633433480218,6.297816977804375
2015-07-02T09:30:00-04:00,20.085664,20.134376,19.92329,20.004477,24095650,45005108.85,47.240066382565864,51.60206082935837,NaN,NaN,-84.7803754474263,-107.97337157560492,-0.05073551395990522,-0.024080720153563107,0.026654793806342114,-1393413167,-1425962993.4,69.56848682376476,68.52299467572935,NaN,NaN,-2.156609929544913,5.0900417053259055
2015-07-06T09:30:00-04:00,19.777153,19.972002,19.752797,19.92329,33243447,44045593.7,45.45961370373167,50.9221784197747,NaN,NaN,-128.01357507701684,-130.9575343121932,-0.050211080787794016,-0.036109057178400406,0.01410202360939361,-1426656614,-1422052579.8,70.39773968551481,68.34308124034149,NaN,NaN,-3.3192636225688013,3.888712372769519
2015-07-07T09:30:00-04:00,19.890815,19.98004,19.590423,19.963883,63114605,45786886.55,46.54444478419617,50.09015540738337,NaN,NaN,-128.49419363973269,-117.68899725538124,-0.04478824344076084,-0.041883280691557445,0.0029049627492033978,-1363542009,-1394930541,75.40398859263931,68.36561407402657,NaN,NaN,-3.915136868116046,2.7738767669287245
2015-07-08T09:30:00-04:00,19.695966,19.825865,19.582304,19.614779,56822784,47068959.2,39.30394686307571,48.80833647612245,NaN,NaN,-163.6414057652225,-113.86068918812074,-0.06134692601950845,-0.07377869477518217,-0.012431768755673719,-1420364793,-1394658820,75.44878530107128,68.66590844427868,NaN,NaN,-6.857126467522508,1.39801916200712
2015-07-09T09:30:00-04:00,19.890815,19.92329,19.728441,19.769035,31255012,45931716.6,43.487246484936485,47.46486245874711,NaN,NaN,-102.92120320619505,-121.57015062711864,-0.05855208461935456,-0.08562187452986691,-0.02706978991051236,-1389109781,-1398617272.8,73.35281486501825,69.02109824224313,NaN,NaN,-7.9191696369318105,0.06699219073013007
2015-07-10T09:30:00-04:00,20.04507,20.053189,19.915171,20.004477,36141849,44735332.8,49.23798866971715,47.5403204571706,NaN,NaN,-40.52048092168792,-112.71817172197098,-0.0384587866343315,-0.07514327320342673,-0.03668448656909523,-1352967932,-1390528225.8,74.8880333724185,69.71803831043266,NaN,NaN,-6.911223724138216,-0.929895797108205
2015-07-13T09:30:00-04:00,20.17497,20.248038,20.134376,20.248038,41215426,44684533.55,54.40674994845512,47.433873780789625,NaN,NaN,30.95329219241679,-80.92479826808426,-0.0079706841049942,-0.04664784170033798,-0.03867715759534378,-1311752506,-1367547404.2,78.65113925546618,70.53868129252935,NaN,NaN,-4.304832634990636,-1.4120296310914096
2015-07-14T09:30:00-04:00,20.183088,20.337344,20.143307,20.29675,27708267,44034817.35,55.38520184923624,47.332224852568125,NaN,NaN,45.75712472994303,-46.074534594149114,0.01501780264227296,-0.01990490429250258,-0.03492270693477554,-1284044239,-1351647850.2,80.79538870935346,71.38191032802412,NaN,NaN,-1.939249288725283,-1.4873467250391057
2015-07-15T09:30:00-04:00,20.394174,20.499718,20.324678,20.467243,62197497,45332215,58.72401169573145,47.8158762133808,NaN,NaN,95.79628115726312,5.813002790348006,0.039838131354446235,0.014874957258282251,-0.02496317409616398,-1221846742,-1311944240,84.87949206313003,72.31298820242765,NaN,NaN,1.1161463553287594,-1.1154191421294106
2015-07-16T09:30:00-04:00,20.621498,20.67021,20.597142,20.67021,39804812,44548415.2,62.33749094817463,48.78655919262899,NaN,NaN,148.90615374087406,56.17847417976183,0.06648711613183822,0.058145721068633804,-0.008341395063204422,-1182041930,-1270530669.8,87.79506565079694,73.74459303125222,NaN,NaN,4.882943944739612,-0.25851012971955034
2015-07-17T09:30:00-04:00,20.653973,20.678329,20.524074,20.613379,22299887,42154515.25,60.73422298988149,49.51745035387872,NaN,NaN,131.3174815878762,90.54606668167466,0.0761540442754348,0.08685116028108908,0.010697116005654279,-1204341817,-1240805446.8,89.37821620330443,75.18088142250892,NaN,NaN,7.429254260817042,0.8397419260713913
2015-07-20T09:30:00-04:00,20.67021,20.702685,20.580905,20.637735,25369004,41068009.4,61.19485221368359,51.062363637910074,NaN,NaN,124.11959842196887,109.17932792758506,0.07967778617203088,0.11029434872069288,0.030616562548662,-1178972813,-1214249508.2,90.55671968153187,77.09313242872655,NaN,NaN,9.622231431325892,2.0943832839648913
2015-07-21T09:30:00-04:00,20.645854,20.727041,20.564667,20.613379,24404516,40253115.05,60.43139518806331,52.40684928097547,NaN,NaN,115.27155610032106,123.08221420166066,0.07587608973764196,0.12546167472071446,0.04958558498307249,-1203377329,-1198116126.2,91.19582238040975,79.14817765822158,NaN,NaN,11.21562122597325,3.397417275680371
2015-07-22T09:30:00-04:00,20.621498,20.791991,20.597142,20.767635,36480543,40399040,63.53434339857708,53.430112508573295,NaN,NaN,127.06487708795245,129.33593338779855,0.07890790529694816,0.1482204666042577,0.06931256130730953,-1166896786,-1187126135,91.61225943864696,80.99456800164762,NaN,NaN,13.501207778464988,4.840815918935316
2015-07-23T09:30:00-04:00,20.783872,20.800109,20.54843,20.589023,36583223,40900363.4,57.874976280428314,54.18974892984919,NaN,NaN,99.96648298942799,119.54799923750932,0.06464119580805952,0.15011405606738393,0.0854728602593244,-1203480009,-1191413750.8,89.82712360112336,82.44161348574467,NaN,NaN,13.880456070197573,6.1321930834013525
2015-07-24T09:30:00-04:00,20.564667,20.580905,20.3617,20.394174,32168535,40321927.6,52.392226716762266,54.68493557363708,NaN,NaN,49.36698205210889,103.15789933035587,0.039096452664885845,0.1343434260904317,0.09524697342554586,-1235648544,-1197675096.2,87.15625383451504,83.63865021067325,NaN,NaN,12.56707500016138,7.051461928652785
2015-07-27T09:30:00-04:00,20.256156,20.300809,20.17497,20.248038,34825467,40525436.55,48.668329061638964,54.836641593454424,NaN,NaN,4.285799207904867,79.19113948754307,0.010841595298808238,0.10879896754905616,0.09795737225024792,-1270474011,-1215975335.8,79.69754019425244,83.94533246793132,NaN,NaN,10.316065306993817,7.517833839844361
2015-07-28T09:30:00-04:00,20.410412,20.410412,20.199407,20.329225,29694687,39362994.85,50.76217027294121,55.65508612273053,NaN,NaN,15.60809532029252,59.25844733153734,-0.003148230243177161,0.09402208444627647,0.09717031468945363,-1240779324,-1223455734.8,76.80417740514747,84.04214618965105,NaN,NaN,9.051094710337292,7.736871107057636
2015-07-29T09:30:00-04:00,20.394174,20.540392,20.345462,20.532192,33110892,37147099.2,55.63440572242267,56.52274035397954,NaN,NaN,46.823889564382526,43.21024982682335,0.0003152501278518849,0.09756437734926848,0.0972491272214166,-1207668432,-1231610064,73.6646431631139,84.06441963951504,NaN,NaN,9.404507621861622,7.975104894886777
2015-07-30T09:30:00-04:00,20.499718,20.54843,20.41853,20.532192,20610101,35557310.2,55.63440572242267,56.97962728631565,NaN,NaN,48.40442402900229,32.897838034738214,0.0015829648633659266,0.09922783330062401,0.09764486843725809,-1207668432,-1232447748.6,73.33301082522162,83.95334660042954,NaN,NaN,9.688455527957222,8.219869271039698
2015-07-31T09:30:00-04:00,20.507836,20.556548,20.410412,20.467243,24151742,35560114.8,53.66367985053047,56.92655085074961,NaN,NaN,38.87592689633083,30.799627003582593,-0.002740540808063338,0.09421919242717891,0.09695973323524225,-1231820174,-1231682074.6,73.45066288019383,83.5818840021958,NaN,NaN,9.377369376846008,8.385226429012029
2015-08-03T09:30:00-04:00,20.467243,20.491599,20.304869,20.442887,42050362,36000460.55,52.90682492104438,56.74952392730733,NaN,NaN,17.574669159395157,33.457400993880654,-0.00774507312486955,0.08727839182915531,0.09502346495402486,-1273870536,-1232361379.6,73.14234408392394,83.03523795752228,NaN,NaN,8.913897841354112,8.46075091648947
2015-08-04T09:30:00-04:00,20.459124,20.515955,20.380129,20.410412,30696662,34379563.4,51.856643159272195,56.25899760327453,NaN,NaN,17.78395773372136,33.892573476566426,-0.013414596919889693,0.07825521880416275,0.09166981572405244,-1304567198,-1245118954.4,67.41869961497514,81.78803849693978,NaN,NaN,8.245562568388056,8.430009723903554
2015-08-05T09:30:00-04:00,20.54843,20.613379,20.434768,20.491599,24786160,32777732.2,54.29895396301635,55.68481639004894,NaN,NaN,36.417007771954914,31.8111971180809,-0.011919500799933161,0.076770439724136,0.08868994052406916,-1279781038,-1259541475.6,61.55434486515209,79.91370129796516,NaN,NaN,8.299805719064937,8.41140915178375
2015-08-06T09:30:00-04:00,20.507836,20.540311,20.345462,20.41853,23935484,32411755.8,51.75422392677724,55.0433878855415,NaN,NaN,-8.299409888304485,20.470430334619543,-0.01582922572462972,0.06890340836828202,0.08473263409291173,-1303716522,-1278751093.6,54.72627470997271,77.43856261987003,NaN,NaN,7.677444191697997,8.306557014628643
2015-08-07T09:30:00-04:00,20.402293,20.48348,20.288631,20.459124,30691892,32139257.95,53.070094866871536,54.46304807505492,NaN,NaN,-36.56312407464675,5.38262014042404,-0.015631848400405685,0.06519282359240464,0.08082467199281032,-1273024630,-1286991984.8,52.058372054271445,74.68868064649429,NaN,NaN,7.482346259743103,8.188812621073566
2015-08-10T09:30:00-04:00,20.597142,20.662092,20.540311,20.653973,30183582,31587665.75,58.868979882425464,54.35144698179507,NaN,NaN,77.20824673663044,17.3093356558711,-0.0029907439231399574,0.07708624208888537,0.08007698601202533,-1242841048,-1280786087.2,53.881690723642,72.02338552815374,NaN,NaN,8.914533752532087,8.292487068424784
2015-08-11T09:30:00-04:00,20.459124,20.532192,20.386056,20.467243,65486675,33476586.15,52.21079668393372,53.54262221646341,NaN,NaN,-27.459419681982055,8.260660172730413,-0.0075574837580556775,0.07063013131445572,0.0781876150725114,-1308327723,-1281538192.2,53.61555744680321,69.30933538587918,NaN,NaN,8.264050878121042,8.288424755524249
2015-08-12T09:30:00-04:00,20.29675,20.312987,19.972002,20.280513,77554875,34244455.05,46.54190604588918,52.733117199710605,NaN,NaN,-182.426886596975,-35.50811870105557,-0.022653145953966836,0.04987118263005286,0.07252432858401969,-1385882598,-1302758504.2,46.61907720809358,66.22304635780563,NaN,NaN,5.9390346638629605,7.952797599572636
2015-08-13T09:30:00-04:00,20.329225,20.426649,20.199326,20.353581,27563810,33632404.95,48.880846773221606,52.482304346600564,NaN,NaN,-91.5262417521357,-52.15348507382182,-0.02692546062352763,0.038867502804610154,0.06579296342813779,-1358318788,-1313678957.4,43.47494089357252,63.10295257630974,NaN,NaN,4.7042715038007366,7.488722443033794
2015-08-14T09:30:00-04:00,20.329225,20.499718,20.321106,20.499718,33623082,34198564.7,53.28330744659927,52.81194565981201,NaN,NaN,-17.26963782401913,-48.294787823696296,-0.019465487503299884,0.04146110404901293,0.060926591552312816,-1324695706,-1324013172.6,40.67899097329557,60.315913346241395,NaN,NaN,4.972931896662913,7.129323793552239
2015-08-17T09:30:00-04:00,20.410412,20.54843,20.337344,20.540311,28788014,34369515.2,54.456617418332044,53.07583474162565,NaN,NaN,12.076211323087152,-61.32119490640495,-0.011734213533094076,0.04625882463594522,0.05799303816903929,-1295907692,-1334626501.4,37.97766236300194,57.542590843231,NaN,NaN,5.538180415170964,6.902017596640628
2015-08-18T09:30:00-04:00,20.515955,20.572786,20.475361,20.524074,20257540,34162166.4,53.87376669453065,52.95007481106193,NaN,NaN,53.95117768994341,-45.03907543201986,-0.00783819279146064,0.04819529717971349,0.05603348997117413,-1316165232,-1336194003.2,37.580732657593934,54.96516866426528,NaN,NaN,5.838936972720006,6.75014893608054
2015-08-19T09:30:00-04:00,20.467243,20.515955,20.260216,20.337344,57415839,35208931.2,47.568299189653374,52.373924344435544,NaN,NaN,-54.61092282993656,-19.475882678612162,-0.01741287044782784,0.03426740191138933,0.05168027235921717,-1373581071,-1333733697.8,38.66432070817364,52.488833655904706,NaN,NaN,4.244276114754458,6.392167104462528
2015-08-20T09:30:00-04:00,20.126257,20.150613,19.907052,19.907052,67771396,36768339.85,36.861745389457255,51.173786168644604,NaN,NaN,-279.90918013750695,-57.15247035568642,-0.05043267084586208,-0.011360566198110433,0.03907210464775165,-1441352467,-1350340433.6,34.33196469608808,49.69464092846857,NaN,NaN,-1.0753592272034551,5.325377628510245
2015-08-21T09:30:00-04:00,19.655373,19.801509,19.192607,19.192607,127791056,41549465.9,26.28364150037487,49.272130210025345,NaN,NaN,-386.2546898282082,-130.94948075652422,-0.1144355018398136,-0.10397227265201536,0.010463229187798243,-1569143523,-1399229997,25.332627019382755,46.27966113814421,NaN,NaN,-10.906072037930837,3.0065991047329477
2015-08-24T09:30:00-04:00,18.015395,19.022114,15.035832,18.388856,143736181,46995001.6,19.503000246183092,46.96115571623327,NaN,NaN,-479.6812146253208,-229.30096594620582,-0.19994124063815594,-0.2394633216098967,-0.039522080971740745,-1712879704,-1482624399.4,17.09904045524067,42.685399769591754,NaN,NaN,-22.91090167590964,-0.6959010067874218
2015-08-25T09:30:00-04:00,19.04647,19.062708,18.064108,18.129057,84986624,49759598.45,17.895912082841107,44.360938439077884,NaN,NaN,-218.4249479479618,-283.7761910737869,-0.2592727809480795,-0.3636130571568401,-0.10434027620876062,-1797866328,-1578964618.6,12.175713645722041,39.15835468248961,NaN,NaN,-32.18454281188721,-5.194278407515963
2015-08-26T09:30:00-04:00,18.551229,18.811028,18.211218,18.811028,146142399,55411173.8,33.408092490672175,43.0505004793561,NaN,NaN,-151.32977924944336,-303.1199623576882,-0.2383960869733519,-0.4023353849254505,-0.1639392979520986,-1651723929,-1634593190.2,10.326760189079423,35.98696078814009,NaN,NaN,-32.562213748430004,-9.103983456217968
2015-08-27T09:30:00-04:00,19.054589,19.312764,18.900334,19.273794,96276535,59194495.5,41.486804093757556,42.22312256699082,NaN,NaN,-78.9160678034988,-262.9213398908866,-0.18178661452834816,-0.3911725661125338,-0.20938595158418566,-1555447394,-1657412175.6,9.677557347351339,32.9597597376458,NaN,NaN,-29.221926592221596,-11.977975332789914
2015-08-28T09:30:00-04:00,19.200725,19.249438,19.062708,19.184488,40372052,60005511,40.46652167442018,40.90866126641901,NaN,NaN,-68.04741146249496,-199.27988421774398,-0.1405657077183997,-0.3850930862321853,-0.2445273785137856,-1595819446,-1662747360.2,9.526758069914607,29.791550262379552,NaN,NaN,-27.285350293252186,-14.164743184284523
2015-08-31T09:30:00-04:00,19.062708,19.143895,19.005877,19.022114,58879759,60846980.85,38.60742573437975,39.936991912879435,NaN,NaN,-68.37828633370435,-117.01929855942066,-0.11549357515016379,-0.3888943474514903,-0.27340077230132653,-1654699205,-1651111260.4,12.721128658247238,26.87051963462555,NaN,NaN,-26.524235694970706,-15.930384971525406
2015-09-01T09:30:00-04:00,18.616179,18.713603,18.267075,18.405093,86345244,63629409.95,32.49764107799328,38.93383012945831,NaN,NaN,-104.65446259874612,-94.26520148957754,-0.13060878022383732,-0.4366617475811232,-0.3060529673572859,-1741044449,-1639746884.6,15.846212306013044,24.67245785590551,NaN,NaN,-28.252494811880023,-17.69068637729035
2015-09-02T09:30:00-04:00,18.648654,18.705485,18.413293,18.656773,52564549,65018329.4,36.885169307142355,38.076996024738364,NaN,NaN,-83.15649649618473,-80.6305449389258,-0.11438411374106694,-0.4490331095336195,-0.3346489957925526,-1688479900,-1647098078.8,15.460578362209574,22.671431960808153,NaN,NaN,-27.942257057250558,-19.155196474427523
2015-09-03T09:30:00-04:00,18.713603,18.953105,18.681129,18.762316,60309043,66837007.35,38.68500590020602,37.034260199995984,NaN,NaN,-59.918420066469906,-76.83101539152004,-0.08843216415251576,-0.44518920098319725,-0.3567570368306815,-1628170857,-1661642771.4,14.69840906837375,20.815676110456593,NaN,NaN,-27.0789685279684,-20.28716391064765
2015-09-04T09:30:00-04:00,18.494399,18.551229,18.267075,18.388856,54241988,68014512.15,34.89323386958783,35.63687566079998,NaN,NaN,-83.2064602127207,-79.8628251415652,-0.0881110836746054,-0.4668958914239383,-0.3787848077493329,-1682412845,-1678961451.2,13.824492774485705,19.090449711276865,NaN,NaN,-27.67563547141406,-21.342659847899995
2015-09-08T09:30:00-04:00,18.746078,18.875977,18.616179,18.85974,49755494,68993107.75,42.540650960527394,34.82736739408546,NaN,NaN,-47.7785952232166,-75.74288691946762,-0.049786882450815195,-0.44101841081285187,-0.3912315283620367,-1632657351,-1674553080.4,15.206499288172296,17.492290184889605,NaN,NaN,-25.456219503357875,-21.93031122725112
2015-09-09T09:30:00-04:00,19.030233,19.11142,18.559348,18.599942,43767452,67907146.6,39.76541015758372,34.27001817750905,NaN,NaN,-45.326687308393126,-63.87733186139703,-0.03616902319985621,-0.4364428073618569,-0.4002737841620007,-1676424803,-1661629151.2,19.292883604144322,16.108616106030365,NaN,NaN,-24.631942008226453,-22.31625848167617
2015-09-10T09:30:00-04:00,18.583704,18.827265,18.527117,18.689247,43679180,66213361.85,41.185786689094805,34.57887827034031,NaN,NaN,-47.832206048934765,-56.81247377194703,-0.01638911672861154,-0.42076018007276517,-0.4043710633441536,-1632745623,-1650482295.8,22.750789524072275,15.281389308029238,NaN,NaN,-23.52662452138343,-22.489167915920063
2015-09-11T09:30:00-04:00,18.599942,18.770434,18.559348,18.770434,26825740,66176458.35,42.5129457843649,35.73811429062531,NaN,NaN,-41.6607696172924,-53.160943682111544,0.005735428496978556,-0.3972017777229304,-0.40293720621990897,-1605919883,-1646032101,24.148056495714656,15.19677712776723,NaN,NaN,-22.235422425188776,-22.45291856010131
2015-09-14T09:30:00-04:00,18.729841,18.782612,18.657584,18.729841,31856084,66088108.45,42.00259805356708,37.345228419724165,NaN,NaN,-34.27044327158051,-43.3737402938835,0.020384955349370182,-0.37745601203319623,-0.3978409673825664,-1637775967,-1637104725.4,27.000611546048674,15.904032205682089,NaN,NaN,-21.343226751342325,-22.294391158850026
2015-09-15T09:30:00-04:00,18.802909,19.054589,18.729841,18.997758,41072404,66702327.95,46.562204209369575,39.39282071447621,NaN,NaN,-3.0333322145241337,-34.424687692145014,0.04922325912350439,-0.3363118934781859,-0.3855351526016903,-1596703563,-1629913967.8,29.306726434035056,17.12767597627587,NaN,NaN,-19.220009340984124,-21.855193756297755
2015-09-16T09:30:00-04:00,19.013995,19.152013,18.912512,19.119538,28024864,67090694.15,48.5424903047515,40.473849129767586,NaN,NaN,29.875410167804933,-19.384268196905374,0.07600475015131847,-0.29052921491254224,-0.3665339650638607,-1568678699,-1608364747,35.84733317846491,18.950574046946265,NaN,NaN,-16.87755678241459,-21.14410276002873
2015-09-17T09:30:00-04:00,19.103301,19.2332,18.811028,18.851621,75265703,67983187.35,44.62451332453972,40.6979712176806,NaN,NaN,32.3277822145694,-3.352270544204542,0.0750503584463007,-0.27272101700598483,-0.34777137545228554,-1643944402,-1610604502.8,35.47990188855786,20.793598657032444,NaN,NaN,-15.972275998541214,-20.405270365530512
2015-09-18T09:30:00-04:00,18.502517,18.591742,18.364499,18.396974,85341058,68861670.45,38.88838939486178,40.585247483426436,NaN,NaN,-66.98197072603993,-8.416510765954046,0.044673956255223524,-0.29192893013325616,-0.3366028863884797,-1729285460,-1635277618.2,31.633343052556782,22.37264044150689,NaN,NaN,-16.9315611979916,-19.909026198739237
2015-09-21T09:30:00-04:00,18.518755,18.677881,18.48628,18.60806,47125095,64828372.4,42.578898939288486,40.86892414091991,NaN,NaN,-26.215507448119432,-6.805523601261832,0.03983249289143459,-0.28681227027418643,-0.326644763165621,-1682160365,-1644154497.8,30.358120815494473,23.632425595595976,NaN,NaN,-16.603825669650014,-19.436854694583634
2015-09-22T09:30:00-04:00,18.332025,18.434726,18.234681,18.372618,65374415,60910284.1,39.6991600422468,41.3833183526523,NaN,NaN,-123.43421958940509,-30.885701076238025,0.022662471902529346,-0.29831667328745937,-0.3209791451899887,-1747534780,-1674320741.2,26.45513985514347,24.390206134819575,NaN,NaN,-17.20699276026015,-19.118302989680277
2015-09-23T09:30:00-04:00,18.380737,18.445686,18.275194,18.380737,34911677,58406536.75,39.85023618871259,41.595108844193035,NaN,NaN,-114.97487253481873,-59.85575761676275,0.014157072369884394,-0.30328280472763325,-0.31743987709751764,-1712623103,-1703109622,23.367528918711656,24.95498831742687,NaN,NaN,-17.64719425482213,-18.908144598986254
2015-09-24T09:30:00-04:00,18.169651,18.279253,18.088464,18.250838,51301203,53664476.95,38.201173407766944,41.56054938044739,NaN,NaN,-145.99417410355332,-95.5201488803873,0.002688103646023232,-0.3140797475399886,-0.3167678511860118,-1763924306,-1727105602.8,21.151607777274663,25.41593108234836,NaN,NaN,-18.485715645709412,-18.84779760566099
2015-09-25T09:30:00-04:00,18.510636,18.640535,18.429449,18.518755,55448805,51623090.45,43.4032520635776,42.16840782287523,NaN,NaN,-45.99816994493278,-91.32338872416587,0.015344410476388404,-0.2975873380905263,-0.3129317485669147,-1708475501,-1722943611,22.523931231695983,26.037319543577667,NaN,NaN,-17.721873663786507,-18.68695132825035
2015-09-28T09:30:00-04:00,18.388856,18.42133,18.031633,18.088464,58457299,52527352.8,37.88711669547639,41.836012518228735,NaN,NaN,-138.28055399705238,-113.73639803395244,-0.002134468311848048,-0.31559983395672475,-0.3134653656448767,-1766932800,-1739898098,20.926137082452243,26.44586510031195,NaN,NaN,-18.720555752539692,-18.691751960291683
2015-09-29T09:30:00-04:00,18.104701,18.17371,17.958564,18.120938,48292688,51997999.25,38.52213989820069,41.74720749970137,NaN,NaN,-150.72403149987946,-119.19436041604732,-0.008047779840080871,-0.3235250904449778,-0.3154773106048969,-1718640112,-1734119164.4,22.932887920620956,26.705865408631706,NaN,NaN,-19.340674591941763,-18.784455193384552
2015-09-30T09:30:00-04:00,18.364499,18.396974,18.177769,18.396974,49115649,50136519.5,43.78337042067562,41.932749194814285,NaN,NaN,-73.3369211873447,-110.86677014655251,0.009159868042487307,-0.3040274755517878,-0.3131873435942751,-1669524463,-1725499436.4,25.951499986565864,26.934487584524106,NaN,NaN,-18.319520640195684,-18.718035971500427
2015-10-01T09:30:00-04:00,18.388856,18.478161,18.210244,18.405093,48541552,49935369.65,43.935347893855536,42.03434934549218,NaN,NaN,-55.73589653677707,-92.81511463319728,0.022838517790878532,-0.2846391963556769,-0.30747771414655545,-1620982911,-1696911157.4,35.0394704838254,27.712445726532017,NaN,NaN,-17.449688378567004,-18.536843458224222
2015-10-02T09:30:00-04:00,18.007277,18.429449,17.844903,18.429449,75390449,50689439.95,44.42076501167883,42.20707555678588,NaN,NaN,-83.77261820145043,-100.37000428450081,0.034572356259716996,-0.2642622688219092,-0.29883462508162617,-1545592462,-1664334549.6,43.5425192343113,28.89401056140792,NaN,NaN,-16.59837802738434,-18.259919825247096
2015-10-05T09:30:00-04:00,18.559348,18.843503,18.54717,18.819147,48003714,50377526.25,51.63606625896628,42.56949427461422,NaN,NaN,51.20972443932129,-62.47194859722606,0.06770859303529264,-0.2141988837875104,-0.28190747682280304,-1497588748,-1610465739.2,54.21498325056741,30.6731717625888,NaN,NaN,-13.705661914093847,-17.609311552225204
2015-10-06T09:30:00-04:00,18.778553,18.843503,18.697366,18.729841,36706540,49725078.55,50.03305680057676,42.675963310030305,NaN,NaN,57.49844825873241,-20.82745264550369,0.08179914433047852,-0.1796585464097049,-0.26145769074018343,-1534295288,-1573596774.4,59.81416361788727,32.385088222547544,NaN,NaN,-11.737288959525753,-16.77045118183957
2015-10-07T09:30:00-04:00,18.851621,18.981521,18.73796,18.875977,38619739,49467692.9,52.62481859011869,43.24741368614309,NaN,NaN,84.10896029074704,10.661723650114661,0.09805250056873555,-0.138892065029264,-0.23694456559799953,-1495675549,-1538826991.6,64.25388435799599,34.440372684650264,NaN,NaN,-9.317446342878249,-15.705736204845095
2015-10-08T09:30:00-04:00,18.802909,19.005877,18.762316,18.989639,37258883,49146678.05,54.59740370028082,44.36948613653016,NaN,NaN,91.14258186781879,40.03741933103383,0.11251353695581776,-0.09630264440322733,-0.2088161813590451,-1458416666,-1506313742.6,67.83270741767282,37.02604156787284,NaN,NaN,-6.706251748761742,-14.42009556826176
2015-10-09T09:30:00-04:00,19.030233,19.04647,18.782612,18.867859,58373495,50724065.8,52.09462120650489,45.04918058418848,NaN,NaN,80.22870200304365,72.83768337193266,0.10981131104561637,-0.07155204255202463,-0.181363353597641,-1516790161,-1500553282.4,68.43566874341755,39.74586641986735,NaN,NaN,-5.14941918239129,-13.09571322742312
2015-10-12T09:30:00-04:00,18.85974,18.916571,18.811028,18.884096,25327059,50397614.55,52.407878138282726,45.956946162476754,NaN,NaN,69.41404565230845,76.47854761453007,0.10505078029926115,-0.05004987822356455,-0.1551006585228257,-1491463102,-1499328153.2,68.57060243388251,42.75411374692013,NaN,NaN,-3.7697359103623733,-11.7634307535573
2015-10-13T09:30:00-04:00,18.819147,18.939872,18.73796,18.73796,42476982,50467843.45,49.28424090052769,46.63080364189212,NaN,NaN,56.321675238718385,76.24319301052728,0.08864800134076567,-0.044290656846868615,-0.13293865818763428,-1533940084,-1499257112.4,68.5789903596394,45.983503849843544,NaN,NaN,-3.38718992917923,-10.56682492150329
2015-10-14T09:30:00-04:00,18.746078,18.778553,18.559348,18.583704,44790195,51306110,46.15693401488758,47.199072256686456,NaN,NaN,22.47460375031467,63.916321702440804,0.06508770137114146,-0.05157903147370746,-0.11666673284484892,-1578730279,-1515868058.4,64.26048254389893,49.0627091903167,NaN,NaN,-3.8995539866976805,-9.614357645102489
2015-10-15T09:30:00-04:00,18.689247,19.030233,18.67301,19.005877,55685218,50327085.75,54.64025839707709,48.00171556622214,NaN,NaN,95.06951925133421,64.70170917914388,0.0749142798513622,-0.023023883030646175,-0.09793816288200838,-1523045061,-1528793737.4,61.039437282587265,51.813816765380366,NaN,NaN,-1.8617085643873832,-8.506836347857474
2015-10-16T09:30:00-04:00,19.062708,19.152013,19.022114,19.119538,36563792,47888222.45,56.62184505248533,49.33991044886564,NaN,NaN,129.3611546280964,74.52819970415443,0.08529272155394307,0.008677739060420464,-0.07661498249352261,-1486481269,-1522731959,62.001386116688394,54.74776312496867,NaN,NaN,0.42762854614331974,-7.230484220143075
2015-10-19T09:30:00-04:00,18.997758,19.143895,18.989639,19.103301,32709547,47167445.05,56.24384098754348,50.60574624096155,NaN,NaN,109.2968371209919,82.50475799789112,0.08698881910936959,0.03212104139318939,-0.054867777716180205,-1519190816,-1528277501.8,60.52900918149493,57.43320035788823,NaN,NaN,2.1935003978567913,-5.884200703285951
2015-10-20T09:30:00-04:00,19.103301,19.241319,19.087064,19.216963,23955523,45096500.45,58.34046730801579,51.64553887577157,NaN,NaN,120.09823816764836,95.26007058367712,0.09124566491926281,0.0591893034328983,-0.0320563614863645,-1495235293,-1520536543.6,61.88950599628244,60.0002007871537,NaN,NaN,4.292136418170533,-4.430438257363596
2015-10-21T09:30:00-04:00,19.241319,19.306269,19.04647,19.078945,29232425,44812537.85,54.90043332045805,52.428759263386034,NaN,NaN,101.8099258890218,111.12713501141855,0.080614790276581,0.06871212635936175,-0.01190266391721925,-1524467718,-1509684031.4,63.77468219914779,62.052715909676735,NaN,NaN,5.156432737745915,-3.060885258062237
2015-10-22T09:30:00-04:00,19.119538,19.460524,19.11142,19.387456,61240297,45309492.55,60.50627168257646,53.57772402559301,NaN,NaN,132.64542236577103,118.64231563430592,0.08952256908585825,0.10000054744010356,0.010477978354245316,-1463227421,-1497720503.4,65.78400719786035,63.64139362135881,NaN,NaN,7.612409328927404,-1.5361288884922886
2015-10-23T09:30:00-04:00,19.541711,19.60666,19.452405,19.598542,45930459,44833575.25,63.819953347341155,54.448001674762644,NaN,NaN,164.30629788292765,125.63134428527216,0.10378836092667723,0.14021342951259186,0.03642506858591463,-1417296962,-1483883642,67.99514996020905,64.62569124347607,NaN,NaN,10.75051302320153,0.21910567032111405
2015-10-26T09:30:00-04:00,19.598542,19.598542,19.444286,19.517355,24500137,43135717.15,61.676499606804505,55.279676160921774,NaN,NaN,146.91933326765403,133.1558435146046,0.1017758804265487,0.1636449191191005,0.06186903869255181,-1441797099,-1468404898.6,70.30682640879456,65.3751671571123,NaN,NaN,12.719337364179175,2.00485305515798
2015-10-27T09:30:00-04:00,19.41993,19.444286,19.338743,19.403693,28681020,42155133.75,58.70388922087832,55.713895491690316,NaN,NaN,108.92306262840059,130.92080840675504,0.08736154528782067,0.17107097030232765,0.08370942501450698,-1470478119,-1463453463.8,71.02772454823629,65.85901288498661,NaN,NaN,13.522030712395877,3.6501641490491084
2015-10-28T09:30:00-04:00,19.444286,19.890815,19.444286,19.85834,112124178,45305560.2,65.80362333473701,56.5143397512943,NaN,NaN,161.53626669075237,142.86607656710117,0.10199862926542165,0.21120771159628404,0.10920908233086239,-1358353941,-1430230708.4,75.3517872998699,66.39609001942925,NaN,NaN,16.556836880983365,5.49397453932543
2015-10-29T09:30:00-04:00,19.850221,19.931409,19.7325,19.833984,48508110,45303888.1,65.15735526466636,57.447392184020124,NaN,NaN,162.4792184453607,148.8328357830191,0.10327595186692917,0.23830402216452384,0.13502807029759467,-1406862051,-1418957634.4,76.62653398925576,66.98115182270342,NaN,NaN,18.773498387307054,7.391049374751376
2015-10-30T09:30:00-04:00,19.785272,19.80159,19.525474,19.54983,62904600,44679595.65,58.000428316921656,57.8468600539229,NaN,NaN,106.75950268988319,137.32347674441021,0.07929758728866351,0.23415005440842407,0.15485246711976056,-1469766651,-1429451572.2,72.849541727633,67.2867903436856,NaN,NaN,18.469488203927316,8.973683493205082
2015-11-02T09:30:00-05:00,19.598542,19.898934,19.590423,19.817747,73574757,45958147.8,62.21465339911054,58.77046094667882,NaN,NaN,120.14036378658597,131.9676828481966,0.07579757900344014,0.24959944087406072,0.17380186187062058,-1396191894,-1420330531.2,74.04695966751113,67.67735957996214,NaN,NaN,19.5522493735151,10.484907190392226
2015-11-03T09:30:00-05:00,19.809628,19.915171,19.720322,19.850221,42504200,46248030.8,62.70315407706833,59.95233380826316,NaN,NaN,115.8933267708748,133.3617356766914,0.07011830369176103,0.26144974148532185,0.19133143779356082,-1353687694,-1396972446.2,76.86134880185199,68.57742145553023,NaN,NaN,20.562341755936313,11.924540699755667
2015-11-04T09:30:00-05:00,19.850221,19.898934,19.73656,19.793391,40124168,46323252.25,61.21172390667534,60.421724201805894,NaN,NaN,100.01087662620017,121.05665766378097,0.05751183657655798,0.2632212335142583,0.20570939693770032,-1393811862,-1404064030.4,74.22948703141216,69.51956786616057,NaN,NaN,20.952047852611955,13.214184578735136
2015-11-05T09:30:00-05:00,19.793391,19.907052,19.760997,19.874578,45263419,46723479.05,62.58102497018831,60.84737991021325,NaN,NaN,96.56038195640781,107.87289036599036,0.049901233076402346,0.26808593828320326,0.21818470520680092,-1348548443,-1392401308.8,75.70298430586996,70.49825345110212,NaN,NaN,21.66575505511707,14.421551789646841
2015-11-06T09:30:00-05:00,20.248038,20.272394,20.000417,20.077545,85606494,48085129,65.82877528698481,61.53201807445906,NaN,NaN,132.15022823520405,112.95103547505455,0.05347888061115602,0.28503330597074594,0.23155442535958992,-1262941949,-1351036368.4,80.05818468142412,71.89319455823991,NaN,NaN,23.23919920424016,15.681215706017316
2015-11-09T09:30:00-05:00,20.101901,20.150613,19.744678,19.85834,59204182,49778985.15,59.792776120179944,61.635754418185066,NaN,NaN,87.0870053981954,106.34036379737645,0.03681764099078491,0.27757647659807105,0.24075883560728614,-1322146131,-1336227215.8,81.34726566085405,73.28303453428074,NaN,NaN,22.802248337272037,16.698506081910846
2015-11-10T09:30:00-05:00,19.809628,19.955765,19.777153,19.947646,41143474,49712309.75,61.347749802494704,62.096277024044824,NaN,NaN,76.92206037522777,98.54611051824705,0.027949005137067162,0.2756950920286201,0.24774608689155292,-1281002657,-1321690208.4,82.5403741346143,74.62344110109977,NaN,NaN,22.889420287092054,17.582922396936734
2015-11-11T09:30:00-05:00,20.036952,20.036952,19.866459,19.882696,27592589,48852429.45,59.54414565947307,62.027553736680304,NaN,NaN,79.21388167874319,94.38671152875564,0.014521571916571885,0.2658980517872678,0.2513764798706959,-1308595246,-1304646885.2,83.84506213749536,75.91351645393084,NaN,NaN,22.445976499240487,18.277644411551556
2015-11-12T09:30:00-05:00,19.833984,19.842103,19.574186,19.582304,66636658,49400001.45,51.938655938008836,61.17888963601371,NaN,NaN,13.603243967765001,77.79528393102709,-0.016117794942001662,0.2312292361931938,0.24734703113519546,-1375231904,-1309983577.4,81.7842242363093,76.89845033079514,NaN,NaN,19.712999894663223,18.48269519485322
2015-11-13T09:30:00-05:00,19.48488,19.622898,19.3631,19.41993,53909500,50267286.85,48.344106479765685,60.22657584122522,NaN,NaN,-45.293609403335616,42.30651640331915,-0.047094380074727965,0.1884790560417855,0.23557343611651346,-1429141404,-1343223468.4,70.20895799890019,76.8914597300884,NaN,NaN,16.278580050936444,18.16782160286511
2015-11-16T09:30:00-05:00,19.3631,19.655373,19.322506,19.655373,53592047,51311411.85,53.38212967862429,59.846450159635644,NaN,NaN,-34.356399601543735,18.01783540337133,-0.05116339412429294,0.1716191934611473,0.22278258758544023,-1375549357,-1353904113.6,66.93094272191843,76.59883245677999,NaN,NaN,14.833246144984166,17.69145368031069
2015-11-17T09:30:00-05:00,19.73656,19.793391,19.574186,19.614779,46040273,52415649.35,52.43261313639047,58.8913780026109,NaN,NaN,-6.304623769773583,1.3724985743710565,-0.05565338420773988,0.15321585732576537,0.20886924153350525,-1421589630,-1382021508.2,59.10709591464166,75.4384973578351,NaN,NaN,13.380664158610115,17.075626605782038
2015-11-18T09:30:00-05:00,19.728441,19.988239,19.663491,19.963883,83622012,55135128.7,59.16031428694003,58.463017932773305,NaN,NaN,62.16534616202534,-2.037208528972512,-0.03517539993948665,0.16489999160914692,0.20007539154863357,-1337967618,-1387895982.6,57.59236009575323,74.07891350829922,NaN,NaN,14.186944010024005,16.66295766353089
2015-11-19T09:30:00-05:00,19.972002,20.036952,19.898934,19.996358,35634060,53854816.85,59.730883737028705,58.58662189135237,NaN,NaN,97.67246048404081,14.77663477428265,-0.020247814056449487,0.17476562397807172,0.1950134380345212,-1302333558,-1373316313.4,60.310877446518006,73.18329463107672,NaN,NaN,15.00435655805202,16.42601464846248
2015-11-20T09:30:00-05:00,20.053189,20.11002,19.967943,20.028833,44215290,53769058.4,60.327777901869105,58.45184507012085,NaN,NaN,112.09353248414082,46.25406315177794,-0.009535490206885738,0.18309407527591404,0.19262956548279977,-1258118268,-1339111686.2,65.84297596249016,72.59729579500379,NaN,NaN,15.842967551588869,16.342722206051963
2015-11-23T09:30:00-05:00,20.020714,20.085664,19.92329,19.947646,31847553,54136429.2,58.01267579918131,58.116810907414624,NaN,NaN,84.44402804647285,70.01414868138126,-0.009258678648012192,0.18105621717278453,0.19031489582079672,-1289965821,-1321994979,68.2294830726961,71.98073395720694,NaN,NaN,15.897146908071658,16.279068592054777
2015-11-24T09:30:00-05:00,19.825865,19.955765,19.720322,19.890815,35938040,54499280.2,56.381601605248676,57.77180217159844,NaN,NaN,19.546004213609333,75.18427427805784,-0.013961709521372767,0.17286275891908076,0.18682446844045353,-1325903861,-1302857825.2,70.69478140232097,71.72825498370044,NaN,NaN,15.493154765506766,16.166795188262203
2015-11-25T09:30:00-05:00,19.898934,19.947646,19.850221,19.907052,24240345,50105088.55,56.755699164818,57.35570747121484,NaN,NaN,40.06758299671071,70.76472164499492,-0.01684461788592087,0.16576869608305245,0.18261331396897332,-1301663516,-1295597004.8,71.59537185584853,71.43485409441318,NaN,NaN,15.254475018959845,16.03646373550472
2015-11-27T09:30:00-05:00,19.939527,19.980121,19.842103,19.955765,23204878,48839926.95,57.92169543752184,56.79091605339606,NaN,NaN,49.20933251176244,61.072096050539244,-0.016324647161705674,0.16220750501684122,0.1785321521785469,-1278458638,-1290822020.8,72.200422160896,70.87358534294688,NaN,NaN,15.351843443623379,15.93866083666453
2015-11-30T09:30:00-05:00,20.020714,20.020714,19.907052,19.939527,30378975,47213645.7,57.366432775197794,56.61760581446875,NaN,NaN,60.35783496129968,50.72495654597101,-0.01780688938355235,0.15627354044910646,0.1740804298326588,-1308837613,-1300965889.8,68.8454124842228,69.98059583033037,NaN,NaN,15.29456637283537,15.846647341831792
2015-12-01T09:30:00-05:00,20.012595,20.166851,19.972002,20.158732,38290817,45449448.7,62.581355303518045,56.70572049311328,NaN,NaN,126.64428914000939,59.165008764678305,-0.005400370579029701,0.16732996660887167,0.17273033718790137,-1270546796,-1297082084.8,69.43110840579533,69.0442197068433,NaN,NaN,16.6576827371506,15.962509541163051
2015-12-02T09:30:00-05:00,20.207444,20.207444,19.882696,19.92329,43872366,45517857,54.82444768075879,56.368599208919406,NaN,NaN,69.25397304960036,69.1066025318765,-0.013941216514508303,0.155303816544766,0.1692450330592743,-1314419162,-1294785145,69.79279928351622,68.0404866458448,NaN,NaN,15.662281108164692,15.919619765020428
2015-12-03T09:30:00-05:00,20.036952,20.036952,19.533592,19.598542,59343470,46478822.1,46.29990672851462,55.96583140824124,NaN,NaN,-73.90828201890447,46.31142952875347,-0.04083126502655271,0.1182059517760834,0.1590372168026361,-1373762632,-1309204968.2,64.6233714005102,66.81471144328772,NaN,NaN,12.001524808016626,15.359891914019885
2015-12-04T09:30:00-05:00,19.720322,20.150613,19.667551,20.118139,52578423,46844572.3,57.64702314226339,56.630325455562506,NaN,NaN,51.38577208612012,46.74671744362501,-0.023835429385327844,0.12924293007097631,0.15307835945630416,-1321184209,-1317750082.4,61.70657622642117,66.20739845953922,NaN,NaN,12.593978717375911,14.96476145735646
2015-12-07T09:30:00-05:00,20.093783,20.11002,19.83642,19.931409,31399621,44134228.65,53.28908668932925,56.62367952775572,NaN,NaN,47.40902205095652,44.15695486155638,-0.025245534822652294,0.12152144092798878,0.14676697575064107,-1352583830,-1326499325.8,58.781133573146754,65.62526923462694,NaN,NaN,11.52321302807883,14.473111681745369
2015-12-08T09:30:00-05:00,19.712204,19.85834,19.631017,19.679729,35718813,42959960.2,48.01988945724266,56.308484979245165,NaN,NaN,-65.95177823361348,5.637741386831806,-0.042205625073012565,0.09400994440937538,0.13621556948238794,-1388302643,-1350050495.2,51.67882653146511,65.09467856440004,NaN,NaN,8.759904241574096,13.65693919029233
2015-12-09T09:30:00-05:00,19.590423,19.805569,19.338743,19.452405,66664013,44235987.15,43.806549588956265,55.21178750081775,NaN,NaN,-131.39639207186846,-34.49233163746196,-0.0663725304179675,0.05324990645992855,0.11962243687789606,-1454966656,-1378159994,44.73174167317449,64.17606296278728,NaN,NaN,5.007517699234041,12.421307548712575
2015-12-10T09:30:00-05:00,19.444286,19.655373,19.380149,19.468643,58195554,45766135.4,44.183289392563616,54.101245047641676,NaN,NaN,-122.31504786485755,-44.173684806652574,-0.0780948244755442,0.022003906283465824,0.10009873075901002,-1396771102,-1382761688,43.69616420590842,62.98929773131516,NaN,NaN,2.251796049558812,10.968520191690608
2015-12-11T09:30:00-05:00,19.176369,19.29815,18.932808,19.038351,89594704,46914037.7,37.087526498005275,52.44122709022283,NaN,NaN,-224.94012370184257,-99.43886396424512,-0.10972108276826467,-0.037052622701320814,0.07266846006694386,-1486365806,-1415798007.4,37.06241430255231,60.93354332703389,NaN,NaN,-2.7353623031026943,9.010822692434422
2015-12-14T09:30:00-05:00,19.054589,19.208844,18.869564,19.078945,71991225,47818123.95,38.09755152701101,51.01871821363925,NaN,NaN,-205.50772908512727,-150.02221419146187,-0.12186393853372482,-0.07966146310021216,0.04220247543351265,-1414374581,-1428156157.6,34.926344644698176,58.55474772503404,NaN,NaN,-6.262892121946526,6.828863433237144
2015-12-15T09:30:00-05:00,19.273794,19.631017,19.257556,19.525474,93387874,49807915.3,47.98906108332902,50.41925103350212,NaN,NaN,-82.74380601119636,-153.38061974697843,-0.09497485055870528,-0.07651608776486896,0.018458762793836327,-1320986707,-1414692970.4,39.0477963460107,56.29424879244045,NaN,NaN,-5.953713650171609,5.002780992750179
2015-12-16T09:30:00-05:00,19.704085,19.907052,19.517355,19.842103,102265448,52619174.05,53.64537521632232,50.197085037181004,NaN,NaN,-4.180561834520445,-127.93745369950884,-0.053104314479377315,-0.04792163030538532,0.005182684173991998,-1218721259,-1367443891,50.82012947183849,54.81030290786831,NaN,NaN,-3.6682154993080056,3.764067208170439
2015-12-17T09:30:00-05:00,19.915171,19.915171,19.533592,19.557948,70955030,51985824.95,48.543187707359856,49.527191627883724,NaN,NaN,-26.12254309135626,-108.69895274480857,-0.042258215520644404,-0.04764008522681351,-0.005381869706169103,-1289676289,-1346024928.4,55.057711155079375,53.585823550309975,NaN,NaN,-3.591272753000079,2.7133043565746506
2015-12-18T09:30:00-05:00,19.29815,19.322506,18.916571,18.916571,113665645,55887404.2,39.427897333828604,48.24586766778592,NaN,NaN,-167.9188954875429,-97.29470710194865,-0.07412696161876017,-0.09804057172961933,-0.02391361011085915,-1403341934,-1329420154,58.073743656688826,52.81641863405754,NaN,NaN,-7.038164926617919,1.3202373161185692
2015-12-21T09:30:00-05:00,19.070826,19.168251,18.93289,19.103301,50757950,56214537.2,42.79577070038708,46.83261162470514,NaN,NaN,-137.76793185202536,-83.74674765532828,-0.07808112827245058,-0.12151502045142237,-0.0434338921789718,-1352583984,-1317062034.6,60.21376341118089,52.15803684872794,NaN,NaN,-8.45097398180762,-0.07565001215660061
2015-12-22T09:30:00-05:00,19.216963,19.322506,19.04647,19.281912,57121342,57478226.65,45.89463273430417,46.194767699958376,NaN,NaN,-90.16750320099923,-85.23148709328885,-0.06467186630272513,-0.12427372505737821,-0.059601858754653084,-1295462642,-1311957221.6,61.097099180796704,51.536915412819404,NaN,NaN,-8.470116237962428,-1.2748594729860043
2015-12-23T09:30:00-05:00,19.403693,19.541711,19.342803,19.509236,40651801,57713914.7,49.63428224126803,46.432937379440766,NaN,NaN,-31.526465277136154,-90.70066778181202,-0.03782632920493317,-0.10688477026081955,-0.06905844105588638,-1254810841,-1319175138,59.09912131159822,51.14232612075426,NaN,NaN,-7.201399555248919,-2.121508056166421
2015-12-24T09:30:00-05:00,19.533592,19.598542,19.444286,19.492999,13852776,57194536.25,49.37179111951858,45.84184937781613,NaN,NaN,-17.323912369678595,-88.94094163747647,-0.01942376273694371,-0.09333814447706601,-0.0739143817401223,-1268663617,-1314972603.6,59.920932044123184,51.014780107732975,NaN,NaN,-6.303766586826052,-2.718973560546368
2015-12-28T09:30:00-05:00,19.411812,19.48488,19.315037,19.476761,16756894,56872137.05,49.09217860298918,45.54207022879184,NaN,NaN,-32.613882852443844,-61.87993911045667,-0.007233572768611057,-0.08295634770088611,-0.07572277493227506,-1285420511,-1291388319,64.26083203194068,51.40618714050396,NaN,NaN,-5.674050564847478,-3.1411274183036695
2015-12-29T09:30:00-05:00,19.639135,19.704085,19.574186,19.679729,38062634,57256320,52.69825255507509,45.876239021494165,NaN,NaN,26.574748088324593,-29.011403122386685,0.01442949165235452,-0.057685910366831905,-0.07211540201918643,-1247357877,-1270343097.6,67.62928069769288,52.54550529523452,NaN,NaN,-4.052811527291481,-3.271368005301928
2015-12-30T09:30:00-05:00,19.639135,19.67161,19.509236,19.541711,19350541,56309306.2,50.09943503258304,46.325730838896085,NaN,NaN,14.943960102513438,-7.989110461684144,0.019100538981902823,-0.04823972829180789,-0.06734026727371072,-1266708418,-1264592252.8,68.5028934930462,54.243444710939634,NaN,NaN,-3.4509126866958075,-3.2970172455010536
2015-12-31T09:30:00-05:00,19.346862,19.574186,19.306269,19.346862,59189547,57075165.25,46.605132868955465,46.49871965863836,NaN,NaN,-25.277748865297546,-6.739367179316391,0.00920609952466428,-0.05583264286788037,-0.06503874239254465,-1325897965,-1278809677.6,63.91075911357038,55.687344347201204,NaN,NaN,-3.9626625289027806,-3.3921094288441576
2016-01-04T09:30:00-05:00,18.949046,18.989639,18.754197,18.973402,93442413,58780112.4,40.73998355157098,46.759609448178765,NaN,NaN,-152.2720556747431,-33.72899584032929,-0.02071854131918127,-0.09093691904152124,-0.07021837772233996,-1419340378,-1308945029.8,55.42905425620229,56.99924720103335,NaN,NaN,-6.257935465947781,-3.8015131484303892
2016-01-05T09:30:00-05:00,19.005877,19.103301,18.875977,19.04647,52127228,58757552.65,42.270750390653234,47.05769508129607,NaN,NaN,-108.35270293993429,-48.87675985782739,-0.03308542968574191,-0.11157516482951735,-0.07848973514377544,-1367213150,-1325303557.6,51.438356027430196,58.178676585514204,NaN,NaN,-7.664492412943398,-4.3533673290751045
2016-01-06T09:30:00-05:00,18.766375,18.867859,18.656773,18.754197,77294064,61052274.8,38.03810126013298,46.34691223678207,NaN,NaN,-150.28510506148493,-84.24873048778929,-0.05703896695629637,-0.1497884438391459,-0.09274947688284954,-1444507214,-1364733425,43.338912014135246,58.485184847523094,NaN,NaN,-10.207098885819141,-5.189614694324252
2016-01-07T09:30:00-05:00,18.364499,18.534992,18.153413,18.226482,92061092,63869388.75,31.839018821775426,44.78931535145729,NaN,NaN,-215.9329258867046,-130.42410768563292,-0.10189446234518981,-0.2201175548143368,-0.118223092469147,-1536568306,-1418705402.6,35.17451761465992,57.36764114343891,NaN,NaN,-14.642053538459413,-6.539963100629275
2016-01-08T09:30:00-05:00,18.388856,18.405093,17.901734,17.942327,83077067,64690041.45,29.08991246077403,43.39979569098688,NaN,NaN,-214.66398420288655,-168.3013547531507,-0.14172383266571306,-0.29537788330128834,-0.15365405063557527,-1619645373,-1477454884.2,28.811870747785576,55.49293825720364,NaN,NaN,-19.268041617764137,-8.358260031648541
2016-01-11T09:30:00-05:00,18.039751,18.072226,17.788072,17.966683,71028412,65331684.35,29.650608590322236,42.70141792359357,NaN,NaN,-199.30710083394635,-177.70836378499135,-0.1563035351940087,-0.3490334696280861,-0.19272993443407743,-1548616961,-1503310200.8,26.536829820168407,53.240301554595035,NaN,NaN,-22.703366930742046,-10.407561017233327
2016-01-12T09:30:00-05:00,18.153413,18.185888,17.869259,18.104701,80680990,64885998.65,32.888988304447594,41.99379060959789,NaN,NaN,-151.81998222340707,-186.4018196416859,-0.14668305234063667,-0.37608374985987325,-0.22940069751923658,-1467935971,-1523454765,24.88791233182046,50.71702647749786,NaN,NaN,-24.551705477682013,-12.428153083011711
2016-01-13T09:30:00-05:00,18.177769,18.254897,17.552629,17.633816,125598839,67566379.35,28.13106525770924,40.72496436126968,NaN,NaN,-153.37432947133925,-187.0196645236568,-0.16092313033815525,-0.43055461044193066,-0.2696314801037754,-1593534810,-1553260284.2,22.645782697458245,47.97050387154512,NaN,NaN,-27.783272183537676,-14.621741525943992
2016-01-14T09:30:00-05:00,17.67441,17.934208,17.499858,17.788072,95320096,67662990.45,31.6208794364713,39.438292732355634,NaN,NaN,-136.5314195502882,-171.13936325637349,-0.14911024265980788,-0.45601928342853526,-0.3069090407687274,-1498214714,-1545589565.8,24.53016781814361,45.50129290772693,NaN,NaN,-29.30881294903031,-16.719894586384896
2016-01-15T09:30:00-05:00,17.187288,17.471442,17.155625,17.390255,94418341,67270635.1,27.86321284600345,37.901965712818836,NaN,NaN,-153.07867935545497,-158.82230228688718,-0.15647926862950412,-0.5025081265556075,-0.3460288579261034,-1592633055,-1540187102.2,25.899309580695558,43.0711770174821,NaN,NaN,-31.87707803346804,-18.885206507396774
2016-01-19T09:30:00-05:00,17.576985,17.641935,17.260356,17.382137,83828720,67914319.6,27.790636818984353,36.38042701396135,NaN,NaN,-123.55364611784071,-143.67161134366603,-0.15025852226251618,-0.5338520107542486,-0.3835934884917324,-1676461775,-1565756065,23.707204702684948,40.174489351106686,NaN,NaN,-33.90808838727337,-21.031332490236288
2016-01-20T09:30:00-05:00,17.024914,17.203525,16.667691,17.041151,107745547,67618314.7,24.861368145974325,34.39207812759701,NaN,NaN,-141.91322482347266,-141.69025986367916,-0.1567464602296335,-0.5795265637787743,-0.4227801035491408,-1784207322,-1629010335.2,19.345022494267937,36.72561376514776,NaN,NaN,-36.608355126930824,-23.256621438335507
2016-01-21T09:30:00-05:00,17.057389,17.276594,16.907193,16.968083,91548597,69657847.05,24.27099891551768,32.54718983352091,NaN,NaN,-117.857732113099,-134.58694039203112,-0.15340468915608158,-0.6145359649942428,-0.4611312758381612,-1875755919,-1685454557,16.4383505783954,33.00671784267271,NaN,NaN,-38.96523483021945,-25.5007090657475
2016-01-22T09:30:00-05:00,17.187288,17.349662,17.154813,17.276594,59369136,69770236.75,31.65103904361979,31.47904027456836,NaN,NaN,-90.9056095458858,-125.46177839115062,-0.1193759073915927,-0.6103511600776521,-0.4909752526860594,-1816386783,-1749088970.8,13.902236973070814,29.43468054692274,NaN,NaN,-38.73108233898669,-27.390762390495954
2016-01-25T09:30:00-05:00,17.203525,17.266039,16.886896,16.92749,79028643,71689078.85,28.2912121278394,30.589842315730387,NaN,NaN,-100.69603067710914,-114.98524865548147,-0.10959231795345081,-0.627965650127873,-0.5183733321744222,-1895415426,-1809645445,12.004229296017726,26.33290733548098,NaN,NaN,-39.58741691309295,-29.13314160800981
2016-01-26T09:30:00-05:00,16.992439,17.260356,16.968083,17.211644,64011398,74197009.95,34.395643885114524,30.02733470819191,NaN,NaN,-84.42128183214372,-107.15877579834208,-0.07485518806828506,-0.6119423172597784,-0.5370871291914934,-1831404028,-1840633895.6,11.164253213230978,23.456185705895315,NaN,NaN,-38.342584448325375,-30.448776299483463
2016-01-27T09:30:00-05:00,17.154813,17.447086,17.024914,17.146694,77251718,77221751.15,33.689684254624225,29.716733493512713,NaN,NaN,-74.09212279438908,-93.59455539252535,-0.04840703180445105,-0.5975959189470572,-0.5491888871426062,-1908655746,-1865523580.4,10.527097611664814,21.112484677147428,NaN,NaN,-37.55858480339782,-31.464463228614086
2016-01-28T09:30:00-05:00,17.252238,17.333425,17.037092,17.154813,79953676,79316303.25,33.872396341336525,29.861974744909936,NaN,NaN,-71.50567200260382,-84.32414337042631,-0.023767277382509167,-0.5788979838707426,-0.5551307064882335,-1828702070,-1856112810.6,12.55908476957795,19.497096616784436,NaN,NaN,-36.876132280595684,-32.2375588074686
2016-01-29T09:30:00-05:00,17.276594,17.641935,17.219763,17.633816,100578045,83377678.45,43.72444105756927,30.907298216109602,NaN,NaN,-34.04468739041539,-72.95195893933224,0.028552236399336683,-0.5194404109890627,-0.5479926473883994,-1728124025,-1838460259,16.39465973207912,18.6101529728054,NaN,NaN,-33.14406954484387,-32.36706034137936
2016-02-01T09:30:00-05:00,17.552629,17.650054,17.430849,17.560748,84611352,84648768.7,42.679864461886474,31.837959349792758,NaN,NaN,-21.288003419515267,-57.07035348781348,0.06018125393181728,-0.47276607997362774,-0.532947333905445,-1812735377,-1821924249.2,19.937509920851056,18.138772979997018,NaN,NaN,-30.42543685474236,-32.08968555757407
2016-02-02T09:30:00-05:00,17.309068,17.333425,17.033033,17.073626,86208165,84287056.3,36.4312306567214,32.090976660669455,NaN,NaN,-67.7870199368408,-53.74350110875289,0.050622699667710935,-0.4696689593208063,-0.5202916589885173,-1898943542,-1835432152,19.220977049022935,17.733991888368625,NaN,NaN,-29.924296222246245,-31.78034422395581
2016-02-03T09:30:00-05:00,17.17105,17.17105,16.602741,17.089864,152019644,89281677.1,36.76359063428304,32.70758561613901,NaN,NaN,-93.1207010561628,-57.54921676110763,0.04775752843344627,-0.46059474844670945,-0.5083522768801557,-1746923898,-1803085782.4,26.072592501085538,17.978764017199147,NaN,NaN,-29.42759670479932,-31.444237435504885
2016-02-04T09:30:00-05:00,16.98432,17.357781,16.98432,17.236,97068131,90270380.45,39.81340932896066,33.2927663227454,NaN,NaN,-48.842692354033204,-53.0166208313935,0.05741877484741387,-0.43657880832088836,-0.4939975831683022,-1649855767,-1767316521.8,32.85490474577378,18.573388083458447,NaN,NaN,-28.106175569136994,-30.967371454595185
2016-02-05T09:30:00-05:00,17.252238,17.341543,16.959964,17.008676,81554688,89745060.25,36.83718278345976,33.93376417542085,NaN,NaN,-61.63885127935478,-58.535453609181374,0.05046066493293955,-0.4309217520021278,-0.48138241693506734,-1731410455,-1767973807.8,32.79536405589417,19.06596340311549,NaN,NaN,-27.85162159787109,-30.522264332206028
2016-02-08T09:30:00-05:00,16.765115,16.821946,16.351062,16.578385,132390604,92210737.1,31.96607647765633,34.23200986532599,NaN,NaN,-167.25649554364816,-87.72915203400797,0.020382730227073487,-0.45590400415122545,-0.47628673437829894,-1863801059,-1778186944.2,31.830110889332218,19.64617098787601,NaN,NaN,-29.166318840379894,-30.328557833373722
2016-02-09T09:30:00-05:00,16.253637,16.667691,16.253637,16.554029,169023567,97110494.85,31.710469761636062,34.72123140930183,NaN,NaN,-178.01630245200113,-109.77500853704002,0.003249839282750855,-0.47222443527486035,-0.4754742745576112,-2032824626,-1804963161,29.38795744418468,20.363523484298632,NaN,NaN,-30.28988409311258,-30.323033013336417
2016-02-10T09:30:00-05:00,16.679869,16.870577,16.456605,16.464724,80884474,97120669.05,30.739871591313204,35.18329374328722,NaN,NaN,-147.23249520121632,-120.59736736605073,-0.009023515053344033,-0.48675366837429124,-0.4777301533209472,-2113709100,-1878320201.4,23.963438805509753,20.90102978623537,NaN,NaN,-31.50149158046571,-30.49138423721203
2016-02-11T09:30:00-05:00,16.026314,16.139976,15.855821,15.961364,155528361,98617145.15,25.923518215444545,34.77418511270327,NaN,NaN,-248.3252999900039,-160.49388889324487,-0.04401107284916256,-0.5327439943824004,-0.48873292153323783,-2269237461,-2002196540.2,17.941028061708906,21.189514863995235,NaN,NaN,-34.165406745329186,-31.016244595514483
2016-02-12T09:30:00-05:00,16.342943,16.635216,16.267033,16.635216,119711022,99836691.45,39.573042788236535,35.5800301598745,NaN,NaN,-111.50649347966898,-170.4674173333077,-0.01617411793676815,-0.508950568954198,-0.49277645101742984,-2149526439,-2085819737,15.169519931566299,21.415607052248703,NaN,NaN,-31.8640384113619,-31.1373579977784
2016-02-16T09:30:00-05:00,16.919371,16.976202,16.748878,16.903133,97553508,99993449.8,43.991885685129155,36.26547600273268,NaN,NaN,-25.414718155598905,-142.09906185569787,0.023711805977816247,-0.4631366935451595,-0.48684849952297576,-2051972931,-2123454111.4,14.112879819856218,21.62622323843622,NaN,NaN,-28.469265930017535,-30.756201988098276
2016-02-17T09:30:00-05:00,17.065507,17.211644,17.061935,17.130457,79893341,99796680.85,47.499947778856566,37.25192339732071,NaN,NaN,38.31125151168775,-98.83355106296008,0.06641430976610657,-0.40383061231534256,-0.47024492208144913,-1972079590,-2111305104.2,16.14351854346377,22.027396162136146,NaN,NaN,-24.53686798501838,-29.867725701944003
2016-02-18T09:30:00-05:00,17.195407,17.195407,16.951846,17.033033,79538672,98386337.1,46.1653876126108,38.12999420241173,NaN,NaN,19.371575437061455,-65.51273693530455,0.08776762510624436,-0.3605353906986437,-0.44830301580488807,-2051618262,-2098886936.6,18.2706010635941,22.435361611708725,NaN,NaN,-21.835509288844186,-28.720266214358315
2016-02-19T09:30:00-05:00,16.895015,17.106101,16.87415,17.033033,91535739,98385694.2,46.1653876126108,38.30434752777184,NaN,NaN,6.890264052053554,-14.469624126893033,0.1006376385633721,-0.32250596760067296,-0.42314360616404506,-2051618262,-2055363096.8,25.411816018042032,23.07944420356322,NaN,NaN,-19.700386224752766,-27.43171193012895
2016-02-22T09:30:00-05:00,17.236,17.369959,17.236,17.30095,52439034,98039189.1,50.592696839202894,38.8695498404373,NaN,NaN,76.29616008269282,23.090906585579337,0.12438427887883158,-0.2676632575655056,-0.39204753644433715,-1999179228,-2025293654.6,29.964769520968616,23.79567703214305,NaN,NaN,-16.511292265332074,-25.871651978015112
2016-02-23T09:30:00-05:00,17.211644,17.236,16.959964,16.992439,71595416,97667527.75,45.910542201185365,39.54664352218473,NaN,NaN,19.557544769008025,32.08535917050072,0.11663355481801391,-0.24625559292181975,-0.36288914773983366,-2070774644,-2029053997.2,29.72044602681987,24.54563910198569,NaN,NaN,-15.173665556734239,-24.343368203546415
2016-02-24T09:30:00-05:00,16.748878,17.000558,16.602741,16.951846,89075411,98920728.4,45.316281018414294,40.1575499781941,NaN,NaN,-26.24739758455054,19.173629351253062,0.10637926812495235,-0.22991506258364325,-0.3362943307085956,-2159850055,-2066608090.2,27.324276673152966,24.635045114276213,NaN,NaN,-14.267779987619257,-22.903998458413962
2016-02-25T09:30:00-05:00,16.951846,17.199466,16.951846,17.187288,87765416,99446413.3,49.40676645954837,40.84278977323608,NaN,NaN,36.15235687706056,22.529785639252886,0.11246679249046732,-0.19571084009551143,-0.30817763258597874,-2072084639,-2070701365.6,27.06811241756364,24.221702805118348,NaN,NaN,-12.276205039232451,-21.385742255673748
2016-02-26T09:30:00-05:00,17.30095,17.463324,17.211644,17.309068,100155165,100456487.75,51.4305171169334,41.88517079705563,NaN,NaN,83.32830229093362,37.8173932870289,0.12096795147298411,-0.15696769324474857,-0.2779356447177327,-1971929474,-2054763608,29.826675027509594,24.00965358880516,NaN,NaN,-10.023412516677162,-19.76255229295995
2016-02-29T09:30:00-05:00,17.292831,17.382056,17.11422,17.122338,70887719,98971971.45,48.24390068475448,43.04787252613407,NaN,NaN,60.99518095973778,34.75719746243789,0.1105721871771066,-0.13972041074634944,-0.25029259792345604,-2042817193,-2063491201,29.175884278723686,23.820065973761697,NaN,NaN,-9.008706640430507,-18.226288628312886
2016-03-01T09:30:00-05:00,17.244119,17.731241,17.244119,17.698766,100283875,99755597.6,57.08377463197024,44.86025144544366,NaN,NaN,145.33476329947436,59.91264116853115,0.1373281049098818,-0.0786324667861038,-0.2159605716959856,-1942533318,-2037842935.8,33.75062522071232,24.13168510065653,NaN,NaN,-5.212596193632764,-16.367189709072868
2016-03-02T09:30:00-05:00,17.715003,17.901734,17.686588,17.893615,89916498,99941014.25,59.59593517416995,46.92139884421914,NaN,NaN,183.90318038733986,101.94275676290923,0.16130290889932866,-0.014331935571824772,-0.17563484447115343,-1852616820,-1976396288.8,43.2141019906683,25.506732471024996,NaN,NaN,-1.2759472177308193,-14.211297924595431
2016-03-03T09:30:00-05:00,17.877377,18.023514,17.80025,18.015395,76688797,96174471.9,61.12748450507335,49.43596786490691,NaN,NaN,178.75370133002465,130.46302565350206,0.17724703099687134,0.045923944274935735,-0.1313230867219356,-1775928023,-1917164965.6,50.547350895603195,27.835755530588873,NaN,NaN,2.414230439095002,-11.836222444068227
2016-03-04T09:30:00-05:00,18.104701,18.177769,17.950446,18.088464,70748872,94858508.95,62.05683881810563,51.04195329561184,NaN,NaN,174.71966674165733,148.7412985436468,0.18380925597871647,0.09843848325145999,-0.08537077272725649,-1705179151,-1863814901,56.05237850836842,30.755959714646167,NaN,NaN,5.705498789018981,-9.33026226791291
2016-03-07T09:30:00-05:00,17.966683,18.100642,17.909852,18.080345,48279677,93194758.4,61.87981092018217,52.319662240972775,NaN,NaN,141.30929075959565,164.80412050361838,0.17854691996368566,0.13781287722735058,-0.040734042736335074,-1753458828,-1805943228,61.10976639195797,34.11288018408201,NaN,NaN,8.337676879412859,-6.806270961152087
2016-03-08T09:30:00-05:00,17.917971,17.991039,17.763716,17.788072,94740240,91312240.2,55.7178715502662,52.906656796073456,NaN,NaN,99.47001628890058,155.6311711015036,0.14760804955376666,0.14377601920587324,-0.0038320303478934087,-1848199068,-1787076378,62.620013694805586,37.43262983774928,NaN,NaN,8.920955904142552,-4.559524266109996
2016-03-09T09:30:00-05:00,17.853021,17.901734,17.747478,17.812428,59948765,85858500.1,56.11009632467456,53.61699313264944,NaN,NaN,85.00169389352415,135.85087380274047,0.12206758600716178,0.1487524521610588,0.02668486615389704,-1788250303,-1774203074.6,63.657070951486936,40.67452054402734,NaN,NaN,9.507677942825092,-2.5499239505478406
2016-03-10T09:30:00-05:00,17.92609,18.007277,17.585104,17.79619,95271878,86577870.3,55.755523305062304,54.30200282496741,NaN,NaN,73.04320188129748,114.70877391299504,0.09838078163542963,0.14966084319818407,0.05128006156275444,-1883522181,-1795721906.2,60.62905763860601,43.19003780263905,NaN,NaN,9.90127312512356,-0.7711815111662121
2016-03-11T09:30:00-05:00,17.974802,18.283312,17.974802,18.258956,79330865,82767995.5,62.942612852245034,55.18413968304185,NaN,NaN,117.44820941643206,103.25448244794998,0.10744220288650208,0.18558281517088204,0.07814061228437996,-1804191316,-1815524339.2,57.89963071332433,45.185385030664456,NaN,NaN,12.386067873987304,1.1084255438557187
2016-03-14T09:30:00-04:00,18.202125,18.250838,18.090493,18.202125,55380451,79551466.95,61.61883230398497,56.30616040467039,NaN,NaN,107.71789486504193,96.53620326903925,0.10315021366374921,0.20707837936406648,0.10392816570031727,-1859571767,-1836746927,55.0398523036863,46.99391405044064,NaN,NaN,14.059131634605142,2.958526413962779
2016-03-15T09:30:00-04:00,18.080345,18.194007,18.015395,18.194007,75743623,78460972.7,61.4201174632148,57.45643443644186,NaN,NaN,91.29762358669691,94.90172472859851,0.0935872082772562,0.2209121760468875,0.12732496776963131,-1935315390,-1854170191.4,52.73688925522086,48.80910066344548,NaN,NaN,15.381884930446276,4.733291916317564
2016-03-16T09:30:00-04:00,18.096582,18.267075,18.015395,18.153413,72422605,78087435.9,60.371668009041656,58.23964168997709,NaN,NaN,84.49768842567458,94.80092363502861,0.07893589399180598,0.2259948352593888,0.14705894126758282,-2007737995,-1898067729.8,47.36015970814492,50.25853261277272,NaN,NaN,16.222114091385897,6.374552227041612
2016-03-17T09:30:00-04:00,18.104701,18.429449,18.025544,18.372618,65898189,77405411.75,63.95026073830763,59.133909091503824,NaN,NaN,97.6028878567623,99.71286083012157,0.07826322674307676,0.24488797469642876,0.166624747953352,-1941839806,-1909731254.8,46.01769497803926,51.41503403781055,NaN,NaN,17.954961832550485,8.028896456400021
2016-03-18T09:30:00-04:00,18.405093,18.526873,18.354026,18.453805,65069495,76082099.55,65.20358014947956,60.345314767555614,NaN,NaN,118.73904961211143,99.97102886925744,0.07740100292471744,0.2633760016092488,0.18597499868453135,-1876770311,-1924247053.8,44.33340591621596,52.49771415477428,NaN,NaN,19.77177815542967,9.706450984832827
2016-03-21T09:30:00-04:00,18.396974,18.543111,18.344203,18.42133,47512258,75835760.75,64.24147510439288,60.856579087014374,NaN,NaN,110.23698448293412,100.47484679283588,0.06903511207103252,0.272268888773322,0.20323377670228948,-1924282569,-1937189214.2,42.82827972498074,53.14611804793632,NaN,NaN,21.053830940291807,11.32750526418411
2016-03-22T09:30:00-04:00,18.291431,18.433508,18.250838,18.364499,43507987,74431389.3,62.50337284179379,61.06425320613035,NaN,NaN,88.94828264479742,100.00497860445599,0.05469293390759847,0.27159994408678756,0.2169070101791891,-1967790556,-1943684247.4,42.05660319882636,53.06343956280474,NaN,NaN,21.708352226609325,12.810483401673427
2016-03-23T09:30:00-04:00,18.332025,18.36044,18.218363,18.226482,55945185,72774878,58.37287079737787,60.86749508415211,NaN,NaN,69.28427727698039,96.96229637471714,0.03205101820267295,0.2569707829325303,0.22491976472985734,-2023735741,-1946883796.6,41.65840490338203,52.42851484907466,NaN,NaN,21.200432320594608,14.00904753294788
2016-03-24T09:30:00-04:00,18.064108,18.11282,17.942327,18.11282,48529332,70813073.8,55.14108836686903,60.373512909063784,NaN,NaN,15.50519502348669,80.54275780806202,0.0068751428831608785,0.23351369333380845,0.22663855045064757,-2072265073,-1972968850,38.46116476322847,51.17199958156466,NaN,NaN,19.88675200729042,14.8487196007111
2016-03-28T09:30:00-04:00,18.137176,18.226482,18.080345,18.169651,36142552,67612443.15,56.439692229330475,59.98493300257438,NaN,NaN,36.13759111134059,64.02246610790783,-0.0077044131304713215,0.21700803403755842,0.22471244716802974,-2036122521,-2004839292,34.93343763844466,49.302261813456575,NaN,NaN,19.0912296074201,15.454792458812385
2016-03-29T09:30:00-04:00,18.096582,18.210244,17.991039,18.202125,44464212,66291267.8,57.202097024822166,60.0909491078998,NaN,NaN,19.232849185341983,45.82163904838941,-0.016414963991825543,0.20419374217824782,0.22060870617007336,-1991658309,-2018314440,33.53296493798098,47.22461547368339,NaN,NaN,18.602483229435784,15.904462568901442
2016-03-30T09:30:00-04:00,18.29955,18.443657,18.283312,18.307669,37658256,63159986.85,59.672556947137494,60.34541058093287,NaN,NaN,93.93861367806319,46.819705255042564,-0.016289744937104028,0.20024652499869333,0.21653626993579736,-1954000053,-2015556339.4,34.11517533889058,45.11448007278365,NaN,NaN,18.798692657905892,16.31792401018779
2016-03-31T09:30:00-04:00,18.258956,18.380737,18.226482,18.267075,39969517,60662637.8,58.279138901641836,60.52566883783141,NaN,NaN,66.24213223457333,46.21127624656115,-0.019922058797257253,0.1916336964392258,0.21155575523648304,-1993969570,-2009603105.2,35.42989362595904,43.31453978616601,NaN,NaN,18.611372946811972,16.645559572562675
2016-04-01T09:30:00-04:00,18.177769,18.453805,18.104701,18.429449,45780193,59117207.6,62.09220737767691,60.464925589647976,NaN,NaN,75.82229886571974,58.27469701500776,-0.012720759606717424,0.19565480572808625,0.20837556533480367,-1948189377,-1984787966,40.73836376470254,42.08873500412159,NaN,NaN,19.44611142312266,17.045638408356957
2016-04-04T09:30:00-04:00,18.413212,18.453805,18.29955,18.340143,38567486,57508138.3,58.90352363148407,60.270974970183616,NaN,NaN,82.65997000502766,67.57917279374517,-0.015139302086457862,0.18945143772673134,0.2045907398131892,-1986756863,-1974914834.4,42.75486886537296,41.21123618709921,NaN,NaN,19.320094726031503,17.37056073945332
2016-04-05T09:30:00-04:00,18.169651,18.202125,18.04787,18.080345,61680393,58178174.1,50.740210392226004,59.50812446511299,NaN,NaN,-33.39573965946236,57.053455024784306,-0.03430648657236848,0.1617076315977286,0.1960141181700971,-2048437256,-1986270623.8,41.02573298432024,40.37472502489203,NaN,NaN,16.802520788897223,17.289412175088163
2016-04-06T09:30:00-04:00,18.04787,18.194007,17.991039,18.177769,38152009,55348762.55,53.351059696008555,59.00665244275348,NaN,NaN,-37.8943237364288,30.686867541885903,-0.04009135498294783,0.1458999244414123,0.18599127942436014,-2010285247,-1997527662.6,39.32774689865022,39.80098125278526,NaN,NaN,15.401431794358414,17.01970069212677
2016-04-07T09:30:00-04:00,18.04787,18.064108,17.73936,17.836784,51345458,54918597.2,44.46751802380407,57.61502796314608,NaN,NaN,-163.00576468072356,-15.162711841173472,-0.06507205644391229,0.10465120886946977,0.16972326531338205,-2061630705,-2011059889.6,37.32770601320173,39.18026775529687,NaN,NaN,11.200357725418417,16.188365982597006
2016-04-08T09:30:00-04:00,17.958564,18.080345,17.865199,17.901734,55989711,52954488.85,46.301658235911056,56.26489068360547,NaN,NaN,-139.03220897097563,-58.133613408512545,-0.07472066878535685,0.07632242933168598,0.15104309811704283,-2005640994,-2022550213,35.668967213491456,38.56137927653083,NaN,NaN,8.344475293504058,15.067810169869443
2016-04-11T09:30:00-04:00,17.982921,18.129057,17.958564,17.974802,45449836,51260437.4,48.36770261371918,55.1310497914145,NaN,NaN,-91.32471910962495,-92.93055123144306,-0.07356525318262744,0.059086531638758544,0.13265178482138598,-1960191158,-2017237072,37.061692732177924,38.14948020561634,NaN,NaN,6.596810609424808,13.85766737552021
2016-04-12T09:30:00-04:00,17.999158,18.2346,17.958564,18.202125,48254295,50904129.6,54.26349987973272,54.54248743698156,NaN,NaN,-32.900421521512015,-92.83148760385299,-0.055686787143501906,0.0630433008920086,0.11873008803551051,-1911936863,-1989936993.4,43.794844483858384,38.27364029740435,NaN,NaN,6.8820198147029386,12.861146295403456
2016-04-13T09:30:00-04:00,18.388856,18.632416,18.372618,18.616179,69690447,50601470.8,62.63312742546364,54.84679148184483,NaN,NaN,146.4656445843204,-55.95949393970316,-0.016220198168194477,0.09845484032526741,0.11467503849346189,-1842246416,-1956329227.2,50.77618818342506,38.924910531693136,NaN,NaN,10.0727456774699,12.462803349984377
2016-04-14T09:30:00-04:00,18.526873,18.754197,18.526873,18.656773,52085628,49584621.95,63.341413119160116,55.43252896415134,NaN,NaN,165.74584045830446,9.790827088102446,0.01091212860583321,0.1283151992507534,0.1174030706449202,-1790160788,-1902035243.8,59.523300449377416,40.42934879498949,NaN,NaN,12.793763167352571,12.510083323894118
2016-04-15T09:30:00-04:00,18.705485,18.729841,18.559348,18.591823,53933510,48986388,61.33807679760833,55.78241357617118,NaN,NaN,137.36277971209643,65.06982482471685,0.022130814924564632,0.145066589300626,0.12293577437606136,-1844094298,-1869725904.6,63.6615520044891,42.48135696399267,NaN,NaN,14.363391029822731,12.774841567598205
2016-04-18T09:30:00-04:00,18.502517,18.746078,18.48628,18.729841,52464874,48356156.95,63.94749014232596,56.2642273702786,NaN,NaN,136.20575525365393,110.57591969737264,0.03568954061546681,0.16754770014539488,0.13185815952992808,-1791629424,-1836013557.8,67.40605603084006,44.90086347062546,NaN,NaN,16.500698740150348,13.307106877962797
2016-04-19T09:30:00-04:00,18.786672,18.965283,18.786672,18.965283,57202982,48840693.15,67.92457401514818,56.853657160850794,NaN,NaN,192.8704635423077,155.7300967101366,0.056140215242753394,0.2020334285833698,0.14589321334061642,-1734426442,-1800511473.6,70.81652764259091,47.52238863517549,NaN,NaN,19.66095985240008,14.214800160025266
2016-04-20T09:30:00-04:00,18.957165,19.143895,18.949046,19.11142,74787142,50404650.9,70.12731974843791,57.6999557927648,NaN,NaN,196.0304169856881,165.64305119041012,0.07401138041325689,0.23840743885718751,0.16439605844393063,-1659639300,-1763990050.4,73.84804595202381,50.266542372751545,NaN,NaN,23.008001552698083,15.470971787549955
2016-04-21T09:30:00-04:00,19.103301,19.184488,18.892215,18.940927,63474043,50781093.8,64.55716294787517,57.87602404777896,NaN,NaN,147.9783919372045,162.08956148619012,0.06895364921920186,0.25058811996793295,0.1816344707487311,-1723113343,-1750580561.4,74.87984418197586,52.705219545413925,NaN,NaN,24.059926625808234,16.697965335872567
2016-04-22T09:30:00-04:00,18.957165,19.160132,18.957165,19.119538,46755617,50692408.05,67.47205908879302,58.4880622947296,NaN,NaN,138.4871746741449,162.3144404785998,0.07191150701201704,0.2715238545137524,0.19961234750173534,-1676357726,-1717033247,77.29347841848087,55.17226308492163,NaN,NaN,25.883959865631468,18.010250268695266
2016-04-25T09:30:00-04:00,19.038351,19.095182,18.940927,19.078945,38212148,50795887.85,66.14071257061525,59.58809816461454,NaN,NaN,112.80520632060313,157.63433069198967,0.0655853368507413,0.281594018565162,0.21600868171442067,-1714569874,-1701621337,78.32389709424969,57.83641766420231,NaN,NaN,26.940609114093423,19.28601581803786
2016-04-26T09:30:00-04:00,19.095182,19.223214,19.067822,19.200725,41689320,50657143.25,68.1698670001854,60.64658440062717,NaN,NaN,120.67988212978035,143.19621440948418,0.06398452940053953,0.2959893434650951,0.23200481406455556,-1672880554,-1689312159.4,79.13817502850105,60.68001967347737,NaN,NaN,28.443365233346096,20.594208591653324
2016-04-27T09:30:00-04:00,19.184488,19.29815,19.119538,19.2332,56949680,51621714.45,68.70841293284822,62.37807689413033,NaN,NaN,114.74928865008715,126.93998874236402,0.05958433457142048,0.3064852322788312,0.2469008977074107,-1615930874,-1680570474.2,79.72080520876334,63.708098187446055,NaN,NaN,29.825386880559236,21.912948347211312
2016-04-28T09:30:00-04:00,19.070826,19.225082,18.961224,19.030233,74894914,53367984.3,61.68388749490323,63.47680755548691,NaN,NaN,80.97163430945623,113.53863721681437,0.03849904029454343,0.29502469807558995,0.2565256577810465,-1690825788,-1674112963.2,80.16156578952827,66.88614094287725,NaN,NaN,28.944120534131706,22.917401516771367
2016-04-29T09:30:00-04:00,18.92469,18.997758,18.754197,18.92469,60353676,54096658.45,58.343562656325346,64.18936898710163,NaN,NaN,46.05886873723535,95.05297602943246,0.014190799875078763,0.274264157624895,0.2600733577498162,-1751179464,-1689077310.8,76.03721534666805,69.67010684391225,NaN,NaN,27.20221315243417,23.529517464723195
2016-05-02T09:30:00-04:00,18.940927,19.119538,18.896274,19.095182,43590266,54347797.45,61.92996867673167,64.73697390117299,NaN,NaN,64.79747511402357,85.45142978811653,0.006720322511027277,0.2684737608886003,0.26175343837757303,-1707589198,-1687681175.6,76.16045252557373,71.98193598974908,NaN,NaN,26.758055644978786,23.990737204759707
2016-05-03T09:30:00-04:00,18.875977,18.892215,18.689247,18.851621,44168090,53472182.3,54.686510315776786,64.16935839333821,NaN,NaN,21.452973860638863,65.60604813428822,-0.016244168534849723,0.24144822770901087,0.2576923962438606,-1751757288,-1703456522.4,71.67498034358236,73.47470685833174,NaN,NaN,24.059191313141138,24.000516363099912
2016-05-04T09:30:00-04:00,18.632416,18.79885,18.616179,18.705485,46493991,53889281.4,50.843967703115,63.276683720763565,NaN,NaN,-3.0852438313228996,42.0391416380062,-0.04146171097653678,0.20586525752318963,0.2473269684997264,-1798251279,-1739920603.4,62.51059531463571,73.68808506299305,NaN,NaN,20.569157830891793,23.51032228707018
2016-05-05T09:30:00-04:00,18.746078,18.817117,18.648654,18.697366,47070779,53675547.45,50.63111167518548,62.51190049773336,NaN,NaN,-10.01968721998031,23.840877332118914,-0.05786705500617201,0.1749931497420114,0.23286020474818342,-1845322058,-1770819857.4,55.97887855621988,73.13932267383095,NaN,NaN,17.72384099455443,22.683682102425074
2016-05-06T09:30:00-04:00,18.559348,18.786672,18.559348,18.778553,38986981,52825410.95,52.760807691971195,61.712851751279445,NaN,NaN,-25.459501267413696,9.537203331189104,-0.062057897540644585,0.15528783282237768,0.21734573036302227,-1806335077,-1781850980,53.81691242063099,72.16866955881602,NaN,NaN,15.947022939654099,21.72130222202922
2016-05-09T09:30:00-04:00,18.746078,18.835384,18.658234,18.729841,32008131,52153325.7,51.33003711815294,60.527527687208355,NaN,NaN,-30.912117302924912,-9.604715152200592,-0.06652164449220724,0.13419367474776323,0.20071531923997046,-1838343208,-1808001782,48.98683533888309,70.60940582283689,NaN,NaN,14.060962673345484,20.626968000788686
2016-05-10T09:30:00-04:00,18.819147,19.001817,18.811028,18.997758,37571187,51619170.3,58.06565474259707,59.66598018679115,NaN,NaN,22.178835005495113,-9.459542923229344,-0.050564306293502365,0.1375099363730925,0.18807424266659487,-1800772021,-1817804728.6,47.27400636466651,68.71126013802565,NaN,NaN,14.34966023959032,19.73020974918892
2016-05-11T09:30:00-04:00,18.940927,18.989639,18.778553,18.79479,31979937,49733644.8,52.17466748087136,58.78151622486231,NaN,NaN,-16.85005794928695,-12.212505746822155,-0.05257947192603199,0.12234990275905488,0.17492937468508687,-1832751958,-1824704864.4,46.053382559459685,66.65222716498877,NaN,NaN,12.760008601435175,18.73446672808124
2016-05-12T09:30:00-04:00,18.85974,18.940927,18.689247,18.802909,35275732,48893150,52.38277725144964,57.703710379337785,NaN,NaN,-40.71329172828562,-18.351226648483216,-0.05216289800782603,0.10972575217530434,0.16188865018313037,-1797476226,-1815135698,48.05643505174995,64.563866924508,NaN,NaN,11.551595054039616,17.70834220321815
2016-05-13T09:30:00-04:00,18.762316,18.892215,18.543111,18.575586,45565669,48474757.95,46.306940690816106,56.28701238792355,NaN,NaN,-105.81009261679519,-34.42134491835951,-0.06515046295152205,0.08045057149372781,0.14560103444524986,-1843041895,-1822477061.6,46.62607848831038,62.29973702408376,NaN,NaN,8.586716124074735,16.40525276334052
2016-05-16T09:30:00-04:00,18.575586,18.754197,18.559348,18.67301,33816124,47542320.45,49.03525666149674,54.920254506588655,NaN,NaN,-109.96048414839771,-50.23101828745407,-0.0649855668818052,0.06436907584299334,0.12935464272479855,-1809225771,-1816653574.2,47.94953140558992,60.0719767653044,NaN,NaN,6.940257049292973,15.053110518476586
2016-05-17T09:30:00-04:00,18.624298,18.705485,18.48628,18.567467,45484315,46956387.1,46.291020804762255,53.319012211725365,NaN,NaN,-124.66276430665421,-79.59933814988395,-0.06939037169877309,0.042616678101332184,0.11200704980010527,-1854710086,-1827441187.2,45.68945926260866,57.64116634057906,NaN,NaN,4.729464856125537,13.57830399528358
2016-05-18T09:30:00-04:00,18.510636,18.908452,18.510636,18.892215,100301092,48232084.6,54.69297421782347,52.81966126336253,NaN,NaN,-43.97800174427842,-85.02492690888224,-0.04881014827950286,0.05099436445072669,0.09980451273022956,-1754408994,-1811772594.4,49.418674583758836,55.445245540166965,NaN,NaN,5.425164159668599,12.413569733052869
2016-05-19T09:30:00-04:00,18.802909,18.892215,18.599942,18.713603,66242237,48370494.3,50.05498691915179,52.227620139278706,NaN,NaN,-53.94890956763878,-87.67205047675286,-0.045660653579090354,0.04272869575636662,0.08838934933545697,-1820651231,-1816407595.4,48.36080679854831,53.46835921530127,NaN,NaN,4.498686848691678,11.282872178144128
2016-05-20T09:30:00-04:00,18.811028,18.949046,18.780989,18.843503,35786430,47822034.95,53.16560122035444,51.60159389239461,NaN,NaN,3.828306194274607,-65.7443707145389,-0.033808918701390064,0.04612820095871939,0.07993711966010945,-1784864801,-1804772176.6,51.1857135390309,51.68444928769106,NaN,NaN,4.737091466350552,10.347760647887903
2016-05-23T09:30:00-04:00,18.802909,18.892215,18.746078,18.827265,38598411,47841348.1,52.723555901602545,51.461382862810744,NaN,NaN,-8.582257411568605,-45.46872536717308,-0.026373204187749563,0.0469706144254225,0.07334381861317206,-1823463212,-1807619664.8,50.458233130105185,50.168967343871266,NaN,NaN,4.793154402356712,9.554245469954875
2016-05-24T09:30:00-04:00,18.957165,19.152013,18.932808,19.11142,47414422,48127603.2,59.12784657134732,52.0530884962559,NaN,NaN,122.34427562981843,3.9326826201214518,-0.0028646687732395565,0.06976298264662262,0.07262765141986217,-1776048790,-1791887405.6,54.32103668899571,49.58399887061127,NaN,NaN,6.9140351126223525,9.177072561764515
2016-05-25T09:30:00-04:00,19.192607,19.407752,19.184488,19.314387,51703113,47865274.85,62.98493472297867,52.93550442824114,NaN,NaN,235.68470655311975,59.86522427960108,0.02431094379677931,0.1030163311658363,0.078705387369057,-1724345677,-1785874742.2,55.74136780579776,49.567033817009694,NaN,NaN,9.99406455185022,9.29378570320533
2016-05-26T09:30:00-04:00,19.322506,19.346862,19.176369,19.200725,36219666,45931512.45,59.593337303456124,53.42354225763291,NaN,NaN,186.0749339239824,107.8699929779253,0.032098486132854084,0.1188284950351246,0.08673000890227052,-1760565343,-1773857564.6,58.51761032078734,49.90279795273515,NaN,NaN,11.445704437343343,9.601202665225046
2016-05-27T09:30:00-04:00,19.2332,19.338743,19.208844,19.330625,37048103,44766233.8,62.10481966009851,54.1931695820576,NaN,NaN,169.52639594930383,141.00961092893118,0.042796124710075156,0.14022516478986446,0.09742904007978931,-1723517240,-1761588052.4,61.19410634396244,50.77474588166939,NaN,NaN,13.44705318113531,10.150609881783655
2016-05-31T09:30:00-04:00,19.428049,19.428049,19.216963,19.281912,40908941,44632167.55,60.58407589031273,54.37305680689444,NaN,NaN,153.17175446417193,173.36041330407926,0.04326076192964119,0.1515049924918408,0.1082442305621996,-1764426181,-1749780646.2,63.626321288611535,51.942768376236884,NaN,NaN,14.614243357690814,10.788271806913249
2016-06-01T09:30:00-04:00,19.143895,19.346862,19.062708,19.322506,38475037,44347514.9,61.43162283122907,55.03426790334856,NaN,NaN,109.74909933466029,170.84137804504763,0.04288795916895932,0.16185417952339876,0.11896622035443943,-1725951144,-1739761117,65.5968379831913,53.338729477932006,NaN,NaN,15.816985664047309,11.506659500789544
2016-06-02T09:30:00-04:00,19.273794,19.3631,19.208844,19.3631,28243631,43434996.9,62.30452574389528,55.74296422423753,NaN,NaN,112.65396345844846,146.2352294261134,0.04191205785501889,0.17135629267321306,0.12944423481819417,-1697707513,-1734433484.2,66.63196854382184,54.66555329879428,NaN,NaN,17.06153368743781,12.30021295602501
2016-06-03T09:30:00-04:00,19.127657,19.139835,18.884096,19.087064,86133894,45388152.65,53.446404282033534,56.252925909324496,NaN,NaN,26.74200085463722,114.36864281224435,0.020307191458957485,0.154828224141891,0.13452103268293353,-1783841407,-1739088697,64.79735750246877,55.96350179980559,NaN,NaN,15.54901358547677,12.764327331660976
2016-06-06T09:30:00-04:00,19.095182,19.290031,19.078945,19.200725,46953094,45786458.3,56.20732503258259,56.7652165072592,NaN,NaN,64.69767061050845,93.40289774448527,0.011728320135415193,0.14918143285220253,0.13745311271678734,-1736888313,-1741762911.6,63.71211994461354,57.089400981164424,NaN,NaN,15.094123393429959,13.097155340485116
2016-06-07T09:30:00-04:00,19.216963,19.273794,19.143895,19.160132,26519413,45512022.4,54.95382881992981,57.38398850834259,NaN,NaN,58.93354286737237,74.55525542512535,0.0018927476500468499,0.1398190472793459,0.13792629962929906,-1763407726,-1741559220.6,63.761904330636,58.38028991459495,NaN,NaN,14.35832678686336,13.277322689967722
2016-06-08T09:30:00-04:00,19.127657,19.225082,19.127657,19.176369,30487872,45157856.65,55.38245149125872,57.433236885016534,NaN,NaN,49.43159833505135,62.49175522520356,-0.00459245993501417,0.13218572471053136,0.13677818464554553,-1732919854,-1742952962.6,63.12375893312083,59.359224510977945,NaN,NaN,13.870236356997555,13.362024642400556
2016-06-09T09:30:00-04:00,19.062708,19.095182,18.940927,19.038351,39594478,45538583.7,50.945001632252165,57.4968093645237,NaN,NaN,2.932359447476885,40.54743442300925,-0.018471484997049675,0.11368882839923344,0.13216031339628312,-1772514332,-1757914326.4,56.577737573494744,59.946148137759835,NaN,NaN,12.182522871389073,13.193524389398915
2016-06-10T09:30:00-04:00,18.819147,18.888643,18.746078,18.802909,47377541,46143674.15,44.40830444758841,56.87128816646898,NaN,NaN,-61.277767365797615,22.943480778922275,-0.0424325220129185,0.079119660880135,0.1215521828930535,-1819891873,-1765124419.6,53.68826666069488,60.1249019321644,NaN,NaN,8.648448516952499,12.544227836192285
2016-06-13T09:30:00-04:00,18.697366,18.916571,18.664891,18.67301,56290986,46679940,41.26258645632672,56.05264749180642,NaN,NaN,-82.7957153163381,-6.555196406447036,-0.06462447165312321,0.04077159332664948,0.10539606497977269,-1876182859,-1792983328.8,44.27859455274651,59.68349917663878,NaN,NaN,4.666994114915884,11.418908733152799
2016-06-14T09:30:00-04:00,18.599942,18.697366,18.29955,18.396974,66927633,48335515.45,35.506719523318196,54.365424131232906,NaN,NaN,-159.66437366634858,-50.27477971319122,-0.09372308262281678,-0.011757788298748295,0.08196529432406849,-1943110492,-1828923882,35.60801375951472,58.34685468167584,NaN,NaN,-0.8285492486945005,9.669271878603185
2016-06-15T09:30:00-04:00,18.445686,18.629088,18.405093,18.42133,58068815,48964740.45,36.35039405749378,52.46295694084114,NaN,NaN,-148.20244706838102,-89.8015887938777,-0.1062413283063229,-0.050836366058835125,0.05540496224748777,-1885041677,-1859348246.6,30.214295292598322,56.52349235930446,NaN,NaN,-4.943967605136868,7.581666238068892
2016-06-16T09:30:00-04:00,18.275194,18.48628,18.169651,18.470043,71530209,47526196.3,38.09465796449291,50.92733698805805,NaN,NaN,-157.89255075545336,-121.96657083446375,-0.1059145428041188,-0.07698821625766072,0.028926326546458072,-1813511468,-1867547673.8,28.941921916310037,54.410943187556086,NaN,NaN,-7.811386869208372,5.382658651314998
2016-06-17T09:30:00-04:00,18.396974,18.445686,18.275194,18.356381,46551886,46541678.75,35.640432060177844,49.03702358806372,NaN,NaN,-144.54396356758716,-138.61981007482166,-0.10767486373536632,-0.10566725312274983,0.0020076106126164887,-1860063354,-1875581970,27.710530961722114,52.01925923168177,NaN,NaN,-10.992006753847388,3.0434207362917998
2016-06-20T09:30:00-04:00,18.648654,18.746078,18.453805,18.461924,70608374,48282775.95,39.535792475719575,47.533574772735626,NaN,NaN,-88.71708801819126,-139.8040846151923,-0.09641649982113532,-0.11851301416380267,-0.022096514342667344,-1789454980,-1858236394.2,34.21785165457537,49.91865425782204,NaN,NaN,-12.567292114319034,0.8133189004902519
2016-06-21T09:30:00-04:00,18.534992,18.607979,18.453805,18.567467,40331842,48369447.5,43.23572901165814,46.2338680713377,NaN,NaN,-83.34911223654692,-124.54103232923197,-0.07736870579339561,-0.11880739658441186,-0.041438690791016246,-1749123138,-1819438923.4,45.93989753469508,48.51458708292945,NaN,NaN,-12.828152831842962,-1.1354627755573499
2016-06-22T09:30:00-04:00,18.567467,18.705485,18.510636,18.551229,54036983,48700575.55,42.80177325146894,44.840814321878675,NaN,NaN,-65.77291884250373,-108.05512668405649,-0.062032604701567004,-0.118979446667975,-0.05694684196640799,-1803160121,-1803062612.2,49.99072092539429,47.32592653875606,NaN,NaN,-13.162247684184925,-2.853574905361289
2016-06-23T09:30:00-04:00,18.770434,18.940927,18.762316,18.940927,73788860,49804862.9,54.58323529056917,44.92201653677409,NaN,NaN,-2.2288382684772365,-76.92238418666128,-0.023779592561953403,-0.08667133266884974,-0.06289174010689634,-1729371261,-1786234570.8,53.82004500249862,46.5418327887582,NaN,NaN,-9.655710308669493,-3.825308534405318
2016-06-24T09:30:00-04:00,17.950446,18.340143,17.86114,17.92609,166012260,56294492.6,34.597674735680656,43.37847008699538,NaN,NaN,-157.4939774517081,-79.51238696348545,-0.06274793460697686,-0.14132665836561742,-0.07857872375864056,-1895383521,-1793298604.2,52.01934941461065,45.70663489375799,NaN,NaN,-14.360388559086573,-5.33031996650264
2016-06-27T09:30:00-04:00,17.658173,17.682529,17.309068,17.414612,145870500,61735612.45,28.861842269981594,41.514756761999074,NaN,NaN,-224.07976270113318,-106.58492190007387,-0.11580812986939741,-0.22333888609538732,-0.10753075622598991,-2041254021,-1843658412.4,41.38803313043561,44.10850123660082,NaN,NaN,-20.688935706953725,-7.524407929424223
2016-06-28T09:30:00-04:00,17.731241,17.86114,17.576985,17.86114,109786739,65179502.35,38.454754612606884,40.305635556381084,NaN,NaN,-150.0013920481708,-119.91537786239863,-0.11351766761359061,-0.2494278407429782,-0.13591017312938758,-1931467282,-1880127241.2,35.6982978241727,42.149539728818816,NaN,NaN,-21.32162443841613,-9.49543885928021
2016-06-29T09:30:00-04:00,18.015395,18.267075,17.974883,18.267075,100067811,68259141.05,45.63237825103316,39.92616245772258,NaN,NaN,-75.42608541541375,-121.84601117698064,-0.07898637606264575,-0.23464314320769475,-0.155656767145049,-1831399471,-1885775111.2,34.89815538478547,40.600998143911006,NaN,NaN,-18.704671385490336,-10.811043505881656
2016-06-30T09:30:00-04:00,18.323906,18.559348,18.2346,18.555289,72749809,70484449.95,50.08353844488411,40.331536314672285,NaN,NaN,-21.92675814120895,-125.78559515152696,-0.033389997955454,-0.19739426458936649,-0.1640042666339125,-1758649662,-1891630791.4,34.04610634625904,39.19798669287987,NaN,NaN,-14.917413182939937,-11.39766774546141
2016-07-01T09:30:00-04:00,18.48628,18.591823,18.429449,18.461924,45121896,68433850.05,48.692781664356175,40.86226454381724,NaN,NaN,-9.06612896416041,-96.10002545401743,-0.007523853228412536,-0.17340908316942816,-0.16588522994101562,-1803771558,-1873308398.8,39.05977565229282,38.82521391427604,NaN,NaN,-12.660802287202442,-11.5781155371387
2016-07-05T09:30:00-04:00,18.283312,18.332025,18.096582,18.185888,59591998,69065795.25,44.73735955514024,41.52159597466168,NaN,NaN,-61.05768828864752,-63.49561057152029,-0.007020670678090285,-0.17466106828862848,-0.1676403976105382,-1863363556,-1837730305.8,47.418390030110224,39.668812219318575,NaN,NaN,-12.303498171978177,-11.681741627830053
2016-07-06T09:30:00-04:00,18.031633,18.258956,17.991039,18.2346,58595575,70669603.35,45.57751860562387,42.18067629952811,NaN,NaN,-62.395170618125675,-45.97436628551126,-0.0017002189005940194,-0.16976567123628072,-0.1680654523356867,-1804767981,-1812390445.6,52.42365994725107,41.255195408936636,NaN,NaN,-11.74801945981253,-11.691209889541836
2016-07-07T09:30:00-04:00,18.291431,18.409152,18.169651,18.258956,65770176,72433718.55,46.01941671067668,42.7467304956841,NaN,NaN,-28.120028238933326,-36.51315485021517,0.004810229151525736,-0.16205266589627954,-0.16686289504780527,-1738997805,-1793910112.4,55.73316012519355,43.16885528099974,NaN,NaN,-11.176853161171575,-11.617730356917514
2016-07-08T09:30:00-04:00,18.510636,18.632416,18.487092,18.60806,55359911,73221990.2,52.031604467127885,43.91752852475195,NaN,NaN,54.09111237992027,-21.30958074598933,0.03243895057383844,-0.1263142068305072,-0.15875315740434565,-1683637894,-1778907758.8,58.27088665355636,45.351737830416475,NaN,NaN,-8.723644255735895,-11.20428948532014
2016-07-11T09:30:00-04:00,18.705485,18.770434,18.648654,18.713603,42582515,72982238.9,53.71017574185162,44.92998447233282,NaN,NaN,92.6638616375428,-0.9635826256486894,0.056238424437212,-0.08845512685783063,-0.14469355129504263,-1641055379,-1746364523,63.19931274598145,47.421842194088335,NaN,NaN,-6.220053539644638,-10.49225577879507
2016-07-12T09:30:00-04:00,18.851621,18.973402,18.827265,18.949046,55091674,72922273.3,57.299849894466206,45.93456453539053,NaN,NaN,141.97700107820336,39.64335524772149,0.0845519281535679,-0.03900364110308274,-0.12355556925665065,-1585963705,-1690884552.8,69.75704255647162,49.12306683850094,NaN,NaN,-2.9693970063929216,-9.417561668451906
2016-07-13T09:30:00-04:00,18.932808,18.989639,18.843503,18.949046,57410865,72446434.9,57.299849894466206,46.97014143846177,NaN,NaN,128.28963857366873,77.78031708608037,0.09899236451024815,0.0001848863811595436,-0.0988074781290886,-1585963705,-1647123697.6,73.73300478275128,50.81894425688358,NaN,NaN,-0.38740460842336816,-8.127539231304972
2016-07-14T09:30:00-04:00,19.322506,19.322506,19.078945,19.127657,67078935,72896940.9,60.02711159083626,47.35898974562371,NaN,NaN,161.92500961540253,115.78932465694754,0.11515335260567346,0.04513421262800321,-0.07001913997767024,-1518884770,-1603101090.6,77.00772748172419,52.475207291113975,NaN,NaN,2.6241166216346743,-6.591588395170737
2016-07-15T09:30:00-04:00,19.200725,19.216963,18.973402,19.095182,62747798,72457820.35,59.285677013079834,49.12241847972365,NaN,NaN,126.14923695642433,130.20094957224836,0.11781209032925487,0.07724597293389834,-0.040566117395356524,-1581632568,-1582700025.4,78.3544979012719,54.356289325875494,NaN,NaN,4.887596089010811,-4.951704897430516
2016-07-18T09:30:00-04:00,19.103301,19.184488,19.087064,19.160132,38976123,72079032.2,60.34075487920231,51.37091223752513,NaN,NaN,120.15419002262308,135.6990152492644,0.1178174219896383,0.10670566009169136,-0.011111761897946944,-1542656445,-1563020238.6,79.59608557630403,57.085435929151814,NaN,NaN,7.078703381835864,-3.2330751432496045
2016-07-19T09:30:00-04:00,19.070826,19.176369,19.04647,19.168251,30795658,70088396.4,60.478627294803786,52.944046000539196,NaN,NaN,104.4814980907036,128.19991465176446,0.11226401925103167,0.12921826216584265,0.016954242914810975,-1511860787,-1548199655,80.50308143840326,60.28577761588257,NaN,NaN,8.938666842861466,-1.4942548595194518
2016-07-20T09:30:00-04:00,19.241319,19.241319,19.119538,19.200725,31836371,69663622.85,61.061706805190056,54.04614089726469,NaN,NaN,101.08270456489535,122.75852785000977,0.10481603482356484,0.14797428644426702,0.04315825162070218,-1480024416,-1527011797.2,81.7519445337174,63.632476840806284,NaN,NaN,10.668880824648365,0.24333595250452178
2016-07-21T09:30:00-04:00,19.176369,19.208844,19.078945,19.103301,36546057,68789076.55,58.28355088337778,54.631856071442805,NaN,NaN,82.077368267203,106.78899958036989,0.088042315108516,0.15321114550634718,0.06516883039783118,-1516570473,-1526548937.8,81.77940185757002,67.04199794875707,NaN,NaN,11.48804452350473,1.849722891218837
2016-07-22T09:30:00-04:00,19.127657,19.2332,19.095182,19.225082,23498625,66274564.8,60.69110874684995,55.48887943447807,NaN,NaN,85.089913107904,98.5771348106658,0.08009119604133383,0.16528282544949846,0.08519162940816463,-1493071848,-1508836793.8,82.84325859636746,70.16938958761953,NaN,NaN,12.833649001399516,3.4188551926732194
2016-07-25T09:30:00-04:00,19.192607,19.2332,19.127657,19.184488,37118133,59829858.45,59.45926414584165,56.54044404809961,NaN,NaN,77.19486343278169,89.98526949269751,0.06754178573920917,0.1696188615821761,0.10207707584296692,-1530189981,-1506343501,82.99378580072431,72.71048928552055,NaN,NaN,13.67771075831296,4.884405987764611
2016-07-26T09:30:00-04:00,19.135776,19.225082,19.122542,19.200725,34504468,54261556.85,59.810638921592705,57.55709549924023,NaN,NaN,72.12462285020436,83.51389444459767,0.05624099666010243,0.17237832166809497,0.11613732500799254,-1495685513,-1503108446.2,83.19974870659513,74.90878133975941,NaN,NaN,14.485058116238262,6.255927720403704
2016-07-27T09:30:00-04:00,19.168251,19.249438,19.127657,19.192607,50739829,51309211.35,59.53281902726826,58.52233852185392,NaN,NaN,68.58111216572799,77.01357596476419,0.04463276140091185,0.17192827675913236,0.1272955153582205,-1546425342,-1516388631.4,78.97151477368786,76.56866381465186,NaN,NaN,15.112216965947503,7.521111898338532
2016-07-28T09:30:00-04:00,19.143895,19.273794,19.078945,19.2332,33020793,47956860.45,60.52033725191311,59.128676577910014,NaN,NaN,65.42229438218573,73.68256118776074,0.03644724283696782,0.1728545689044303,0.13640732606746248,-1513404549,-1515755446.6,79.02624461939038,78.05118938364001,NaN,NaN,15.896083861272006,8.717536464471886
2016-07-29T09:30:00-04:00,19.160132,19.290031,19.160132,19.200725,54472602,47043000.1,59.27413062903438,59.52610192699449,NaN,NaN,65.97206296114044,69.85899115840802,0.026090015498838104,0.16901984544101012,0.14292982994217202,-1567877151,-1530716507.2,74.11767869861288,78.83107266597082,NaN,NaN,16.29274057749034,9.79970848061738
2016-08-01T09:30:00-04:00,19.216963,19.29815,19.11142,19.152013,39432964,46758553.5,57.365971655100985,59.53082490989697,NaN,NaN,55.42854962954109,65.5057283977599,0.013818874315413454,0.16020342283643885,0.1463845485210254,-1607310115,-1546140534,69.33618798266994,78.801011624985,NaN,NaN,16.196315838788024,10.713509531784615
2016-08-02T09:30:00-04:00,19.095182,19.168251,18.940927,18.989639,39732856,45765596.4,51.42338854758425,59.11107767083398,NaN,NaN,11.988952589953437,53.47859434570972,-0.006293736804313749,0.1385173775156332,0.14481111431994695,-1647042971,-1576412025.6,61.01645795463931,77.89268685154842,NaN,NaN,14.600990631063187,11.268863974538696
2016-08-03T09:30:00-04:00,18.989639,19.192607,18.989639,19.184488,33531183,44512376.8,57.158617531119404,58.90618523799706,NaN,NaN,31.296115491305834,46.021595010825294,-0.007455411034982873,0.13549185052621837,0.14294726156120124,-1613511788,-1589829314.8,57.71105846494664,76.51435335035002,NaN,NaN,14.62961925462819,11.748971871694339
2016-08-04T09:30:00-04:00,19.168251,19.200725,19.095182,19.135776,31381702,42792953.1,55.39770500785057,58.62847295190925,NaN,NaN,33.38852775384939,39.61484168515803,-0.012204609908770203,0.12769149917523848,0.13989610908400868,-1644893490,-1616127103,51.7892334334781,74.61683445979331,NaN,NaN,14.183113663774073,12.096706413420016
2016-08-05T09:30:00-04:00,19.338743,19.501117,19.281912,19.501117,51572671,42603591.1,64.28474208576938,58.91018632380688,NaN,NaN,215.52521653297927,69.5254723995258,0.007498273057095911,0.14926895040537858,0.14177067734828266,-1593320819,-1621215836.6,50.70500073440474,72.55318554251481,NaN,NaN,16.463494771952433,12.72053332178179
2016-08-08T09:30:00-04:00,19.557948,19.582304,19.468643,19.525474,45046315,42726781.1,64.78846854879109,59.218032127663115,NaN,NaN,285.6750810315863,115.57477867993484,0.01971649716173035,0.16641629880044562,0.14669980163871527,-1548274504,-1609408714.4,53.155532574038844,70.59978919506021,NaN,NaN,18.460534002143284,13.54053341897629
2016-08-09T09:30:00-04:00,19.517355,19.574186,19.492999,19.541711,32258998,41585147.3,65.14142190997718,59.50944034943363,NaN,NaN,245.8165189251706,162.34029194697828,0.02603984528138814,0.17924960824045044,0.1532097629590623,-1516015506,-1583203221.4,58.13047929762988,68.9125416781968,NaN,NaN,20.199065802486103,14.491752330906264
2016-08-10T09:30:00-04:00,19.525474,19.557948,19.354981,19.387456,33564970,40392852.55,59.08232209977935,59.56649543631945,NaN,NaN,136.26309242506318,183.33368733372976,0.017397167764800686,0.17495622266506317,0.15755905490026248,-1549580476,-1570416959,60.34347584492646,67.38140410586513,NaN,NaN,19.990024500471755,15.277219783701334
2016-08-11T09:30:00-04:00,19.428049,19.476761,19.354981,19.428049,25154346,38296623.1,60.133215496371314,59.52664591842813,NaN,NaN,105.72536039781934,197.80105386252373,0.012222231251404453,0.17283684396451804,0.16061461271311359,-1524426130,-1546323487,64.18487692504931,66.04866255791383,NaN,NaN,20.10939462615088,15.96753047547984
2016-08-12T09:30:00-04:00,19.29815,19.403693,19.290031,19.371218,28878463,36603156.35,57.891495900721125,59.41466247234809,NaN,NaN,59.349967786678675,166.5660041132636,0.0032468573236125176,0.16467318436762923,0.16142632704401672,-1553304593,-1538320241.8,65.3843724575299,64.79084731911423,NaN,NaN,19.58676038459845,16.48456331963964
2016-08-15T09:30:00-04:00,19.444286,19.517355,19.428049,19.501117,26291405,35968920.45,61.43076122641158,59.53038549412087,NaN,NaN,109.11412476377869,131.2538128597021,0.00426921890364057,0.16676285067356744,0.16249363176992687,-1527013188,-1534067978.6,66.0352500301961,63.56481169937144,NaN,NaN,20.12268757580493,17.00429535623468
2016-08-16T09:30:00-04:00,19.468643,19.497058,19.403693,19.452405,27653648,35811819.95,59.41403389432696,59.52190084176792,NaN,NaN,81.96097806735385,98.48270468813874,0.00009610636266166317,0.16261376472325395,0.1625176583605923,-1554666836,-1541798244.6,63.6906864660379,62.47332396311072,NaN,NaN,20.011052960455164,17.433832156837607
2016-08-17T09:30:00-04:00,19.452405,19.525474,19.403693,19.517355,25691684,35504585.6,61.24112549981818,59.57338571661828,NaN,NaN,85.48473001014638,88.32703220515539,0.00013875700983287387,0.1626911046228834,0.1625523476130505,-1528975152,-1537677179.8,64.41602431865837,61.42973679877273,NaN,NaN,20.41750733718663,17.86007146831604
2016-08-18T09:30:00-04:00,19.48488,19.541711,19.444286,19.501117,26610650,35007815.25,60.50773814466367,59.66150053916323,NaN,NaN,82.26884073495148,83.63572827258182,-0.002360014212288347,0.15960232984769007,0.16196234405997842,-1555585802,-1543909114.2,62.386424058048654,60.59179003873243,NaN,NaN,20.56169384939469,18.246017522755846
2016-08-19T09:30:00-04:00,19.444286,19.509236,19.371218,19.492999,31528657,35409316.85,60.12011362588666,59.85822496564793,NaN,NaN,59.33253969685599,83.63224265461727,-0.005797131330102956,0.15471592989734972,0.16051306122745268,-1587114459,-1550671087.4,60.17108752650097,59.93714000614893,NaN,NaN,20.58309699609244,18.579886018946787
2016-08-22T09:30:00-04:00,19.460524,19.509236,19.411812,19.492999,32536585,35180239.45,60.12011362588666,60.4794196140981,NaN,NaN,60.05780956873671,73.82097961560888,-0.00911092148786094,0.1491244093676265,0.15823533085548744,-1587114459,-1562691341.6,56.341079613291846,59.60318441033839,NaN,NaN,20.601223159045432,18.868648467532307
2016-08-23T09:30:00-04:00,19.566067,19.614779,19.517355,19.517355,29873041,34948668.1,60.989686623853125,60.753067406436216,NaN,NaN,89.21124577813858,75.27103315776581,-0.010598589687484922,0.14498709374613128,0.1555856834336162,-1557241418,-1563206258,56.17612239506979,59.49354611963291,NaN,NaN,20.82842332784887,19.148616304720388
2016-08-24T09:30:00-04:00,19.525474,19.574186,19.460524,19.509236,24313515,33627352.4,60.51598648729374,61.11865894068215,NaN,NaN,67.82060745013501,71.73820864576355,-0.012912016299039292,0.1394456630598171,0.15235767935885638,-1581554933,-1573722214.2,52.77758244085972,59.56414247730303,NaN,NaN,20.911321048443526,19.400431268109408
2016-08-25T09:30:00-04:00,19.48488,19.582304,19.460524,19.54983,27265665,33339596,62.10095053387127,60.96267382983229,NaN,NaN,71.69021581553162,69.62248366187957,-0.012483559685326495,0.13675322975219828,0.14923678943752477,-1554289268,-1573462907.4,52.85332526766631,59.71759422967885,NaN,NaN,21.36481850169713,19.681058015764798
2016-08-26T09:30:00-04:00,19.60666,19.716263,19.452405,19.574186,64991566,33865544.2,63.05910244013313,60.83914767921386,NaN,NaN,94.23615268743812,76.603206259996,-0.011366822856193032,0.13502826086728348,0.1463950837234765,-1489297702,-1553899556,58.289049462450436,60.08427400742253,NaN,NaN,21.99284472743954,20.01131326028976
2016-08-29T09:30:00-04:00,19.622898,19.817747,19.598542,19.744678,40475299,33917660.95,68.97248261870276,61.112794872694266,NaN,NaN,168.59707506709046,98.31105935966676,-0.0005252611039170685,0.14573850734358018,0.14626376844749725,-1448822403,-1526241144.8,64.51761216300702,60.54049778352089,NaN,NaN,24.216566723826645,20.612063755080744
2016-08-30T09:30:00-04:00,19.777153,19.92329,19.752797,19.92329,39382286,33900132.45,73.7188748423901,62.158262925737894,NaN,NaN,252.97686864269025,131.0641839325771,0.016362696533636062,0.16671713911454233,0.15035444258090627,-1409440117,-1496680884.6,69.72160112289829,61.21036387480459,NaN,NaN,27.769619992657702,21.63457178902031
2016-08-31T09:30:00-04:00,19.931409,19.952598,19.777153,19.939527,56419228,35044534.7,74.1066541306774,63.15636568533118,NaN,NaN,233.29312503575275,164.1586874497006,0.025755436270909343,0.18254873791954296,0.15679330164863362,-1353020889,-1450974075.8,75.6647506792873,62.03035485725017,NaN,NaN,30.799063072254107,22.94378482948228
2016-09-01T09:30:00-04:00,19.988239,20.004477,19.704085,19.85834,62997471,36625323.15,68.65209288386608,63.92497975555582,NaN,NaN,175.60628132136097,184.94190055086648,0.02368186176817627,0.18639562885885397,0.1627137670906777,-1416018360,-1423319894.2,78.42415962065401,62.96176822604475,NaN,NaN,31.863224259729687,24.217990462374765
2016-09-02T09:30:00-04:00,19.882696,20.004477,19.85834,19.947646,66957702,37394574.7,71.1661975979495,64.62036806780853,NaN,NaN,173.0418150794894,200.70303302927672,0.025356613045023513,0.1944095333969571,0.1690529203519336,-1349060658,-1395272485.4,80.8018546994025,64.01652570241664,NaN,NaN,33.53389466485827,25.548833919872408
2016-09-06T09:30:00-04:00,19.939527,19.967943,19.760916,19.915171,60335423,38159030.1,68.99913400292657,65.30501807556564,NaN,NaN,120.81541859799276,191.14670173545719,0.021463377306423892,0.19588214198496345,0.17441876467853956,-1409396081,-1387387221,81.42172665159886,65.28302857281385,NaN,NaN,34.301657087088586,26.79923722947472
2016-09-07T09:30:00-04:00,19.842103,19.931409,19.801509,19.907052,38693810,38480770.7,68.43804269665227,65.81908358962521,NaN,NaN,102.32776081120728,161.01688016916063,0.01578974866852914,0.19415595051420098,0.17836620184567184,-1448089891,-1395117175.8,78.73779568262518,66.30601224166863,NaN,NaN,34.78071446557615,27.939448263203495
2016-09-08T09:30:00-04:00,19.907052,19.963883,19.850221,19.890815,72108453,40407944.85,67.26007020557898,66.30139302254774,NaN,NaN,96.04867184210919,133.5679895304319,0.008743565415697263,0.1892956586152934,0.18055209319959614,-1520198344,-1428552666.8,68.25701235422086,66.72533997710948,NaN,NaN,34.86835237358793,28.929291707544127
2016-09-09T09:30:00-04:00,19.777153,19.846162,19.517355,19.517355,66515921,42476023.6,47.15556118826974,65.37535356271796,NaN,NaN,-7.412831793424132,96.96416690747489,-0.021610601585759115,0.15353884121739725,0.17514944280315636,-1586714265,-1462691847.8,59.542070401154156,66.68041018244186,NaN,NaN,27.95178646376209,28.78964810128955
2016-09-12T09:30:00-04:00,19.428049,19.809547,19.338743,19.73656,87204399,45392320.4,55.553370917553295,65.04915765497985,NaN,NaN,-12.887984695679007,59.77820695244121,-0.027110794999182453,0.1412609490541783,0.16837174405336075,-1499509866,-1492781689.4,53.10611214365084,66.44934107746751,NaN,NaN,24.89083752384757,28.23267516165498
2016-09-13T09:30:00-04:00,19.509236,19.557948,19.314387,19.387456,83279848,48241742.55,43.65495087651002,63.810962244455354,NaN,NaN,-94.36740172606676,16.74164288762931,-0.052951031762541595,0.10218295435018376,0.15513398611272536,-1582789714,-1527460416,46.82425460625186,65.78135052112337,NaN,NaN,17.19703095737518,26.656154561043582
2016-09-14T09:30:00-04:00,19.387456,19.517355,19.281912,19.338743,82925542,51005337.25,42.29372695685355,62.50937227799533,NaN,NaN,-107.2573445924747,-25.175378193107086,-0.07089448777128554,0.06651587639861845,0.137410364169904,-1665715256,-1570985489,40.36977858124062,64.89507881686487,NaN,NaN,11.01078953055921,24.42110241383153
2016-09-15T09:30:00-04:00,19.29815,19.509236,19.257556,19.452405,76530588,53547282.45,46.4866179155985,61.39406280526157,NaN,NaN,-93.5239891187534,-63.08991038527959,-0.07242379293446528,0.046880623001822386,0.11930441593628767,-1589184668,-1584782753.8,38.555457467954845,63.8738025454569,NaN,NaN,7.653017357561584,22.025661691507253
2016-09-16T09:30:00-04:00,19.281912,19.290031,19.119538,19.176369,75279991,55980749.5,39.06334990215253,59.6800804811201,NaN,NaN,-157.9475954496003,-93.19686311651483,-0.08828940511936875,0.008942659537076736,0.09723206465644549,-1664464659,-1600332832.6,36.56110733701194,62.32180667935415,NaN,NaN,1.8877734010721374,19.148820507159378
2016-09-19T09:30:00-04:00,19.35,19.4499,19.23,19.31,50396136,56924123.45,43.74654815761438,57.878228019613786,NaN,NaN,-104.36534143858053,-111.49233446509513,-0.08596381490108909,-0.01022270396991587,0.07574111093117322,-1614068523,-1623244564,33.78787401278477,60.1268253829097,NaN,NaN,-0.8921463320909465,16.28582524440933
2016-09-20T09:30:00-04:00,19.45,19.48,19.29,19.32,39903177,57292453.05,44.092813535129224,55.76208078338086,NaN,NaN,-88.36094433586246,-110.29104298705427,-0.08005215539333277,-0.02432408331049274,0.05572807208284003,-1574165346,-1621519690.4,34.19256736130451,57.589037257081564,NaN,NaN,-2.8585197486727734,13.550918816826174
2016-09-21T09:30:00-04:00,19.41,19.46,19.25,19.44,64029726,59000287.3,48.21238228767054,53.9124899374518,NaN,NaN,-75.5084426086627,-103.94126259029187,-0.06500031801362001,-0.025522325434184978,0.03947799257943503,-1510135620,-1590403763.2,41.17721168644693,55.125641614735834,NaN,NaN,-3.081923110926931,11.174798541432873
2016-09-22T09:30:00-04:00,19.54,19.56,19.44,19.48,38355740,59702398.55,49.54693311199139,52.54783566803218,NaN,NaN,-39.03631418002847,-93.04372760254688,-0.049965900638312424,-0.022979383218455496,0.026986517419856925,-1471779880,-1566922805.6,45.848112920457936,52.798781136150396,NaN,NaN,-2.8314487760934535,9.17390606750054
2016-09-23T09:30:00-04:00,19.41,19.51,19.35,19.38,59009524,61289591.5,46.332394671297806,50.77399260184277,NaN,NaN,-61.3578349533486,-73.72577550329655,-0.044551121326150966,-0.02870238423783178,0.015848737088319183,-1530789404,-1540187754.6,50.65282399933449,50.6452789432884,NaN,NaN,-3.6278331448767407,7.345086180018072
2016-09-26T09:30:00-04:00,19.26,19.27,19.02,19.07,54188999,60749463.15,38.08366673951187,48.56574494017029,NaN,NaN,-132.274547163913,-79.30761664836304,-0.058749764852095016,-0.05758846897679959,0.0011612958752954278,-1584978403,-1534369730.6,51.658034827041305,48.51930095581999,NaN,NaN,-7.218863932095718,5.26452187828753
2016-09-27T09:30:00-04:00,19,19.24,18.94,19.22,47620011,61106698.75,43.34011251553789,46.77303564151926,NaN,NaN,-113.87722331572765,-84.41087244433608,-0.05500737752796272,-0.06759792603465797,-0.012590548506695253,-1537358392,-1527008339.8,52.96359830734374,46.678286857585604,NaN,NaN,-8.363237924684192,3.31769904929157
2016-09-28T09:30:00-04:00,19.3,19.34,19.12,19.31,42936410,61284404.95,46.28660602157893,45.27493105694783,NaN,NaN,-74.3846294864693,-84.18610981989738,-0.04391976865888855,-0.06749025933030595,-0.023570490671417393,-1494421982,-1523865612.2,53.5404710819411,45.62710533813705,NaN,NaN,-8.298778599007747,1.6582022423916678
2016-09-29T09:30:00-04:00,19.3,19.4,18.94,19.04,62580775,61592482.3,39.62859652395408,44.73729072378243,NaN,NaN,-103.8103378989446,-97.14091456368062,-0.051683804941882426,-0.08817524684877043,-0.036491441906888,-1557002757,-1540910187.6,49.96159718100808,44.94278582241234,NaN,NaN,-10.564783749099286,-0.08793861353561128
2016-09-30T09:30:00-04:00,19.14,19.4,19.11,19.3,47336889,60809453.2,47.46524005785903,44.15956709094712,NaN,NaN,-58.15091220267539,-96.49953001354598,-0.03691552390833818,-0.08263584679231073,-0.04572032288397255,-1509665868,-1536685480.4,50.83876383745386,44.78083237196969,NaN,NaN,-9.653965758750344,-1.4545139199948587
2016-10-03T09:30:00-04:00,19.24,19.31,19.16,19.21,33170494,59120092.8,45.274425523599206,44.27524385145349,NaN,NaN,-69.16372085941238,-83.87736475264586,-0.03105064498947216,-0.08453362912081275,-0.05348298413134059,-1542836362,-1528257072.2,52.62310898028737,45.19503625582937,NaN,NaN,-9.691382488704873,-2.631209429810575
2016-10-04T09:30:00-04:00,19.26,19.43,19.19,19.29,68471721,59526907.7,47.59008935269945,44.65355545115677,NaN,NaN,-36.702216838494635,-68.44236345719926,-0.02015391912287192,-0.07867538303493049,-0.05852146391205857,-1474364641,-1515658322,55.23844685477835,46.257083989653495,NaN,NaN,-8.955187626890591,-3.5346348865362915
2016-10-05T09:30:00-04:00,19.37,19.64,19.34,19.6,58651881,60524811.25,55.45571949897719,45.29420556425524,NaN,NaN,70.75242697184848,-39.4149521655357,0.008049444088044824,-0.048459658802002537,-0.05650910289004736,-1415712760,-1499916477.6,58.33345349187022,47.66979799136174,NaN,NaN,-5.529704564395592,-3.8196448405161916
2016-10-06T09:30:00-04:00,19.65,19.66,19.46,19.63,53337261,59586251.65,56.141706794987435,46.51408819945773,NaN,NaN,117.42799852178852,4.832715118610926,0.02773451321747343,-0.02184096136820557,-0.049575474585679,-1362375499,-1460991026,64.81245565214539,49.687751442442725,NaN,NaN,-2.6573807618220218,-3.653607114988453
2016-10-07T09:30:00-04:00,19.55,19.66,19.49,19.62,55532849,59037098.05,55.833047834569385,47.377409604954515,NaN,NaN,123.50610175191868,41.16411790952974,0.03843263767316135,-0.00153467749422731,-0.03996731516738866,-1417908348,-1442639522,67.38718504795182,52.08770223066894,NaN,NaN,-0.49294969022359825,-3.202084625736331
2016-10-10T09:30:00-04:00,19.72,19.81,19.7,19.72,37997419,56576749.05,58.30189539559504,48.39234402355921,NaN,NaN,193.89206389429867,93.77527486027195,0.04986945321618399,0.022369501352841326,-0.027499951863342663,-1379910929,-1410054435.4,71.39021731686012,54.74467722749434,NaN,NaN,2.070947713447617,-2.4487942915671956
2016-10-11T09:30:00-04:00,19.66,19.72,19.411,19.54,78581159,56341814.6,52.602125467535465,48.70589710783528,NaN,NaN,90.60796158452473,119.23731054487583,0.04318712081233837,0.0264839491520803,-0.01670317166025807,-1458492088,-1406879924.8,71.7539655352484,56.928731073837305,NaN,NaN,2.5592832680797617,-1.733354640189059
2016-10-12T09:30:00-04:00,19.52,19.65,19.49,19.52,51378746,54764474.8,51.99389360541221,48.88068000022248,NaN,NaN,79.58009620227685,121.00284439096149,0.03561075043490186,0.027810266383369253,-0.0078004840515326045,-1509870834,-1425711539.6,66.36367461611661,58.39412833781292,NaN,NaN,2.774440975110452,-1.0893838380034144
2016-10-13T09:30:00-04:00,19.36,19.37,19.11,19.33,73171091,54596499.95,46.49380990893901,48.892209660054,NaN,NaN,-45.42678008348958,88.43188866990587,0.016941013277997238,0.013375782545963943,-0.003565230732033295,-1583041925,-1469844824.8,55.78672282095086,58.760835396499814,NaN,NaN,1.2914357301362516,-0.7492667568406051
2016-10-14T09:30:00-04:00,19.56,19.62,19.36,19.42,76176507,54641325.75,49.23329849730509,49.68861192846781,NaN,NaN,37.12255413785249,71.15517914709264,0.010127201082864266,0.009093770621547037,-0.0010334304613172285,-1506865418,-1487636238.8,52.176500558304625,58.79786866301862,NaN,NaN,0.8676479707605489,-0.5182789386118688
2016-10-17T09:30:00-04:00,19.43,19.47,19.28,19.33,41236064,54183322.15,46.66053500199766,49.92578496321494,NaN,NaN,-12.474364449985934,29.881893478235718,-0.00040861716607494894,-0.0015442019189109146,-0.0011355847528359657,-1548101482,-1521274349.4,46.101776399965644,58.30773852677733,NaN,NaN,-0.24933152880434328,-0.4798578800679366
2016-10-18T09:30:00-04:00,19.53,19.55,19.41,19.49,45958713,54486098.95,51.51163907594014,50.29900160995503,NaN,NaN,40.67860225950686,19.89602161323214,0.0032303355755132074,0.0029023347165555435,-0.00032800085895766384,-1502142769,-1530004485.6,44.64887467229031,57.67262449751656,NaN,NaN,0.23667551309667773,-0.377495966758706
2016-10-19T09:30:00-04:00,19.55,19.71,19.5301,19.66,49835923,53776408.8,56.081977268299,51.47424309169394,NaN,NaN,95.95644271401885,23.17129091558055,0.016193814297191078,0.019914267012531184,0.0037204527153401057,-1452306846,-1518491688,47.02010743690362,57.46251808722339,NaN,NaN,2.0766908549920426,-0.02689784936574191
2016-10-20T09:30:00-04:00,19.64,19.78,19.58,19.66,56238168,54670530.2,56.08197726829899,52.08972432101109,NaN,NaN,103.61822021599316,52.980290975477104,0.023436246453918973,0.03301576078273882,0.00957951432881985,-1452306846,-1492344672.2,52.04479882217018,57.54866344327455,NaN,NaN,3.5447403539496576,0.4833361796793151
2016-10-21T09:30:00-04:00,19.5,19.67,19.47,19.65,39543061,53697207.05,55.723657397426464,52.83609802628446,NaN,NaN,66.02990046432673,58.76176024077195,0.026021584613110455,0.04210649509520792,0.016084910482097464,-1491849907,-1489341570,52.60083326291982,57.54707232060544,NaN,NaN,4.647869434172542,1.078269501749776
2016-10-24T09:30:00-04:00,19.74,19.81,19.7,19.71,33808676,52678190.9,57.47909737559771,53.542455742205775,NaN,NaN,112.49615569627258,83.75586427002365,0.029960346791454043,0.05353534397141502,0.023574997179960974,-1458041231,-1471329519.8,55.903380176909344,57.59456755790051,NaN,NaN,6.070065981737271,1.7913832846051325
2016-10-25T09:30:00-04:00,19.75,19.76,19.635,19.69,36177841,52106082.4,56.672512377710625,53.62936951925816,NaN,NaN,89.42772548127503,93.50568891437729,0.02936723370682928,0.06028403931349757,0.030916805606668294,-1494219072,-1469744780.4,56.1925848507784,57.44164836925109,NaN,NaN,7.052480923222899,2.5429686615505274
2016-10-26T09:30:00-04:00,19.6,19.84,19.58,19.81,40419157,51980219.75,60.274525020552254,53.92457082108422,NaN,NaN,101.59540459254261,94.63348129008205,0.03483226004083281,0.07445713065770931,0.0396248706168765,-1453799915,-1470043394.2,56.11789903787996,56.82060861108928,NaN,NaN,8.91905653304864,3.453838357478829
2016-10-27T09:30:00-04:00,19.92,19.95,19.77,19.86,45545849,51128473.45,61.703149942649155,54.3438638288042,NaN,NaN,146.0505937810788,103.11995600309918,0.0392612988521021,0.08870149418200413,0.04944019532990203,-1408254066,-1461232838.2,57.896016371360425,56.14266799133275,NaN,NaN,10.901957064628217,4.517855315643027
2016-10-28T09:30:00-04:00,19.9,19.92,19.62,19.77,55749883,51549123.15,57.68203155353334,54.29958784008551,NaN,NaN,97.78626550802748,109.47122901183931,0.03378486584510808,0.09167127763628713,0.05788641179117905,-1464003949,-1455663646.6,59.02620952572831,55.25952457768049,NaN,NaN,11.557615933475583,5.523535403904821
2016-10-31T09:30:00-04:00,19.87,19.87,19.74,19.74,38579109,51819553.9,56.36346920775579,54.568255250101245,NaN,NaN,97.84082821376029,106.54016351533687,0.026139015956731085,0.0905601817370929,0.06442116578036182,-1502583058,-1464572012,56.41745324103966,54.16405941380844,NaN,NaN,11.762520729758437,6.4148190218839085
2016-11-01T09:30:00-04:00,19.81,19.86,19.5,19.66,62758908,51533913.25,52.891323276032416,54.63235736943126,NaN,NaN,33.35099249247168,95.32481691757619,0.01428376638537926,0.0822758737620859,0.06799210737670663,-1565341966,-1478796590.8,52.43256800416072,53.1689803700973,NaN,NaN,11.007255291388384,7.070881346098833
2016-11-02T09:30:00-04:00,19.62,19.63,19.44,19.53,66529874,51927812.9,47.7442604124821,54.721675262541474,NaN,NaN,-47.157086582135875,65.5743186826405,-0.00281182036901817,0.06447733191543392,0.06728915228445209,-1631871840,-1514410975.8,44.044454582909516,52.33024692452292,NaN,NaN,8.867145544075985,7.327490517238426
2016-11-03T09:30:00-04:00,19.55,19.73,19.52,19.55,53462052,51934052.45,48.573412265189226,54.674540531676065,NaN,NaN,-9.411685300086887,34.48186286640735,-0.012716711760722713,0.051393262583548704,0.06410997434427142,-1578409788,-1548442120.2,37.818533179879324,51.30467782606396,NaN,NaN,7.303413221940085,7.324050903624378
2016-11-04T09:30:00-04:00,19.56,19.65,19.4,19.49,64891375,52401978.75,46.20480448403542,54.64198835182162,NaN,NaN,-55.48727854686584,3.8271540554286814,-0.022671812979182138,0.035770208120293745,0.05844202109947588,-1643301163,-1584301563,32.59074116413791,50.3396038806477,NaN,NaN,5.301245178491705,7.035078657176853
2016-11-07T09:30:00-05:00,19.82,19.99,19.8,19.98,59001803,53452197.95,62.351189664055404,55.416241965258415,NaN,NaN,157.15481752363144,15.689951917402912,0.003014866859102086,0.06221060467335349,0.0591957378142514,-1584299360,-1600644823.4,30.520034917200675,49.33040104099844,NaN,NaN,8.701750898518487,7.273174691654229
2016-11-08T09:30:00-05:00,19.92,20.09,19.79,19.99,63290418,52687660.9,62.59791640279209,55.881666189150785,NaN,NaN,149.67457576153043,38.95466857121466,0.01905523624146635,0.08301478311608435,0.063959546874618,-1521008942,-1591778218.6,33.00693004181214,48.329459798491904,NaN,NaN,11.399820365780498,7.862695502243696
2016-11-09T09:30:00-05:00,20.54,20.94,20.11,20.84,268936640,63565555.6,76.62202890725166,57.348812734790265,NaN,NaN,337.8225839483236,115.95060267730655,0.08177202931063558,0.16617458351291248,0.0844025542022769,-1252072302,-1515818311,49.63778170864835,48.157530004668914,NaN,NaN,20.717127400145728,9.6990429162297
2016-11-10T09:30:00-05:00,21.16,21.7,21.08,21.61,241635544,71988778.25,82.88323249152177,59.2887823843685,NaN,NaN,393.6317864761511,196.55929703255416,0.16516519444583147,0.29085904725956624,0.12569385281373477,-1010436758,-1402223705,64.0218421255891,48.97331635200242,NaN,NaN,32.033050269783175,12.889615395308768
2016-11-11T09:30:00-05:00,21.47,21.7,21.4,21.67,134954549,74927680.35,83.25947282163303,61.130237773371014,NaN,NaN,279.2670324712184,263.510159236171,0.21145931530889864,0.39001799694985806,0.17855868164095942,-875482209,-1248659914.2,74.58824396534317,50.3079494797477,NaN,NaN,39.68718353835257,16.717839415743597
2016-11-14T09:30:00-05:00,21.88,22.3293,21.85,22.2,261730895,85952421.9,86.1545490478354,63.236097535522795,NaN,NaN,246.73020353099625,281.42523643764395,0.26158600307795865,0.5055411854884078,0.24395518241044908,-613751314,-1054550305,81.84601264899372,52.14033717962021,NaN,NaN,47.14559057594884,21.064661010058632
2016-11-15T09:30:00-05:00,22.01,22.2,21.79,22.18,122754546,89792213.55,85.55328343861626,65.04172313681308,NaN,NaN,179.52746374110782,287.3958140335594,0.27579122321711796,0.5886942114318465,0.31290298821472856,-736505860,-897649688.6,85.46072334066588,54.23625320124778,NaN,NaN,52.04897246706209,25.490991218201984
2016-11-16T09:30:00-05:00,21.98,22.03,21.8,21.86,117887705,93194802.65,76.3696674401316,66.0893315294904,NaN,NaN,133.52415400778168,246.53612804545105,0.24696301911778168,0.6216067621119556,0.37464374299417397,-854393565,-818113941.2,86.88617738387413,56.306978987855906,NaN,NaN,52.32916484155581,29.325016021538243
2016-11-17T09:30:00-05:00,21.86,22.18,21.81,22.16,98536426,95309715.55,78.68021933024917,67.5892020849701,NaN,NaN,122.25591654724738,192.2609540596703,0.23167759338785998,0.6642407347289989,0.43256314134113893,-755857139,-767198017.4,87.71643128333776,58.35628054197086,NaN,NaN,53.42572135460012,32.76797392626137
2016-11-18T09:30:00-05:00,22.14,22.24,22.06,22.16,92344297,97949777.35,78.68021933024917,69.1832556651482,NaN,NaN,111.44889531571897,158.6973266285704,0.20600846680321389,0.6900737248451563,0.4840652580419424,-755857139,-743273003.4,88.09775495201643,60.61915923561206,NaN,NaN,54.231281153838104,35.834160673058044
2016-11-21T09:30:00-05:00,22.28,22.3,22.09,22.24,71943930,99856540.05,79.30600880106466,71.0700189169362,NaN,NaN,100.67061956901155,129.4854098361735,0.17981253385866747,0.7088309253652767,0.5290183915066092,-683913209,-757305382.4,86.40355523644402,63.04565832363229,NaN,NaN,55.064099868296665,38.58129484380642
2016-11-22T09:30:00-05:00,22.34,22.35,22.12,22.25,98286517,102961973.85,79.38745518896009,73.33024711525607,NaN,NaN,90.52344700078262,111.68460648810847,0.1497825773811129,0.7162466132330003,0.5664640358518874,-585626692,-727129548.8,86.98326993968612,66.11271656340206,NaN,NaN,55.74044194401109,41.03260157240709
2016-11-23T09:30:00-05:00,22.34,22.41,22.17,22.38,101948383,106038435.15,80.46390400536443,75.60813938241144,NaN,NaN,85.53295532452188,102.08636675145652,0.1262404840375233,0.7242646408987916,0.5980241568612683,-483678309,-652986497.6,88.30292953711,69.7187448746328,NaN,NaN,56.62373994968225,43.25990705487497
2016-11-25T09:30:00-05:00,22.43,22.45,22.32,22.41,33114823,105416883.85,80.71420461780247,78.07309653482336,NaN,NaN,81.66399003778542,93.96798144956412,0.10132947906932888,0.7246860056979294,0.6233565266286005,-450563486,-591927767,89.26788514386146,73.76711230175592,NaN,NaN,57.41185793359358,45.28161432326335
2016-11-28T09:30:00-05:00,22.25,22.375,22.09,22.15,99791424,107618960.9,72.0932472775566,78.76895779293059,NaN,NaN,64.65708742407085,84.60961987123451,0.058128269972207436,0.6960168640938598,0.6378885941216523,-550354910,-550827321.2,89.87346910523176,78.00664331518671,NaN,NaN,55.53759885652143,46.74675497087164
2016-11-29T09:30:00-05:00,22.19,22.28,22.11,22.21,74645748,109422292.85,72.8148527208557,79.49873895850658,NaN,NaN,59.824215456569675,76.44033904874614,0.026016960370940923,0.6704097945853285,0.6443928342143875,-475709162,-509186511.8,90.46076875639584,82.11048893765698,NaN,NaN,54.197722214622736,47.81117886283609
2016-11-30T09:30:00-05:00,22.52,22.57,22.43,22.51,98843676,111226531.25,76.13734477216984,79.4641186631436,NaN,NaN,76.14448325305827,73.56454629920127,0.017796854238203652,0.6666389020121422,0.6488420477739385,-376865486,-467434270.6,91.0229520180614,85.06657253118648,NaN,NaN,53.976941263957876,48.692002062996345
2016-12-01T09:30:00-05:00,22.63,22.95,22.6,22.9,120088254,113904450.25,79.62379587581039,79.23130176202135,NaN,NaN,96.35870413961976,75.72969606222084,0.030685230249424378,0.687198585585719,0.6565133553362946,-256777232,-422054055.2,91.60224613640803,87.03660138910212,NaN,NaN,54.90305757598573,49.579295707709115
2016-12-02T09:30:00-05:00,22.84,22.85,22.55,22.65,82108345,115336764.9,72.32863053294611,78.45052731282942,NaN,NaN,84.36144040506247,76.26918613567625,0.015215121271654253,0.6755322569258624,0.6603171356542081,-338885577,-399718473.4,91.87998571101981,88.27172579950759,NaN,NaN,53.27890594211752,50.107811455481745
2016-12-05T09:30:00-05:00,22.85,23,22.79,22.92,95145737,116849483,74.9933761810058,77.65330067948445,NaN,NaN,109.03372431129766,85.14451351312161,0.015931938819800484,0.6802320591789588,0.6643001203591583,-243739840,-338395459.4,92.60329467579224,89.04010308713605,NaN,NaN,52.7813243271106,50.489741865714436
2016-12-06T09:30:00-05:00,23.07,23.14,22.84,23.12,79142635,117856524.6,76.77734741989985,77.026448106719,NaN,NaN,131.99222352104692,99.57811512601707,0.02225328298264606,0.6921167240874659,0.6698634411048199,-164597205,-276173068,93.25939991468715,89.59715141385186,NaN,NaN,52.952592268186535,50.841577637496165
2016-12-07T09:30:00-05:00,23.18,23.5,23.1,23.48,120172457,120700626.55,79.59864552832232,77.25708939873262,NaN,NaN,182.74817485245697,120.89885344589679,0.04191616702084944,0.7222586498808816,0.6803424828600322,-44424748,-209684920.4,93.88371668495722,90.09697564964351,NaN,NaN,54.056067200455274,51.30079043220461
2016-12-08T09:30:00-05:00,23.61,23.84,23.47,23.7,116856521,113096620.6,81.10905821812342,77.43057789072363,NaN,NaN,201.9162554217933,142.01036370233152,0.05988050055380989,0.7551931085522945,0.6953126079984846,72431773,-143843119.4,94.43354522169201,90.5767695023831,NaN,NaN,55.46684420526229,51.895940971212845
2016-12-09T09:30:00-05:00,23.7,23.75,23.53,23.75,95677338,105798710.3,81.44527786359558,77.62808207167696,NaN,NaN,169.43264177030102,159.0246039753792,0.06485301286567746,0.7763788740805815,0.711525861214904,168109111,-42444181.8,95.15578221325093,91.080914306757,NaN,NaN,56.68249935088059,52.57973502545109
2016-12-12T09:30:00-05:00,23.68,23.78,23.46,23.52,85143226,103308144.15,74.84622102411413,77.30952580189476,NaN,NaN,133.770371116745,163.97193333646868,0.04340507701381413,0.7657822074821716,0.7223771304683575,82965885,22896963.2,95.55592960630274,91.73465533317548,NaN,NaN,55.62376451229023,53.014596380713826
2016-12-13T09:30:00-05:00,23.58,23.72,23.38,23.58,113420674,95892633.1,75.40604618130301,77.02513944420498,NaN,NaN,113.19707857855423,160.21290434797015,0.024929845897109892,0.7535394378397449,0.728609591942635,196386559,95093716,95.95364793570499,92.3753966186054,NaN,NaN,54.93794804597061,53.28936090432194
2016-12-14T09:30:00-05:00,23.4,23.83,23.31,23.47,142995830,96904697.3,72.23205819720253,76.4371504579077,NaN,NaN,97.23616925952783,143.1105032293843,-0.0016194723490393637,0.7265852515063358,0.7282047238553752,53390729,114656811.4,96.05663120248028,92.92923245184613,NaN,NaN,53.43056761615838,53.30953329172714
2016-12-15T09:30:00-05:00,23.59,23.87,23.5,23.67,110426017,96531612.9,74.3463740251601,75.98230541557609,NaN,NaN,102.77170951791757,123.2815940486092,-0.012050545965187842,0.7131415413988904,0.7251920873640783,163816746,132933806,96.15508702521255,93.42117544337121,NaN,NaN,52.75029760719799,53.22964247965155
2016-12-16T09:30:00-05:00,23.68,23.69,23.33,23.36,83096468,95759615,65.96258709022518,75.544401116481,NaN,NaN,68.2422833527057,103.04352236509013,-0.044351744909226776,0.6697524062275448,0.7141041511367716,80720278,115456039.4,93.74470114765211,93.69769201782981,NaN,NaN,49.53681072774228,52.70209508652166
2016-12-19T09:30:00-05:00,23.39,23.43,23.18,23.37,73717593,94828279.8,66.09540662969052,75.06444068139777,NaN,NaN,45.88467488131477,85.46638311800407,-0.06814469347047114,0.6289232842986827,0.6970679777691539,154437871,129750436.6,93.87982826477604,93.9419105541427,NaN,NaN,47.00706975738889,51.888520039502694
2016-12-20T09:30:00-05:00,23.51,23.66,23.51,23.66,60793628,94270764.7,69.77843495563644,74.61023283735967,NaN,NaN,74.97131617767596,77.82123063782839,-0.06733330843479635,0.6129013422256584,0.6802346506604547,215231499,133519424.6,93.91714003540622,94.14863826966732,NaN,NaN,45.86194090708513,51.02758016344304
2016-12-21T09:30:00-05:00,23.66,23.67,23.52,23.6,37737962,91243336.95,68.1294401970465,73.78920743173369,NaN,NaN,66.79487834073711,71.73297245407028,-0.07332565401617819,0.588577583140232,0.6619032371564102,177493537,158339986.2,94.16924342964695,94.33199521918438,NaN,NaN,44.44344217962144,50.0869890228971
2016-12-22T09:30:00-05:00,23.59,23.59,23.46,23.54,37796099,88035722.75,66.438597560622,73.36849079085339,NaN,NaN,52.73404435415689,61.725439421318114,-0.08310119348314904,0.5580267453024739,0.6411279387856229,139697438,153516124.6,93.35940779792587,94.43766822539195,NaN,NaN,42.78903546918627,49.044424229509836
2016-12-23T09:30:00-05:00,23.54,23.58,23.47,23.58,18276667,87293814.95,67.02612982119638,72.79940176515272,NaN,NaN,50.39165006017846,58.15531276281267,-0.08816434484143398,0.5309225077338304,0.6190868525752644,157974105,168966890,93.55071837624102,94.50534134685257,NaN,NaN,41.56982821279811,47.976624798551015
2016-12-27T09:30:00-05:00,23.63,23.64,23.575,23.61,38241051,84216296.3,67.48586712088547,72.1357246009374,NaN,NaN,57.7544859712845,60.52927498080661,-0.09044567612912968,0.5060297574138524,0.596475433542982,196215156,177322347,93.65713814712409,94.53375122059808,NaN,NaN,40.6666290589774,46.93233969289764
2016-12-28T09:30:00-05:00,23.65,23.67,23.35,23.37,30834389,82025728.35,60.248795715394536,70.75359247144256,NaN,NaN,24.536205864752898,50.442252918221996,-0.10788845057315744,0.46161487032653525,0.5695033208996927,165380767,167352200.6,91.71242668953028,94.37865907806757,NaN,NaN,37.82117696809472,45.6307450179258
2016-12-29T09:30:00-05:00,23.39,23.43,23.1,23.2,39251797,79046134.4,55.692915064673414,68.93815367476756,NaN,NaN,-42.06838142308409,28.66960096545776,-0.12920660873275625,0.4079950599837474,0.5372016687165037,126128970,157079287.2,89.6469207806527,94.03675733227907,NaN,NaN,34.020052985147174,43.97207472752885
2016-12-30T09:30:00-05:00,23.29,23.33,23.17,23.25,44761220,75279782.7,56.729305974935734,67.17272711129185,NaN,NaN,-52.41081877111871,7.64062834040264,-0.13750187521230373,0.36532432470112397,0.5028261999134277,170890190,163317837.6,89.79719776444965,93.65400130022182,NaN,NaN,31.121938064297733,42.13634091849583
2017-01-03T09:30:00-05:00,23.61,23.67,23.26,23.51,71259897,74737360.3,61.74087256741271,66.23663079295605,NaN,NaN,9.9179793404058,-0.4541058035518958,-0.12348468991691197,0.34847033751728773,0.4719550274341997,242150087,180153034,90.21016672528462,93.27216109443482,NaN,NaN,29.924115381543036,40.39173727035972
2017-01-04T09:30:00-05:00,23.58,23.73,23.51,23.7,45092157,72234681.3,64.93679474134461,65.4888271186733,NaN,NaN,77.10006693440573,3.4150103890723513,-0.10040308600902781,0.3464511699229149,0.4468542559319427,287242244,198358451.6,90.65086031395067,92.8933905500238,NaN,NaN,29.831157810002324,38.88308306173723
2017-01-05T09:30:00-05:00,23.63,23.655,23.24,23.46,62201101,71387604.6,58.310781215929744,64.49445019143953,NaN,NaN,-38.58454554833237,-9.209139893544705,-0.10006281243832149,0.3217757403840409,0.4218385528223624,225041143,210290526.8,90.93876507494306,92.52782868377115,NaN,NaN,27.719509883725973,37.28828689344991
2017-01-06T09:30:00-05:00,23.55,23.64,23.42,23.54,38060761,67282019.8,59.78385773557186,63.45427045646893,NaN,NaN,7.229187845931801,0.6503739602584766,-0.09334448604120177,0.30515794527086015,0.3985024313120619,263101904,237685113.6,91.57987046286064,92.20102750074601,NaN,NaN,26.418242994092093,35.735423479255935
2017-01-09T09:30:00-05:00,23.48,23.5257,23.33,23.38,34022403,63140313.9,55.555757245519445,62.710925467561374,NaN,NaN,-65.82077271615924,-2.031616828749628,-0.09808419381804873,0.275897189039501,0.3739813828575497,229079501,249322975.8,91.8438795097155,92.06525452660769,NaN,NaN,24.038919538946846,34.06449434492607
2017-01-10T09:30:00-05:00,23.42,23.6299,23.31,23.43,46212104,60667052.2,56.58898487593614,62.031895342293204,NaN,NaN,-29.70934770138856,-9.9570822371085,-0.09613184900265914,0.25381657160422577,0.3499484206068849,275291605,255951279.4,91.99777457111536,91.93082211991764,NaN,NaN,22.377762294694527,32.39496119489299
2017-01-11T09:30:00-05:00,23.46,23.58,23.3,23.58,48001233,58809952.55,59.62171852357221,61.306415597145765,NaN,NaN,-5.211471114044915,-26.41938984679863,-0.08348653009926121,0.24559025798280842,0.32907678808206964,323292838,263161398.2,92.17082854079297,91.80608558458812,NaN,NaN,21.821192525236654,30.884422813513517
2017-01-12T09:30:00-05:00,23.47,23.5,23.18,23.38,57418139,56009825.8,54.18613785144725,60.31046542960296,NaN,NaN,-92.52068368773541,-37.20661747467927,-0.08694785035364427,0.2203919751400143,0.30733982549365857,265874699,271328109.4,92.37204719607291,91.67771442504711,NaN,NaN,19.715599311150147,29.288876598890177
2017-01-13T09:30:00-05:00,23.54,23.79,23.41,23.51,72479684,52484018.5,56.93447044116614,59.631599206784685,NaN,NaN,59.32965318054613,-26.786524407756406,-0.07906505106885114,0.20850851165759465,0.2875735627264458,338354383,286378605.2,92.74225245841895,91.6336319007966,NaN,NaN,18.743466004592168,27.78238937113332
2017-01-17T09:30:00-05:00,23.34,23.35,22.94,22.95,96657836,51795609.45,44.53946465585837,58.02540883783197,NaN,NaN,-233.97561852957614,-60.417493570439774,-0.10833918958282057,0.1521495757479201,0.26048876533074067,241696547,288902014.4,92.80530009815865,91.58038773807644,NaN,NaN,13.527711430703699,25.7460068082148
2017-01-18T09:30:00-05:00,23.07,23.17,22.85,23.14,68289123,51055242.2,48.62608565998414,56.67828159062473,NaN,NaN,-191.9485220728645,-92.86532844473496,-0.1112578033543507,0.12141651113780227,0.23267431449215298,309985670,295840827.4,92.98573936735283,91.53243068237849,NaN,NaN,10.64520412183779,23.588749281589514
2017-01-19T09:30:00-05:00,23.19,23.25,22.96,23.04,56729679,50205846.5,46.67664068967964,55.70884194593081,NaN,NaN,-152.5189041440728,-122.32681505074054,-0.11575782972013998,0.08797702734197799,0.20373485706211797,253255991,281833458,88.17806523692711,91.27997629290682,NaN,NaN,7.70824711461283,21.32010611487856
2017-01-20T09:30:00-05:00,23.11,23.23,23.03,23.15,74805151,50906422.65,49.094248718387604,55.237508635481824,NaN,NaN,-109.79055816270221,-125.78078994573389,-0.10734761113387914,0.06955034314476904,0.17689795427864818,328061142,294270746.6,88.73499921433738,91.21483903817001,NaN,NaN,6.075975262767506,19.142373136005553
2017-01-23T09:30:00-05:00,23.05,23.19,22.92,23,46651232,51352086.15,46.029546114597096,54.47324007402907,NaN,NaN,-128.7536785664743,-163.39745629513797,-0.10763430435282598,0.04235507383761572,0.1499893781904417,281409910,282881852,84.79560845706936,90.85758265907144,NaN,NaN,3.7621734725812566,16.94520175551637
2017-01-24T09:30:00-05:00,23.11,23.38,23.01,23.29,45229461,51723754.25,52.23734452609501,53.79441664250637,NaN,NaN,-49.50353304496055,-126.50303919821485,-0.08503193204025011,0.04369946314012907,0.12873139518037918,326639371,299870416.8,85.80775851591096,90.54312492983046,NaN,NaN,3.7423398951014293,15.059078632599949
2017-01-25T09:30:00-05:00,23.54,23.69,23.43,23.68,92850136,55452427.7,59.05767379273462,53.37447943189137,NaN,NaN,91.23422310069735,-69.86649016350249,-0.04269241923760059,0.07536587113337845,0.11805829037097904,419489507,321771184.2,87.00843158458086,90.28295144916117,NaN,NaN,6.084817704535206,13.777041357162128
2017-01-26T09:30:00-05:00,23.72,23.8,23.611,23.74,70704365,57075593.4,60.00392315150024,53.49541814157498,NaN,NaN,129.8001490546799,-13.402679523751948,-0.011164080772164728,0.10410318940577312,0.11526727017793785,490193872,369158760.4,89.14778285276775,90.15502414757722,NaN,NaN,8.23327019489107,12.985074048266263
2017-01-27T09:30:00-05:00,23.74,23.75,23.58,23.65,43944530,57731100.45,57.84434016280478,53.35688117209162,NaN,NaN,100.32572376240842,28.620576861270177,0.0023880510911796216,0.11825233404191238,0.11586428295073276,446249342,392796400.4,90.02974711894097,90.04430105158296,NaN,NaN,9.30923291705831,12.459953886665128
2017-01-30T09:30:00-05:00,23.5,23.505,23.25,23.46,46168751,58076948.15,53.4692210259009,53.20784287069029,NaN,NaN,8.374132562387372,56.046139087042505,-0.0024245894660406275,0.11283354611818197,0.1152581355842226,400080591,416530536.6,90.83514777775244,89.97224878501417,NaN,NaN,8.870114885860488,11.947119743693037
2017-01-31T09:30:00-05:00,23.34,23.52,23.18,23.31,56477262,58662750.25,50.23857996282649,52.754242519753895,NaN,NaN,-18.54357609556626,62.238130476921356,-0.015937394338640415,0.09533639266092209,0.1112737869995625,343603329,419923328.2,90.94772025181234,89.89724490506396,NaN,NaN,7.511864402664874,11.313511837831872
2017-02-01T09:30:00-05:00,23.49,23.6099,23.27,23.34,72132221,58706366.45,50.87783917247184,52.12967970896101,NaN,NaN,9.130467829591908,45.81737942270026,-0.022671426060976357,0.08293450442334205,0.1056059304843184,415735550,419172536.8,90.68227440367271,89.79091960955536,NaN,NaN,6.6010406956202905,10.640301674658788
2017-02-02T09:30:00-05:00,23.21,23.36,23.1,23.25,39396487,58421582.95,48.85035312695673,51.74855222864024,NaN,NaN,-48.744314971234296,10.108486617517425,-0.03241009192120907,0.06509331558280707,0.09750340750401613,376339063,396401575,82.78989059233469,89.1064798521455,NaN,NaN,5.257193722402905,9.871286252907948
2017-02-03T09:30:00-05:00,23.65,23.74,23.44,23.72,86346618,59628858.8,58.214969148827926,51.840016422044656,NaN,NaN,97.2304002250205,9.489421910039841,-0.007709726399595357,0.08786624950452193,0.09557597590411729,462685681,399688842.8,83.01964870657142,88.41200815558496,NaN,NaN,6.984456530351305,9.458882006828429
2017-02-06T09:30:00-05:00,23.58,23.78,23.56,23.61,34952083,59473424.9,55.64711982523037,52.63342036271409,NaN,NaN,98.37513007518658,27.48962141259969,0.0002848498329239141,0.09593203819527218,0.09564718836234827,427733598,405219444.2,83.42067786754545,87.74167799625543,NaN,NaN,7.598999997369534,9.193184576905729
2017-02-07T09:30:00-05:00,23.75,23.76,23.52,23.55,50838490,60314229.25,54.241683185829466,53.03453447170303,NaN,NaN,76.69444105406507,46.53722484252595,0.00057970604793324,0.09637182092226482,0.09579211487433158,376895108,411877800,83.91325779211915,87.09364359802444,NaN,NaN,7.680231307459475,8.977048395556263
2017-02-08T09:30:00-05:00,23.48,23.48,23.28,23.39,54341095,60720678.8,50.5735473246931,53.31288494563257,NaN,NaN,0.023900483056352614,44.715911373218844,-0.010350017574793827,0.0828545929058393,0.09320461048063312,322554013,393241492.6,77.01611677690006,86.29636156516537,NaN,NaN,6.655886075721564,8.64545377843702
2017-02-09T09:30:00-05:00,23.46,23.74,23.33,23.71,76813699,62161302.1,56.85749161564377,53.867402295436584,NaN,NaN,69.66204203846804,68.39718277515931,0.0029139322053709643,0.09684702573734683,0.09393309353197586,399367712,397847222.4,77.50814173758191,85.49444317396855,NaN,NaN,7.724204561347952,8.513846747424296
2017-02-10T09:30:00-05:00,23.85,23.86,23.69,23.78,55078737,62044332,58.11206082118661,54.73043906019298,NaN,NaN,115.24478936406784,72.00006060296877,0.014685632204675086,0.11229013378781971,0.09760450158314463,454446449,396199376,76.87405817970838,84.92861815415706,NaN,NaN,8.974253321248064,8.579619115113406
2017-02-13T09:30:00-05:00,23.93,24.16,23.89,24.05,76687038,62254699.7,62.62649632100645,55.47252133125808,NaN,NaN,168.37204584975595,85.99944375788264,0.03763498822237972,0.14464823686111927,0.10701324863873955,531133487,416879353.8,79.17641528369606,84.45495078042742,NaN,NaN,11.504661397556001,8.997482298319492
2017-02-14T09:30:00-05:00,24.03,24.36,23.99,24.33,75954279,61219521.85,66.64161531932749,56.014231440300435,NaN,NaN,188.98933451387418,108.45842244984446,0.06693963820801839,0.19068779639876254,0.12374815819074415,607087766,462917885.4,83.18899006845108,84.1821335292753,NaN,NaN,15.019659422439577,9.857793316050932
2017-02-15T09:30:00-05:00,24.45,24.57,24.265,24.52,76869353,61648533.35,69.06988229277161,56.66179995039125,NaN,NaN,213.018988638599,151.057440080953,0.09279530643480516,0.23974229123425062,0.14694698479944546,683957119,535198506.6,87.32011304725307,84.05158568602424,NaN,NaN,18.745738398533256,11.12749975640555
2017-02-16T09:30:00-05:00,24.49,24.53,24.31,24.46,64048170,62014457.9,67.40132101082713,57.34444143953571,NaN,NaN,183.13189018626025,173.75140971051144,0.09896790763177127,0.27065686933915956,0.1716889617073883,619908949,579306754,89.08312503015732,83.98396982253969,NaN,NaN,21.231185303468123,12.570883405985917
2017-02-17T09:30:00-05:00,24.28,24.47,24.2499,24.47,54156555,60982028.1,67.54205787188965,58.34964407139204,NaN,NaN,147.04879662668372,180.11221116303463,0.09672163437092868,0.29259100467104915,0.19586937030012047,674065504,623230565,90.4997071930581,83.96000978077579,NaN,NaN,23.269566772749428,14.09926674409499
2017-02-21T09:30:00-05:00,24.6,24.65,24.51,24.59,55216106,61410271.8,69.25726394216333,59.70812149848753,NaN,NaN,154.17401778640453,177.27260555036435,0.09611582190719256,0.3160141476841112,0.21989832577691862,729281610,662860189.6,91.56339846982296,84.003986796348,NaN,NaN,25.501409999726622,15.728144352042365
2017-02-22T09:30:00-05:00,24.49,24.6785,24.45,24.61,50438917,61670744.6,69.54611335121278,61.04156965411188,NaN,NaN,128.64121639704797,165.20298192699912,0.08996914239835857,0.3323597537748668,0.24239061137650825,779720527,697386741.8,92.36541275917469,84.12421096459812,NaN,NaN,27.420490335136122,17.39847949248433
2017-02-23T09:30:00-05:00,24.62,24.67,24.47,24.61,53509388,59703707.2,69.54611335121278,62.51983824155874,NaN,NaN,110.63182891341562,144.72554998196242,0.07919036271608682,0.34137856477161677,0.26218820205552995,779720527,716539423.4,92.77568515155991,84.83748200454276,NaN,NaN,29.011553503290845,19.05749006545669
2017-02-24T09:30:00-05:00,24.35,24.48,24.31,24.42,61686780,59252827.95,63.022100431614525,62.863204761757785,NaN,NaN,73.04929256340412,122.70903045739121,0.053767466845277834,0.32939753561212726,0.2756300687668494,718033747,736164383,93.18010132873027,85.56322862041127,NaN,NaN,28.676741696560708,20.431668869900122
2017-02-27T09:30:00-05:00,24.45,24.6,24.44,24.55,39655008,59038351.85,65.4128349362542,63.56075584111663,NaN,NaN,82.32028099703385,109.76332733146123,0.040797738350734525,0.3266272417052676,0.28582950335453305,757688755,752889033.2,93.51336229696986,86.28413465108444,NaN,NaN,29.03903148381806,21.66129210045983
2017-02-28T09:30:00-05:00,24.46,24.55,24.38,24.54,48912989,59175563.75,65.06435835824675,64.33380406771786,NaN,NaN,69.69780561431045,92.8680848970424,0.027285849276124263,0.3199368149496884,0.29265096567356413,708775766,748787864.4,92.32199142286477,86.884758481852,NaN,NaN,29.247573148445365,22.745046535886335
2017-03-01T09:30:00-05:00,25.01,25.29,24.98,25.24,92150012,60959201.25,75.0744506898458,66.08386859380019,NaN,NaN,152.05766600518672,97.55137481867015,0.059390811346638483,0.36688947985686227,0.3074986685102238,800925778,753028914.6,92.42940368103596,87.98570754643313,NaN,NaN,32.84667087801883,24.18813572761955
2017-03-02T09:30:00-05:00,25.29,25.295,24.84,24.85,69446222,60824901.3,64.06119666079857,66.5984189541684,NaN,NaN,117.28879509971136,98.8827680559293,0.04870791957314119,0.3683835679766503,0.3196756484035091,731479556,743380720.4,89.36647292679584,88.83273120280556,NaN,NaN,32.07610213659388,25.31498807175874
2017-03-03T09:30:00-05:00,24.87,25.03,24.86,24.97,57652782,61737716.05,65.72719464042949,67.14235708411431,NaN,NaN,105.75171291858247,105.42325212696498,0.044202438133806976,0.37492869607076784,0.33072625793696087,789132338,757600438.6,89.89781241455808,89.76299936243768,NaN,NaN,32.033537808700025,26.274780891321782
2017-03-06T09:30:00-05:00,24.82,24.86,24.67,24.78,49017181,59871244.2,60.91244274696128,67.01992468596823,NaN,NaN,72.48107797786928,103.45541152313206,0.02392080051638612,0.3606272585824435,0.33670645806605737,740115157,754085719,88.71779110904914,90.44452620710577,NaN,NaN,30.374150654942127,26.860405143267545
2017-03-07T09:30:00-05:00,24.82,24.82,24.65,24.71,53726499,60809965,59.192074185587614,66.48781460498681,NaN,NaN,61.93253047518957,101.90235649530788,0.0024177701142634733,0.3397286707088867,0.3373109005946232,686388658,749608297.4,87.14843214134879,90.72734349802703,NaN,NaN,28.504407672228275,27.09526264740479
2017-03-08T09:30:00-05:00,24.98,25.06,24.71,24.72,104601047,63498092.85,59.36862253859445,65.79486747968845,NaN,NaN,77.28045265050088,86.94691382437072,-0.01362367871899145,0.3202813021958839,0.33390498091487536,790989705,747621082.8,86.41777085814225,90.66289048451911,NaN,NaN,27.074188386915964,27.09225203876353
2017-03-09T09:30:00-05:00,24.82,24.94,24.7,24.81,60804082,63821242.2,61.00381351126178,65.33790265829093,NaN,NaN,70.08209442965456,77.50557369035934,-0.02026453055322175,0.3085743177233482,0.32883884827656995,851793787,771683929,87.75637856025111,90.5681228795258,NaN,NaN,26.355286844204446,26.98697129668366
2017-03-10T09:30:00-05:00,24.93,24.95,24.63,24.79,62148618,63087988.15,60.421880037833795,64.82931852728693,NaN,NaN,57.93979548634342,67.94319020391154,-0.027638901937369453,0.2942902208548581,0.3219291227922276,789645169,771786495.2,87.76191509056606,90.37256630077637,NaN,NaN,25.603470609372987,26.789328341353563
2017-03-13T09:30:00-04:00,24.82,24.8767,24.7,24.85,49418405,62804971.55,61.60518020506644,64.2827411174943,NaN,NaN,54.559029214496206,64.35878045123692,-0.029918044677538558,0.28453156694530435,0.3144496116228429,839063574,791576178.6,88.81305064254732,90.17611288454239,NaN,NaN,25.28848421487097,26.574922037570335
2017-03-14T09:30:00-04:00,24.75,24.8,24.6,24.78,49511126,61446175.95,59.37482724252453,63.55622068115942,NaN,NaN,21.6280279324438,56.29787994268777,-0.037112227406781606,0.2680593273643659,0.3051715547711475,789552448,812208936.6,89.79700728357112,89.9926553505707,NaN,NaN,24.41907973518032,26.266944565800333
2017-03-15T09:30:00-04:00,24.82,24.92,24.6342,24.74,86455125,61971218.25,58.080822821609075,62.737271357616294,NaN,NaN,28.245169357719234,46.490823284131444,-0.0450108148467121,0.24890803621275737,0.29391885105946947,703097323,794630460.2,83.0915303038083,89.30093000430273,NaN,NaN,23.34064626923206,25.848901952004866
2017-03-16T09:30:00-04:00,24.84,24.97,24.77,24.78,89233679,62589434.55,59.04211542833352,62.45298671452479,NaN,NaN,51.84656644114969,42.843717686430466,-0.04772885065011945,0.23425778774682016,0.2819866383969396,792331002,782737903.2,78.8041164043249,88.27407393827379,NaN,NaN,22.662418177755335,25.393689984254934
2017-03-17T09:30:00-04:00,24.75,24.76,24.45,24.45,83056828,63539867.45,49.04879473018322,61.284126699805434,NaN,NaN,-67.38423753076272,17.778911083009234,-0.07056108503091069,0.19378528210830126,0.26434636713921195,709274174,766663704.2,73.2988941239906,86.83018335448955,NaN,NaN,19.09270362601818,24.493549075935398
2017-03-20T09:30:00-04:00,24.4,24.47,24.25,24.271,78676416,64765860.5,44.63560022406267,59.824929690220856,NaN,NaN,-154.79215724419066,-24.091326208728145,-0.0950063157262099,0.14558847248144957,0.24059478820765948,630597758,724970541,61.33080514167794,84.61652719154763,NaN,NaN,14.621939005948251,23.083319065937236
2017-03-21T09:30:00-04:00,24.36,24.38,23.51,23.57,192257047,71617907.55,32.35712730230425,56.77369230539646,NaN,NaN,-270.76748469562995,-82.5704287343429,-0.15227736377711712,0.050248083486263084,0.2025254472633802,438340711,654728193.6,47.31432689003334,81.39402170647602,NaN,NaN,5.381422539568946,20.55447670502748
2017-03-22T09:30:00-04:00,23.4,23.63,23.23,23.52,133199544,75755938.9,31.68756874305906,54.4612903112722,NaN,NaN,-278.26727344372387,-143.87291729463152,-0.18522838517012058,-0.029010034199270507,0.15621835097085007,305141167,575136962.4,36.99680588088633,77.65333120319677,NaN,NaN,-1.9064845716664596,17.34576795121406
2017-03-23T09:30:00-04:00,23.49,23.84,23.44,23.57,85238878,77342413.4,33.17669406801633,52.136254556099836,NaN,NaN,-189.415288122923,-192.12528820744606,-0.19440479868133909,-0.08678764738082378,0.1076171513005153,390380045,494746771,29.903783122269786,73.36804339660476,NaN,NaN,-7.153619011813019,13.845855527924478
2017-03-24T09:30:00-04:00,23.61,23.73,23.38,23.54,97583434,79137246.1,32.71587966665804,50.12221433607817,NaN,NaN,-167.21299692736642,-212.09104008676678,-0.19286103104855296,-0.1334591375101759,0.059401893538377055,292796611,411451258.4,24.633874619441457,68.79062079020422,NaN,NaN,-11.47683239207384,10.228328682210433
2017-03-27T09:30:00-04:00,23.04,23.46,22.975,23.45,103962988,82352645.1,31.310824497229845,48.13069650119547,NaN,NaN,-165.29913696976396,-214.19243603188147,-0.18806847893691994,-0.17568370513277287,0.01238477380414707,188833623,323098431.4,20.5058819153804,64.03043863120648,NaN,NaN,-15.492508682131016,6.5539233444473695
2017-03-28T09:30:00-04:00,23.37,23.86,23.37,23.77,82301069,84022049.1,41.011352351850064,46.81946291642801,NaN,NaN,-96.54903152836319,-179.3487453984281,-0.15489699688328654,-0.1812364722999611,-0.026339475416674564,271134692,289657227.6,19.194782777110163,59.228796625418475,NaN,NaN,-16.06852778399092,3.322144611813328
2017-03-29T09:30:00-04:00,23.73,23.77,23.6,23.62,76476885,83238392.75,38.28218747490969,45.19648962811715,NaN,NaN,-84.8075516265027,-140.65680103498386,-0.13531831564173338,-0.1954873699688413,-0.06016905432710792,194657807,267560555.6,18.359474148294026,54.27187488170726,NaN,NaN,-17.401343008116086,0.3616463803948404
2017-03-30T09:30:00-04:00,23.64,23.99,23.61,23.93,92566017,84394382.5,46.24393292518791,44.183779120071016,NaN,NaN,-55.146491556358306,-113.80304172167091,-0.09562114226624517,-0.17969548215991438,-0.0840743398936692,287223824,246929311.4,17.58979829939034,49.25958082519471,NaN,NaN,-15.922307345909445,-1.9646327233629148
2017-03-31T09:30:00-04:00,23.84,23.91,23.73,23.73,70540021,85038744.45,42.44005406980914,42.81484153898121,NaN,NaN,-54.776206718477894,-91.31568367989323,-0.0777241478275945,-0.18122952467816233,-0.10350537685056783,216683803,231706749.8,17.022744574063523,44.131701820303014,NaN,NaN,-15.93004255200311,-3.959691270311514
2017-04-03T09:30:00-04:00,23.77,23.825,23.4,23.68,93489066,87262338.7,41.52053747103482,41.53953512673195,NaN,NaN,-66.54374821383892,-71.56460592870822,-0.06467947460123397,-0.1843547201021103,-0.11967524550087633,123194737,218578972.6,16.52789960945924,38.89819412929503,NaN,NaN,-16.221402067630457,-5.711364241357077
2017-04-04T09:30:00-04:00,23.58,23.7,23.5399,23.65,105795928,89865810.15,40.94728662145078,40.315711112434926,NaN,NaN,-61.061530457371134,-64.46710571450981,-0.053936194749197724,-0.1870954889373735,-0.13315929418817576,17398809,167831796,14.743670722768883,34.01620415922079,NaN,NaN,-16.62429449660095,-7.270354277820488
2017-04-05T09:30:00-04:00,23.87,23.9599,23.47,23.47,104651195,89868317.55,37.593535398950685,38.78366968176472,NaN,NaN,-55.595209204720135,-58.624637230153304,-0.05464828223570872,-0.20146964698281167,-0.14682136474710294,-87252386,111449757.4,13.057139046890839,29.319991490832646,NaN,NaN,-17.9752707131982,-8.799628054303017
2017-04-06T09:30:00-04:00,23.45,23.72,23.33,23.62,80802117,90868219.3,41.86655800579145,38.27065277287959,NaN,NaN,-61.09876505240851,-59.81509192936336,-0.04131865969070381,-0.1984696893604827,-0.1571510296697789,-6450269,52714938.8,11.572091741918271,24.91093417782748,NaN,NaN,-17.834277881988168,-10.090292315400896
2017-04-07T09:30:00-04:00,23.44,23.68,23.395,23.52,61525690,90837072.9,39.90489153315924,37.93274500924364,NaN,NaN,-61.09994362920423,-61.07983931150862,-0.03574696854212042,-0.20183474034742943,-0.166087771805309,-67975959,-4217013.6,10.344012413479092,21.269020411527556,NaN,NaN,-18.290938133016397,-11.261813146488825
2017-04-10T09:30:00-04:00,23.52,23.67,23.38,23.46,60428984,91387601.85,38.732246593117196,38.38811067287313,NaN,NaN,-63.3717936547654,-60.445448399693916,-0.03269569462861427,-0.20695739009107683,-0.17426169546246256,-128404943,-54536949.6,9.394983863714799,18.560495909647653,NaN,NaN,-19.00338392051401,-12.367751828492423
2017-04-11T09:30:00-04:00,23.34,23.43,23.15,23.39,83801181,93102104.6,37.35313646863647,38.79279408184294,NaN,NaN,-94.93292998447514,-67.21972830511473,-0.03194777876645366,-0.21419641892052965,-0.182248640154076,-212206124,-100457936.2,8.617933453247261,16.533433593387716,NaN,NaN,-19.98777632105175,-13.456326756000898
2017-04-12T09:30:00-04:00,23.36,23.3843,23.14,23.2,74023032,92480499.95,33.831916888292895,38.83959571186269,NaN,NaN,-113.63858394038492,-78.82840325224768,-0.0402680743007259,-0.23258373302998336,-0.19231565872925746,-286229156,-140253290.2,8.000386518334452,14.968905264535197,NaN,NaN,-21.882991089862497,-14.660135946552554
2017-04-13T09:30:00-04:00,23.11,23.3664,22.9,22.9,120159316,94026781.8,29.158045291977075,38.58546468509977,NaN,NaN,-173.8233794282614,-101.37332612741825,-0.060764149350506474,-0.26827084541739055,-0.20750669606688407,-406388472,-220240930.8,6.926077163128653,13.704062589084284,NaN,NaN,-25.07918038154977,-16.148570865837872
2017-04-17T09:30:00-04:00,22.96,23.31,22.89,23.3,86681175,94207999.15,40.884685401694554,39.26931189256153,NaN,NaN,-134.83339107118664,-116.12001561581474,-0.043006470534233565,-0.26126478423467603,-0.21825831370044246,-319707297,-270587198.4,6.348245692107554,12.69280285885051,NaN,NaN,-24.02616721848321,-17.273941773358633
2017-04-18T09:30:00-04:00,23.14,23.25,22.94,23.08,74890353,94018696,37.2340327726506,38.99950335119014,NaN,NaN,-145.61805005427246,-132.56926689571614,-0.04167189788109599,-0.27034818605181243,-0.22867628817071645,-394597650,-323825739.8,5.797445489091601,11.735850195420616,NaN,NaN,-24.380426667309024,-18.28915390106583
2017-04-19T09:30:00-04:00,23.23,23.32,22.98,23.01,55583806,87185033.95,36.12862793399567,38.845677669696286,NaN,NaN,-121.06137364005544,-137.7949556268322,-0.04103334224904906,-0.2799679659820278,-0.23893462373297872,-450181456,-371420806.2,5.35049938546787,10.806637712361606,NaN,NaN,-25.0154086769826,-19.25004744048251
2017-04-20T09:30:00-04:00,23.18,23.45,23.0936,23.4,85694445,84809779,45.78571731327918,38.81294798313137,NaN,NaN,-46.46410944541322,-124.36006072783786,-0.011414862099822065,-0.2532032013577563,-0.24178833925793425,-364487011,-387072377.2,5.208300817225265,9.922245035064098,NaN,NaN,-22.236914385631145,-19.676742718360888
2017-04-21T09:30:00-04:00,23.34,23.43,23.15,23.16,94675256,85281597.9,41.61578143061278,38.75407136604593,NaN,NaN,-60.80615330812581,-101.75661550381075,-0.005364087794716754,-0.2484934490013302,-0.24312936120661344,-459162267,-397627136.2,5.109679759400606,9.071311834016745,NaN,NaN,-21.357743932620686,-19.91688574896943
2017-04-24T09:30:00-04:00,23.69,23.81,23.59,23.68,98770606,85340956.5,51.848401494817224,39.49177593917324,NaN,NaN,73.79547618706181,-60.03084205216103,0.03411136382467586,-0.20049015642576862,-0.23460152025044448,-360391661,-405764009,5.03059606803906,8.250075866772447,NaN,NaN,-16.733989057885772,-19.462186221671764
2017-04-25T09:30:00-04:00,23.89,24.01,23.86,23.89,69012648,83593439.5,55.25875994613193,40.51402403379332,NaN,NaN,127.32127117081674,-5.442977807143194,0.07260616475542847,-0.1438438143061589,-0.21644997906158736,-291379013,-385120281.6,8.883647858776683,7.83150280505872,NaN,NaN,-11.838835022027022,-18.373136050293944
2017-04-26T09:30:00-04:00,23.86,24.09,23.82,23.87,71691249,83062948.5,54.86024697455985,41.747360574908264,NaN,NaN,120.06223899664134,42.78174472019616,0.09362480494421072,-0.09941897288132395,-0.19304377782553467,-363070262,-367698042.8,12.123998095686915,7.764849879972725,NaN,NaN,-8.253520616347815,-16.927476702587356
2017-04-27T09:30:00-04:00,23.92,23.92,23.62,23.76,68871770,82682692.75,52.612846345835415,42.514952599197116,NaN,NaN,73.03798307484695,66.68216322424819,0.0966309146866633,-0.07225513446720555,-0.16888604915386884,-431942032,-381189047,11.774798203285613,7.779328912927537,NaN,NaN,-6.082444984744074,-15.378186457181172
2017-04-28T09:30:00-04:00,23.77,23.79,23.53,23.53,64091925,81258988.15,48.16945742014775,43.10527873398201,NaN,NaN,36.61775120921549,86.16694412771645,0.08031117300688476,-0.0684970828952629,-0.14880825590214766,-496033957,-388563385,11.578487704789254,7.867505719449693,NaN,NaN,-5.666728538342295,-13.990835325918475
2017-05-01T09:30:00-04:00,23.65,23.8,23.55,23.68,69086646,81186319.4,51.071681415872945,43.986666935607424,NaN,NaN,56.27831127085897,82.66351114447589,0.07680153672770687,-0.05280633499251408,-0.12960787172022095,-426947311,-401874515,11.215019314479491,7.9975082516471705,NaN,NaN,-4.411913512696848,-12.622417924029671
2017-05-02T09:30:00-04:00,23.68,23.71,23.5229,23.65,76511460,80337439.1,50.46307910269453,44.92309140946871,NaN,NaN,42.29426914097859,65.65811073850826,0.06984278154905861,-0.04230439478389769,-0.1121471763329563,-503458771,-444290466.6,10.124377572794131,8.105111403043377,NaN,NaN,-3.5876013809030263,-11.331729846440151
2017-05-03T09:30:00-04:00,23.57,23.84,23.55,23.84,78115437,78953414.55,54.186672952021446,46.37700255687789,NaN,NaN,72.64741790288448,56.17514651975689,0.07496767512302173,-0.018437582429179145,-0.09340525755220087,-425343334,-456745081,9.822325266713875,8.235249885070479,NaN,NaN,-1.7626923841813538,-9.964724494688895
2017-05-04T09:30:00-04:00,23.99,24.07,23.781,23.88,64482819,76944995.75,54.954347691051794,48.219595585383225,NaN,NaN,110.81142741718334,63.72983538822416,0.07765419417765305,0.003662485169865448,-0.0739917090077876,-360860515,-442528777.6,13.012480739811124,8.669992997690658,NaN,NaN,-0.051216190692737966,-8.548509022689444
2017-05-05T09:30:00-04:00,23.95,23.96,23.76,23.84,46881451,75248962.45,53.98024453856228,49.154992666588065,NaN,NaN,86.77000220920065,73.7602855882212,0.07338915283285033,0.017744732033275312,-0.05564442079957502,-407741966,-424870379.4,16.94290005446973,9.42675402357367,NaN,NaN,1.1003112960091714,-7.170106120018214
2017-05-08T09:30:00-04:00,23.87,23.91,23.78,23.82,45893018,74467328.85,53.4698959495509,50.3146971792238,NaN,NaN,74.62456546128627,77.42953642630664,0.06609967317067833,0.026980170663772896,-0.039119502506905435,-453634984,-430207914,16.697314594749955,10.205316102549267,NaN,NaN,1.9248043455013149,-5.870833196372566
2017-05-09T09:30:00-04:00,23.88,23.96,23.65,23.73,65737851,74732772.2,51.127378713712176,51.38603652063212,NaN,NaN,55.727214539006916,80.11612550591231,0.05267876974049175,0.02672895966870925,-0.025949810071782497,-519372835,-433390726.8,16.54332450717871,11.0048036112429,NaN,NaN,2.0215437738455346,-4.743350772055695
2017-05-10T09:30:00-04:00,23.69,23.81,23.645,23.81,51192670,73102346.65,53.09449238744341,51.90809188307242,NaN,NaN,45.84086096703746,74.7548141187429,0.04684729188967346,0.032609304790309324,-0.014237987099364132,-468180165,-441958093,16.11256802839739,11.783679840612336,NaN,NaN,2.619128064160308,-3.691568081167695
2017-05-11T09:30:00-04:00,23.72,23.76,23.47,23.66,77266708,73264530.45,49.103658678092444,52.4429402578924,NaN,NaN,11.653596823478654,54.92324800000197,0.031293577532887126,0.024878984816744776,-0.006414592716142349,-545446873,-478875364.6,14.375563837098468,12.445528703305042,NaN,NaN,2.0773354257753454,-2.8674390087472608
2017-05-12T09:30:00-04:00,23.55,23.57,23.43,23.56,55787188,70045924.05,46.58948380434795,52.06730328000174,NaN,NaN,-26.785108835688508,32.21222579102413,0.013581063890704601,0.010561737147238404,-0.0030193267434661976,-601234061,-517573783.6,12.815891934713804,13.00162126521038,NaN,NaN,0.9243663257936305,-2.3257525323842763
2017-05-15T09:30:00-04:00,23.61,23.79,23.6,23.74,52192101,68321470.35,51.411940865100775,51.79253048849951,NaN,NaN,25.421786829370642,22.37167006464101,0.013281967790163687,0.013583132994238412,0.0003011652040747245,-549041960,-536655178.8,12.117767918250308,13.232629840887068,NaN,NaN,1.2269777100524246,-1.8182196406076048
2017-05-16T09:30:00-04:00,23.79,23.83,23.67,23.81,51529642,67153434.8,53.18230200527451,51.6726772764077,NaN,NaN,40.84620950922147,19.395469058683943,0.016862728251385326,0.021379575518306382,0.004516847266921056,-497512318,-532283075.4,13.283372120620342,13.315442271239457,NaN,NaN,1.9701946282179923,-1.277017602203948
2017-05-17T09:30:00-04:00,23.31,23.49,22.97,23.06,141192783,71433883.65,37.441331417708774,50.58899763868436,NaN,NaN,-210.26543712615285,-31.82579055995412,-0.029681319639244048,-0.03258480228213401,-0.002903482642889958,-638705101,-566388062.6,11.951715032431565,13.328079187607022,NaN,NaN,-2.7760783431994804,-1.4911691366318813
2017-05-18T09:30:00-04:00,23.03,23.29,23,23.15,101656920,72232007.4,39.74603939016891,49.98732492225731,NaN,NaN,-203.91730405366533,-74.93997073538291,-0.051528223086878475,-0.06731376150148805,-0.015785538414609574,-537048181,-564708324.2,12.417419331247615,13.38800287521119,NaN,NaN,-5.740517752275993,-2.0982189388667543
2017-05-19T09:30:00-04:00,23.19,23.48,23.18,23.35,69775647,70987026.95,44.62796400698915,49.527059393051324,NaN,NaN,-135.64195341955218,-96.71133965215566,-0.04961279781837108,-0.07780153568757342,-0.028188737869202344,-467272534,-537916018.8,19.711888704455973,13.994922117352369,NaN,NaN,-6.585410144418255,-2.7392462539455398
2017-05-22T09:30:00-04:00,23.48,23.48,23.25,23.41,79181862,70007589.75,46.04043598282801,49.21115631306086,NaN,NaN,-101.4247302871694,-122.08064307546366,-0.04172541035366488,-0.08034550081128344,-0.038620090457618564,-388090672,-505725761.2,27.522389559566037,15.237637259264647,NaN,NaN,-6.810658248439452,-3.3208765388732413
2017-05-23T09:30:00-04:00,23.43,23.66,23.32,23.59,65577828,69835848.75,50.14881735380451,48.92273805604536,NaN,NaN,-42.14215156380266,-138.6783152900685,-0.022755162256210007,-0.06706404327788107,-0.04430888102167106,-322512844,-470725866.4,34.93394082102195,17.03132408457237,NaN,NaN,-5.700895696683096,-3.6608792757032207
2017-05-24T09:30:00-04:00,23.62,23.64,23.475,23.58,60004715,69251522.05,49.9214116491375,48.563242624480054,NaN,NaN,-20.416343069720718,-100.70849647878205,-0.009906336084631304,-0.056691801127460195,-0.04678546504282889,-382517559,-419488358,43.967362128620415,19.24238704091589,NaN,NaN,-4.8850871104788665,-3.8357661092425985
2017-05-25T09:30:00-04:00,23.63,23.73,23.56,23.62,49362388,68276052.95,50.880891394078006,48.34186025701689,NaN,NaN,11.139506199487112,-57.69713442815157,0.0016456064505276577,-0.04472845697966932,-0.046374063430196975,-333155171,-378709756,49.92590274516148,21.59831580453673,NaN,NaN,-3.9403460320960626,-3.8507060982216648
2017-05-26T09:30:00-04:00,23.56,23.68,23.56,23.61,42601706,67201542,50.61977829245815,48.13828042436741,NaN,NaN,2.9189739816789846,-29.984948947905337,0.008584481669965324,-0.035643461342740324,-0.04422794301270565,-375756877,-360406624.6,52.373957240317225,24.146647422077248,NaN,NaN,-3.2334046656366473,-3.762520179280948
2017-05-30T09:30:00-04:00,23.54,23.566,23.4,23.45,46584183,66076418.85,46.50733369589269,47.80827720880888,NaN,NaN,-50.59911728551383,-19.81982634757422,0.0026760130180819713,-0.04088292674010319,-0.04355893975818516,-422341060,-367256702.2,51.361902891687926,26.633688735256474,NaN,NaN,-3.750040317459323,-3.7607373418778587
2017-05-31T09:30:00-04:00,23.45,23.46,23.1,23.25,115877876,68044739.65,41.92251804325983,47.0102790413672,NaN,NaN,-112.4743822395493,-33.886272482723555,-0.013533995915596973,-0.06047643465268138,-0.0469424387370844,-538218936,-410397920.6,45.41041547400001,28.72639212422809,NaN,NaN,-5.549341059760232,-4.016252158718197
2017-06-01T09:30:00-04:00,23.38,23.56,23.22,23.54,81187583,68198346.95,49.67030113908957,47.05075350286699,NaN,NaN,-45.85867756089534,-38.97473938095848,-0.0040495532848375745,-0.05200438034313137,-0.0479548270582938,-457031353,-425300679.4,43.533822168254424,30.809124862167803,NaN,NaN,-4.795969499292061,-4.1276403502287495
2017-06-02T09:30:00-04:00,23.37,23.57,23.32,23.45,83704479,69159429.95,47.55022505460164,47.11937787788511,NaN,NaN,-37.326624088760354,-48.66796543860797,-0.003198998852375373,-0.051953575623763015,-0.04875457677138764,-540735832,-466816811.6,38.73186783410672,32.66026599783873,NaN,NaN,-4.813816090220892,-4.225665455941913
2017-06-05T09:30:00-04:00,23.46,23.64,23.46,23.49,44055796,69018147.2,48.6002931451636,46.9185458978896,NaN,NaN,1.3099814894005817,-48.98976393706365,0.0004990017165545924,-0.0481308246256944,-0.048629826342248994,-496680036,-491001443.4,36.22513247996675,34.382220609389904,NaN,NaN,-4.523919299854132,-4.2682731479293725
2017-06-06T09:30:00-04:00,23.31,23.45,23.26,23.39,60397338,69743363.2,46.11465726374621,46.41371413063758,NaN,NaN,-60.829793700558305,-51.035899220072544,-0.0031477392011800553,-0.05256450034372406,-0.04941676114254401,-557077374,-517948706.2,33.614606955659156,35.83445166903553,NaN,NaN,-4.99060939170754,-4.371464039897682
2017-06-07T09:30:00-04:00,23.43,23.63,23.39,23.57,83049054,70608923.35,50.975066346804745,47.380409482715855,NaN,NaN,18.78566390973455,-24.783889990215773,0.006669266596701459,-0.04108017789666718,-0.04774944449336864,-474028320,-505110583,35.981586124853024,37.550871032779924,NaN,NaN,-3.968185959782819,-4.3138528855955585
2017-06-08T09:30:00-04:00,23.57,24.01,23.55,23.84,77986983,71948639,57.20985673545652,48.627825007379265,NaN,NaN,145.4124653925659,13.470338600476477,0.030138853470017178,-0.010075877655847165,-0.04021473112586434,-396041337,-492912579.8,38.2349763412226,39.39498224777814,NaN,NaN,-1.0829883854042905,-3.852300814139663
2017-06-09T09:30:00-04:00,23.99,24.33,23.97,24.29,133216200,74746113.6,65.16210874914619,50.09454963181905,NaN,NaN,270.62831947089563,75.06132731240768,0.07235378608506823,0.05022750148047095,-0.02212628460459728,-262825137,-437330440.8,47.33218207602966,41.36786034574768,NaN,NaN,4.416492546593675,-2.6710446197491864
2017-06-12T09:30:00-04:00,24.34,24.51,24.2,24.34,86644404,76288974.4,65.91996800995129,51.514516205185,NaN,NaN,245.06689917894835,123.81271085031722,0.09841298728757797,0.10088994950487518,0.0024769622172972107,-176180733,-373230580.2,55.47660296958987,43.3645898750351,NaN,NaN,8.955608483233647,-1.0100941764659248
2017-06-13T09:30:00-04:00,24.47,24.55,24.395,24.47,94978649,78428301.8,67.87663010865165,52.780788544816936,NaN,NaN,220.3436304348794,180.04739567740475,0.11786113264189763,0.14980337801966925,0.03194224537777162,-81202084,-278055522.2,64.30322637469934,45.462395986012055,NaN,NaN,13.317298372144418,1.0366761876212667
2017-06-14T09:30:00-04:00,24.26,24.54,24.13,24.51,117605841,81732111.75,68.47635705295644,54.10614178794686,NaN,NaN,166.09560390796693,209.50938367705126,0.1261338732462567,0.1896095869355925,0.0634757136893358,36403757,-175969106.8,70.9546225607606,47.39005744545064,NaN,NaN,16.997426772301434,3.3167834140041474
2017-06-15T09:30:00-04:00,24.33,24.54,24.31,24.41,59547702,77649857.7,65.19918443232004,55.12887700496416,NaN,NaN,139.60470352764978,208.34783130406805,0.11774645837851364,0.21065878666247784,0.0929123282839642,-23143945,-101389628.4,74.6681514384004,49.15736092353914,NaN,NaN,19.09908758681233,5.5713982958338875
2017-06-16T09:30:00-04:00,24.31,24.37,24.2201,24.29,53818768,75257950.1,61.401625946390084,55.89900898024501,NaN,NaN,98.58134495702575,173.93843640129404,0.09781174169595871,0.2151770054039126,0.11736526370795389,-76962713,-64217143.6,76.2949633597513,50.86600421778443,NaN,NaN,19.757227016104352,7.597945255872525
2017-06-19T09:30:00-04:00,24.45,24.59,24.42,24.54,58041293,74671232.4,65.86265902839054,57.28153221828056,NaN,NaN,118.6555828909067,148.65617314368572,0.09507401360127882,0.2362077807095524,0.14113376710827358,-18921420,-32765281,77.60542054118653,52.74054119274861,NaN,NaN,21.719682428956542,9.615336280598813
2017-06-20T09:30:00-04:00,24.46,24.48,24.32,24.33,45689645,72996621.55,59.6284166864517,58.546239264222834,NaN,NaN,83.2318274976244,121.23381255623471,0.07368572275843105,0.2332409205563124,0.15955519779788135,-64611065,-29447077.2,77.74520125226738,55.05016874833914,NaN,NaN,21.438563286395958,11.304368709998405
2017-06-21T09:30:00-04:00,24.37,24.38,24.11,24.13,51938219,72314641.1,54.35182005074377,58.88063347219814,NaN,NaN,49.82980807668859,97.98065338997907,0.04219906202585047,0.21230402533019443,0.17010496330434396,-116549284,-60037685.4,73.20854524856829,57.16979182550442,NaN,NaN,19.498472303613763,12.474954937657742
2017-06-22T09:30:00-04:00,24.04,24.11,23.95,23.98,58380184,72233414.55,50.726226451559256,59.107490714837965,NaN,NaN,15.741731620548693,73.20805900855885,0.00912822446169853,0.18151524388146711,0.17238701941976858,-174929468,-90394790,68.91111856809295,59.32545259221771,NaN,NaN,16.71986753925372,13.081371023600024
2017-06-23T09:30:00-04:00,24.08,24.09,23.81,23.89,85352592,74032924.75,48.63015252722162,59.10962352784211,NaN,NaN,-0.3434131180387957,53.42310739354592,-0.019393661738731582,0.1481449422463541,0.1675386039850857,-260282060,-127058659.4,64.02296213337834,61.311011853175685,NaN,NaN,13.791856738234982,13.18286898283359
2017-06-26T09:30:00-04:00,23.94,24.12,23.86,24.02,60302320,74917955.45,51.732660636183745,59.51090948301622,NaN,NaN,8.619993210311614,31.4159894574269,-0.029485100829486466,0.1306822279482276,0.16016732877771406,-199979740,-163270323.4,59.5314062610997,63.1622118035643,NaN,NaN,12.260860806603972,13.051153529086502
2017-06-27T09:30:00-04:00,24.11,24.32,24.05,24.14,75943411,76385916.85,54.46641251709634,59.76029135232276,NaN,NaN,34.29317809741807,21.628259577385627,-0.028066656945702706,0.1250840075955857,0.1531506645412884,-124036329,-175155376.2,58.09092811195417,64.74145051692867,NaN,NaN,11.788626987389213,12.870792594558317
2017-06-28T09:30:00-04:00,24.3,24.56,24.28,24.52,90097595,75096902.8,61.83747184300867,60.090835288576486,NaN,NaN,81.19577979190387,27.90145392042869,-0.0028518363881506748,0.14958586905610005,0.15243770544425073,-33938734,-158633266.2,59.55601555133519,66.26438188907956,NaN,NaN,13.766247898299547,12.998714780807065
2017-06-29T09:30:00-04:00,25.02,25.02,24.51,24.69,119176691,76996358.2,64.59849336186218,60.05057704662762,NaN,NaN,128.57202161962203,50.46751192024336,0.022561080007237944,0.18063905545329817,0.15807797544606023,85237957,-106599781.2,63.84298298057039,67.44372481083248,NaN,NaN,16.310989300751448,13.471896855084834
2017-06-30T09:30:00-04:00,24.87,24.88,24.62,24.67,72754878,76448878.15,64.01173671016127,59.91427481092834,NaN,NaN,119.94888280316394,74.52597110448392,0.03458919457540205,0.20131446866531277,0.16672527408991072,12483079,-52046753.4,67.70768535179536,68.31737355241857,NaN,NaN,18.14386727401579,14.1393212006464
2017-07-03T09:30:00-04:00,24.81,25.19,24.78,25.03,61454445,77318810.6,69.39963541273612,60.023060904077234,NaN,NaN,166.37524675794432,106.07702181401046,0.061769317503383936,0.24393692096914066,0.18216760346575672,73937524,2736699.4,71.0537269704126,68.7995521663981,NaN,NaN,21.59534541753328,15.204467517344526
2017-07-05T09:30:00-04:00,25.1,25.13,24.915,25.07,78100184,78203952.9,69.93817307029283,60.127476333886975,NaN,NaN,165.9730245281211,132.41299110015106,0.07645916158031443,0.27774155544114976,0.20128239386083532,152037708,57951506.8,73.98009360861735,69.01565724124501,NaN,NaN,24.500091541776936,16.532413806549155
2017-07-06T09:30:00-04:00,25.06,25.17,24.88,24.88,98353765,78969188.45,64.16193332272002,60.05338696891555,NaN,NaN,141.0788688141189,144.38960890459407,0.06769794637658971,0.2859048268315725,0.21820688045498277,53683943,75476042.2,74.84918177404167,69.02858797950509,NaN,NaN,25.174476261802308,17.766994157299607
2017-07-07T09:30:00-04:00,25.01,25.1,24.88,25.05,59432444,78041461.5,66.80373467477057,60.43925187808558,NaN,NaN,131.66167508243402,145.00753959715647,0.06751740057714478,0.30260363117641376,0.23508623059926897,113116387,81051728.2,75.13376196816137,68.94564502296296,NaN,NaN,26.56792164138489,19.02426951216893
2017-07-10T09:30:00-04:00,25.01,25.08,24.93,25.02,55022450,74131774,65.88079894557336,60.440547586455786,NaN,NaN,113.1386834076687,143.6454997180574,0.05980709805744444,0.3098451031710745,0.25003800511363006,58093937,90173899.8,75.6198045824254,68.80381531162287,NaN,NaN,27.414260029996733,20.22283958614433
2017-07-11T09:30:00-04:00,25,25.01,24.73,24.8,49857176,72292412.6,59.39980191221222,60.424217959724395,NaN,NaN,68.01036993833267,123.97252435413506,0.0355198081003098,0.2944377652390173,0.2589179571387075,8236761,77033747.2,73.39437482178569,68.4930419951599,NaN,NaN,26.17195115685458,21.072712667674367
2017-07-12T09:30:00-04:00,24.77,24.9,24.73,24.88,47818560,69934408.15,60.90587634917682,60.892364838183894,NaN,NaN,59.22995826544801,102.62391110160047,0.021179905757121753,0.2853928393351097,0.264212933577988,56055321,57837269.8,70.14656517552561,68.2743291327997,NaN,NaN,25.588292238509545,21.717795463507965
2017-07-13T09:30:00-04:00,24.88,25.03,24.86,25.03,48875853,66497908.75,63.63012093868277,61.814071587264145,NaN,NaN,78.048436482675,90.01782463531167,0.018245517811586565,0.2870198308424712,0.2687743130308846,104931174,68086716,70.88731838911302,68.41548626287258,NaN,NaN,25.89339361977407,22.314309485831693
2017-07-14T09:30:00-04:00,24.72,24.96,24.59,24.92,61742329,66607640.1,60.311042183658486,62.64842084843821,NaN,NaN,44.23595701542657,72.53268102191018,0.00597953297554793,0.2762487292503195,0.2702691962747716,43188845,54101207.6,68.39354551083466,68.72767078983375,NaN,NaN,25.172090277816068,22.722563884686604
2017-07-17T09:30:00-04:00,24.85,24.9,24.74,24.84,43257045,66079553.95,57.943794365572664,63.092073257680276,NaN,NaN,40.75523446384664,58.055991233145754,-0.009591411465356858,0.2582799319430755,0.2678713434084324,-68200,42468780.2,66.30421912006145,69.21144313690245,NaN,NaN,23.883249227170598,22.88837607647003
2017-07-18T09:30:00-04:00,24.67,24.84,24.64,24.8,63210692,66338023.9,56.744501190649814,63.254793877219804,NaN,NaN,25.099108653388036,49.47373897615684,-0.023843018601950372,0.23806757015599445,0.2619105887579448,-63278892,28165649.6,63.726379728537104,69.6139753952298,NaN,NaN,22.47702629305505,22.829611821696464
2017-07-19T09:30:00-04:00,24.85,24.92,24.72,24.81,48259409,66466512.1,56.98420288196883,62.908131808574105,NaN,NaN,33.38760789257369,44.30526890158197,-0.03327537162701821,0.22031637422417205,0.25359174585119026,-15019483,13950688.8,61.18056148036638,69.73001439016059,NaN,NaN,21.37333357029889,22.62157207149681
2017-07-20T09:30:00-04:00,24.83,24.94,24.75,24.8,40163535,65877777.9,56.646149835545025,62.34010727098002,NaN,NaN,32.681820375467076,35.231945680140385,-0.0403931619811555,0.2031002933747459,0.2434934553559014,-55183018,-18072149.6,55.77493467973471,69.15372522581518,NaN,NaN,20.358395906109823,22.298261190727242
2017-07-21T09:30:00-04:00,24.73,24.88,24.73,24.8,43888447,65153191.05,56.646149835545025,61.813993922793145,NaN,NaN,21.114438377079537,30.607641952470978,-0.04495686213669928,0.1872973776850273,0.23225423982172658,-55183018,-37746522.2,52.69442202192851,68.08134927368184,NaN,NaN,19.500046241994397,21.898516198051123
2017-07-24T09:30:00-04:00,24.79,24.94,24.785,24.91,26364776,62203800.25,59.696405282729536,61.1209060563641,NaN,NaN,37.78801843318462,30.014198746338575,-0.040558062530813566,0.1815566616582096,0.22211472418902317,-28818242,-43496530.6,51.79406206700527,66.70565892343846,NaN,NaN,19.492676690281844,21.554824839798368
2017-07-25T09:30:00-04:00,25.19,25.32,25.145,25.22,75786820,62978025.25,66.78817967134083,60.895906527867574,NaN,NaN,182.78125060856482,61.550627137373944,-0.01791636125885554,0.19971927261545375,0.2176356338743093,46968578,-21447036.6,54.9713411878141,65.34789089338109,NaN,NaN,21.538310168906687,21.552465601099556
2017-07-26T09:30:00-04:00,25.25,25.29,24.99,25.05,56086548,61985182.1,60.50113480701926,60.63442091960324,NaN,NaN,118.25563122054507,78.52423180296822,-0.015618921661715218,0.19811198179716527,0.2137309034588805,-9117970,-20266734,55.14178304518919,63.94021955560591,NaN,NaN,21.47667620836982,21.54163854499531
2017-07-27T09:30:00-04:00,25.1,25.11,24.8,24.91,67826171,60871610.9,55.839361072014356,59.851251376549214,NaN,NaN,18.87879015499414,75.76362575887363,-0.024243178132149545,0.18342693079369354,0.2076701089258431,-76944141,-24618958.6,54.325216965885005,62.453894912586165,NaN,NaN,20.01441228719619,21.32346336530972
2017-07-28T09:30:00-04:00,24.87,24.98,24.77,24.91,43735806,57099566.65,55.83936107201434,59.13400581415215,NaN,NaN,-18.68860314670533,67.80301745411666,-0.030271116292908795,0.1698312135597071,0.2001023298526159,-76944141,-28971183.2,53.472459803177486,60.871941714068456,NaN,NaN,18.835378520729947,20.968022673226894
2017-07-31T09:30:00-04:00,25,25.1775,24.97,25.09,43039260,55613785.75,60.39031928485962,59.20475705505553,NaN,NaN,94.26218442015248,79.09785065151023,-0.02279956447269757,0.17160287426174392,0.1944024387344415,-33904881,-29988511,53.261996856095536,59.43391471651916,NaN,NaN,19.122581985091916,20.70438828920761
2017-08-01T09:30:00-04:00,25.26,25.29,25.14,25.27,60987497,55590438.35,64.34714150931669,59.450561709351234,NaN,NaN,166.81752899575085,75.90510632894743,-0.007206500134255556,0.18539431356662206,0.19260081370087762,27082616,-33965703.4,52.3937851611288,58.165859001205106,NaN,NaN,20.59028571321447,20.68808792120859
2017-08-02T09:30:00-04:00,25.3,25.33,25.18,25.31,43341507,53852504.5,65.17957853680602,59.56123725207432,NaN,NaN,164.68647938978552,85.19127596279552,0.0037415088488929604,0.19727769976199383,0.19353619091310087,70424123,-18057284.8,55.51723848419056,57.0679961508535,NaN,NaN,22.03643490300609,20.880708918608235
2017-08-03T09:30:00-04:00,25.27,25.31,25.18,25.22,40816841,50975658.3,61.68949782379585,59.65969836922699,NaN,NaN,124.86945997912063,106.38940992762082,0.0028993504516019453,0.1971603789776033,0.19426102852600136,29607282,3252999.8,59.363465832750904,56.4229904595618,NaN,NaN,22.250413719095576,21.07638103296357
2017-08-04T09:30:00-04:00,25.45,25.49,25.34,25.39,50792914,50543681.8,65.45247792024631,60.19603290884654,NaN,NaN,167.57146208237995,143.64142297343787,0.0112974752749741,0.208382872619719,0.1970853973447449,80400196,34721867.2,64.27574398237473,56.27809937829847,NaN,NaN,23.573721781722607,21.433143997072005
2017-08-07T09:30:00-04:00,25.39,25.4,25.31,25.35,39486769,49766897.75,63.862983408055065,60.704495924375486,NaN,NaN,123.83379534413356,149.5557451582341,0.01161952839343186,0.2116098078365347,0.19999027944310285,40913427,49685528.8,66.35825023822474,56.466090128990444,NaN,NaN,24.20182913852298,21.828670445850715
2017-08-08T09:30:00-04:00,25.31,25.59,25.27,25.28,52736465,49910862.2,61.06806070983007,60.996200054937,NaN,NaN,115.59302463082147,139.31084428524824,0.004921760499996819,0.20614248006809888,0.20122071956810206,-11823038,41904398,64.26048613579455,56.68608474723531,NaN,NaN,23.93480974759879,22.129547488957584
2017-08-09T09:30:00-04:00,25.07,25.3,25.07,25.28,46567038,49848286.1,61.06806070983008,61.31205083167164,NaN,NaN,54.91099476440414,117.35574736017195,-0.00136876836716332,0.19950975910914792,0.20087852747631124,-11823038,25454965.8,59.946132205327515,56.98402742763479,NaN,NaN,23.715795418066758,22.35615433597318
2017-08-10T09:30:00-04:00,25.12,25.175,24.83,24.83,71130286,50961007.75,46.044256826435685,60.5547727595924,NaN,NaN,-35.39197338323496,85.30346068770083,-0.03578911680233027,0.1561421314733984,0.19193124827572866,-82953324,2942844.6,54.548483291686246,57.11646037547463,NaN,NaN,18.51850243737218,21.807918350458753
2017-08-11T09:30:00-04:00,24.83,24.958,24.67,24.73,50477789,50397780.75,43.48408962814939,59.39675021283667,NaN,NaN,-86.86252695481895,34.41666288026106,-0.06361856666289004,0.11240803994711612,0.17602660661000616,-133431113,-39823417.2,46.063187137123776,56.70711216619738,NaN,NaN,13.426315803507622,20.610546558037164
2017-08-14T09:30:00-04:00,24.93,25.14,24.92,25.07,49472883,50708572.65,53.04388542079297,58.415014909226116,NaN,NaN,-5.923926451587892,8.465118521116759,-0.05763333157422407,0.10398494214222609,0.16161827371645016,-83958230,-64797748.6,41.95848724036144,55.7776225985222,NaN,NaN,12.097028027303923,19.394329625075272
2017-08-15T09:30:00-04:00,25.28,25.31,25.09,25.09,48535038,49974789.95,53.54171060668442,57.91791318063077,NaN,NaN,30.734264112442077,-8.506633582559127,-0.05105775737314172,0.09779607700002302,0.14885383437316474,-35423192,-69517779.4,41.21104658574009,54.78256999427583,NaN,NaN,11.233872997790655,18.228550106891756
2017-08-16T09:30:00-04:00,25.2,25.24,24.995,25.04,35084074,49316023.2,52.055847084583704,57.64766218152858,NaN,NaN,-1.0414050596785633,-19.697113547375658,-0.04880773802866939,0.08784416183732802,0.1366518998659974,-70507266,-81254625,39.334654978880394,53.711815566632644,NaN,NaN,10.079141970750587,17.064348944585873
2017-08-17T09:30:00-04:00,24.98,25.02,24.6,24.61,76613078,51138500.35,41.41205085049274,56.61714002284847,NaN,NaN,-135.58664508545834,-39.736047887820334,-0.07352631194337253,0.04474400993678174,0.11827032188015427,-147120344,-94088029,37.33304958324993,52.559000550923535,NaN,NaN,5.21582308936641,15.371702393840236
2017-08-18T09:30:00-04:00,24.49,24.8,24.48,24.62,71725883,52530372.15,41.710543244649116,55.28287030569057,NaN,NaN,-166.17605928699336,-55.59875435425522,-0.0856051357367966,0.011263902209158516,0.09686903794595511,-75394461,-82480698.6,40.29247468541829,51.63260611016087,NaN,NaN,1.5890997659265937,13.402759161281145
2017-08-21T09:30:00-04:00,24.6,24.63,24.45,24.55,45047234,53464495.05,40.1678270611799,53.555776416537945,NaN,NaN,-174.09392461985954,-89.23275398790955,-0.0940387188092284,-0.020679360565580396,0.073359358243648,-120441695,-89777391.6,39.04421791280918,50.67906559242376,NaN,NaN,-1.8289944853962699,11.226794354612942
2017-08-22T09:30:00-04:00,24.65,24.84,24.62,24.82,42644026,51807355.35,48.135965870074166,52.338375511771396,NaN,NaN,-89.61267231673455,-113.30214127374488,-0.07783309429704699,-0.023932009627660733,0.05390108466938626,-77797669,-98252287,37.58769074329394,49.39838361093115,NaN,NaN,-2.2420376377400264,9.302675498562518
2017-08-23T09:30:00-04:00,24.64,24.88,24.62,24.74,36612709,50833663.4,46.17383067514245,51.230113572581864,NaN,NaN,-82.88015471161499,-129.66989120413217,-0.06919240239732458,-0.03258941832726947,0.036602984070055106,-114410378,-107032909.4,36.08568214259336,47.73568477591989,NaN,NaN,-3.1968138764264764,7.517034159278376
2017-08-24T09:30:00-04:00,24.85,24.85,24.69,24.74,31067169,48995713.3,46.173830675142455,49.85306734078873,NaN,NaN,-72.93651334712925,-117.13986485646633,-0.06048310646277819,-0.03900089900841763,0.02148220745436056,-114410378,-100490916.2,38.07126694571057,45.86393641615816,NaN,NaN,-3.9518518526071884,5.8786218718661525
2017-08-25T09:30:00-04:00,24.79,24.92,24.78,24.81,37177271,48667786.55,48.311925730165356,48.74227750665375,NaN,NaN,-49.62428944782808,-93.82951088863328,-0.04758227683126284,-0.037995638584717994,0.009586638246544849,-77233107,-100858645.4,37.999805077952836,43.83833319042446,NaN,NaN,-3.9589444098100035,4.47325526019813
2017-08-28T09:30:00-04:00,24.83,24.84,24.59,24.65,36486934,48340170.25,44.00883923571181,47.52376168707388,NaN,NaN,-80.51889756710152,-75.11450547808167,-0.04730017093314613,-0.04953857541988782,-0.0022384044867416863,-113720041,-99514314.6,38.454620520894814,41.99505707507448,NaN,NaN,-5.238868412734102,3.085809021207811
2017-08-29T09:30:00-04:00,24.37,24.61,24.35,24.57,42814209,47431505.85,41.99476457582057,46.16138339178749,NaN,NaN,-116.18963287061896,-80.42989758885855,-0.04972880530034546,-0.06439941111217351,-0.01467060581182805,-156534250,-115261630.8,35.19746417406233,40.22729507284125,NaN,NaN,-6.9009301253287205,1.6591320002740206
2017-08-30T09:30:00-04:00,24.61,24.7766,24.59,24.67,35176115,47023236.25,45.36091679831276,46.11257338977871,NaN,NaN,-66.03858735064026,-77.06158411666362,-0.042128644629859435,-0.06733141159915235,-0.02520276696929291,-121358135,-116651182.2,34.91642131666153,38.825004931768056,NaN,NaN,-7.337662277878919,0.37387567482360073
2017-08-31T09:30:00-04:00,24.75,24.775,24.62,24.7,44225193,47193653.85,46.36647869238309,46.31845832293825,NaN,NaN,-55.783565533759926,-73.63099455398977,-0.033012259265192336,-0.06646809105078333,-0.03345583178559099,-77132942,-109195695,37.78674072154035,38.233830187797814,NaN,NaN,-7.4157996735061085,-0.7389350892235005
2017-09-01T09:30:00-04:00,24.73,24.91,24.67,24.77,42132639,46760640.1,48.73714100730089,46.01083372197453,NaN,NaN,-26.790057692443334,-69.0641482029128,-0.020795481452029634,-0.05945018360062804,-0.038654702148598404,-35000303,-100749134.2,40.96338661146647,38.16275157144817,NaN,NaN,-6.822094195804916,-1.6079578187351313
2017-09-05T09:30:00-04:00,24.58,24.62,24.17,24.24,96579242,49615263.75,35.82535324299808,44.74537962456837,NaN,NaN,-162.06369699412107,-85.37310808831671,-0.04551906257884161,-0.09555353037215042,-0.05003446779330881,-131579545,-104321035,40.03248755841635,38.07856878378219,NaN,NaN,-10.58505501486356,-2.8904002753249065
2017-09-06T09:30:00-04:00,24.33,24.42,24.22,24.3,77593850,50858133,37.833264237829134,43.729480849800176,NaN,NaN,-171.8652383927315,-96.50822919273921,-0.05434392525550702,-0.11796437436269258,-0.06362044910718556,-53985695,-83811324,47.42110266189469,38.656172189711775,NaN,NaN,-12.909143077070318,-4.3216492470028225
2017-09-07T09:30:00-04:00,24.34,24.36,23.79,23.88,87667847,52913173.45,30.61277810925729,42.95810422542622,NaN,NaN,-241.83726083138407,-131.66796388888798,-0.08324978316724829,-0.16768267806624593,-0.08443289489899763,-141653542,-87870405.4,46.20767462286062,39.29007397825539,NaN,NaN,-17.67574391855516,-6.229377057224585
2017-09-08T09:30:00-04:00,23.9,24.19,23.85,24.1,68639461,52788632.2,37.35687937096448,42.64712823444875,NaN,NaN,-184.39690693460216,-157.39063216905643,-0.08219367908357178,-0.18717499375346236,-0.10498131466989058,-73014081,-87046633.2,46.50683544834001,39.73395688989266,NaN,NaN,-19.15402616469326,-8.07575550114868
2017-09-11T09:30:00-04:00,24.38,24.59,24.33,24.52,73305743,53930029.9,47.789906702354486,43.191562494532654,NaN,NaN,-48.115038603157934,-161.65562835119937,-0.04946249161778696,-0.16680942919212427,-0.11734693757433731,291662,-79988240.2,49.11798698254957,40.45351182344554,NaN,NaN,-16.43312482597,-9.269665404694583
2017-09-12T09:30:00-04:00,24.61,24.83,24.59,24.81,66350629,54773917.2,53.54323688155427,43.5777961382098,NaN,NaN,35.37209658292946,-122.16846963578924,-0.0067773597417829096,-0.12581863725156595,-0.11904127750978304,66642291,-40343873,60.71654090543131,42.105572549312505,NaN,NaN,-12.016877681692959,-9.662124301408637
2017-09-13T09:30:00-04:00,24.77,24.86,24.68,24.85,51049443,54899637.45,54.29142225575151,44.1576241082533,NaN,NaN,61.17457775820098,-75.56050640560275,0.023970117523177,-0.08907863060581178,-0.11304874812898878,117691734,-6008387.2,67.6042394523844,44.356898071440426,NaN,NaN,-8.44981998827374,-9.488937970960794
2017-09-14T09:30:00-04:00,24.86,24.92,24.75,24.8,47163158,55503591.65,53.139372112860556,44.655162782376024,NaN,NaN,77.96506155771954,-11.600041927782025,0.03982524809262865,-0.06326718801320297,-0.10309243610583162,70528576,36428036.4,73.73394394676001,46.90423214294396,NaN,NaN,-6.0579262151259465,-8.99879343441296
2017-09-15T09:30:00-04:00,24.66,24.79,24.63,24.77,59250192,54635447.35,52.42062144344975,44.94864104761062,NaN,NaN,46.12820096330383,34.50497965179918,0.04670057560235462,-0.04471671660288834,-0.09141729220524296,11278384,53286529.4,75.70094838129071,49.597170950325236,NaN,NaN,-4.3898458979630215,-8.340372357777255
2017-09-18T09:30:00-04:00,24.86,25.07,24.84,25.06,44010385,53249672.45,58.2932154637498,45.96895363532762,NaN,NaN,121.93016054376092,68.51401948118294,0.06790233285623798,-0.006539376134945485,-0.07444170899118346,55288769,64285950.8,76.91563481859461,52.34438625730379,NaN,NaN,-0.9994616768013189,-7.29167083192355
2017-09-19T09:30:00-04:00,25.06,25.31,25.02,25.25,58443318,53919476.65,61.63435068368726,47.37178121446096,NaN,NaN,167.28399974694412,94.89640011398588,0.09043565804162709,0.03860286356085041,-0.051832794480776684,113732087,73703910,77.93280504171575,55.396910604993316,NaN,NaN,2.9371651571881245,-5.83040854776474
2017-09-20T09:30:00-04:00,25.27,25.49,25.15,25.4,70595545,55317052.6,64.0808006230252,48.708915773368986,NaN,NaN,189.8959802572065,120.64068061378698,0.10986352235831542,0.0854966084671176,-0.024366913891197828,184327632,87031089.6,79.32136218750425,58.5686920957678,NaN,NaN,6.983627807424958,-3.999831925594783
2017-09-21T09:30:00-04:00,25.34,25.52,25.3201,25.46,51050081,56038921.2,65.0410775480695,50.0428156916323,NaN,NaN,183.86598776199884,141.82086585464285,0.12033251228062473,0.1260487264595831,0.005716214178958359,235377713,120000917,82.29024049199806,61.747513507943346,NaN,NaN,10.544096890572456,-1.9221278089994631
2017-09-22T09:30:00-04:00,25.36,25.46,25.285,25.43,42306550,56600890.25,64.11807058309745,51.14145351847492,NaN,NaN,148.44002628046297,162.28323091807468,0.11861959966401961,0.15399071375898288,0.03537111409496327,193071163,156359472.8,84.87002440886006,64.88370192204289,NaN,NaN,13.165567531395597,0.2332572396284025
2017-09-25T09:30:00-04:00,25.4,25.49,25.23,25.4,39774597,56730756.55,63.15291936014663,53.09342252684267,NaN,NaN,125.47526872568383,162.99225255445924,0.10909074218659856,0.17173454182821146,0.0626437996416129,153296566,175961032.2,86.04985103874148,68.17065645635184,NaN,NaN,15.059827876606779,2.3513387591967416
2017-09-26T09:30:00-04:00,25.44,25.48,25.32,25.39,46811004,57246960.05,62.81350409541646,54.87772537381319,NaN,NaN,112.37083294616112,152.00961919430264,0.09619023375321094,0.18288159183312658,0.08669135807991564,106485562,174511727.2,85.51884963619051,70.89192409737295,NaN,NaN,16.539385256860307,4.378202544577251
2017-09-27T09:30:00-04:00,25.71,25.83,25.595,25.7,65919146,58402206.9,68.47067157738677,57.58186062153673,NaN,NaN,143.54753974609847,142.73993109208104,0.10205512121115874,0.21426025959386408,0.11220513838270534,172404708,172127142.4,84.59389121240505,73.63379671091184,NaN,NaN,19.60980362644546,6.554145556272709
2017-09-28T09:30:00-04:00,25.79,25.8,25.61,25.74,37718872,58529344.75,69.12339073933133,59.850897147848634,NaN,NaN,123.95192425153328,130.75711838998794,0.10191097468021462,0.23959385673297362,0.137682882052759,210123580,167076315.8,82.55708787495622,76.20881474138443,NaN,NaN,22.330401087504224,8.80789634644864
2017-09-29T09:30:00-04:00,25.74,25.86,25.7,25.86,42740827,58455126.45,71.05905607228863,61.51297924570108,NaN,NaN,119.93232855110944,125.0555788441172,0.1028811758383559,0.26628435185070387,0.16340317601234797,252864407,179034964.6,83.56600957118064,78.66938778342951,NaN,NaN,25.236085605354376,11.154780526292317
2017-10-02T09:30:00-04:00,25.81,26.08,25.81,26.08,52773978,58987193.4,74.2466338523686,62.99179331504496,NaN,NaN,126.7630287818742,125.31313085535528,0.11064624836292902,0.30171098646600925,0.19106473810308022,305638385,209503328.4,85.81693123555779,80.46227280700998,NaN,NaN,28.806765194453433,13.676492621743904
2017-10-03T09:30:00-04:00,26.06,26.17,26.01,26.17,48062892,56561375.9,75.43844768619226,64.50229513150502,NaN,NaN,128.98294576353305,128.6355534188297,0.11371467521079212,0.3332080821165704,0.21949340690577826,353701277,258946471.4,88.55617244851754,81.95883944959091,NaN,NaN,32.156172042966475,16.3164468247757
2017-10-04T09:30:00-04:00,26.1,26.18,26.04,26.05,39283783,54645872.55,70.73788437533491,65.75933172168176,NaN,NaN,115.84140197075646,123.09432586376128,0.10001759538330227,0.3445154011349061,0.24449780575160382,314417494,287349028.6,89.77755298062559,83.10481152343846,NaN,NaN,33.65202908673009,18.792958576483468
2017-10-05T09:30:00-04:00,26.08,26.41,26.0062,26.32,61260377,53325499.05,74.57638540169883,67.34188629012812,NaN,NaN,129.36300479784973,124.17654197302458,0.10119117288898799,0.3709867718628388,0.2697955989738508,375677871,320459886.8,90.98542917369774,84.19656015146754,NaN,NaN,36.199853290031605,21.279657821276057
2017-10-06T09:30:00-04:00,26.39,26.46,26.21,26.35,66077803,53197416.15,74.96927590027366,68.53303346416553,NaN,NaN,133.1296534547122,126.81600695374513,0.09607699497838057,0.38989184269682653,0.29381484771844596,441755674,358238140.2,92.12828865279633,85.28317828248194,NaN,NaN,38.371395399036984,23.721334618099046
2017-10-09T09:30:00-04:00,26.42,26.42,26.19,26.25,31340231,51099140.55,71.02894217898354,69.20407571382955,NaN,NaN,111.04821970486647,123.67304513834358,0.07877459224152827,0.3922830880203563,0.313508495778828,410415443,379193551.8,92.68246927710904,86.33672572786716,NaN,NaN,39.05299108629319,25.911571256412493
2017-10-10T09:30:00-04:00,26.29,26.37,26.22,26.37,35822514,49572734.8,72.87158054877246,69.83198856566864,NaN,NaN,104.275510489225,118.73155808348199,0.06860020966077685,0.39925875785479903,0.3306585481940222,446237957,397700887.8,93.14170011706737,87.32389272283596,NaN,NaN,40.1695931348439,27.948431524759837
2017-10-11T09:30:00-04:00,26.31,26.345,26.21,26.32,33748617,48707693.5,70.84955641575846,70.2468799133607,NaN,NaN,91.96900387132592,113.95707846359588,0.05242153336520883,0.3961854649005332,0.34376393153532436,412489340,417315257,93.60011014584784,88.13174055525381,NaN,NaN,40.522113842793765,29.74467185590754
2017-10-12T09:30:00-04:00,26.39,26.4,26.09,26.12,53834797,49041275.45,63.28515342944526,70.18738583095698,NaN,NaN,72.10334336064379,102.50514617615468,0.023635466186127108,0.37330826426798325,0.34967279808185614,358654543,413910591.4,92.4450460542202,88.67281352992238,NaN,NaN,38.57967652092827,31.00681537948193
2017-10-13T09:30:00-04:00,25.99,26.22,25.89,26.13,69561357,49556833.7,63.495020508685286,70.21182162728118,NaN,NaN,46.269169029248886,85.13304929106201,0.0018041832485625742,0.35192802714255933,0.35012384389399676,428215900,411202636.6,91.47810827323028,89.06054618952874,NaN,NaN,37.05760529992439,31.87121393954514
2017-10-16T09:30:00-04:00,26.15,26.31,26.14,26.3,42000717,49456350.3,66.95333037889097,70.5075235046722,NaN,NaN,69.77549379781865,76.87850410965245,-0.00431682962465374,0.3447278068631796,0.34904463648783335,470216617,423162871.4,91.88198401326908,89.51505578789148,NaN,NaN,36.6921457763664,32.559918487662465
2017-10-17T09:30:00-04:00,26.39,26.4,26.11,26.17,37844216,48426395.2,62.107844143741396,70.0530358308404,NaN,NaN,60.30270370121726,68.0839427520509,-0.019405536188112027,0.3247877162526933,0.34419325244080534,432372401,420389760.2,90.80738805865468,89.95887699119503,NaN,NaN,34.94123102695473,32.900105993275645
2017-10-18T09:30:00-04:00,26.28,26.35,26.1701,26.31,52201500,47506692.95,65.04198719462156,69.76150700621828,NaN,NaN,66.25675127117265,62.94149223202025,-0.02204904611948172,0.3166319447914532,0.3386809909109349,484573901,434806672.4,91.37232291456553,90.58853663688141,NaN,NaN,34.286987196719856,33.09823187948196
2017-10-19T09:30:00-04:00,26.12,26.34,26.08,26.33,34671617,46687769.75,65.45353681323455,69.3611127734287,NaN,NaN,56.3844204855837,59.79770765700823,-0.02436143616853681,0.30822919570026386,0.33259063186880067,519245518,466924867.4,92.48095109505955,91.22531817430134,NaN,NaN,33.86863369962537,33.20828928235959
2017-10-20T09:30:00-04:00,26.61,26.66,26.52,26.64,56083775,47376631,71.12738780028832,69.1383094839944,NaN,NaN,141.85215689067033,78.91430522929252,-0.0077824202348353855,0.32286260657525645,0.33064502681009184,575329293,496347546,93.32688494788448,91.76174343946754,NaN,NaN,35.24284156522858,33.49893960848373
2017-10-23T09:30:00-04:00,26.65,26.7,26.56,26.62,43555183,47565660.3,70.32490364702686,68.77305633833974,NaN,NaN,145.28838399565973,94.01688326886075,-0.00127382777915791,0.32905274208614443,0.33032656986530234,531774110,508659044.6,93.6488715404105,92.12550766031703,NaN,NaN,36.1064253652845,33.871437573740984
2017-10-24T09:30:00-04:00,26.71,26.86,26.69,26.81,61259191,48288069.65,73.3957552444715,68.96290425756378,NaN,NaN,194.25605762050247,120.80755405271779,0.011986239878439553,0.3453093697133518,0.33332312983491225,593033301,540791224.6,94.40734618527564,92.45620717493489,NaN,NaN,37.813075455149196,34.43452869965644
2017-10-25T09:30:00-04:00,26.89,26.92,26.5,26.65,68653530,48424788.85,67.09877477260687,68.42878921262864,NaN,NaN,152.08318780067313,137.9728413586179,0.006419385335522387,0.3413473615043152,0.33492797616879283,524379771,548752398.6,94.58005197632419,92.71296594655105,NaN,NaN,37.3144406726014,34.84594469579143
2017-10-26T09:30:00-04:00,26.75,26.92,26.75,26.8,41832594,48630474.95,69.72149402677653,68.05394765023598,NaN,NaN,170.53277258782882,160.80251177906692,0.009112849115137711,0.346319037562715,0.33720618844757727,566212365,558145768,94.78469531722473,92.9027092797245,NaN,NaN,37.70677669837747,35.25463498187515
2017-10-27T09:30:00-04:00,26.75,26.83,26.61,26.78,56694352,49328151.2,68.93247580972226,67.9042000524316,NaN,NaN,119.92440310659305,156.41696102225146,0.0059727516928151925,0.34467212806359626,0.33869937637078107,509518013,544983512,89.6753061964117,92.68791191681755,NaN,NaN,37.786864531390826,35.61638206037739
2017-10-30T09:30:00-04:00,26.65,26.79,26.6,26.67,48157525,49097328.55,64.60220497559541,67.31353036863325,NaN,NaN,88.54557726587598,145.06839967629472,-0.006416302633241777,0.33067899807922885,0.3370953007124706,461360488,530900787.6,84.43116276996564,92.06573067773884,NaN,NaN,36.56874298810842,35.75243362148182
2017-10-31T09:30:00-04:00,26.67,26.77,26.57,26.6,39890794,48688723.65,61.935818473613175,66.67683480133715,NaN,NaN,67.06579692909793,119.63034753801381,-0.0213856386604796,0.3103632523868711,0.3317488910473507,421469694,496588066.2,73.19907579403089,90.60851393832334,NaN,NaN,34.770014142725664,35.61208798165951
2017-11-01T09:30:00-04:00,26.71,26.83,26.611,26.64,40921865,48770627.75,62.87867553623348,66.64780066610774,NaN,NaN,72.1597464139197,103.6456592606631,-0.030118842723132366,0.29410033764343524,0.3242191803665676,462391559,484190423.8,69.59649538629091,88.97647460489982,NaN,NaN,33.534682754180395,35.31531580630536
2017-11-02T09:30:00-04:00,26.67,26.93,26.535,26.89,51098312,48262524.5,68.18324297219348,66.98267369921547,NaN,NaN,89.02387026195355,87.34387879548805,-0.02101519475974556,0.2979501869168857,0.31896538167663124,513489871,473645925,66.59444743687808,87.19907025944609,NaN,NaN,33.986633178119774,35.125504002278845
2017-11-03T09:30:00-04:00,26.8,26.82,26.7,26.78,42386958,47077982.25,63.85922476853567,66.76166615561867,NaN,NaN,75.71664764089284,78.502327702348,-0.024135442867552925,0.2887960780921901,0.312931520959743,471102913,465962905,64.41421557741808,85.23708679974244,NaN,NaN,33.058077071580925,34.83015729789343
2017-11-06T09:30:00-05:00,26.71,26.8,26.66,26.75,33642145,47193077.95,62.69152301174321,66.80335750333309,NaN,NaN,61.63580255874188,73.12037276092117,-0.0295934009929818,0.27593976971851575,0.30553317071149755,437460768,461182961,63.031609108984924,83.25310258905175,NaN,NaN,31.96025135029964,34.42017073395146
2017-11-07T09:30:00-05:00,26.77,26.85,26.31,26.38,70325500,48918227.25,50.44094321994045,65.76042579085586,NaN,NaN,-6.324392249898327,58.442334925121905,-0.05786103163571754,0.23320688116685062,0.29106791280256816,367135268,450316075.8,59.8845933298329,81.00397904728514,NaN,NaN,26.834647546151174,33.3365245642657
2017-11-08T09:30:00-05:00,26.33,26.34,26.16,26.25,55844924,50023042.6,46.96815994938228,64.44004172915213,NaN,NaN,-85.22385488048381,26.96561466624121,-0.08349537089575598,0.18669869918287318,0.27019407007862917,311290344,420095832.8,52.09501029879119,78.11926899040883,NaN,NaN,21.44962923766702,31.63839666046589
2017-11-09T09:30:00-05:00,26.08,26.25,25.89,26.16,94577042,52060154.85,44.674957132347835,62.55058239572781,NaN,NaN,-125.47691921700513,-15.934543229550528,-0.10339241031734475,0.14095355718194824,0.244345967499293,216713302,360740519,40.854513909846034,74.3712424876918,NaN,NaN,16.31543464477935,29.449402086796386
2017-11-10T09:30:00-05:00,26.18,26.225,26.06,26.08,53209576,51242565.8,42.680167087661985,60.575958355773174,NaN,NaN,-121.05378946209474,-55.28863065014805,-0.11777655680996077,0.09712527148684202,0.2149018282968028,163503726,299220681.6,32.92486995892561,70.03381380330003,NaN,NaN,11.473362392309024,26.881396416155333
2017-11-13T09:30:00-05:00,25.92,26.175,25.9,26.12,51018678,51693463.85,44.025948357208236,58.478115006682934,NaN,NaN,-128.77614014810376,-93.37101919151716,-0.1200247318345247,0.06487091350364693,0.18489564533817163,214522404,254633008.8,28.593153636300713,65.33280004980183,NaN,NaN,7.918413793357705,24.172398898612816
2017-11-14T09:30:00-05:00,26.02,26.12,25.93,26.11,54101775,52506341.8,43.74940299038877,56.8103027365245,NaN,NaN,-124.01910599153605,-116.90996193984469,-0.11746578455455839,0.03806341464497365,0.15552919919953204,160420629,213290081,25.2729617342585,60.38229360394,NaN,NaN,4.942078690791251,21.42521029749545
2017-11-15T09:30:00-05:00,25.88,26.2666,25.86,26.18,64952279,53143880.75,46.2925693303597,55.13680811535187,NaN,NaN,-103.6320842093163,-120.59160780561119,-0.1066548289991211,0.022210662950630677,0.12886549194975178,225372908,196106593.8,24.02429500962546,55.327979296254334,NaN,NaN,3.1008399266652087,18.80744310166256
2017-11-16T09:30:00-05:00,26.3,26.36,26.17,26.19,53648093,54092704.55,46.66355602268066,53.546170987706034,NaN,NaN,-67.63135214895597,-109.02249439200136,-0.09482437457877668,0.010335023726280923,0.1051593983050576,279021001,208568133.6,26.847013375688306,50.84024409477409,NaN,NaN,1.6691981815045709,16.359122398782848
2017-11-17T09:30:00-05:00,26.06,26.22,26.03,26.16,41938651,53385448.35,45.64491239944135,52.192078660837886,NaN,NaN,-82.59375156178089,-101.3304868119386,-0.08531167261254122,-0.0014801924606189232,0.0838314801519223,237082350,223283858.4,30.14743773194064,46.96283516348659,NaN,NaN,0.18612661537371827,14.048694429724401
2017-11-20T09:30:00-05:00,26.21,26.32,26.13,26.28,35232374,52969307.9,50.3168618351254,51.36215318666019,NaN,NaN,-51.00992365418791,-85.77724351315543,-0.06798327240696593,-0.0011476103567851226,0.06683566205018081,272314724,234842322.4,32.71521722914909,44.07113098028075,NaN,NaN,0.10907639811618272,12.057320425208943
2017-11-21T09:30:00-05:00,26.37,26.399,26.301,26.36,35972390,51704967.85,53.204579391664886,50.671146319191,NaN,NaN,-20.68835362125589,-65.1110930390994,-0.049062286256099465,0.005507804230056479,0.054570090486155944,308287114,264415619.4,38.90357595813272,41.87877959255515,NaN,NaN,0.8350189718986573,10.454134503307474
2017-11-22T09:30:00-05:00,26.36,26.43,26.23,26.23,30959362,49820259.45,48.292519985137325,49.25038039154414,NaN,NaN,-30.652301539362686,-50.51513650510867,-0.0434248539747703,0.0002890230176930686,0.04371387699246337,277327752,274806588.2,40.958322663741434,40.047627823045396,NaN,NaN,0.11547825226163372,8.977183610300925
2017-11-24T09:30:00-05:00,26.33,26.38,26.2,26.22,12172481,48337253.8,47.925975333256375,48.112291146167045,NaN,NaN,-33.531275173624884,-43.69512111004245,-0.038651725744989866,-0.0046007801887739674,0.0340509455562159,265155271,272033442.2,40.566212285352286,38.34419901646927,NaN,NaN,-0.5788979133418202,7.61202910692339
2017-11-27T09:30:00-05:00,26.2,26.34,26.18,26.2,42346421,47619857.25,47.15508913857814,47.0025458695124,NaN,NaN,-36.60145661349845,-34.49666212038596,-0.0352206233561608,-0.009974833638985103,0.0252457897171757,222808850,269178742.2,40.140203876150544,36.70909864269538,NaN,NaN,-1.366453033016926,6.329388801217631
2017-11-28T09:30:00-05:00,26.23,26.91,26.21,26.88,86506957,49537328.85,66.74237157275427,48.1669336089991,NaN,NaN,89.25815708835066,-6.4430459718782505,0.011942098775466127,0.040173413186508355,0.02823131441104223,309315807,276578958.8,41.845140971356706,35.42056633137566,NaN,NaN,5.02083215757685,6.142452137840376
2017-11-29T09:30:00-05:00,27.14,27.52,27.07,27.34,135340640,54309821.15,73.81341473595504,50.08445180804001,NaN,NaN,226.03280395903295,42.90118554417951,0.06997550061413926,0.11570069017871631,0.045725189564577044,444656447,303852825.4,47.75167197488792,35.11032787966828,NaN,NaN,13.755518109568582,7.230032990944405
2017-11-30T09:30:00-05:00,27.58,27.88,27.375,27.52,135241711,59025813.45,75.96671550595894,52.31957740615509,NaN,NaN,233.940606160502,95.81976708415245,0.11375179288365685,0.1879149306691481,0.07416313778549126,579898158,364366906.6,57.95525341016309,36.331809272548085,NaN,NaN,21.31104819731302,9.241606591854207
2017-12-01T09:30:00-05:00,27.56,27.71,26.95,27.58,148119604,63876878.05,76.65579348431204,54.746407863058664,NaN,NaN,170.06258721986254,136.53853956284993,0.1383797964999578,0.24713788341043852,0.10875808691048071,728017762,456939404.8,68.18959056831874,38.85071788750473,NaN,NaN,27.197735203563077,11.806767822098331
2017-12-04T09:30:00-05:00,28.04,28.2,28,28,99820365,66748548.4,80.8046938850602,57.37346111504809,NaN,NaN,223.6897698077535,188.5967848471003,0.17237394653378413,0.3242255200777109,0.15185157354392675,827838127,577945260.2,76.30783070713728,42.2589091068502,NaN,NaN,34.00743008732586,14.978291002845122
2017-12-05T09:30:00-05:00,28.1,28.15,27.78,27.85,77706195,68951750.9,75.63457070008786,59.650973094312306,NaN,NaN,164.42045627025627,203.62924468348143,0.1736876427043846,0.3689611269244075,0.1952734842200229,750131932,666108485.2,80.26053084937715,46.18659261507296,NaN,NaN,37.321193656995696,18.170134239152347
2017-12-06T09:30:00-05:00,27.75,27.91,27.67,27.75,60299083,68450430.05,72.31277620575847,61.50955929969793,NaN,NaN,121.44051413344938,182.71078671836472,0.15724401131483148,0.39182849836356226,0.23458448704873078,689832849,715143765.6,82.05388238888014,50.33156314216257,NaN,NaN,38.70607520651431,21.103840091632627
2017-12-07T09:30:00-05:00,27.63,27.94,27.58,27.84,59625533,68639460.5,73.44323510328039,63.42239351974077,NaN,NaN,104.2554467524953,156.7737548367634,0.1422993985728065,0.41245873526473886,0.2701593366919324,749458382,749055810.4,83.19123655725197,54.35615051227427,NaN,NaN,40.17329707796679,23.828048232537505
2017-12-08T09:30:00-05:00,27.98,28.01,27.78,28.01,55001592,66660688,75.47976629336563,65.55345451216394,NaN,NaN,102.64932481988617,143.29110235676814,0.1338588469648302,0.43748289539797014,0.30362404843313995,804459974,764344252.8,83.69299351714965,58.180833068360634,NaN,NaN,42.05888203091671,26.432453060877393
2017-12-11T09:30:00-05:00,28.01,28.05,27.86,27.94,43278359,66164127.15,72.99744850542135,67.17349641718508,NaN,NaN,91.88198740479768,116.92954587617696,0.11431605182838167,0.44651911321861704,0.33220306139023537,761181615,751012950.4,81.41089600995863,61.65909583841846,NaN,NaN,42.777413419770674,28.767447397862146
2017-12-12T09:30:00-05:00,28.05,28.325,27.955,28.22,69517086,67089047.55,76.34815597367589,68.82660903018585,NaN,NaN,99.2542703248338,103.89630868709249,0.11091468407878119,0.47084641648871184,0.35993173240993065,830698701,767126304.2,82.04806468408762,64.74084503312952,NaN,NaN,44.50983511404747,31.016359928745764
2017-12-13T09:30:00-05:00,28.19,28.25,27.85,27.87,97335327,69250725.15,65.42021427566216,70.05001576522334,NaN,NaN,76.46528181328564,94.90126222305972,0.07735083041589436,0.4566202704297986,0.3792694400139042,733363374,775832409.2,82.39910211171446,67.70090070798473,NaN,NaN,42.20889411829865,32.615293384396175
2017-12-14T09:30:00-05:00,27.97,28.01,27.66,27.69,76947478,69850485.1,60.61503780565179,70.95637737039445,NaN,NaN,53.565927295134294,84.76335833158751,0.03731389225768217,0.4259118053360069,0.38859791307832475,656415896,757223912,78.85002005200084,70.43545840560249,NaN,NaN,38.683093151668125,33.48212192257788
2017-12-15T09:30:00-05:00,27.73,28,27.6337,27.81,111826079,72759384.4,62.58792649397471,72.05872289577992,NaN,NaN,51.858947937788464,74.60528295516797,0.014378805835465913,0.40657142037265714,0.39219261453719123,768241975,749980312.2,77.4515552673125,73.10055493354263,NaN,NaN,36.500662096118994,33.91334194736947
2017-12-18T09:30:00-05:00,28.04,28.1961,27.99,28.06,61275464,73726225.05,66.36774997622581,72.0319642103136,NaN,NaN,73.90591152833159,71.01006777987475,0.011628647981393125,0.40672842451393265,0.3950997765325395,829517439,763647477,78.23588626623354,75.69989388317667,NaN,NaN,35.90378438810496,34.197690867474535
2017-12-19T09:30:00-05:00,28.22,28.24,27.94,27.94,57366287,74832920.7,63.07367271757344,71.2648397804292,NaN,NaN,65.59259306382633,64.27773232767325,-0.001964859527603724,0.3926437021230349,0.3946085616506386,772151152,751937967.2,75.80304156871013,77.70356313987827,NaN,NaN,34.35164120698267,34.219683773118554
2017-12-20T09:30:00-05:00,28.17,28.22,27.87,27.89,69680335,76518317.95,61.69952955627415,70.24575506973743,NaN,NaN,56.906474633385024,60.365970891693124,-0.017170459624335777,0.3731454871202189,0.39031594674455466,702470817,745759455.8,74.48685385623284,78.88439174316898,NaN,NaN,32.68794236508009,34.0008635719702
2017-12-21T09:30:00-05:00,28.04,28.21,28.005,28.13,46123492,77276524.45,65.57627788697457,69.45436109849904,NaN,NaN,71.3027566995008,63.91333677256644,-0.014043127982671932,0.3727620367662148,0.3868051647488867,748594309,764195138.4,75.83512078611241,79.43050104443994,NaN,NaN,32.45590719608442,33.78015551827223
2017-12-22T09:30:00-05:00,28.21,28.25,27.92,28.05,43020251,78818912.95,63.277095289603956,68.20238977025217,NaN,NaN,64.98128152870177,66.5378034907491,-0.019978655079965324,0.36183184589893,0.38181050097889535,705574058,751661555,73.0102635893293,79.19496053602509,NaN,NaN,31.566820223916835,33.46396476193575
2017-12-26T09:30:00-05:00,28.05,28.135,27.86,27.97,33710115,78387097.65,60.974796199103224,67.15526302018183,NaN,NaN,44.970216080138115,60.750664401110406,-0.031237920923454898,0.34276309982457676,0.37400102074803165,671863943,720130855.8,66.31761469349257,78.19903795346191,NaN,NaN,30.151695351988195,32.990783417657525
2017-12-27T09:30:00-05:00,27.99,28.01,27.91,28,29420966,75532798.1,61.53991710554229,66.38577308445211,NaN,NaN,32.29236795398367,54.09061937914188,-0.038152633194027286,0.3263102292554976,0.36446286244952486,701284909,705957607.2,63.49983391840109,76.87374877699912,NaN,NaN,29.151047788794354,32.442249756391355
2017-12-28T09:30:00-05:00,28.07,28.12,27.995,28.11,28129661,70172249.15,63.62015567598639,65.68412455393111,NaN,NaN,70.70598372763678,56.85052119799222,-0.03678941213589165,0.3184760972796603,0.35526550941555196,729414570,711346357.8,64.12397954305996,75.51180184741396,NaN,NaN,28.874253992164896,31.932536075787574
2017-12-29T09:30:00-05:00,28.2,28.2,27.91,27.91,55169774,66168652.3,57.52757879216221,64.40182544670229,NaN,NaN,32.70906634600607,49.13178312729328,-0.050008830409503935,0.29275447140367206,0.342763301813176,674244796,696476455.2,61.02306478186554,73.8925212234651,NaN,NaN,26.85260816039221,31.206832087873952
2018-01-02T09:30:00-05:00,28.09,28.09,27.79,27.92,55436075,61534475.85,57.74546727854389,63.31239821621106,NaN,NaN,-30.603779845829113,30.0147708523871,-0.058159691111675516,0.2700636879235816,0.3282233790352571,729680871,701297817.8,61.67028387197538,72.48247749932344,NaN,NaN,25.261344426111588,30.357476707622187
2018-01-03T09:30:00-05:00,27.97,28.09,27.875,28.07,56906235,59388769.35,60.97916735818796,62.21461331510477,NaN,NaN,31.346660372073092,27.29005971077409,-0.0536393659006672,0.26117417165942314,0.31481353756009034,786587106,724242450.4,64.67639255293399,71.2416437756696,NaN,NaN,24.768359303948493,29.55903136424023
2018-01-04T09:30:00-05:00,28.23,28.54,28.18,28.33,62246955,58615807.35,65.85668541449374,62.24578982502131,NaN,NaN,240.75794291870216,68.98317470371778,-0.03427175177302688,0.27197384784380674,0.3062455996168336,848834061,753752280.8,68.13752969262254,70.22296003144875,NaN,NaN,25.785323096728984,29.019930183167194
2018-01-05T09:30:00-05:00,28.48,28.48,28.23,28.41,37989521,57500329.25,67.21463515632495,62.717189635783676,NaN,NaN,213.20632145180346,97.48324224855112,-0.018022494160689795,0.28371748191597135,0.30173997607666114,886823582,785234083.2,71.36143694815648,69.68806123831702,NaN,NaN,27.032765527102743,28.73604951801513
2018-01-08T09:30:00-05:00,28.38,28.426,28.27,28.37,44252096,56731657.4,65.80536578698371,62.94700672814147,NaN,NaN,171.3072009324412,125.20286916583814,-0.012196617682554034,0.2864942039734686,0.2986908216560226,842571486,818899421.2,74.35022260332364,69.46653747660353,NaN,NaN,27.66685960210784,28.583308101456947
2018-01-09T09:30:00-05:00,28.49,28.74,28.44,28.59,51418697,56552512.65,69.5827989455331,63.17665308309199,NaN,NaN,232.94537461547918,177.9127000580998,0.0034110745147368227,0.30295466479944366,0.29954359028470684,893990183,851761283.6,76.8860074003424,69.3701175576113,NaN,NaN,29.364677757495638,28.6949323380339
2018-01-10T09:30:00-05:00,28.68,28.95,28.63,28.83,64670892,57622139.3,73.07691191538052,63.891170168649644,NaN,NaN,239.88858701750772,219.62108538718672,0.02560021703161186,0.33154386157422167,0.3059436445426098,958661075,886176077.4,79.2046447122704,69.61308921072275,NaN,NaN,31.975076191535273,29.163524317105527
2018-01-11T09:30:00-05:00,28.95,29,28.81,28.97,42361715,56264370.75,74.8890150784441,64.83327627737607,NaN,NaN,210.58895979985968,213.58728876341826,0.04431117913358856,0.3613326184595955,0.31702143932600696,1001022790,916613823.2,81.01826266891939,70.07961841162893,NaN,NaN,34.74298013078686,29.960589433345717
2018-01-12T09:30:00-05:00,29.14,29.25,28.96,29.23,44537496,53624479.2,77.8682442430398,65.71127387423788,NaN,NaN,206.05866136630755,212.15775674631905,0.06741835110092198,0.4012943782021594,0.3338760271012374,1045560286,948361164,82.7118497865431,70.57081334023111,NaN,NaN,38.161423782962686,31.132137197576714
2018-01-16T09:30:00-05:00,29.48,29.53,28.99,29.15,67563916,53155301.1,74.9227694648498,66.54310774389829,NaN,NaN,181.27905706887097,214.152127973605,0.07021800034830744,0.42164852753662174,0.3514305271883143,977996370,975446140.8,84.02166185373025,71.35734178768833,NaN,NaN,40.02465004312206,32.402496175511764
2018-01-17T09:30:00-05:00,29.23,29.45,28.99,29.37,54311955,50279594.9,77.44902682280201,67.71983850273391,NaN,NaN,159.86619203355127,199.53629145721942,0.07912778365603879,0.45034025675836276,0.37121247310232397,1032308325,1003109769.2,85.2507832409904,72.70971096965245,NaN,NaN,42.44967171581215,33.83780696698325
2018-01-18T09:30:00-05:00,29.47,29.48,29.29,29.33,49247357,49678189.55,75.95088525885657,68.7491933708278,NaN,NaN,144.72046327867864,180.50266670945362,0.07462727423866611,0.4644965659006566,0.38986929166199047,983060968,1007989747.8,85.46321767496408,74.27852409512124,NaN,NaN,43.94378557355376,35.28151819649332
2018-01-19T09:30:00-05:00,29.43,29.55,29.37,29.54,60727800,49846265.2,78.32174171921082,69.79930665962954,NaN,NaN,136.93360063856844,165.77159487719535,0.07774170258301832,0.48704641989076336,0.40930471730774504,1043788768,1016542943.4,85.847960179122,75.83023699769709,NaN,NaN,45.98681234299875,36.810845931708386
2018-01-22T09:30:00-05:00,29.55,29.79,29.51,29.78,46868889,48705692.9,80.66744006846679,71.45215389365129,NaN,NaN,141.3224390982042,152.82435042357469,0.08720310375921608,0.5183085970067651,0.43110549324754904,1090657657,1025562417.6,86.26091006139588,77.63294023194926,NaN,NaN,48.52598318833103,38.48443696836876
2018-01-23T09:30:00-05:00,29.71,29.86,29.57,29.81,60861986,49442617.6,80.94499663224832,73.10926313320161,NaN,NaN,127.38920053267367,142.04637911633523,0.08654621934668472,0.539288267430905,0.45274204808422025,1151519643,1060267072.2,87.74293643496762,79.49527255787727,NaN,NaN,50.63540478867604,40.22028951412695
2018-01-24T09:30:00-05:00,29.95,30.08,29.77,30.01,66370993,50610154.7,82.72556782194916,74.66257745204169,NaN,NaN,132.62911452381985,136.59896361438894,0.09023357102587226,0.5655340118665606,0.47530044084068834,1217890636,1097383534.4,89.0974672703151,81.2396350376902,NaN,NaN,53.02143253582133,42.04902423151186
2018-01-25T09:30:00-05:00,30.13,30.13,29.85,29.95,45423660,51195831.95,80.30130959387205,75.69433632199728,NaN,NaN,120.53544045750888,131.76195905015499,0.0796522555040915,0.5748657602208027,0.4952135047167112,1172466976,1135264736,90.27829550559375,82.8211183100453,NaN,NaN,54.246847908576115,43.79157047109246
2018-01-26T09:30:00-05:00,30.04,30.18,29.9,30.17,33871918,51418379.55,82.34435839177118,76.77503083881486,NaN,NaN,118.70230362404027,128.11569964724936,0.07836970812186728,0.5931756398690453,0.514805931747178,1206338894,1167774761.2,91.16289666917152,84.23550829011779,NaN,NaN,55.953974903686934,45.52905681860596
2018-01-29T09:30:00-05:00,30.19,30.3255,30.025,30.05,41045016,52064147.3,77.61573826415312,77.6186288728984,NaN,NaN,112.49630895900289,122.35047361940909,0.06110605560015048,0.5911885012473661,0.5300824456472156,1165293878,1182702005.4,91.54339113907074,85.46359175695689,NaN,NaN,55.9403534231982,47.01638490497628
2018-01-30T09:30:00-05:00,29.83,30.02,29.66,29.66,67316874,52671502.3,64.62661022337015,77.26461539274389,NaN,NaN,69.43007261140404,110.75864803515518,0.01736070288251146,0.5517833242503549,0.5344226213678435,1097977004,1171993477.6,88.59633120477828,86.30004345727373,NaN,NaN,51.56343360091719,47.665963290110696
2018-01-31T09:30:00-05:00,29.74,29.89,29.64,29.74,49722319,52385814.5,65.88771474595029,76.75110130921317,NaN,NaN,61.451820412765585,96.5231892129443,-0.010734929366195356,0.5210039596600993,0.5317388890262946,1147699323,1157955215,84.74471612845358,86.69576284414394,NaN,NaN,48.4566690717468,47.77892125891585
2018-02-01T09:30:00-05:00,29.68,30.05,29.67,30.02,60824211,52581713.3,69.92863494641057,76.39678844263935,NaN,NaN,74.40536249741243,87.29717362092501,-0.014760800703124799,0.5132878881473886,0.5280486888505134,1208523534,1165166526.6,85.10298733801902,86.98752889193678,NaN,NaN,47.06563659769653,47.67702345017023
2018-02-02T09:30:00-05:00,29.96,30.04,29.34,29.36,73085959,53123663.5,53.76211928988035,74.67492237455653,NaN,NaN,24.848794477835504,68.52647179168407,-0.06344413051938513,0.44874352570128195,0.5121876562206671,1135437575,1150986262.8,81.07106439573028,86.87032993545014,NaN,NaN,39.51773572298111,46.51141091771464
2018-02-05T09:30:00-05:00,28.73,29.21,27.6,27.88,147871518,58617763.35,34.50060148561563,71.7876246617541,NaN,NaN,-166.24511667615735,12.778186664652026,-0.18975171188100076,0.2749980163694161,0.4647497282504169,987566057,1115440698.6,71.87820859227512,86.00294041677478,NaN,NaN,22.113542985621464,43.0260012131299
2018-02-06T09:30:00-05:00,27.24,28.4594,27.17,28.39,159006394,64355478.25,42.18715432841865,69.26891948358386,NaN,NaN,-187.83258887538122,-38.67434563270503,-0.23066178461987985,0.17642249747556704,0.4070842820954469,1146572451,1125159788,72.78684131975962,85.11265885097258,NaN,NaN,13.182627200709064,38.76266206849836
2018-02-07T09:30:00-05:00,28.34,28.81,28.22,28.41,102699437,66919515.25,42.47226670523101,66.87758958689632,NaN,NaN,-120.98481870153786,-75.1616734555657,-0.24664671017045814,0.09877589438237422,0.34542260455283236,1249271888,1145474301,74.63185514002038,84.3389900984766,NaN,NaN,7.281797619534737,34.26539571864641
2018-02-08T09:30:00-05:00,28.46,28.51,27.14,27.16,135270547,70449498,31.887580407186377,63.560863778894564,NaN,NaN,-202.079414320754,-130.458628819199,-0.3266573554370087,-0.0628990897434285,0.2637582656935802,1114001341,1126569862.4,69.88355961764526,83.19867577265684,NaN,NaN,-2.853825728718594,28.962649797594267
2018-02-09T09:30:00-05:00,27.57,27.8861,26.76,27.68,149504929,75806658.7,38.72842337606524,60.56521972943732,NaN,NaN,-182.71374553542964,-171.97113682185204,-0.3289020080547303,-0.14736924437483268,0.18153276367989762,1263506270,1152183601.4,72.44189098490031,82.21160298147858,NaN,NaN,-7.296597214743858,23.78275736726025
2018-02-12T09:30:00-05:00,27.96,28.3487,27.705,28.07,83571825,77758375.15,43.32584479717199,57.87813745550329,NaN,NaN,-104.37287967494737,-159.59668942161005,-0.2898334367483705,-0.18075903225556544,0.109074404492805,1347078095,1224086009,78.0729337087016,81.52088850103101,NaN,NaN,-8.67020183090123,19.146620338951465
2018-02-13T09:30:00-05:00,27.91,28.25,27.83,28.19,43365499,76548454.3,44.70075947594804,55.162079716503214,NaN,NaN,-86.49629306246945,-139.32943025902767,-0.24348875632331884,-0.19528654091134356,0.04820221541197528,1390443594,1272860237.6,80.92086638307444,80.93684558051382,NaN,NaN,-9.150023285053893,15.104242678379272
2018-02-14T09:30:00-05:00,28.17,28.865,28.07,28.86,57379663,76701839.7,51.740430678454246,53.12201693683051,NaN,NaN,-40.17294434654894,-123.1670553880299,-0.15935834116508193,-0.15099571104437715,0.00836263012070479,1447823257,1312570511.4,82.87145956309142,80.40778587033508,NaN,NaN,-6.849248484664298,11.968029655087333
2018-02-15T09:30:00-05:00,29.1,29.14,28.7,29.02,66976040,77588273.85,53.270305897396106,51.04529890151802,NaN,NaN,-10.02413631920327,-84.75599978771974,-0.08813861354154032,-0.1018106368062206,-0.01367202326468029,1514799297,1392730102.6,85.98607913447024,80.038013189285,NaN,NaN,-4.563831387170623,9.606335220479053
2018-02-16T09:30:00-05:00,28.88,29.23,28.84,28.98,47508240,76927295.85,52.81949798568286,49.27413888162728,NaN,NaN,-3.0738884544499867,-48.82802837152383,-0.04130715758487204,-0.06530597024577034,-0.023998812660898303,1467291057,1433487060,87.25505552974333,79.73170350290445,NaN,NaN,-2.966597699280489,7.81020194622769
2018-02-20T09:30:00-05:00,28.92,29.21,28.8,28.89,58236090,77495655.9,51.758163206818445,48.35496409473074,NaN,NaN,-4.370872080338616,-28.827626852602076,-0.015313515959392288,-0.04314070761013866,-0.027827191650746375,1409054967,1445882434.4,87.62215314642914,79.66211935587951,NaN,NaN,-2.025918062471924,6.405041944984888
2018-02-21T09:30:00-05:00,28.9,29.4,28.87,28.93,44578761,76681494.65,52.217707392249494,47.37853499803782,NaN,NaN,7.460851593363085,-10.03619792143557,0.004587956589159024,-0.022092245914297592,-0.026680202503456617,1453633728,1458520461.2,88.00161719628177,79.89475514643867,NaN,NaN,-1.136833294594708,5.327631196473518
2018-02-22T09:30:00-05:00,29,29.16,28.62,28.69,47602660,75743078,49.18998492507259,45.897202853656545,NaN,NaN,-9.83975133394062,-3.969559318913916,0.0017483047585359276,-0.024494821555286705,-0.026243126313822633,1406031068,1450162023.4,86.12114950246139,79.96748101532741,NaN,NaN,-1.2541852935898923,4.38737169789303
2018-02-23T09:30:00-05:00,28.78,29.12,28.77,29.12,41187335,75531261.75,54.302478829259684,45.93579996361221,NaN,NaN,12.635634823362166,0.5623949095991708,0.027557665994749042,0.00820395617961367,-0.019353709815135373,1447218403,1436645844.6,83.03134643060963,80.10750116067594,NaN,NaN,0.18210746791224933,3.786619665038633
2018-02-26T09:30:00-05:00,29.33,29.56,29.14,29.56,55124197,76593875.7,58.86366670995551,47.676018908207915,NaN,NaN,60.89340092380477,13.355852785250121,0.07054607137671957,0.0688288794057641,-0.001717191970955479,1502342600,1443656153.2,83.36471083748697,80.9279656067625,NaN,NaN,2.8583475572122765,3.654009363920582
2018-02-27T09:30:00-05:00,29.58,29.77,29.26,29.28,72752079,78179228.85,55.09500151696858,48.59800799310433,NaN,NaN,69.67973409704297,28.16597402072647,0.07593893885537686,0.09320648159826561,0.01726754274288874,1429590521,1447763264,83.56838505697831,81.69807587370669,NaN,NaN,3.9600806541529407,3.697733833953776
2018-02-28T09:30:00-05:00,29.43,29.54,28.87,28.87,65254660,78076118.15,50.04267647446347,49.13875154804952,NaN,NaN,36.995446845794696,34.07289307121279,0.04901557199950484,0.0785370077422698,0.029521435742764952,1364335861,1429903690.6,79.0367579218308,82.01271178669315,NaN,NaN,3.3404313663215874,3.646690624292035
2018-03-01T09:30:00-05:00,28.88,29.11,28.21,28.37,82467921,79713398.25,44.66364508496833,50.051327596462514,NaN,NaN,-18.922422025513526,32.25635893289821,-0.0026069232354242675,0.026262781698484616,0.028869704933908884,1281867940,1405071065,73.10105638605582,82.24253298443675,NaN,NaN,1.0710049970849167,3.278735534691018
2018-03-02T09:30:00-05:00,28.17,28.52,27.89,28.44,78991163,80621745.85,45.546125457137066,50.53830631653908,NaN,NaN,-46.773410320027935,20.374549904220192,-0.03062220705291882,-0.009408053882239642,0.02121415317067918,1360859103,1387799205,69.20791772274339,82.0115348942827,NaN,NaN,-0.46980437790103785,2.743229832892153
2018-03-05T09:30:00-05:00,28.22,29,28.21,28.84,58952137,79915054.75,50.41257982735628,51.04450167583796,NaN,NaN,13.602485483643793,10.916366816187994,-0.0212427173669403,-0.005339243537996197,0.015903473828944102,1419811240,1371292933,65.6116520768333,81.12144334914925,NaN,NaN,-0.3001615813283635,2.308459630860651
2018-03-06T09:30:00-05:00,29,29.02,28.66,28.96,49746126,75008785.15,51.80413237308784,51.55188545420508,NaN,NaN,38.17966228136488,4.616352453052376,-0.006737125873452692,0.007482066487128236,0.014219192360580928,1469557366,1379286302,66.51897172795836,80.09273658806954,NaN,NaN,0.25225965755642704,2.014716777531476
2018-03-07T09:30:00-05:00,28.6,28.97,28.57,28.91,41530226,69134976.75,51.15991658336973,51.51042016169904,NaN,NaN,24.361203108017914,2.0895037054970182,-0.0006126477279106389,0.013453382700692629,0.014066030428603268,1428027140,1392024557.8,67.96934443845433,79.02829979345259,NaN,NaN,0.5212769078740266,1.801368224723269
2018-03-08T09:30:00-05:00,28.98,29.04,28.69,29,50803041,66540156.95,52.309540153311474,51.44179403712157,NaN,NaN,36.023625822208956,13.078713275041517,0.00887352495824563,0.025157936626410304,0.016284411668164675,1478830181,1431417006,72.00772073788804,78.02984562226814,NaN,NaN,1.062064462142596,1.6957534014974585
2018-03-09T09:30:00-05:00,29.31,29.72,29.185,29.7,54595689,62506414.05,60.16368088671737,51.96637853005261,NaN,NaN,133.4267877207792,49.118752883202944,0.05887801217871417,0.08988192689155738,0.031003914712843215,1533425870,1465930359.4,74.98365714607688,77.15331716629196,NaN,NaN,3.983368439927535,2.022555549844612
2018-03-12T09:30:00-04:00,29.7,29.81,29.55,29.6,51784453,57620390.25,58.67698679391359,52.460580214845116,NaN,NaN,156.4197447824096,77.6822047429561,0.08046895017681746,0.13159010243386504,0.05112115225704758,1481641417,1478296394.8,75.96943133590331,76.32097989411155,NaN,NaN,5.9395344296473205,2.582123961244999
2018-03-13T09:30:00-04:00,29.74,29.77,29.2,29.27,47049369,55794267.45,53.94005406255998,52.583604977010154,NaN,NaN,100.61077179345183,90.1684266453735,0.06825752564435741,0.13644305931249434,0.06818553366813693,1434592048,1471303331.2,74.18904169004936,75.33436735795208,NaN,NaN,6.236935234784116,3.1042398574648726
2018-03-14T09:30:00-04:00,29.4,29.4001,28.8501,28.94,57278946,56489939.8,49.62565466934319,52.61472424445805,NaN,NaN,13.855299191346942,88.0672458620393,0.03534400548272035,0.11236554052153735,0.07702153503881701,1377313102,1461160523.6,71.56918434050266,74.29494127495504,NaN,NaN,5.194830512712468,3.402895665357386
2018-03-15T09:30:00-04:00,29.05,29.11,28.8649,28.95,47451563,55993534.8,49.75680125649258,52.2900329892604,NaN,NaN,-14.33297727941895,77.99592524171372,0.012797643520988819,0.09301858944005303,0.08022094591906422,1424764665,1450347420.4,68.78061910976146,73.27703218060876,NaN,NaN,4.391431515390145,3.544115072504923
2018-03-16T09:30:00-04:00,28.91,29.15,28.87,28.87,61278207,55708643.15,48.6652571940301,51.561575166694304,NaN,NaN,-17.651121405820636,47.78034341639375,-0.007841625138008776,0.07041891449655324,0.07826053963456202,1363486458,1416359538,60.76614763992636,71.66284909506871,NaN,NaN,3.420139441111949,3.5264042680202126
2018-03-19T09:30:00-04:00,28.83,28.93,28.39,28.66,52145040,55940483.15,45.823474742828154,50.899323254255705,NaN,NaN,-89.95110241972597,-1.4938260240333647,-0.034482043739918464,0.035157984959663935,0.0696400286995824,1311341418,1382299538.2,53.97828415567991,69.54927045926169,NaN,NaN,1.7887558738997666,3.2781687831458632
2018-03-20T09:30:00-04:00,28.77,28.85,28.655,28.73,37146544,54886005.85,46.935812684241625,50.677404412097005,NaN,NaN,-63.045800522571874,-34.22514048723811,-0.04553979467850801,0.012715285351447392,0.0582550800299554,1348487962,1365078721,50.883420696118115,67.5383178002822,NaN,NaN,0.713405642516489,2.9117740487702384
2018-03-21T09:30:00-04:00,28.78,29.1,28.62,28.72,53291400,55321637.8,46.78802204308458,50.829145623391014,NaN,NaN,-42.43605492448978,-45.483411310405444,-0.05125258453748273,-0.0058106506418980075,0.04544193389558472,1295196562,1348655413,48.05371695810542,65.74922212685718,NaN,NaN,-0.2243004452920272,2.4637634067613434
2018-03-22T09:30:00-04:00,28.34,28.45,27.56,27.66,85160298,57199519.7,34.41698803615081,50.034207236177714,NaN,NaN,-221.82824489967956,-86.98246483445757,-0.1202075144575698,-0.10481745917637753,0.015390055281192274,1210036264,1305709732.8,41.54718193050841,63.773455284554686,NaN,NaN,-5.228093653561225,1.3649266838581193
2018-03-23T09:30:00-04:00,27.69,27.8,26.77,26.82,89289521,59604629,28.080670983859093,48.439070890213635,NaN,NaN,-283.7454919611924,-140.20133894553192,-0.21087279791426655,-0.2482009421116409,-0.03732814419737436,1120746743,1257161789.8,35.66775971148863,61.634605829887214,NaN,NaN,-12.149401223638007,-0.5656915886413272
2018-03-26T09:30:00-04:00,27.36,27.77,27.1,27.69,84145032,61055670.75,40.333099265223794,47.61971138250906,NaN,NaN,-180.97063912418605,-158.40524628642396,-0.2007840595023539,-0.28830821857531674,-0.08752415907296285,1204891775,1235871861.2,33.433358598446304,59.271347749207784,NaN,NaN,-13.598864822033347,-2.4275734791259014
2018-03-27T09:30:00-04:00,27.78,27.9,26.93,27.15,78827371,61359435.35,36.20965507744347,46.55183556065718,NaN,NaN,-170.3740820786366,-179.87090259763687,-0.21759879894823095,-0.35952265775825154,-0.1419238588100206,1126064404,1191387149.6,29.30274250007693,56.509447610752254,NaN,NaN,-16.318748432511846,-4.412027043895322
2018-03-28T09:30:00-04:00,27.22,27.47,26.85,27.2,84244472,62308925.95,36.85339355624233,45.44782508943796,NaN,NaN,-153.56362178047706,-202.09641596883435,-0.21224628735066353,-0.40723171799835,-0.19498543064768648,1210308876,1174409612.4,27.886686787159675,53.357945185700224,NaN,NaN,-18.130040810737533,-6.371743296301352
2018-03-29T09:30:00-04:00,27.32,27.76,27.2,27.57,59281808,61149620.3,41.55371774699151,44.118542008028975,NaN,NaN,-99.01088733479035,-177.5329444558565,-0.1723749551090953,-0.4104541245340556,-0.2380791694249603,1269590684,1186320496.4,30.426884445800383,50.1753185642519,NaN,NaN,-18.005627026818356,-8.033726686375209
2018-04-02T09:30:00-04:00,27.57,27.5999,26.55,26.96,74363891,60918256.7,36.70313663040791,42.54898128206428,NaN,NaN,-124.99543727991517,-145.78293351960104,-0.17510644909965828,-0.45696223079953313,-0.28185578169987485,1195226793,1201216506.4,33.57807151775373,47.147364291526934,NaN,NaN,-19.581128949569017,-9.683355581117182
2018-04-03T09:30:00-04:00,27.13,27.39,26.89,27.33,75160424,61728671.05,41.18758925478895,41.63809093865207,NaN,NaN,-95.30533246061955,-128.64987218688776,-0.14145696623085935,-0.45867698948844904,-0.3172200232575897,1270387217,1214315594.8,36.30994244680496,44.44171434558091,NaN,NaN,-19.325019725746763,-11.060736173207122
2018-04-04T09:30:00-04:00,26.84,27.7,26.82,27.62,70326960,62757712.75,44.50617373838671,41.27241372929803,NaN,NaN,-71.87005608257428,-108.94906698767531,-0.09155155744394161,-0.4316594700625167,-0.3401079126185751,1340714177,1257245549.4,44.383361120461196,42.49986982986367,NaN,NaN,-18.014876334601205,-12.054184767691991
2018-04-05T09:30:00-04:00,27.87,28.04,27.745,27.84,45378315,62950117.2,46.95165910611096,41.07204643284221,NaN,NaN,-29.071664382748324,-84.05067550812956,-0.03833194516340016,-0.3880228440728253,-0.3496908989094251,1386092492,1292402272.6,49.97576968943443,41.1566662998403,NaN,NaN,-16.17136537881551,-12.642353426423922
2018-04-06T09:30:00-04:00,27.52,27.7,26.9159,27.17,88521048,64836017.55,41.02266433703475,40.526146943056816,NaN,NaN,-70.87272539270138,-78.42304311971175,-0.04253526889777165,-0.40285998503163967,-0.360324716133868,1297571444,1297998424.6,50.82342296602465,40.4464716802759,NaN,NaN,-16.513546616906893,-13.195381025064346
2018-04-09T09:30:00-04:00,27.32,27.87,27.27,27.32,54633200,64837893.1,42.76523799591653,40.30770146113456,NaN,NaN,-48.15435353923609,-63.05482637157593,-0.03008240047103289,-0.39792771672265914,-0.36784531625162625,1352204644,1329393994.8,55.39040846793105,40.547337702579554,NaN,NaN,-16.232146706030758,-13.629204693773834
2018-04-10T09:30:00-04:00,27.76,27.89,27.55,27.73,68783202,65687830.55,47.34480582065701,40.3369152565928,NaN,NaN,-22.52582307972905,-48.498924495397816,0.008818603046217954,-0.35682206244385384,-0.3656406654900718,1420987846,1359514120.6,59.2959564753793,41.14823311538392,NaN,NaN,-14.533929022241038,-13.758451026412006
2018-04-11T09:30:00-04:00,27.48,27.6099,27.325,27.4,52480824,65959403.3,44.27416010139966,40.15735368932959,NaN,NaN,-45.16932634846265,-43.158778548575484,0.015012359762209049,-0.3468752157873105,-0.36188757554951956,1368507022,1365072689.6,59.99208677394999,42.000973816515675,NaN,NaN,-14.07678784696412,-13.803927715062308
2018-04-12T09:30:00-04:00,27.61,28.06,27.585,27.88,63289118,66259911.9,49.413463948435286,41.22853054020705,NaN,NaN,5.410532464642534,-36.26233917909731,0.05203925235381002,-0.29683851010725704,-0.34887776246106705,1431796140,1374213419.2,61.16818400581356,43.40247396475176,NaN,NaN,-12.041265273235972,-13.552118794801403
2018-04-13T09:30:00-04:00,28.22,28.24,27.31,27.46,70103895,67392528.5,45.46257821211811,42.470095342225555,NaN,NaN,-8.98070318593385,-23.88393473774381,0.04889624086297778,-0.2877574613823448,-0.3366537022453226,1361692245,1387037579.4,62.81955505680733,45.34188791798881,NaN,NaN,-11.578673401780309,-13.270198024369819
2018-04-16T09:30:00-04:00,27.62,27.78,27.5,27.58,44633622,66560299.25,46.772077671741954,42.930022371262574,NaN,NaN,-7.806881767558499,-15.814440383408291,0.055090367607486146,-0.2677907427359649,-0.32288111034345107,1406325867,1397861824,64.20329158748686,47.539740274348844,NaN,NaN,-10.807387726911687,-12.9183679818758
2018-04-17T09:30:00-04:00,27.82,27.85,27.475,27.58,50750123,66490553.4,46.772077671741954,43.684481127998176,NaN,NaN,4.1927657283314925,-10.470722621796181,0.05902844359869347,-0.24909555584508425,-0.3081239994437777,1406325867,1394929428.2,63.5136623677834,49.98337740775645,NaN,NaN,-10.189017835490247,-12.528460818106435
2018-04-18T09:30:00-04:00,27.65,27.76,27.39,27.45,66795512,67973001.8,45.4023919548067,44.295123870752775,NaN,NaN,-5.162111441291806,-2.4692796403620165,0.05291519617439211,-0.24198000422578758,-0.2948952004001797,1339530355,1389134094.8,62.094116811112876,52.426765266610246,NaN,NaN,-10.051353877720468,-12.174588398051297
2018-04-19T09:30:00-04:00,27.5,27.925,27.48,27.87,76142031,69115533.35,50.450874722795135,44.93063508331018,NaN,NaN,83.05233314210781,13.059080495131038,0.07580155115537596,-0.20014326145595973,-0.2759448126113357,1415672386,1385909344,61.273468536161324,54.63009270163603,NaN,NaN,-8.474713825253247,-11.646034887651576
2018-04-20T09:30:00-04:00,27.92,28.04,27.755,27.88,49800356,67347536.25,50.56807541438454,45.92098785359422,NaN,NaN,126.01392889397859,40.05800691111352,0.08932654532891904,-0.16428663095018692,-0.25361317627910596,1465472742,1406665443.4,64.52345937728367,56.84047754874531,NaN,NaN,-7.152946395318573,-11.004165103032575
2018-04-23T09:30:00-04:00,27.96,27.99,27.76,27.85,45689166,65167518.5,50.184571027047895,46.563629408755574,NaN,NaN,107.41441735073477,63.102266734772186,0.0935187175460693,-0.13671477934651932,-0.23023349689258862,1419783576,1409356985.2,64.93441478304605,58.885082715619674,NaN,NaN,-6.15039357535685,-10.310769170507472
2018-04-24T09:30:00-04:00,28,28.17,27.48,27.67,69592858,64439909.8,47.840218080043726,46.80177543315965,NaN,NaN,69.0966809623965,76.08304978158517,0.08185569952607713,-0.1279138724849922,-0.20976957201106933,1350190718,1398129955.4,61.722631054572794,60.12360199662765,NaN,NaN,-5.889823467006271,-9.679205498578728
2018-04-25T09:30:00-04:00,27.64,27.79,27.37,27.65,51818979,63089490.2,47.574288129734974,46.846248934847075,NaN,NaN,12.654367919939942,79.64634565383153,0.07089061062225147,-0.121156308733255,-0.19204691935550647,1298371739,1389898232.2,59.40263298080384,60.7969493745826,NaN,NaN,-5.73748218569832,-9.116102168167242
2018-04-26T09:30:00-04:00,27.63,27.805,27.52,27.66,33456163,60550074.75,47.730737982153116,47.32539705235553,NaN,NaN,26.187402380866278,68.27335950158322,0.06269073411981882,-0.11368350170573294,-0.17637423582555176,1331827902,1373129335.4,54.8774558870116,61.0865231546531,NaN,NaN,-5.5697637034335346,-8.609482387490997
2018-04-27T09:30:00-04:00,27.61,27.77,27.565,27.7,47185230,59945245.85,48.394136573333384,47.72746123645673,NaN,NaN,29.47098780186531,48.964771283160566,0.05842553530586353,-0.10334231669322236,-0.1617678519990859,1379013132,1355837413.4,50.597108267018314,60.744144568873615,NaN,NaN,-5.266015573715763,-8.131844271237393
2018-04-30T09:30:00-04:00,27.77,27.92,27.44,27.45,41731358,58313619.2,44.58536276638516,47.53035816115159,NaN,NaN,-9.938300400333798,25.49422773294685,0.03820981888905392,-0.11400557838776848,-0.1522153972768224,1337281774,1339337053,46.84253721286212,59.854614621550965,NaN,NaN,-5.9382894443781105,-7.818479295971781
2018-05-01T09:30:00-04:00,27.39,27.48,27.17,27.46,46372385,56874217.25,44.77259978206723,47.56596099548499,NaN,NaN,-125.52225638536368,-13.429559736605189,0.02556187299739701,-0.12026305603007614,-0.14582492902747315,1383654159,1346029741.2,48.51146301278786,59.034570067182244,NaN,NaN,-6.467498575937934,-7.625482050252661
2018-05-02T09:30:00-04:00,27.36,27.47,27.11,27.15,45430348,55629386.65,40.23414164706022,46.91029511681534,NaN,NaN,-173.22491071984757,-50.60541546456269,-0.0021596278186391538,-0.1485244638007721,-0.14636483598213296,1338223811,1354000155.6,50.504447657224,58.272874613711565,NaN,NaN,-8.13834773958919,-7.698748577300736
2018-05-03T09:30:00-04:00,27.02,27.06,26.46,26.92,68947893,56807865.55,37.21961759750608,46.32151221577163,NaN,NaN,-271.9881004311914,-110.24051602697423,-0.03276539862354508,-0.1873215842615643,-0.15455618563801923,1269275918,1341489758.8,47.402935393441474,57.17168749489972,NaN,NaN,-10.450834906769089,-8.091903767224787
2018-05-04T09:30:00-04:00,26.76,27.419,26.67,27.27,40575562,54410591.25,44.08517600697179,46.12959066828804,NaN,NaN,-152.35371584283595,-146.60545675591447,-0.026485644915182738,-0.18766324178199767,-0.16117759686681493,1309851480,1327657428.4,44.17288987751622,55.74094451561609,NaN,NaN,-10.659982895040146,-8.458772214055553
2018-05-07T09:30:00-04:00,27.37,27.56,27.26,27.45,36873637,53522613.1,47.27840174519754,46.165756673534865,NaN,NaN,-46.842656795325226,-153.9863280349128,-0.008204590806200729,-0.17143333537456584,-0.16322874456836511,1346725117,1329546097,44.726703788211594,54.399018902789535,NaN,NaN,-9.940176386916571,-8.670401381607128
2018-05-08T09:30:00-04:00,27.47,27.8265,27.46,27.64,47718493,52469377.65,50.492362994513144,46.52932603351389,NaN,NaN,27.920116066825283,-123.29785354447498,0.0172971993859056,-0.14160724533598312,-0.15890444472188872,1394443610,1331703987.2,45.39323945293247,53.20609909149094,NaN,NaN,-8.402582528937456,-8.63214154551146
2018-05-09T09:30:00-04:00,27.77,28.12,27.67,28.05,43817010,52036186.95,56.6356381489325,46.97109484966656,NaN,NaN,120.30227230546657,-64.59241693941215,0.05998842330805118,-0.08391891558682474,-0.14390733889487592,1438260620,1351711349,51.261692546946485,52.490972235118456,NaN,NaN,-5.130358167546633,-8.131886777230772
2018-05-10T09:30:00-04:00,28,28.3375,27.9601,28.28,41445454,50944003.75,59.65973165193496,47.62049886663444,NaN,NaN,186.41553611067502,27.08831036896114,0.09959180153730267,-0.01941758697324758,-0.11900938851055025,1479706074,1393797380.2,60.80397169590404,52.225294543591325,NaN,NaN,-1.4072102910981135,-7.171218707783249
2018-05-11T09:30:00-04:00,28.3,28.45,28.2,28.26,25893973,48733507.65,59.272649241087635,48.26964731049443,NaN,NaN,187.80903025963252,95.12085958945482,0.11900229756403616,0.029743483444494956,-0.0892588141195412,1453812101,1422589504.4,65.74508672032482,52.28319968196838,NaN,NaN,1.5010165598116894,-5.932327955269686
2018-05-14T09:30:00-04:00,28.34,28.39,28.19,28.24,31292920,48066472.55,58.861369622238065,49.056872420651175,NaN,NaN,150.6678396622008,134.62295888096003,0.1244675256434807,0.06632559293480966,-0.05814193270867103,1422519181,1437748317.2,68.03015704508164,52.73373725271902,NaN,NaN,3.7874126005136772,-4.543793590157778
2018-05-15T09:30:00-04:00,28.2,28.34,28.08,28.19,54655751,48261753.95,57.78192699879757,49.78598948272707,NaN,NaN,114.7206653421756,151.9830687360301,0.11870741706885243,0.0902423386273945,-0.028465078441457927,1367863430,1432432281.2,66.35837428421182,53.230575917248146,NaN,NaN,5.430710545669188,-3.1188644278967828
2018-05-16T09:30:00-04:00,28.16,28.32,28.1,28.24,31984886,46521222.65,58.59956078946082,50.56233396896334,NaN,NaN,104.31902871025292,148.7864200169874,0.11232464752619468,0.11194073096628543,-0.0003839165599092524,1399848316,1424749820.4,63.91397948536005,53.87604188855875,NaN,NaN,7.04285383031123,-1.667190391009924
2018-05-17T09:30:00-04:00,28.21,28.28,28,28.18,45070410,44967641.6,57.16874085795546,51.18909141786491,NaN,NaN,80.85139011824235,127.67359081850084,0.09861024786558314,0.12287889327206969,0.024268645406486537,1354777906,1399764186.8,56.610239512794465,54.305551263257044,NaN,NaN,8.06696361169212,-0.27659696205248907
2018-05-18T09:30:00-04:00,28.18,28.19,27.94,27.95,33266115,44140929.55,51.93390719083553,51.7139874481828,NaN,NaN,53.08897940245365,100.72958064706508,0.06994570042580515,0.11170077093874298,0.04175507051293782,1321511791,1373304124.8,50.08306110693886,54.537017255691104,NaN,NaN,7.6026694645697015,0.8490125274649667
2018-05-21T09:30:00-04:00,28.11,28.26,28.1,28.15,29647924,43338867.45,55.730030616947786,52.4966610792457,NaN,NaN,74.87733885133207,85.57148048489132,0.06069550797501514,0.11762445548170675,0.056928947506691606,1351159715,1359032231.6,46.93934765353971,54.42472330145909,NaN,NaN,8.222174901805838,1.902321438085091
2018-05-22T09:30:00-04:00,28.17,28.5,28.17,28.34,52841403,42501294.7,59.039617566299306,53.839909359191346,NaN,NaN,93.46074199023154,81.3194958145025,0.063322253507962,0.1360817643916441,0.0727595108836821,1404001118,1366259769.2,48.69565176878352,54.29552359514191,NaN,NaN,9.696037750708765,3.015709482745616
2018-05-23T09:30:00-04:00,28.15,28.2355,27.86,28.16,44968489,42158770.2,54.855639102068736,55.099625180945814,NaN,NaN,45.288760020080844,69.51344207646808,0.04949867549620665,0.13463285525394042,0.08513417975773377,1359032629,1358096631.8,46.81101932910118,54.253243876260456,NaN,NaN,9.792180433928541,3.983776761486034
2018-05-24T09:30:00-04:00,28.07,28.085,27.6635,27.94,43245202,42648222.15,50.175364843233005,55.53463866925019,NaN,NaN,10.762295259949859,55.49562310480959,0.02342348413740207,0.11441353492948636,0.09099005079208429,1315787427,1350298536,45.018580198737084,54.31365032777624,NaN,NaN,8.499185758307163,4.628835189603338
2018-05-25T09:30:00-04:00,27.81,27.9,27.72,27.85,39312481,42254584.7,48.35767432474632,55.61172956778939,NaN,NaN,-3.4149177638712183,44.19484367154462,-0.0007209670580417965,0.09008884196953204,0.09080980902757384,1276474946,1341291167,42.971787723710925,54.1882991803119,NaN,NaN,6.887484347599545,4.951499355031368
2018-05-29T09:30:00-04:00,27.46,27.5,26.72,26.92,126469714,46491502.5,34.46392949578728,54.46684146073755,NaN,NaN,-126.61377796887747,3.8966203075027126,-0.07599477007233721,-0.004183653562847667,0.07181111650948954,1150005232,1301060270.4,35.26064545591798,53.464542466239436,NaN,NaN,0.07914411463873174,4.255448606403848
2018-05-30T09:30:00-04:00,27.18,27.52,27.11,27.41,65843728,47465069.65,43.65028868821945,53.53931649925805,NaN,NaN,-76.66142166081173,-30.127812422705937,-0.08857519305422776,-0.03890787480829516,0.049667318245932596,1215848960,1263429838.8,29.862699527342386,51.936042964839146,NaN,NaN,-2.3145204508278967,3.316881598227885
2018-05-31T09:30:00-04:00,27.35,27.385,27.1,27.18,66686937,48527899.1,40.762035092679895,52.18948103073983,NaN,NaN,-96.68431739882226,-58.522427906486556,-0.10694797061036813,-0.08401764501702758,0.02293032559334056,1149162023,1221455717.6,25.224152612753826,49.3946273160427,NaN,NaN,-5.24840373467936,2.0932694078125644
2018-06-01T09:30:00-04:00,27.51,27.63,27.4,27.48,62934254,48227217.15,45.79968640265432,51.2271265422803,NaN,NaN,-62.77105342855585,-73.2290976441877,-0.0939210345562921,-0.09447096760202456,-0.0005499330457324654,1212096277,1200717487.6,23.298591471072257,46.36273479823894,NaN,NaN,-5.837415013443574,0.960314490490259
2018-06-04T09:30:00-04:00,27.61,27.665,27.524,27.57,44196942,48408286.15,47.249007281640004,50.39767208938044,NaN,NaN,-56.17665675940087,-83.78144544329362,-0.07508390420450164,-0.09440481330135952,-0.01932090909685788,1256293219,1196681142.2,22.93166617095369,43.14141402151552,NaN,NaN,-5.808962299387149,-0.006725050920799225
2018-06-05T09:30:00-04:00,27.48,27.52,27.31,27.45,44996769,48814442.75,45.5019150034445,49.52052837542665,NaN,NaN,-87.87795933165533,-76.03428171584919,-0.06682310812510714,-0.10284979425324181,-0.03602668612813467,1211296450,1208939385.8,26.706832500172993,40.30916103694132,NaN,NaN,-6.34554208062566,-0.9122703408786363
2018-06-06T09:30:00-04:00,27.61,27.97,27.58,27.95,61959987,49526517.45,53.257407680209795,49.138946010480154,NaN,NaN,-9.523184386563809,-62.60663426099961,-0.025905143103515174,-0.06840811500752864,-0.04250297190401346,1273256437,1220420881.2,30.15773983858405,37.89800106217161,NaN,NaN,-4.181494596229253,-1.3793023773572959
2018-06-07T09:30:00-04:00,28.07,28.18,27.8524,28.04,65166111,50593972.5,54.51222367382164,48.94919478304202,NaN,NaN,28.547626788043466,-37.56024542362647,0.007230516292346625,-0.033464826538580184,-0.04069534283092681,1338422548,1258272986.2,40.160779642616944,36.72303964287321,NaN,NaN,-2.0656169064577123,-1.477347310085927
2018-06-08T09:30:00-04:00,28.01,28.11,27.86,28.08,47713396,50907369.6,55.089281610221235,49.174578670141,NaN,NaN,29.448569514356553,-19.116320835043986,0.03054398827060619,-0.002515357492669068,-0.03305934576327526,1386135944,1293080919.6,47.593859149010086,36.54523950302116,NaN,NaN,-0.2050216913603188,-1.2955865074108401
2018-06-11T09:30:00-04:00,28.17,28.27,28.02,28.02,47319625,51978652.2,53.98302002706657,49.0497921994352,NaN,NaN,50.78561977934031,2.2761344727042343,0.0400275904286685,0.016975142272560362,-0.023052448156108137,1338816319,1309585539.6,50.71970883777553,36.81526530189514,NaN,NaN,0.994109025585471,-0.9684871455542243
2018-06-12T09:30:00-04:00,28.1,28.17,27.81,27.95,55517218,53189867.1,52.65453108290146,48.593714593478204,NaN,NaN,28.034032155260668,25.45853277008743,0.03961634440298992,0.02646798234762926,-0.013148362055360657,1283299101,1323986069.8,53.335084228829174,37.14665333475555,NaN,NaN,1.6181235235311144,-0.5989713356848902
2018-06-13T09:30:00-04:00,27.96,28.18,27.82,27.85,61095759,53511867.5,50.73372227735169,48.29929196314127,NaN,NaN,25.803466725308322,32.52386299246186,0.0310199338500323,0.025626555257179717,-0.005393378592852582,1222203342,1313775450.8,51.2578777838491,37.464286081523255,NaN,NaN,1.6173174242607933,-0.28235865569264973
2018-06-14T09:30:00-04:00,27.9,27.95,27.51,27.59,70635531,55444399.75,46.031908726992356,48.00333081198123,NaN,NaN,-29.6557470835392,20.883188218145328,0.007462331875691834,0.003934536251762211,-0.0035277956239296235,1151567811,1276404503.4,44.436484496430474,37.422707817072784,NaN,NaN,0.26862077347300495,-0.20364730866898478
2018-06-15T09:30:00-04:00,27.3,27.555,27.11,27.47,63517019,56366730.2,44.00487020623118,47.69241623208728,NaN,NaN,-87.98306936995067,-2.603139558716113,-0.015320261841891508,-0.02267812292629401,-0.007357861084402501,1088050792,1216787473,36.16750471609111,36.9366876022428,NaN,NaN,-1.452386348310159,-0.38203860004629536
2018-06-18T09:30:00-04:00,27.23,27.46,27.14,27.42,49824557,57194652.3,43.152203246387174,48.31300721427299,NaN,NaN,-85.36247028292757,-29.83275757116969,-0.03192063974646704,-0.047258660767486305,-0.015338021021019263,1038226235,1156669456.2,30.087343784849466,36.56716605430933,NaN,NaN,-3.1247323224121755,-0.7738519889557067
2018-06-19T09:30:00-04:00,27.14,27.4199,27.13,27.35,50214730,58222992.6,41.92733694056498,48.189939232297675,NaN,NaN,-84.55103957074746,-52.34977191637131,-0.04497950498978881,-0.07156240225825528,-0.026582897268466466,988011505,1097611937,25.54431022232974,36.258709675379855,NaN,NaN,-4.87631002691511,-1.3599174229499071
2018-06-20T09:30:00-04:00,27.6,27.6,27.25,27.28,42833585,57722601.7,40.6837077072113,48.18434441904992,NaN,NaN,-61.203011791438136,-69.7510676197206,-0.05503153402243481,-0.09537231479650998,-0.04034078077407517,945177920,1042206852.6,22.163238245801764,36.04007293488328,NaN,NaN,-6.705601803069413,-2.123586620109837
2018-06-21T09:30:00-04:00,27.19,27.355,27.01,27.2,75190888,59233721.65,39.250798191327846,47.716566689669456,NaN,NaN,-94.9744623439334,-82.81481067179945,-0.06318474103864989,-0.11932170707238754,-0.05613696603373765,869987032,985890696.8,19.358456752088813,35.75863474067018,NaN,NaN,-8.66307344906189,-3.0577990242458446
2018-06-22T09:30:00-04:00,27.39,27.42,27.05,27.07,61978929,60170408,36.97198335202971,46.98249355184015,NaN,NaN,-88.2732954025731,-82.87285587832393,-0.07276727100203519,-0.14709605478628163,-0.07432878378424644,808008103,929882159,17.04777825696212,35.338357032527924,NaN,NaN,-10.998651467628932,-4.1922065161577144
2018-06-25T09:30:00-04:00,26.95,27,26.595,26.78,80746078,62242087.85,32.44647476240179,46.04996210605138,NaN,NaN,-157.0828003121196,-97.21692188416233,-0.09278831572396726,-0.1903141784392055,-0.09752586271523825,727262025,867689317,14.91836106701686,34.496323358731054,NaN,NaN,-14.469020709279762,-5.660322829460864
2018-06-26T09:30:00-04:00,26.8,26.83,26.52,26.69,56480350,58742619.65,31.17127448344631,44.47238116342542,NaN,NaN,-168.86623591732166,-114.07996115347717,-0.10532746691717614,-0.22918519636170842,-0.12385772944453229,670781675,804243351,13.118184890543745,33.27921229101389,NaN,NaN,-17.777420235677035,-7.391336744634603
2018-06-27T09:30:00-04:00,26.68,26.88,26.35,26.36,78099192,59355392.85,26.983650341656457,42.50605449684219,NaN,NaN,-171.8551165509377,-136.21038210537708,-0.1275959658830048,-0.2833526867982883,-0.15575672091528348,592682483,733744263.6,11.462967231197524,31.22936854734108,NaN,NaN,-22.11783256196261,-9.495121861395747
2018-06-28T09:30:00-04:00,26.36,26.7,26.31,26.59,78544814,59948286.7,33.671855175069396,40.976238322902766,NaN,NaN,-151.47808881201166,-147.51110739899272,-0.11876657127704232,-0.30421493501158636,-0.18544836373454404,671227297,693992316.6,10.647182356682478,28.590320205031965,NaN,NaN,-23.854172028700845,-11.546414742439332
2018-06-29T09:30:00-04:00,26.92,27.07,26.55,26.59,77208627,60662005.35,33.671855175069396,39.525440833474406,NaN,NaN,-103.26996337713891,-150.5104409939059,-0.1053158405398334,-0.31709316440933577,-0.21177732386950238,671227297,666636155.4,10.113758295941992,25.68989516632957,NaN,NaN,-25.246301491157112,-13.503541420827586
2018-07-02T09:30:00-04:00,26.37,26.73,26.35,26.72,66202782,61762297.35,37.42891423638342,38.43789677300883,NaN,NaN,-109.6786293596567,-141.02960680341332,-0.08113732297715265,-0.3131989775909432,-0.23206165461379052,737430079,668669766.2,10.472837371369835,22.628306105082476,NaN,NaN,-25.352850073692977,-15.196299799808356
2018-07-03T09:30:00-04:00,26.79,26.87,26.42,26.48,30717772,61048347.5,33.640439419889205,37.2169479974758,NaN,NaN,-97.60147089569175,-126.77665379908733,-0.07492992154885203,-0.3257240565498556,-0.25079413500100356,706712307,675855892.6,11.813473164481962,19.810848632270535,NaN,NaN,-26.570361339657435,-16.821165734072512
2018-07-05T09:30:00-04:00,26.62,26.68,26.45,26.54,40668535,59983774.9,35.40082909149805,36.457585166369064,NaN,NaN,-91.52385732609288,-110.71040195411838,-0.060995790202046596,-0.3270388727535618,-0.2660430825515152,747380842,706795564.4,17.53893424692697,17.889595043020282,NaN,NaN,-27.065631539060043,-18.28466084907073
2018-07-06T09:30:00-04:00,26.47,26.78,26.37,26.67,41287510,58789844.85,39.16635740531333,36.11197710916064,NaN,NaN,-76.63196882437128,-95.7411779565903,-0.03834288621293103,-0.313971690317679,-0.275628804104748,788668352,730283775.4,21.695311098504718,16.8558669274784,NaN,NaN,-26.39806559808623,-19.443718670358656
2018-07-09T09:30:00-04:00,26.81,27.31,26.78,27.28,73060360,60057193.05,53.0081584904768,36.81597391230991,NaN,NaN,1.8410041203680965,-74.71898445708891,0.019307142724556747,-0.25149487569905205,-0.2708020184236088,861728712,768384058.4,28.03208001719844,16.709062372646184,NaN,NaN,-20.974707500194402,-19.66243136033519
2018-07-10T09:30:00-04:00,27.3,27.3899,27.1,27.18,51260559,60254239.75,50.96104484124489,37.46123876235847,NaN,NaN,26.1381420010927,-47.55563018493904,0.050516035599403375,-0.20765697392435456,-0.25817300952375793,810468153,782991673.2,30.358997101933426,17.052968578332163,NaN,NaN,-17.30082757189428,-19.325059390557918
2018-07-11T09:30:00-04:00,27.03,27.19,26.99,27.05,46023735,59779565.6,48.34709267630464,38.008623403007995,NaN,NaN,10.147627278889283,-26.005810550022836,0.061486448727361365,-0.18131494861455622,-0.24280139734191758,764444418,794538095.4,32.22438114805961,17.77162164277915,NaN,NaN,-15.109619339470854,-18.72285366897405
2018-07-12T09:30:00-04:00,27.22,27.24,26.94,27.1,64876803,59968617.8,49.421663849855385,38.73511380718854,NaN,NaN,23.80982238776476,-2.939074607251288,0.07054372708366255,-0.1546217384873394,-0.22516546557100195,829321221,810926171.2,34.89010672299034,18.88102521212926,NaN,NaN,-13.015809578874748,-17.90756165610272
2018-07-13T09:30:00-04:00,26.99,27.0737,26.7,26.98,64151172,59644399.85,46.89987882965754,39.444249198447665,NaN,NaN,-5.40155287381225,11.307008582860519,0.06691730585823105,-0.14151883324821313,-0.20843613910644418,765170049,806226510.6,34.47138652223974,20.125568659649087,NaN,NaN,-12.0019020428992,-17.063895997073647
2018-07-16T09:30:00-04:00,27.06,27.48,27.04,27.46,55812035,59259150.65,56.46831295322266,41.160094783506295,NaN,NaN,91.01924433683604,29.1426566261541,0.09366917066664776,-0.09134967577313446,-0.18501884643978223,820982084,798077185,33.715781723505785,21.468241563684014,NaN,NaN,-7.851597550475947,-15.747853361845404
2018-07-17T09:30:00-04:00,27.49,27.6,27.34,27.49,55502230,59543034.3,56.989963742083845,43.00428687340899,NaN,NaN,121.66997784280336,48.24902379449624,0.10912773997204153,-0.04860917147473032,-0.15773691144677185,876484314,811280417.2,36.15746513156353,23.113904438042567,NaN,NaN,-4.4182225877185415,-14.12933467982728
2018-07-18T09:30:00-04:00,27.6,27.98,27.56,27.93,59109184,59987757,63.8350423006228,45.636529156192296,NaN,NaN,178.97969832915814,82.01543800455,0.14261404466813848,0.020530644388401242,-0.12208340027973723,935593498,845510233.2,42.111116173886224,25.303057933948907,NaN,NaN,1.056002777627889,-11.960000757333685
2018-07-19T09:30:00-04:00,27.79,27.7955,27.47,27.51,61765223,60934338.9,54.859836169775626,47.14995637009988,NaN,NaN,123.87446206375483,102.02836593974801,0.13043614008734816,0.04096177482944796,-0.08947436525790019,873828275,854411644,43.58448267550035,27.655722242435896,NaN,NaN,2.6684761691808196,-9.870218339260184
2018-07-20T09:30:00-04:00,27.46,27.64,27.36,27.56,52288061,59789197.55,55.65910907954201,48.72047450613364,NaN,NaN,100.80880088860992,123.27043669223244,0.11997219132223103,0.06049087389488861,-0.059481317427342424,926116336,886600901.4,48.67200909861569,30.409883014055445,NaN,NaN,4.17707449533936,-7.863462220031678
2018-07-23T09:30:00-04:00,27.56,27.98,27.55,27.94,81516221,60766062.15,61.27164675138489,50.42352682863374,NaN,NaN,140.18233532537553,133.10305488994035,0.13191744251058807,0.10541548571089265,-0.026501956799695407,1007632557,923930996,53.86772924957613,33.50951814821304,NaN,NaN,7.417795069659426,-5.680425464361521
2018-07-24T09:30:00-04:00,28.05,28.19,27.945,28.02,63133677,59885442.1,62.35205333613228,52.47435639407968,NaN,NaN,155.19534305116505,139.8081279316127,0.13783619060461397,0.14579328145607207,0.007957090851458092,1070766234,962787380,58.568899027031826,36.849191424109456,NaN,NaN,10.319741836733039,-3.39468727849087
2018-07-25T09:30:00-04:00,28,28.13,27.85,28.08,44262784,59274563.8,63.18165273343456,54.45870093993228,NaN,NaN,129.92899347568627,129.99798696091833,0.1380768629203864,0.1805531695019411,0.0424763065815547,1115029018,998674484,62.381834297485526,40.052255713435066,NaN,NaN,12.894429529761348,-1.0676705915976963
2018-07-26T09:30:00-04:00,28.15,28.256,28.04,28.07,40056838,57372446.1,62.932745655713454,56.156300100675146,NaN,NaN,128.02186834568084,130.82746821730353,0.129964069332562,0.20493139324725718,0.07496732391469518,1074972180,1038903265,66.14332822227529,43.22711407941868,NaN,NaN,14.885119020916704,1.211299353047218
2018-07-27T09:30:00-04:00,28.06,28.269,27.97,28.13,63159670,56603188.9,63.8528896224444,56.930923752958556,NaN,NaN,114.43962573216736,133.55363318601502,0.12121179325972084,0.22648206548934624,0.1052702722296254,1138131850,1081306367.8,69.59445553979575,46.19585518817563,NaN,NaN,16.79743372277482,3.437889977294018
2018-07-30T09:30:00-04:00,28.15,28.355,28.11,28.15,56474138,55566464.45,64.17215329186327,57.87457435657415,NaN,NaN,112.20444177104497,127.9580544751489,0.10968853798012154,0.24238094470477733,0.1326924067246558,1194605988,1118701054,72.27816576087804,49.19008152095739,NaN,NaN,18.467798312299948,5.585019739437723
2018-07-31T09:30:00-04:00,28.23,28.24,27.89,27.95,84500132,56481331.95,58.598416229994044,58.60681175326625,NaN,NaN,80.20204522247148,112.95939490941018,0.0827426662938979,0.23612073959202817,0.15337807329813027,1110105856,1126568978.4,72.82171617856103,52.08989116599321,NaN,NaN,18.409081157396894,7.41702851343189
2018-08-01T09:30:00-04:00,28.13,28.27,27.88,27.95,64046851,58147785.9,58.59841622999405,59.26229406613329,NaN,NaN,74.355449509125,101.8446861160979,0.06011769003939518,0.22852518584737425,0.16840749580797906,1110105856,1125584346,72.62979129087651,54.78558292084222,NaN,NaN,18.360623786505542,8.980399266728126
2018-08-02T09:30:00-04:00,27.77,28.0068,27.68,27.96,38330747,58030896.5,58.80589530564588,60.11272381441818,NaN,NaN,45.607121590564034,85.36173676507455,0.04188816223511707,0.2207676986018754,0.17887953636675832,1148436603,1140277230.6,73.74190999905608,57.590620312043384,NaN,NaN,18.37231702021141,10.322101802940024
2018-08-03T09:30:00-04:00,27.92,28.12,27.92,28.12,34894345,57711238.25,62.08026220439731,60.513577332359226,NaN,NaN,67.47210598008671,75.96823281465844,0.036846416313633085,0.22493755675879967,0.1880911404451666,1183330948,1149317050.2,74.43030230931726,60.49880035388706,NaN,NaN,19.239666075679157,11.59603955618847
2018-08-06T09:30:00-04:00,28.16,28.34,28.1,28.27,38230123,55969726.4,64.89727646947603,61.07838538431581,NaN,NaN,92.94697879630574,72.11674021971058,0.0396126561645673,0.23760696065087572,0.19799430448630842,1221561071,1154708066.8,74.85369431847603,63.262816724380805,NaN,NaN,20.772886234837003,12.907017653138261
2018-08-07T09:30:00-04:00,28.35,28.56,28.325,28.4,44608618,55637129.35,67.17335379184777,61.31683620511759,NaN,NaN,119.97537935886139,80.07140704698858,0.0457611408352841,0.25519573053041356,0.20943458969512946,1266169689,1185920833.4,77.20693364555848,65.76966082950025,NaN,NaN,22.743884551985435,14.312284352973572
2018-08-08T09:30:00-04:00,28.36,28.52,28.34,28.47,47523171,55712101.15,68.36290242735143,62.28134093780158,NaN,NaN,117.63045406888118,88.7264079589398,0.04977387858219129,0.27165193792286857,0.22187805934067728,1313692860,1226638234.2,79.85533834612366,68.36043623454478,NaN,NaN,24.75032456180785,15.803432954235612
2018-08-09T09:30:00-04:00,28.4,28.47,28.3,28.3,29357810,53936151.5,62.44473707994983,62.76602865211642,NaN,NaN,95.62142531575469,98.72926870397794,0.03680793313636829,0.26788797576113765,0.23108004262476936,1284335050,1253817923.6,81.40826400156496,70.69874015618402,NaN,NaN,24.89065595582248,17.101607668748024
2018-08-10T09:30:00-04:00,27.93,28.069,27.83,27.97,83301442,54893665,52.875621713102944,62.16631257795342,NaN,NaN,-5.191766145025082,84.19649427895558,0.0035850553466549584,0.23556136180808807,0.2319763064614331,1201033608,1257358455.6,81.60717003701956,72.68012878385854,NaN,NaN,22.06224014631072,17.810269451256982
2018-08-13T09:30:00-04:00,27.97,28.04,27.69,27.7,74413496,55823738.05,46.58547232408239,61.040128219949864,NaN,NaN,-59.7825113784285,53.65059624400874,-0.036771988279531015,0.18601132111201935,0.22278330939155036,1126620112,1238370263.8,76.85800878879138,73.98649376684136,NaN,NaN,17.502559781905205,17.76631092706387
2018-08-14T09:30:00-04:00,27.8,28.01,27.72,27.96,43659034,55231578.25,52.451409264072055,60.27368225785254,NaN,NaN,-44.32236502363378,20.7910473675097,-0.045577833303666215,0.1658110177619676,0.21138885106563382,1170279146,1219192155.2,72.28260685214356,74.6936918064598,NaN,NaN,15.467570586575466,17.43791944985124
2018-08-15T09:30:00-04:00,27.73,27.88,27.61,27.74,55681123,55060175.2,47.67998411061735,59.18419929034568,NaN,NaN,-95.4502363036432,-21.825090706995166,-0.064674978876123,0.13054512747048008,0.19522010634660308,1114598023,1179373187.8,63.791369992574886,74.52569479005263,NaN,NaN,12.150457062268789,16.682567680196605
2018-08-16T09:30:00-04:00,27.87,28.19,27.87,28.11,49534158,54448621.95,55.08090378377494,58.55762887329786,NaN,NaN,6.830325005133442,-39.58331076911942,-0.05142157931751651,0.13094313219970743,0.18236471151722394,1164132181,1155332614,59.26475883946962,73.7878593114579,NaN,NaN,11.812991584411572,15.986913952227315
2018-08-17T09:30:00-04:00,28.03,28.21,28.03,28.17,43193141,53993875.95,56.163795368156514,57.985603307318804,NaN,NaN,29.719439894274107,-32.60106956125957,-0.038252525512726565,0.13454905462631572,0.1728015801390423,1207325322,1156590956.8,59.42704694892319,72.86992225346113,NaN,NaN,11.906985032602236,15.404066963709447
2018-08-20T09:30:00-04:00,28.17,28.31,28.13,28.26,30053680,51420748.9,57.80692231031811,57.92906802734195,NaN,NaN,64.73995263818237,-7.69657675793741,-0.0238249663957944,0.1430203721442993,0.1668453385400937,1237379002,1178742734.8,62.27626324785732,72.11667561555372,NaN,NaN,12.503084803915595,14.989640940881754
2018-08-21T09:30:00-04:00,28.28,28.51,28.22,28.37,47940015,50661065.8,59.790728474135655,58.01423318763778,NaN,NaN,109.31730957785129,23.031358162359602,-0.008034261825768552,0.15680251125788303,0.16483677308365158,1285319017,1201750709,65.02363805089836,71.57337895555531,NaN,NaN,13.606896296347818,14.79210599166262
2018-08-22T09:30:00-04:00,28.25,28.376,28.23,28.27,27323256,49814089.4,57.15961647970608,57.89664184292779,NaN,NaN,70.62974514067363,56.24735445122296,-0.005600336614567464,0.15783635231544224,0.1634366889300097,1257995761,1230430256.6,68.13856022565062,71.17313968602636,NaN,NaN,13.731199515925569,14.640547923700185
2018-08-23T09:30:00-04:00,28.26,28.29,28.1046,28.14,31767818,49399638.4,53.842514244683244,57.30823127437678,NaN,NaN,22.365046707936887,59.35429879178366,-0.013567537937652807,0.14647726650794368,0.1600448044455965,1226227943,1242849409,69.40904634763764,70.81447854590638,NaN,NaN,12.845814617460405,14.384157451380217
2018-08-24T09:30:00-04:00,28.25,28.295,28.19,28.24,22064526,47344881.2,55.95971017347364,56.66983368180519,NaN,NaN,44.21034892904412,62.252480598737655,-0.012927324169140109,0.14388564923417135,0.15681297340331146,1248292469,1251042838.4,70.25184344179422,70.48577491185769,NaN,NaN,12.72065903930433,14.146514821083661
2018-08-27T09:30:00-04:00,28.35,28.72,28.34,28.62,52254529,47133900.75,62.91999443136611,56.36602229891364,NaN,NaN,147.3142802841449,78.76734612793017,0.010972699417454213,0.1705288476751292,0.159556148257675,1300546998,1263676437.6,71.55323779560767,70.08193949400405,NaN,NaN,14.833496154084822,14.244655011512398
2018-08-28T09:30:00-04:00,28.7,28.72,28.54,28.59,28896792,44353733.75,62.08575423622097,55.91765457097575,NaN,NaN,145.66181964861534,86.03624814208298,0.022008391284535245,0.18706663736334406,0.1650582460788088,1271650206,1260942675.4,70.83114757945044,69.43735443924167,NaN,NaN,16.26743470740032,14.533623539496388
2018-08-29T09:30:00-04:00,28.59,28.66,28.44,28.58,34015284,42852155.4,61.7916537902739,55.87100576457033,NaN,NaN,113.05387101058885,94.52107331606602,0.02562865175083165,0.19709406076734837,0.17146540901651672,1237634922,1256870507.6,69.70275114608566,68.60124637813603,NaN,NaN,17.341449619924592,14.93474155098613
2018-08-30T09:30:00-04:00,28.45,28.56,28.31,28.36,43264120,43098824.05,55.5565155698788,56.062498182911455,NaN,NaN,60.4088310348891,102.12983018145647,0.010951161156861677,0.18515436046259381,0.17420319930573214,1194370802,1250499079.4,67.88062242456277,67.62077869153195,NaN,NaN,16.447125465134523,15.150796395864472
2018-08-31T09:30:00-04:00,28.26,28.35,28.171,28.33,34107750,43059494.3,54.74528143491752,56.64534169082826,NaN,NaN,15.080341660194419,96.30382872768652,-0.0023251907911080727,0.17129671081684705,0.17362190160795513,1160263052,1232893196,62.98119067718567,66.62957739784584,NaN,NaN,15.4833051050066,15.198297640027633
2018-09-04T09:30:00-04:00,28.27,28.495,28.2,28.47,43145632,43305269.75,57.839217560517554,57.03018514057436,NaN,NaN,47.31145114135033,76.3032628991276,-0.0031730654439370842,0.16965556980303376,0.17282863524697084,1203408684,1213465533.2,58.00588917892657,65.60981184975891,NaN,NaN,15.528878757738894,15.245523513986385
2018-09-05T09:30:00-04:00,28.45,28.64,28.43,28.49,32727695,42711223.6,58.27804999255318,57.78718984642692,NaN,NaN,88.29262093654064,64.82942315671266,-0.0038374519175692345,0.1680318203500093,0.17186927226757853,1236136379,1206362767.8,56.25616240825634,65.0715827365933,NaN,NaN,15.686825886092903,15.308566710001601
2018-09-06T09:30:00-04:00,28.45,28.53,28.27,28.36,38328974,42251513.75,54.32028388066835,57.732859853347875,NaN,NaN,45.79560630956872,51.377770216508644,-0.013915906561934033,0.15447438906516098,0.168390295627095,1197807405,1198397264.4,54.278744856168544,64.71543888064322,NaN,NaN,14.722910672662598,15.224901561810315
2018-09-07T09:30:00-04:00,28.42,28.44,28.21,28.33,43644283,42965837.4,53.41871046050283,57.53678235994404,NaN,NaN,26.41795842260862,44.57959569405256,-0.022953103960870302,0.13969891567600712,0.16265201963687742,1154163122,1190355728.4,52.28081118592601,64.20499346900057,NaN,NaN,13.672267921202033,15.003096756009132
2018-09-10T09:30:00-04:00,28.4,28.44,28.27,28.3,29927169,40297123.75,52.4806667074419,57.156335531167166,NaN,NaN,25.157642650920756,46.59505589219782,-0.030811601903105362,0.12413751725799571,0.15494911916110107,1124235953,1183150308.6,50.487562047550085,63.36294338326433,NaN,NaN,12.536643292657153,14.650746261244564
2018-09-11T09:30:00-04:00,28.22,28.41,28.12,28.33,32065453,38179721.6,53.36262585531683,56.69718534410868,NaN,NaN,-1.8604174844933123,36.76068216702909,-0.033620072711055354,0.11292402827228187,0.14654410098333723,1156301406,1173728853,48.16139565134768,62.15849749758213,NaN,NaN,11.790592784150277,14.242152907373951
2018-09-12T09:30:00-04:00,28.33,28.39,28.05,28.07,47963444,38394942.1,45.48364309741891,55.86318724537389,NaN,NaN,-63.026219331476554,6.496914113425646,-0.05154655522675816,0.08211090694988954,0.1336574621766477,1108337962,1148169169.6,42.44751927894643,60.32342314424612,NaN,NaN,8.840152672402237,13.470438588092277
2018-09-13T09:30:00-04:00,28.14,28.28,27.97,28.03,44974607,37859616.3,44.39755918792428,55.188547598462534,NaN,NaN,-122.08471140507908,-27.07914942950391,-0.06385160769469933,0.05384295255827354,0.11769456025297287,1063363355,1121280359.6,37.41813613104946,58.038358128775535,NaN,NaN,6.062577752576085,12.412172754447106
2018-09-14T09:30:00-04:00,28.07,28.255,28.06,28.23,34150959,37090456.35,50.73225169165534,54.81515770690408,NaN,NaN,-82.29628944339285,-48.8219990027042,-0.05652643548436753,0.04703651589751345,0.10356295138188099,1097514314,1109950598,35.50900907078966,55.55672710227521,NaN,NaN,5.349757809971857,11.403256333807784
2018-09-17T09:30:00-04:00,28.23,28.31,28.08,28.11,26907851,36276191.85,47.253662891415466,53.69613402547903,NaN,NaN,-92.59905157003287,-72.37333784689494,-0.05757423361894709,0.03159515935819712,0.08916939297714421,1070606463,1099224700,33.75324641638589,52.856727718045086,NaN,NaN,3.7163713801344795,10.305129911854454
2018-09-18T09:30:00-04:00,28.18,28.28,28.06,28.25,36405644,36593790.05,51.43729332331678,52.93552967455731,NaN,NaN,-73.51355180649952,-86.70396471129618,-0.04709130412762477,0.030305262817613254,0.07739656694523803,1107012107,1089366840.2,32.17844441606623,50.095820349231936,NaN,NaN,3.537194088222404,9.338281937049876
2018-09-19T09:30:00-04:00,28.23,28.82,28.23,28.73,75552011,37974389.85,62.437745616930115,52.981679090747036,NaN,NaN,128.2803989531258,-48.442641054375706,-0.00812533412815128,0.06723989928504892,0.0753652334132002,1182564118,1104212071.4,36.9492291424436,47.756283063257506,NaN,NaN,7.208158164274026,9.03397854093904
2018-09-20T09:30:00-04:00,28.94,29.07,28.87,28.98,78555524,40536003.25,66.67220259450895,53.77565673536348,NaN,NaN,242.83214884059365,24.54073099475884,0.03199104992005267,0.11535404581326603,0.08336299589321336,1261119642,1143763328.8,47.53758167112847,46.30320872372648,NaN,NaN,11.825651399488105,9.432788949303193
2018-09-21T09:30:00-04:00,28.95,29,28.7,28.74,64744540,42184839.35,59.712836351592415,54.130482086554544,NaN,NaN,150.75612038817755,71.15121296107291,0.03938195472124237,0.13259043929476633,0.09320848457352396,1196375102,1163535486.4,51.88743813189791,45.510797827634505,NaN,NaN,13.190631047276636,9.96962353472797
2018-09-24T09:30:00-04:00,28.71,28.745,28.4,28.42,47985139,43480870,51.92955218306102,53.70836313102193,NaN,NaN,37.83763810369847,97.23855089581919,0.020678547139351064,0.11905666849771279,0.09837812135836173,1148389963,1179092186.4,55.04568518231955,45.29935468501971,NaN,NaN,11.485803330440353,10.186220648401168
2018-09-25T09:30:00-04:00,28.53,28.552,28.3,28.31,32953640,42515825.55,49.53914921054663,53.084155932307176,NaN,NaN,-9.010576792915883,110.13914589853592,-0.000045227572124301174,0.09832158689320636,0.09836681446533066,1115436323,1180777029.6,55.38725013804876,45.23728952286202,NaN,NaN,9.319725014760639,10.062435557881093
2018-09-26T09:30:00-04:00,28.35,28.39,27.9,27.97,60288142,44085393.05,42.957083075229676,52.272498731918695,NaN,NaN,-115.79083949654868,61.32489820860102,-0.035626914339892915,0.05383317154046452,0.08946008588035743,1055148181,1155293842.2,49.28742988510764,44.880767024929106,NaN,NaN,5.071178592597419,9.349398848554854
2018-09-27T09:30:00-04:00,28,28.1,27.84,27.87,57492175,45259237.6,41.222275055668604,51.40132477443054,NaN,NaN,-152.7174012729419,-17.785011814106092,-0.06325856146203504,0.010386884052813627,0.07364544551484867,997656006,1102601115,39.580711270419435,43.973617030964355,NaN,NaN,1.1592741172331567,8.179381029794612
2018-09-28T09:30:00-04:00,27.76,27.765,27.54,27.58,66454872,46418775.2,36.60543441863482,50.267379610944324,NaN,NaN,-216.7575685716449,-91.28774960607059,-0.09643995821878068,-0.04690450225862719,0.04953545596015349,931201134,1049566321.4,32.61786656266143,42.69721021061516,NaN,NaN,-3.7751334824205713,6.471593242335301
2018-10-01T09:30:00-04:00,27.74,27.89,27.595,27.69,49855733,47206174.35,39.378859266412405,49.26853914030829,NaN,NaN,-156.56639662834826,-130.1685565524799,-0.10561353518268371,-0.08248146301820114,0.023132072164482563,981056867,1016099702.2,29.134878623588136,41.33817328006091,NaN,NaN,-6.760898667174789,4.5812372552624305
2018-10-02T09:30:00-04:00,27.65,27.74,27.47,27.69,47629547,47430370.1,39.3788592664124,48.832483152379254,NaN,NaN,-153.88979268342842,-159.14439973058242,-0.10603781015597333,-0.1094151905304841,-0.0033773803745107724,981056867,989223811,26.671767886354317,40.21133389487576,NaN,NaN,-9.081037633658838,2.6294836997022495
2018-10-03T09:30:00-04:00,27.87,28.07,27.79,27.95,79591391,49773554.9,45.87041912360037,48.93768743349897,NaN,NaN,-70.91877953727463,-150.16998773872763,-0.08412167673732697,-0.10852947629616949,-0.024407799558842518,1060648258,990323826.4,26.944004892017603,39.46318166351633,NaN,NaN,-9.032673887570962,0.9634611872346481
2018-10-04T09:30:00-04:00,27.94,28.345,27.92,28.14,94700771,52592144.75,50.07754791155839,48.89092287777776,NaN,NaN,-18.409729200476246,-123.30845332423448,-0.05362739422263429,-0.09144204233713538,-0.03781464811450109,1155349029,1021862431,34.457272338176054,39.388057611186795,NaN,NaN,-7.641507659418228,-0.26582007657290574
2018-10-05T09:30:00-04:00,28.21,28.31,27.93,28,58148664,53317363.8,47.16842774633648,48.88483465312926,NaN,NaN,-29.763612494884956,-85.9096621088825,-0.040292656100422604,-0.08818046824002934,-0.04788781213960674,1097200365,1055062277.2,41.300848319543924,39.927172032840936,NaN,NaN,-7.394819211488235,-1.2842485244179527
2018-10-08T09:30:00-04:00,27.92,28.28,27.895,28.19,56594940,54650752.35,51.30300417310175,48.875242570971054,NaN,NaN,-16.527597337360877,-57.90190225068502,-0.01726055280133188,-0.06946350314127159,-0.052202950339939706,1153795305,1089609964.8,47.44979328785172,41.01798266653991,NaN,NaN,-5.87963531573565,-1.9407323517490522
2018-10-09T09:30:00-04:00,28.06,28.2,27.88,28.08,47963546,55445657,48.91621477771262,47.909418939598375,NaN,NaN,-32.006994488227704,-33.52534261164489,-0.00846366864625435,-0.06278253614775764,-0.05431886750150329,1105831759,1114564943.2,51.409331623900464,42.05084712950111,NaN,NaN,-5.356747633559941,-2.428734534864893
2018-10-10T09:30:00-04:00,28.07,28.14,27.21,27.21,101604384,58127704,35.03369048425729,45.64952521743754,NaN,NaN,-151.74239082487387,-49.690064869164736,-0.05753242536074808,-0.1262343992024384,-0.06870197384169031,1004227375,1103280766.6,49.589799064573846,42.19743408617578,NaN,NaN,-10.064920849579172,-3.51961829410979
2018-10-11T09:30:00-04:00,27.05,27.215,26.32,26.4,178628215,64810384.4,27.273019503176513,43.33239544255069,NaN,NaN,-274.2690509719067,-100.86192922345083,-0.13633779155521245,-0.23912421328570588,-0.10278642173049343,825599160,1037330792.8,40.55545564430457,41.3880067656334,NaN,NaN,-17.59210725246763,-5.529973859589482
2018-10-12T09:30:00-04:00,26.88,26.919,26.03,26.43,137932962,69999484.55,27.909975564596408,41.61671139837465,NaN,NaN,-232.52868994475105,-141.41494471342406,-0.17573280195016622,-0.3224524241682012,-0.14671962221803497,963532122,1010597144.2,37.56768681129866,40.13957831056047,NaN,NaN,-22.707144209228815,-7.983855338109387
2018-10-15T09:30:00-04:00,26.44,26.63,26.31,26.31,82196431,72763913.55,26.89528247500668,39.999292345836075,NaN,NaN,-188.41712473054974,-175.79285019206182,-0.19753313226329783,-0.39363603754715726,-0.19610290528385943,881335691,956105221.4,32.33806464011873,38.49320791785119,NaN,NaN,-26.966928442169674,-10.695722924403714
2018-10-16T09:30:00-04:00,26.49,26.77,26.31,26.75,75137323,74700497.5,36.07264885263495,39.507547044222164,NaN,NaN,-136.6582663578927,-196.72310456599482,-0.1709745389252239,-0.4098210789403893,-0.23884654001516542,956473014,926233472.4,29.88231912255496,37.10712857766885,NaN,NaN,-27.23215518990918,-13.058070390904495
2018-10-17T09:30:00-04:00,26.69,27.185,26.56,27.02,79472083,74896501.1,40.96979150160888,39.48951250464647,NaN,NaN,-89.65417835482008,-184.30546207198407,-0.1259570717495863,-0.3962928797021483,-0.270335807952562,1035945097,932577016.8,31.079266999615243,36.4998825583257,NaN,NaN,-25.69986848370688,-14.864041547019122
2018-10-18T09:30:00-04:00,26.87,27.0665,26.49,26.57,81622544,75049852.1,36.01753165034779,39.447519449768826,NaN,NaN,-100.28594630282147,-149.508841138167,-0.11739146638126452,-0.41707514092914266,-0.29968367454787814,954322553,958321695.4,35.86432841123322,36.73177269036655,NaN,NaN,-26.1887586308707,-16.481858273283635
2018-10-19T09:30:00-04:00,26.55,26.8757,26.42,26.67,73614334,75493341.8,37.81635298501077,39.33591185824013,NaN,NaN,-92.6108794673171,-121.52527904268022,-0.09675493099379989,-0.420627338290128,-0.3238724072963281,1027936887,971202648.4,38.177097239840585,37.37764544867029,NaN,NaN,-25.953580201784803,-17.83496140592666
2018-10-22T09:30:00-04:00,26.7,26.76,26.1,26.1,58645755,76026372.6,32.25059509009725,38.826750131360484,NaN,NaN,-111.43745490396502,-106.12934507736327,-0.11217168250697385,-0.4640870104300454,-0.35191532792307156,969291132,988793736.6,41.29073861070928,38.421857643267074,NaN,NaN,-27.72634557211176,-19.248016286810245
2018-10-23T09:30:00-04:00,25.57,26.04,25.42,25.89,93698153,79063598.25,30.471234994184982,37.72680840783081,NaN,NaN,-143.54348086563266,-107.50638797891129,-0.12614774326314537,-0.5096000070020033,-0.3834522637388579,875592979,972617729.6,39.32919676801486,39.306514205838305,NaN,NaN,-29.739621194773374,-20.746816987947835
2018-10-24T09:30:00-04:00,25.85,25.85,25.14,25.24,97983187,80948350.5,25.737801251753282,35.98825507498759,NaN,NaN,-154.99249755159408,-120.57405181826607,-0.16628041462027354,-0.5913027820141998,-0.4250223673939263,777609792,920950668.6,33.80517666635228,39.259935943565175,NaN,NaN,-33.23087573718927,-22.530253952125182
2018-10-25T09:30:00-04:00,25.36,25.84,25.334,25.63,72439430,81695713.25,32.51186963687255,34.94135806716874,NaN,NaN,-123.17209077521741,-125.15128071274528,-0.15395436474532775,-0.617465323325586,-0.46351095858025826,850049222,900096002.4,31.85999551750878,38.585589314848384,NaN,NaN,-33.62004833744991,-24.114510292885857
2018-10-26T09:30:00-04:00,25.32,25.52,25.02,25.26,115308867,84138413,29.74016500771303,33.40115526964098,NaN,NaN,-135.69890052408778,-133.76888492409938,-0.1575448879611172,-0.6604420685316548,-0.5028971805705376,734740355,841456696,27.132446294466916,37.134350243892335,NaN,NaN,-34.91338983535621,-25.657207370381624
2018-10-29T09:30:00-04:00,25.57,25.93,25.205,25.48,97946058,86542929.25,33.377089176573875,32.2912177267025,NaN,NaN,-103.40618943908314,-132.16263183112304,-0.13291189135474146,-0.6690370447639644,-0.536125153409223,832686413,814135752.2,25.252335445913317,35.2659933740361,NaN,NaN,-34.69745070468932,-26.94867070385415
2018-10-30T09:30:00-04:00,25.62,25.94,25.44,25.92,82719134,88297408.6,40.05990131979226,32.65023278638357,NaN,NaN,-78.58006541327158,-119.16994874065081,-0.07753742256488494,-0.6330469316153291,-0.5555095090504442,915405547,822098265.8,26.843397807259947,33.641250427085104,NaN,NaN,-32.21502348024561,-27.70100681476722
2018-10-31T09:30:00-04:00,26.17,26.61,26.13,26.28,93781143,89006896.2,44.92739891820068,33.91125988745673,NaN,NaN,-25.4217076499015,-93.25579076031231,-0.010726305362823818,-0.568917390753974,-0.5581910853911501,1009186690,868413645.4,35.45024157214195,33.27659227907349,NaN,NaN,-28.510921696915492,-27.816708940788402
2018-11-01T09:30:00-04:00,26.35,26.51,26.22,26.4,62346640,87389189.65,46.487340226005536,35.23821450612881,NaN,NaN,-15.586210313721041,-71.73861466801304,0.04445894043882892,-0.5026174098426139,-0.5470763502814429,1071533330,912710467,42.426822174528816,33.62367337644708,NaN,NaN,-25.0835060907437,-27.426251390782017
2018-11-02T09:30:00-04:00,26.66,26.81,26.175,26.38,73034236,88133468.25,46.252193769193674,36.620851027142166,NaN,NaN,0.7644891082881794,-44.445936741537835,0.08042860965019494,-0.44654058821869924,-0.5269691978688942,998499094,965462214.8,49.435593351649295,34.84492542727069,NaN,NaN,-22.44862326752525,-26.715161658888192
2018-11-05T09:30:00-05:00,26.49,26.88,26.49,26.8,58705774,88239009.95,51.76952728263467,37.742056629285,NaN,NaN,45.92690878830245,-14.579317096060697,0.13036519723457918,-0.3640127013256702,-0.4943778985602494,1057204868,1010365905.8,54.51191575641047,36.604182329688946,NaN,NaN,-18.41457907148835,-25.5293641464025
2018-11-06T09:30:00-05:00,26.78,26.94,26.65,26.94,51010875,88391376.4,53.4836334102913,38.63590247990518,NaN,NaN,77.09160149981815,16.55501628655725,0.16827214570990706,-0.28403771642286557,-0.45230986213277263,1108215743,1048927945,58.376522255429,38.55398627653278,NaN,NaN,-14.591117841256587,-23.966757531381656
2018-11-07T09:30:00-05:00,27.09,27.32,26.82,27.29,59990828,86310698.6,57.5458325468387,40.17363825822596,NaN,NaN,127.04815632064988,47.048989080667525,0.20967018771086204,-0.1902221274941951,-0.39989231520505714,1168206571,1080731921.2,61.29702797215455,40.370607673741446,NaN,NaN,-10.028576081017606,-21.97558875275822
2018-11-08T09:30:00-05:00,27.13,27.52,27.04,27.37,46730116,79715793.65,58.439231865086725,41.64670103537424,NaN,NaN,140.40891332706764,78.24801380882525,0.23337757573076423,-0.10817034554160188,-0.3415479212723661,1214936687,1109412592.6,63.76606591597623,42.19839115060828,NaN,NaN,-6.0500906589640495,-19.70051759650191
2018-11-09T09:30:00-05:00,27.3,27.375,26.98,27.12,47051212,75171706.15,54.57424743422947,43.24124763138369,NaN,NaN,107.31676648927684,99.558469285023,0.22316228034331181,-0.06259507084322635,-0.28575735118653817,1167885475,1143289868.8,66.48574043061097,43.998034137744106,NaN,NaN,-3.759554014997271,-17.423237084858393
2018-11-12T09:30:00-05:00,27.06,27.18,26.53,26.58,47135521,73418660.65,47.29775311699246,44.44314178301279,NaN,NaN,49.87728200895385,100.34854392915327,0.17320465236678778,-0.06925153572805343,-0.2424561880948412,1120749954,1155998886,67.47212286229839,46.00824314447864,NaN,NaN,-3.9423952847814068,-15.497402541990251
2018-11-13T09:30:00-05:00,26.62,26.99,26.6,26.73,69820555,73152822.25,49.31918992519351,46.12752668825853,NaN,NaN,49.40123421918539,94.81047047302671,0.14459558126570432,-0.06171171151271082,-0.20630729277841514,1190570509,1172469839.2,68.75557502161342,48.50470016985444,NaN,NaN,-3.4845216289455387,-13.781276697269577
2018-11-14T09:30:00-05:00,26.94,26.98,26.08,26.37,104274180,74392927.1,44.87091250078651,47.01031546425238,NaN,NaN,14.304726579691854,72.26178452483512,0.09799053567984656,-0.08381912317860696,-0.18180965885845352,1086296329,1156087790.8,65.96760046457584,50.940957666073515,NaN,NaN,-4.4627546794093345,-12.450059266146685
2018-11-15T09:30:00-05:00,26.19,26.78,26.03,26.76,93998009,75011700.35,50.11962111856741,48.46599090074198,NaN,NaN,22.188831517175146,48.61776816285661,0.09018898303867648,-0.06907343006010791,-0.1592624130987844,1180294338,1149159321,64.77136210534556,53.629451652564846,NaN,NaN,-3.667455719482523,-11.195401616623233
2018-11-16T09:30:00-05:00,26.62,26.91,26.47,26.79,80518388,75356903.05,50.50995017488422,49.689766686335574,NaN,NaN,48.8555478335147,36.925524431704176,0.0839377603974987,-0.05434021260191102,-0.13827797299940972,1260812726,1167744771.2,66.52495450329613,56.577495870949335,NaN,NaN,-2.917318805340168,-10.01281835786851
2018-11-19T09:30:00-05:00,26.77,26.9,26.5413,26.78,65491301,75699180.35,50.36846098896831,50.426092376991,NaN,NaN,47.244309551854556,36.39892994028432,0.07624193629842628,-0.04297555262637687,-0.11921748892480315,1195321425,1182659065.4,67.9055822804169,59.5105090476034,NaN,NaN,-2.3489983936406813,-8.917986934407391
2018-11-20T09:30:00-05:00,26.47,26.58,26.11,26.19,103778269,76203186.15,42.75815736363176,50.27114655166465,NaN,NaN,-16.746469199152155,23.169389256616814,0.030856075998914476,-0.08064739392616005,-0.11150346992507452,1091543156,1162853594.8,64.12342746044477,61.558593753910735,NaN,NaN,-4.15357003397919,-8.237355948631935
2018-11-21T09:30:00-05:00,26.34,26.5855,26.13,26.21,48617952,73734924.4,43.0721581172258,50.0272049724661,NaN,NaN,-23.680761391311318,15.57229166241618,0.0030844806698203386,-0.10764786908779911,-0.11073234975761945,1140161108,1173626550.6,65.25696516825955,63.189318253462936,NaN,NaN,-5.513961375628659,-7.848299581060038
2018-11-23T09:30:00-05:00,26.07,26.215,25.925,26,24252331,71325569.45,40.55650045447141,49.62036973570023,NaN,NaN,-73.50615014523943,-3.5667046700667355,-0.026876094536737158,-0.1443274679285409,-0.11745137339180374,1115908777,1160749438.4,62.70657632177264,64.13724560847174,NaN,NaN,-7.409254440809882,-7.785578846738587
2018-11-26T09:30:00-05:00,26.27,26.63,26.2567,26.53,50168814,68068566.8,48.700039731576474,49.401120624910355,NaN,NaN,-13.330363243634167,-16.003886885496506,-0.009351769782072888,-0.12914108561939486,-0.11978931583732197,1166077591,1141802411.4,59.0497457635714,64.46137632326896,NaN,NaN,-6.643853258422908,-7.622475191264918
2018-11-27T09:30:00-05:00,26.48,26.63,26.415,26.55,47228997,65532713.75,48.984062728446574,49.07972271906431,NaN,NaN,-13.138710047340252,-28.080490805335465,0.004490822299682742,-0.11417578796271854,-0.11866661026240129,1213306588,1145399444,59.53223645033964,64.54392733719115,NaN,NaN,-5.947516551298201,-7.383195385555387
2018-11-28T09:30:00-05:00,26.63,27.06,26.4,27.06,61375319,64465523,55.71691666420304,48.949085870304614,NaN,NaN,50.78466727840837,-14.574263509823362,0.04656054389658065,-0.06046593039167547,-0.10702647428825612,1274681907,1182027194.2,64.16264049673674,64.74861394608988,NaN,NaN,-3.21518298034454,-6.787765041953838
2018-11-29T09:30:00-05:00,26.86,27.005,26.72,26.83,43664093,61959670.5,52.36076448508029,48.51490962887558,NaN,NaN,48.556642633631185,-0.12678270483486215,0.05678592697733084,-0.036044065566592565,-0.0928299925439234,1231017814,1200198535.4,66.22724825809743,64.92441268481282,NaN,NaN,-1.9560263787802865,-6.097516661500474
2018-11-30T09:30:00-05:00,26.75,27.0799,26.71,26.97,45435220,61114099.5,54.17037758824701,48.486061782733984,NaN,NaN,61.20238490167094,26.81492430454721,0.06999897312412091,-0.005331276138772267,-0.07533024926289318,1276453034,1232307386.8,69.56391485113217,65.14428228627862,NaN,NaN,-0.37661036130272585,-5.2802443329007955
2018-12-03T09:30:00-05:00,27.36,27.47,26.95,27.14,65330932,60728934.3,56.33917247471893,49.13187745114301,NaN,NaN,122.15724845177206,53.912446643628456,0.08614696698295396,0.03235345946579926,-0.05379350751715469,1341783966,1267448661.8,72.7384120132428,65.52044579706036,NaN,NaN,1.5868964762260807,-4.299224217311242
2018-12-04T09:30:00-05:00,27,27.01,25.83,25.96,110918561,63339573.65,41.61727945479426,48.581740988971646,NaN,NaN,-107.14297258072502,35.11159413695151,0.01693783216959905,-0.03262121730515588,-0.04955904947475493,1230865405,1270960425.2,73.04102113012004,65.82654909052512,NaN,NaN,-1.6434788440996249,-3.9198320211381534
2018-12-06T09:30:00-05:00,25.38,25.61,24.93,25.6,134687106,67523385.2,38.326787805742825,48.11430351075423,NaN,NaN,-244.71780997434783,-23.988901313599733,-0.049851560458717206,-0.11187350004815144,-0.062021939589434236,1096178299,1235259703.6,65.12649376100961,65.76647004027039,NaN,NaN,-5.425192489148234,-4.1348835165681646
2018-12-07T09:30:00-05:00,25.54,25.9,24.99,25.11,86740000,68860843.8,34.34622583102798,46.987632418787136,NaN,NaN,-211.60321341250068,-76.02087252282611,-0.11980576974391194,-0.21177915176932416,-0.09197338202541222,1009438299,1190943800.6,56.88637118636494,65.20325640320034,NaN,NaN,-9.997071091638018,-4.9723388844352865
2018-12-10T09:30:00-05:00,25.01,25.08,24.3,24.76,101121843,71580430.15,31.80526682355051,45.65158360797758,NaN,NaN,-248.57609990134804,-137.9765694834299,-0.17886897503443558,-0.3155596008184567,-0.1366906257840211,908316456,1117316485,46.38556047362628,63.76472825822392,NaN,NaN,-14.585182143669199,-6.3456022071829885
2018-12-11T09:30:00-05:00,25.07,25.2198,24.43,24.52,92308158,73843277.45,30.157693896079863,44.20795738705698,NaN,NaN,-197.60724722678242,-201.92946861914078,-0.22058209760073927,-0.4124182477849452,-0.1918361501842059,816008298,1012161351.4,36.128172376076954,61.49491326505679,NaN,NaN,-18.811406155677666,-8.126431342682228
2018-12-12T09:30:00-05:00,24.86,25.0167,24.54,24.66,86748915,75823947.15,32.3588854421687,43.46515224980961,NaN,NaN,-155.8254751247375,-211.6659691279433,-0.22448039015955526,-0.47243663788365,-0.24795624772409472,902757213,946539713,31.45375252194451,59.16136505516391,NaN,NaN,-21.483281373787875,-10.03455277569732
2018-12-13T09:30:00-05:00,24.65,24.78,24.3932,24.48,67232895,75694564.15,31.00584138174817,42.60327248298978,NaN,NaN,-144.05020905138036,-191.5324489433498,-0.22438274113188128,-0.5284346741389463,-0.304051933007065,835524318,894408916.8,28.319075704758134,56.52294437919953,NaN,NaN,-24.08666624609953,-12.041997557183349
2018-12-14T09:30:00-05:00,24.24,24.58,24.19,24.24,66817012,73821705.75,29.24968571804264,41.79564285895915,NaN,NaN,-135.73959545101232,-176.35972535105213,-0.22510327842949618,-0.5854310310439352,-0.36032775261443906,768707306,846262718.2,25.765165778651266,53.884272197548,NaN,NaN,-26.801167779066386,-14.150450446023783
2018-12-17T09:30:00-05:00,24.1,24.47,23.89,24,101180358,74180823.2,27.568129208171285,40.286220678715935,NaN,NaN,-129.37731359364938,-152.5199680895124,-0.22578581140387188,-0.6425600168692789,-0.416774205465407,667526948,798104816.6,23.483846981496043,51.34385085597119,NaN,NaN,-29.592647832448897,-16.35647864408451
2018-12-18T09:30:00-05:00,24.14,24.4,23.755,23.91,90844000,74697103.8,26.9426026408442,38.711830672458625,NaN,NaN,-118.46147053993712,-136.69081275214336,-0.21632148338974677,-0.6871760597025904,-0.47085457631284366,576682948,750239746.6,21.45086438122354,48.62375285103433,NaN,NaN,-32.064112487189384,-18.600426335956634
2018-12-19T09:30:00-05:00,23.86,24.39,23.42,23.61,129331720,77889124.75,24.91335906323083,36.511576558103464,NaN,NaN,-117.74079347665226,-129.0738764225263,-0.21390210418268096,-0.7382322065411948,-0.5243301023585138,447351228,659158549.6,18.218806956203338,45.34205045528194,NaN,NaN,-34.80558012575706,-20.915448305928123
2018-12-20T09:30:00-05:00,23.38,23.75,23.27,23.4,107017358,78051079.2,23.574835477720924,34.45543877186351,NaN,NaN,-123.78461838060286,-125.02075828837079,-0.20979407435344355,-0.7865726953003183,-0.5767786209468747,340333870,560120460,15.48641299697968,41.717705079487814,NaN,NaN,-37.52351373633821,-23.28802908170099
2018-12-21T09:30:00-05:00,23.23,23.67,22.7401,22.79,118529507,81546656.95,20.18273316575234,32.027749884542466,NaN,NaN,-131.8128994480658,-124.2354190877815,-0.22989188313530673,-0.8641434748660082,-0.6342515917307014,221804363,450739871.4,13.142121806662644,37.68757700488285,NaN,NaN,-41.09598836548478,-25.832023265098673
2018-12-24T09:30:00-05:00,22.49,22.75,22.28,22.31,71752697,83921675.25,17.989272015134134,29.28847128028641,NaN,NaN,-147.03051343095154,-127.76605905524193,-0.2552876158668804,-0.9533611115643019,-0.6980734956974215,150051666,347244815,11.38585532647329,33.30525152725646,NaN,NaN,-44.92073549829366,-28.5589821555551
2018-12-26T09:30:00-05:00,22.37,23.33,22.05,23.32,108133543,86819911.7,34.19515379896161,28.758319447726937,NaN,NaN,-111.44182662130748,-126.36213027151598,-0.18700252721378396,-0.9318266547146514,-0.7448241275008675,258185209,283545267.2,10.459383066193539,28.835134522690275,NaN,NaN,-42.64029951736602,-30.570598921528088
2018-12-27T09:30:00-05:00,22.93,23.6,22.7116,23.6,98005001,89358711.9,37.86110648990903,28.725056496595954,NaN,NaN,-83.52182727313502,-119.51833703081255,-0.10974040979949007,-0.8819996397502301,-0.77225922995074,356190210,265313063.6,10.203464431410666,24.91206099914749,NaN,NaN,-39.55591249329501,-31.85421514606622
2018-12-28T09:30:00-05:00,23.71,23.9,23.485,23.59,76348396,90107365.75,37.780156019505974,28.970337224344384,NaN,NaN,-57.48330187225293,-106.25807372914255,-0.04915887445106448,-0.8337078230145707,-0.7845489485635062,279841814,253214652.4,10.028121091991451,21.565043135263668,NaN,NaN,-37.21404028361391,-32.61990445143017
2018-12-31T09:30:00-05:00,23.72,23.92,23.52,23.82,56435410,90745931.6,40.90952022229898,29.620641038540704,NaN,NaN,-45.914190676694275,-89.07833197486826,0.01322009336077934,-0.7680238318625321,-0.7812439252233114,336277224,276109224.6,13.07242535743623,19.185533484107236,NaN,NaN,-34.3045527103635,-32.86056848842065
2019-01-02T09:30:00-05:00,23.47,24.07,23.4,24.02,62944991,91621420.15,43.5674512149941,30.578480847034577,NaN,NaN,-34.5022783981596,-66.57268496830986,0.07151098726813543,-0.6918551911381421,-0.7633661784062775,399222215,325943334.4,19.46048730408009,17.994984550393177,NaN,NaN,-31.08800547569004,-32.6073452008877
2019-01-03T09:30:00-05:00,23.84,23.9,23.42,23.48,65730018,91641374.45,38.528329873841386,31.019155449296914,NaN,NaN,-46.07040216347512,-53.498400076743394,0.07679579144131155,-0.6673714391046381,-0.7441672305459497,333492197,341004732,21.341875417787193,17.272707614381936,NaN,NaN,-29.820138688751292,-32.20917284201107
2019-01-04T09:30:00-05:00,23.88,24.31,23.82,24.26,64638355,89327364.15,47.90180929083585,32.22601029994603,NaN,NaN,14.813075607006551,-33.831419500715086,0.1326446503966553,-0.5783614175501306,-0.7110060679467859,398130552,349392800.4,22.428681215105854,16.851965150835344,NaN,NaN,-25.47021078902511,-31.24646397729879
2019-01-07T09:30:00-05:00,24.21,24.51,24.06,24.29,48198218,85002919.75,48.22879249657934,33.58166078412723,NaN,NaN,41.618887689419154,-14.010981588380673,0.16909281797587616,-0.49964004547694074,-0.6687328634528169,446328770,382690191.6,26.755007088942918,16.92266810157046,NaN,NaN,-21.992649363311,-29.92449046101482
2019-01-08T09:30:00-05:00,24.51,24.5451,24.03,24.31,90114691,85171654.3,48.46102979308949,35.0740108259071,NaN,NaN,53.88244451721626,5.94834545040144,0.19044676150784579,-0.4306744115680097,-0.6211211730758555,536443461,422723439,31.68799850059534,17.508678924363267,NaN,NaN,-19.160338207919608,-28.38675442485836
2019-01-09T09:30:00-05:00,24.37,24.52,24.2038,24.43,61037051,83167414.7,49.912827552325375,36.71474117672718,NaN,NaN,70.19706931903066,26.888214993839494,0.20716822851391825,-0.36216088743345765,-0.5693291159473759,597480512,462375098.4,36.26652022407112,18.566940055995236,NaN,NaN,-16.39846891863355,-26.67414220968339
2019-01-10T09:30:00-05:00,24.29,24.52,24.21,24.44,48630810,80983547.3,50.03912769315869,38.509438936007754,NaN,NaN,75.80601194459247,51.263497815453015,0.2126174607296235,-0.3035572900353465,-0.51617475076497,646111322,524898923.4,42.779083202033405,20.321245502125958,NaN,NaN,-14.102924536369757,-24.878253970638585
2019-01-11T09:30:00-05:00,24.32,24.55,24.18,24.5,44961617,78894182.4,50.840112237207926,40.45695870454254,NaN,NaN,83.89752167980294,65.08038703001229,0.21342210179081061,-0.2493971235264567,-0.4628192253172673,691072939,583487400.8,48.128031393763735,22.652789673324815,NaN,NaN,-11.960990567899083,-23.032930627390087
2019-01-14T09:30:00-05:00,24.26,24.75,24.23,24.67,50610566,78063065.95,53.1328028839663,42.810535112986386,NaN,NaN,104.4602282455071,77.64865514122987,0.21780693336210866,-0.1905605586146315,-0.40836749197674016,741683505,642558347.8,52.907820902681884,25.493196751611908,NaN,NaN,-9.489357126295221,-21.098134412947964
2019-01-15T09:30:00-05:00,24.57,24.93,24.5,24.89,59156475,77680039.1,55.993116372997044,45.52509542426231,NaN,NaN,127.88419352731168,92.44900494324897,0.22690035600070912,-0.12474204697585378,-0.3516424029765629,800839980,695437651.6,56.749845843765755,28.73348178856137,NaN,NaN,-6.542455646485773,-19.018751732024793
2019-01-16T09:30:00-05:00,25.18,25.57,25.11,25.42,72982441,76270143.25,62.008567399484335,47.511767824299646,NaN,NaN,178.8237090596961,114.17433289138205,0.25773466403376843,-0.029474072934352336,-0.28720873696812077,873822421,750706033.4,60.38748421127241,32.299774727495574,NaN,NaN,-2.0156965484769183,-16.58974384866081
2019-01-17T09:30:00-05:00,25.32,25.65,25.165,25.56,55771263,74516506.4,63.430577030120645,49.3381585771719,NaN,NaN,159.9419580597852,131.0015221144206,0.2751030341401807,0.05667005570710515,-0.21843297843307558,929593684,807402505.8,63.755243347653554,36.12490179294149,NaN,NaN,2.197627331379544,-13.905833680083617
2019-01-18T09:30:00-05:00,25.74,26.03,25.533,26,58400191,70969929.95,67.54246879724627,51.46403806129613,NaN,NaN,171.40295843121206,148.50260946470243,0.3016390202547574,0.1586157968853712,-0.14302322336938622,987993875,866786693,66.92687865337118,40.189098761611476,NaN,NaN,7.24093880633907,-10.884866182023234
2019-01-22T09:30:00-05:00,25.78,25.91,25.57,25.7,79651742,69601649.15,62.391353883067225,52.998454751351,NaN,NaN,140.61815125458773,155.73419406651857,0.28461746266871996,0.2127486049665137,-0.07186885770220623,908342133,900118418.6,68.58837766515487,44.15452392644852,NaN,NaN,10.036391988554996,-7.896115014797774
2019-01-23T09:30:00-05:00,25.8,25.83,25.44,25.73,44072057,65878776.65,62.697722544509965,54.36490270345928,NaN,NaN,123.11046500394755,154.7794483618457,0.2615983070066532,0.2551290260561103,-0.006469280950542916,952414190,930433260.6,70.06149457064159,47.76888158834577,NaN,NaN,12.391084908576321,-4.9979435971729025
2019-01-24T09:30:00-05:00,25.64,25.86,25.56,25.79,25496893,63565986.45,63.340932462970386,56.13723145982563,NaN,NaN,115.72244696194971,142.15919594229644,0.2373449696974369,0.2902119311712532,0.05286696147381631,977911083,951250993,71.06502993070524,51.32053548212563,NaN,NaN,14.523521739867098,-2.209162834738617
2019-01-25T09:30:00-05:00,25.97,26.17,25.8964,26,63139954,61316307,65.5781311605542,57.399825879091225,NaN,NaN,123.96709381254546,134.9642230928485,0.2226211636371045,0.3311434160201969,0.10852225238309243,1041051037,973542463.6,72.14185400386216,54.87147639560822,NaN,NaN,16.998983365992547,0.5348580510801209
2019-01-28T09:30:00-05:00,25.75,25.95,25.71,25.92,66894895,59760801.7,63.9763687210585,58.52465275226831,NaN,NaN,96.73517633482007,120.0306666735701,0.19562760821880865,0.35305676265660324,0.1574291544377946,974156142,970774917,71.78466809259476,58.08788075301192,NaN,NaN,18.653117830352592,3.1231808766904736
2019-01-29T09:30:00-05:00,25.91,26.01,25.82,25.83,29442082,57415486,62.137585019539806,59.50154955415762,NaN,NaN,87.94438150515684,109.49591272368393,0.16127460685854517,0.35902241301097604,0.19774780615243087,944714060,978049302.4,72.17464047630054,60.97978375127658,NaN,NaN,19.574680431884385,5.473395098861032
2019-01-30T09:30:00-05:00,25.91,26.1366,25.725,25.98,62076761,57697553.55,63.99499334606979,60.507418539425075,NaN,NaN,84.11495854910522,101.69681143271546,0.1390583503196757,0.3715707440520255,0.2325123937323498,1006790821,988924628.6,72.78034657999592,63.587914205271204,NaN,NaN,20.86582377637779,7.672313481363426
2019-01-31T09:30:00-05:00,25.76,25.98,25.72,25.94,64021467,57751377.35,63.1059502710363,61.440763009273475,NaN,NaN,71.36306563616535,92.82493516755858,0.11317148495108414,0.373976749921205,0.26080526497012085,942769354,981896282.8,71.69416979144694,65.65327753308647,NaN,NaN,21.729604150803276,9.680497862711976
2019-02-01T09:30:00-05:00,25.98,26.1717,25.95,26.05,42920281,56610890.5,64.56389210521621,62.42103299984551,NaN,NaN,82.47836227659835,84.52718886036917,0.09565569420437547,0.38037488272559017,0.2847191885212147,985689635,970824002.4,69.92373611693262,67.21011358474138,NaN,NaN,22.853205526542308,11.562313243259165
2019-02-04T09:30:00-05:00,26.06,26.17,25.92,26.16,30362455,54897095.5,66.01038018552711,63.34085994995699,NaN,NaN,80.38722722056966,81.25759903751907,0.08408691887416414,0.3898278371139199,0.30574091823975574,1016052090,979203192,70.5170926848356,68.46791871203808,NaN,NaN,24.20286365112535,13.36810615866862
2019-02-05T09:30:00-05:00,26.21,26.23,25.99,26.09,39095274,54441948.3,64.2140388297709,63.92806869686941,NaN,NaN,78.39765763307007,79.34825426310172,0.06517324132915453,0.3872074699011989,0.3220342285720444,976956816,985651743.2,70.99140390329941,69.48517285914762,NaN,NaN,24.91389179283873,15.017504106407207
2019-02-06T09:30:00-05:00,26.01,26.195,25.97,26.06,51542815,52513354.5,63.417524093600214,64.02870846073482,NaN,NaN,71.56463146707898,76.83818884669645,0.04505157115311742,0.37834869251344116,0.33329712136032374,925414001,969376379.2,68.01723712777367,70.03015521032628,NaN,NaN,25.326006230821292,16.49014726703779
2019-02-07T09:30:00-05:00,25.98,26.05,25.59,25.8,80395650,53481284.45,56.83739016265238,63.55776654162995,NaN,NaN,33.74235001562018,69.31404572258742,0.01044682147705256,0.34635564820663944,0.3359088267295869,845018351,949826178.6,64.52050394505967,70.08481668156958,NaN,NaN,23.963392537609142,17.55775373426227
2019-02-08T09:30:00-05:00,25.66,25.78,25.34,25.67,54911051,53795296.5,53.829903305774884,62.57829757795342,NaN,NaN,-8.404545717609356,51.137464123745886,-0.02314911780911827,0.30697242946818903,0.3301215472773073,790107300,910709711.6,58.08609343690478,69.45333202325055,NaN,NaN,21.955686739069385,18.186029877806146
2019-02-11T09:30:00-05:00,25.75,25.8,25.62,25.75,53115694,54203000.35,55.39410651017162,62.078494194175164,NaN,NaN,3.350997110246202,35.730218101681196,-0.04089712871099149,0.2790001363885679,0.3198972650995594,843222994,876143892.4,53.051328564212604,68.34354280175467,NaN,NaN,20.62299295712205,18.53416746056556
2019-02-12T09:30:00-05:00,25.94,26.225,25.93,26.13,37671288,53556036.45,61.98269013750989,62.02742045081801,NaN,NaN,91.79343689043779,38.40937395315476,-0.02854307309403631,0.284218423732014,0.3127614968260503,880894282,856931385.6,50.43460691064366,66.94162225461197,NaN,NaN,21.21932490663711,18.917761381432925
2019-02-13T09:30:00-05:00,26.25,26.43,26.19,26.2,42969630,52746694.2,63.064964733514564,62.007708470142596,NaN,NaN,151.73990566241517,54.44442879222199,-0.017687665712788958,0.2906519146850641,0.3083395803978531,923863912,856621367.8,50.39141473363203,65.46493545482102,NaN,NaN,22.021224448018337,19.361113248087985
2019-02-14T09:30:00-05:00,26,26.08,25.73,25.88,47630097,51479077,55.31287273342134,61.27447572534741,NaN,NaN,3.7838439176935097,48.45272757263666,-0.033189215525564864,0.266853060990897,0.30004227651646187,876233815,862864460.6,51.29597836282396,63.975944337604005,NaN,NaN,20.42253514745648,19.51274494799777
2019-02-15T09:30:00-05:00,26.09,26.43,25.88,26.43,46880785,51034553.1,63.5957347352781,61.247287583505944,NaN,NaN,136.6656791412297,77.46677254440446,-0.008801166175116226,0.2890408187975666,0.2978419849726828,923114600,889465920.6,55.0564316357229,62.7810703049703,NaN,NaN,21.65084930343389,19.81818842734579
2019-02-19T09:30:00-05:00,26.3,26.55,26.22,26.47,23868332,49307960.15,64.11665694170287,61.38864986366044,NaN,NaN,172.28595395961509,111.25376391427824,0.006783500385590613,0.30632136045467107,0.29953786006908045,946982932,910217908.2,57.79413913242735,61.75389163755079,NaN,NaN,22.782060102499173,20.241598666653413
2019-02-20T09:30:00-05:00,26.46,26.65,26.4,26.64,27509066,46700826.35,66.32230670684157,61.554886532287,NaN,NaN,192.36219023762996,131.36751458371668,0.024314238516756848,0.32993065821502654,0.3056164196982697,974491998,928937451.4,60.15214393429756,60.851877162858045,NaN,NaN,24.41436477296,20.837708110411498
2019-02-21T09:30:00-05:00,26.59,26.68,26.41,26.5,46620034,46828225.2,62.89372300628424,61.53972744194756,NaN,NaN,160.16032217018974,133.0515978852716,0.02230685349428957,0.33349998656613167,0.3111931330718421,927871964,929739061.8,60.25454681057002,60.034761235652546,NaN,NaN,24.7214358652093,21.3925263610969
2019-02-22T09:30:00-05:00,26.5,26.58,26.3622,26.46,26343683,46870564.7,61.908974384076245,61.35009046186614,NaN,NaN,124.89773715058806,157.2743765318505,0.014489506385834738,0.32930501605413554,0.3148155096683008,901528281,934797955,60.93680971021895,59.39283792088729,NaN,NaN,24.682194416784153,21.86247894048079
2019-02-25T09:30:00-05:00,26.58,26.82,26.54,26.57,33835895,45405361.75,63.59697622053783,61.177704464366904,NaN,NaN,149.826380996688,159.90651690294217,0.01298001090920231,0.3310405233048037,0.3180605123956014,935364176,937247870.2,61.28342004969405,58.73328987552003,NaN,NaN,25.130432805491072,22.329329492625117
2019-02-26T09:30:00-05:00,26.38,26.685,26.36,26.49,35659790,43843606.5,61.46368176228943,60.98125038811823,NaN,NaN,97.98786119541869,145.04689835010288,0.003348344683407667,0.322245943249861,0.31889759856645333,899704386,927792161,59.10362500277313,57.884162811196724,NaN,NaN,24.905993750862216,22.697424386658987
2019-02-27T09:30:00-05:00,26.44,26.64,26.405,26.59,42542398,44498622.3,63.12862109736295,60.960614459815574,NaN,NaN,94.06150929830677,125.38676216223826,0.0006103149761071958,0.3196604922865873,0.31905017731048013,942246784,921343118.2,57.598847478034635,57.13999212192965,NaN,NaN,25.172877446564822,23.051060538074108
2019-02-28T09:30:00-05:00,26.6,26.65,26.51,26.52,39835922,43386580.35,61.137407113911046,61.267758527762616,NaN,NaN,87.43787278885124,110.84227228597055,-0.00851377875198428,0.3084079538704998,0.3169217326224841,902410862,916250897.8,56.37826673382621,56.55840374969869,NaN,NaN,24.854970304293257,23.30876193324827
2019-03-01T09:30:00-05:00,26.75,26.94,26.61,26.69,82657330,44318373.5,64.09905280721179,62.00126920643668,NaN,NaN,119.69323866871098,109.80137258959515,-0.005826589679436611,0.30963849552318834,0.31546508520262495,985068192,932958880,59.41703764768492,56.65347119332584,NaN,NaN,25.391776706003938,23.606335472213367
2019-03-04T09:30:00-05:00,26.76,26.94,26.3,26.52,76611896,46002954.25,59.237420068733066,62.27579160347678,NaN,NaN,73.7156159586778,94.5792195819931,-0.01756190998310092,0.29351269772374877,0.3110746077068497,908456296,927577304,58.01517076813273,57.00803135074871,NaN,NaN,24.47788058966941,23.73084191756423
2019-03-05T09:30:00-05:00,26.57,26.5775,26.22,26.42,39868099,46478236.45,56.52172081184396,61.88572236592922,NaN,NaN,27.767787523352613,80.53520484757989,-0.03321453125882379,0.26955644363332,0.3027709748921438,868588197,921354066.2,56.35920172106825,57.43121669435046,NaN,NaN,22.92776020337207,23.616115958393923
2019-03-06T09:30:00-05:00,26.42,26.505,26.23,26.25,43158887,46681417.1,52.14515833073851,61.10573619430236,NaN,NaN,6.758097070631248,63.074522402044785,-0.05489343845298944,0.234154176825907,0.28904761527889644,825429310,897990571.4,50.528111028292784,57.440980715397664,NaN,NaN,20.296034358827082,23.14181858702723
2019-03-07T09:30:00-05:00,26.15,26.15,25.83,25.98,62622140,47235383.35,46.04675289575981,60.443870491612245,NaN,NaN,-75.37982317066404,30.510983210141717,-0.08546971390618985,0.1822104728961591,0.26768018680234895,762807170,870069833,44.59062863989716,56.962027163760034,NaN,NaN,16.042623027340465,22.127647792786263
2019-03-08T09:30:00-05:00,25.69,25.99,25.68,25.97,55964139,46013807.8,45.832956149245945,59.17510059260995,NaN,NaN,-103.64002921695752,-14.15567036699198,-0.10323243317000169,0.13863964533984685,0.24187207850984854,706843031,814424800.8,35.6096913637778,55.57297428719253,NaN,NaN,12.53951344355455,20.75791431432459
2019-03-11T09:30:00-04:00,26.1,26.315,25.9788,26.24,63343530,46435431.75,52.2759513654614,58.32933590859271,NaN,NaN,-42.806915671428776,-37.460176693013295,-0.09392847909291385,0.12446147964370624,0.2183899587366201,770186561,786770853.8,32.14469495813512,53.74087113188593,NaN,NaN,11.297698859579357,19.406454963646702
2019-03-12T09:30:00-04:00,26.28,26.39,26.24,26.3,32521130,45405703.55,53.59685832604517,57.4203753099644,NaN,NaN,-15.88493475194411,-46.19072114807264,-0.08133501457920506,0.11672119051261376,0.19805620509181882,802707691,773594752.6,30.616078200148593,51.6311521508753,NaN,NaN,10.660781391159764,18.157073024719995
2019-03-13T09:30:00-04:00,26.4,26.58,26.32,26.48,42817546,45663016.45,57.40569559099146,57.0283733517292,NaN,NaN,29.041679731511955,-41.734004615896495,-0.059496420263024014,0.12368567976303879,0.1831821000260628,845525237,777613938,31.683293470084223,49.5903483408406,NaN,NaN,11.242033187643061,17.169210190851864
2019-03-14T09:30:00-04:00,26.44,26.68,26.43,26.58,37665726,45397821.25,59.399526434682606,56.84912706962966,NaN,NaN,60.04757192821131,-14.648525596121422,-0.03797778162394844,0.13570987299612725,0.17368765462007568,883190963,801690696.6,37.85033199477004,47.941314218308534,NaN,NaN,12.319279448560346,16.476362941953077
2019-03-15T09:30:00-04:00,26.45,26.71,26.43,26.63,70020432,46517338,60.39771303108733,56.62060827038319,NaN,NaN,66.03191838760122,19.285863924790327,-0.020892051744480306,0.1475725899394753,0.1684646416839556,953211395,850964369.4,48.163399343492884,47.00416988215131,NaN,NaN,13.499087225535522,16.051037839607712
2019-03-18T09:30:00-04:00,26.68,26.98,26.68,26.9,43980696,46372333.55,65.35156176837835,56.898313985103826,NaN,NaN,156.60047870864105,59.16734280080429,0.006607057862906884,0.1767234640125892,0.17011640614968232,997192091,896365475.4,55.49203251113969,46.746198989891774,NaN,NaN,16.087608161990488,16.05626217137668
2019-03-19T09:30:00-04:00,27.05,27.1,26.62,26.69,45029262,47430380.05,59.15366489498252,56.614388542076654,NaN,NaN,122.11580862944353,86.76749147708182,0.008543985923502861,0.18079638855406088,0.17225240263055802,952162829,926256503,59.54707573483839,46.88535815109204,NaN,NaN,16.43671135395217,16.11061205460175
2019-03-20T09:30:00-04:00,26.63,26.64,26.11,26.14,65860286,49347941.05,46.66972441329301,55.58098263488966,NaN,NaN,-59.592979678952254,69.04055959498899,-0.027359982327436277,0.13805242472126267,0.16541240704869895,886302543,934411964.2,60.60177051091304,47.187036992312535,NaN,NaN,12.340372452337647,15.572006397135448
2019-03-21T09:30:00-04:00,25.96,26.17,25.78,26.06,104914052,52262641.95,45.17626862407371,54.229355193236934,NaN,NaN,-137.40981298268395,29.549082612809933,-0.05504308501386984,0.09660855078136166,0.1516516357952315,781388491,914051469.8,56.6320183777864,46.988107044462645,NaN,NaN,8.632601029995506,14.580662773258313
2019-03-22T09:30:00-04:00,25.75,25.885,25.231,25.34,121856178,57038266.7,34.48151721796947,52.4610764181824,NaN,NaN,-228.8133514041123,-29.41997134553277,-0.11684016496060586,0.005601429594474183,0.12244159455508004,659532313,855315653.4,47.055862808762846,46.20529933307908,NaN,NaN,0.8807990385830324,12.623539382590415
2019-03-25T09:30:00-04:00,25.31,25.53,25.08,25.23,72835604,58988252.15,33.188819408031534,50.794440603624366,NaN,NaN,-221.25715722026206,-104.9914985313134,-0.15758464261183958,-0.07453920870971942,0.08304543390212014,586696709,773216577,37.508581170029615,44.858826436576315,NaN,NaN,-5.459893953108644,10.040191763204836
2019-03-26T09:30:00-04:00,25.43,25.59,25.28,25.53,51171543,59763839.8,39.81567206190572,49.91376301299345,NaN,NaN,-148.71821333477362,-159.1583029241568,-0.1564734547135475,-0.11254638448981424,0.04392707022373326,637868252,710357661.6,32.13294551328221,43.544886042647,NaN,NaN,-8.264156899616411,7.4252848113732295
2019-03-27T09:30:00-04:00,25.47,25.5971,25.3,25.42,73148342,61294137,38.315008929414965,49.36149558682596,NaN,NaN,-129.65030792625993,-173.16976857361834,-0.15499480434421192,-0.14981643520653165,0.005178369137680272,564719910,646041135,27.7505535139819,42.34202353365305,NaN,NaN,-10.959249793009967,4.798922725032773
2019-03-28T09:30:00-04:00,25.47,25.65,25.35,25.64,52089324,61906807.1,42.94655229905013,49.15532388324055,NaN,NaN,-97.52004317112325,-165.1918146113062,-0.13195025534151267,-0.15975945003921055,-0.027809194697697895,616809234,613125283.6,25.81045601388155,41.642078151517595,NaN,NaN,-11.604501260344403,2.4555764414074623
2019-03-29T09:30:00-04:00,25.86,25.88,25.61,25.71,50234396,60285660.4,44.377606055838626,48.591156361124625,NaN,NaN,-60.228137125428944,-131.47477175556952,-0.10586856046427723,-0.16014489527804443,-0.0542763348137672,667043630,614627547,26.064512638003976,41.20777941436537,NaN,NaN,-11.655592639903158,0.439695144077374
2019-04-01T09:30:00-04:00,25.92,26.36,25.91,26.34,62485288,59579330,55.25542114520738,48.70962513392193,NaN,NaN,18.803528630703358,-83.46263458537645,-0.04327129933339821,-0.10836545898051497,-0.06509415964711676,729528918,643193988.8,30.90958604574743,41.22874426047957,NaN,NaN,-7.791712569033368,-0.736220243509875
2019-04-02T09:30:00-04:00,26.27,26.46,26.23,26.32,41003636,59636106.85,54.88843726261968,48.529820967609666,NaN,NaN,41.958285031034364,-45.32733491221488,-0.0024510980017768275,-0.0681580321493378,-0.06570693414756097,688525282,653325394.8,32.5966333671454,41.29398282455537,NaN,NaN,-4.9664998690009865,-1.3405459042943195
2019-04-03T09:30:00-04:00,26.5,26.62,26.29,26.4,52030863,60079705.65,56.14317780961917,48.29722463724799,NaN,NaN,57.16328535966416,-7.9646162550300605,0.028967154663352326,-0.029497990818370567,-0.058465145481722894,740556145,688492641.8,38.2344282556939,41.32141827176422,NaN,NaN,-2.312457263505098,-1.4793903841815736
2019-04-04T09:30:00-04:00,26.4,26.67,26.4,26.56,54378854,59667541.35,58.622026168787215,48.170389861369415,NaN,NaN,68.27520290353806,25.19443295990221,0.057884842429919744,0.01389090755567679,-0.043993934874242954,794934999,724117794.8,43.39922363942739,40.98112000718811,NaN,NaN,0.6685619083735488,-1.172540056673699
2019-04-05T09:30:00-04:00,26.61,26.7043,26.52,26.6,37088792,58723774,59.24224893627356,47.734010373361926,NaN,NaN,72.60127114167578,51.76031461332316,0.07592926066220586,0.050917640953514365,-0.02501161970869149,832023791,757113827,47.75662480674222,40.42859088544544,NaN,NaN,3.2623120356540323,-0.5389897577697373
2019-04-08T09:30:00-04:00,26.53,26.635,26.47,26.63,34998006,57306497.8,59.72978681056115,47.7751619387604,NaN,NaN,62.478017685456244,60.495212424273724,0.08540137119777774,0.08174009428853068,-0.003661276909247054,867021797,784612402.8,51.13302400193492,39.82758719023805,NaN,NaN,5.5262894808170895,0.32747870488552366
2019-04-09T09:30:00-04:00,26.51,26.51,26.2927,26.41,65954762,58978179.4,54.57427016976711,48.33977234993712,NaN,NaN,34.38535176653565,58.98062577137398,0.07285491870175513,0.08740737146794686,0.014552452766191729,801067035,807120753.4,53.76689084361106,39.339381499716474,NaN,NaN,6.057223035914852,1.1460136093182849
2019-04-10T09:30:00-04:00,26.41,26.53,26.28,26.49,48232806,59248942.4,56.05951504865642,49.11714709455017,NaN,NaN,39.17010423031207,55.381989545503565,0.06614461128839724,0.09723321687668829,0.031088605588291043,849299841,828869492.6,56.222206408747354,39.31010921621369,NaN,NaN,6.919697323195266,1.9708255684435678
2019-04-11T09:30:00-04:00,26.59,26.75,26.51,26.65,62205014,60475906.8,58.95033128699438,50.86491952805196,NaN,NaN,69.65795676165163,55.65854031712629,0.06839870810740367,0.11658699072254564,0.048188282615141964,911504855,852183463.8,58.751115832887656,40.1454844322226,NaN,NaN,8.489161112931347,2.9020163605132505
2019-04-12T09:30:00-04:00,27.04,27.33,26.9,27.14,84627607,61206265.55,66.26918761148329,53.227802971155654,NaN,NaN,134.41607625589305,68.02150133996975,0.09705729091833577,0.16950989626306168,0.0724526053447259,996132462,885005198,62.07281267848014,41.90007239711192,NaN,NaN,12.333885101994625,4.249426180724875
2019-04-15T09:30:00-04:00,27.15,27.16,26.91,26.97,40030367,61008749.1,62.130381245710566,54.82171076999885,NaN,NaN,115.40721637259018,78.60734107739653,0.09842249242376205,0.19548072087442847,0.09705822845066642,956102095,902821257.6,63.77793601692047,44.160428861657515,NaN,NaN,14.24694106440656,5.677642592679401
2019-04-16T09:30:00-04:00,27.03,27.38,27.01,27.35,56093380,61561955,67.07971168742971,56.87633239557134,NaN,NaN,140.6388282649241,99.85803637707421,0.11748455549941395,0.24391392282493385,0.1264293673255199,1012195475,945046945.6,67.50657560208995,47.00014472509381,NaN,NaN,17.586721429593972,7.378939569381482
2019-04-17T09:30:00-04:00,27.45,27.46,27.2,27.42,58833989,61210640.15,67.91167036257448,58.65955511439451,NaN,NaN,136.84433245576753,119.39288202216531,0.12658815686697356,0.28466456340923685,0.1580764065422633,1071029464,989392870.2,70.89506065543372,50.22047362806182,NaN,NaN,20.510565948050324,9.254886194905602
2019-04-18T09:30:00-04:00,27.37,27.45,27.3,27.34,52495728,58589723.95,65.86307237974174,60.1942312803876,NaN,NaN,123.53280774492734,130.16785221882043,0.11911159194838561,0.3069658964777453,0.1878543045293597,1018533736,1010798646.4,72.39168217938463,53.52955716673186,NaN,NaN,22.275850694456505,11.11502398055573
2019-04-22T09:30:00-04:00,27.26,27.3356,27.17,27.26,39324122,54463121.15,63.79076200349049,60.80389848455068,NaN,NaN,102.70036890402267,123.82471074844636,0.10136335448846126,0.31455849763993626,0.213195143151475,979209614,1007414076.8,71.76332727832188,56.44768154048718,NaN,NaN,23.129601542419795,12.831392203679167
2019-04-23T09:30:00-04:00,27.25,27.46,27.14,27.43,54250320,53533856.95,66.2228507925137,61.61349945097168,NaN,NaN,105.45850289266689,121.8349680524617,0.09383081197604953,0.3304836581215369,0.23665284614548737,1033459934,1022885644.6,72.92043446118237,59.32795304720411,NaN,NaN,24.573412800106816,14.508823717454545
2019-04-24T09:30:00-04:00,27.34,27.5233,27.28,27.4,39505227,52950541.15,65.38817793153004,62.27385660253674,NaN,NaN,102.06842173236859,114.12088674595061,0.08011874530723018,0.33680127777952507,0.2566825324722949,993954707,1019237491,72.16943975237423,61.751882439824136,NaN,NaN,25.52487222011163,16.08254493211984
2019-04-25T09:30:00-04:00,27.27,27.56,27.2,27.45,44532302,51519739.15,66.15386435038332,62.81184504407931,NaN,NaN,91.46149339857648,105.0443189345124,0.06817508808585043,0.34190139257960794,0.2737263044937575,1038487009,1012729000,70.76913237293712,63.706875920789116,NaN,NaN,26.530155042988955,17.575060662244
2019-04-26T09:30:00-04:00,27.45,27.72,27.41,27.7,41527922,50991669.05,69.75644719814544,63.562859205641594,NaN,NaN,109.8339543299018,102.30454825150728,0.07057408984122637,0.3619439167952905,0.2913698269540641,1080014931,1025025239,71.87926134855743,65.42992138806163,NaN,NaN,28.4711267254742,19.131641528419742
2019-04-29T09:30:00-04:00,27.8,28.1284,27.73,27.98,61643171,51562107.8,73.19744073786953,64.52483448616361,NaN,NaN,146.39308438025213,111.04309134675319,0.08359071003168295,0.39585821449366776,0.3122675044619848,1141658102,1057514936.6,74.62178773271572,67.10769022597455,NaN,NaN,31.25801869780871,20.863981124046738
2019-04-30T09:30:00-04:00,28.02,28.06,27.7833,28.02,38915267,50383606.75,73.65852237442019,65.88799535792455,NaN,NaN,135.2641473272524,117.00422023367028,0.08707313556741142,0.4211089239212491,0.3340357883538377,1180573369,1086937623.6,76.82596766812975,68.7547671420116,NaN,NaN,33.66967117599024,22.693365417181525
2019-05-01T09:30:00-04:00,28.05,28.14,27.77,27.79,67969522,51731901.05,66.56738962075909,66.63855782736046,NaN,NaN,117.62996847533302,120.11652958226318,0.06696793158076253,0.41774570282979084,0.3507777712490283,1112603847,1110667451.6,78.4515152900452,70.34257491924716,NaN,NaN,33.69912983789855,24.265617477283957
2019-05-02T09:30:00-04:00,27.77,27.95,27.62,27.82,50972887,51679002.25,67.01346414929618,67.21449588895345,NaN,NaN,94.7128343572771,120.7667977740033,0.049572365523368744,0.41274322815323927,0.36317086262987053,1163576734,1135685396.6,80.04107538940195,71.86328631614103,NaN,NaN,33.84855059473417,25.634607922633986
2019-05-03T09:30:00-04:00,27.94,28.12,27.885,28.07,34598895,50690004.3,70.54090671324924,67.51961868193673,NaN,NaN,121.79482008182849,123.15897092438863,0.04871395293456071,0.42406330379807144,0.37534935086351073,1198175629,1159317536.2,81.43425971891635,73.24624681902934,NaN,NaN,35.02072186042463,26.975481342318364
2019-05-06T09:30:00-04:00,27.58,27.98,27.53,27.88,42517377,50961433.55,64.86383789646248,67.71486558556187,NaN,NaN,78.93053013879586,109.66646007609738,0.03007490613599223,0.412942983533501,0.3828680773975088,1155658252,1162117566.2,81.59815899731312,74.51911988905738,NaN,NaN,34.32035851128039,28.02474950931294
2019-05-07T09:30:00-04:00,27.62,27.885,27.23,27.42,60090811,52216073.8,53.613914771004836,66.75302294867437,NaN,NaN,25.202938125392805,87.65421823572547,-0.016030924109760536,0.3628294222603081,0.37886034637006866,1095567441,1145116380.6,77.14494610073695,75.20757492467501,NaN,NaN,29.886019023583383,28.29064515420872
2019-05-08T09:30:00-04:00,27.31,27.59,27.235,27.36,44254544,51131062.9,52.33880143414454,65.64067516807224,NaN,NaN,-6.542272737899135,62.819769993079035,-0.05137185504659991,0.31464552756181874,0.36601738260841865,1051312897,1132858190.6,74.00871688709859,75.42997894122252,NaN,NaN,25.95730098432228,27.95731027279637
2019-05-09T09:30:00-04:00,27.03,27.355,26.895,27.3,56468339,51542839.55,51.03173903812212,64.5812942150994,NaN,NaN,-65.83829797909013,30.70954352580558,-0.07799583880042721,0.26852258410788465,0.34651842290831186,994844558,1099111755.4,66.04809739923031,74.97686574264006,NaN,NaN,22.37661077325457,27.16006748714754
2019-05-10T09:30:00-04:00,27.15,27.525,26.91,27.48,63453824,51605280.05,54.687645804856786,63.93107162948271,NaN,NaN,-49.77670900495122,-3.604762291550368,-0.0822665281030519,0.24368526277949698,0.3259517908825489,1058298382,1071136306,60.26132356502782,74.15529404883334,NaN,NaN,20.406075530016636,26.195211493271696
2019-05-13T09:30:00-04:00,26.93,26.99,26.59,26.68,54962540,50122026.7,40.290283848710246,62.07874541921104,NaN,NaN,-177.97480641567745,-54.98582960244503,-0.13465653739166916,0.15763111914296246,0.2922876565346316,1003335842,1040671824,54.646454927129724,72.85000979640101,NaN,NaN,13.048934090177172,24.317171864258192
2019-05-14T09:30:00-04:00,26.74,27.12,26.71,26.89,52398357,50740426.2,44.426253662676416,60.58146511429293,NaN,NaN,-136.86575306259942,-87.39956784004349,-0.14969768342129913,0.10516555225800772,0.25486323567930685,1055734199,1032705175.6,53.249184614651384,71.49856300084939,NaN,NaN,8.67882969297491,22.083122982646294
2019-05-15T09:30:00-04:00,26.62,26.92,26.52,26.79,49061697,50388842.05,42.902277784435306,58.9206375024395,NaN,NaN,-158.6812744486191,-117.82736818218748,-0.15998308828095936,0.05488437532810764,0.214867463609067,1006672502,1023777096.6,51.65514510423163,70.13327819594186,NaN,NaN,4.753300191163064,19.607434012434403
2019-05-16T09:30:00-04:00,26.88,27.21,26.86,27.06,44872608,49690773,48.080897549107355,57.37238395607964,NaN,NaN,-83.9344701462331,-121.44660261561607,-0.14277133935875058,0.03640328941062876,0.17917462876937934,1051545110,1035117207,53.55688619711754,68.82453711369614,NaN,NaN,3.2204811843145267,17.26644075127442
2019-05-17T09:30:00-04:00,26.79,27.14,26.75,26.88,62711461,50201559.65,45.141459815486286,55.36838531876655,NaN,NaN,-99.43528459571183,-131.3783177337682,-0.13761971942990522,0.0071499794819978035,0.14476969891190303,988833649,1021224260.4,50.91445321703383,67.13115607686173,NaN,NaN,1.0046270741968433,14.943324511691909
2019-05-20T09:30:00-04:00,26.78,27.03,26.78,26.91,44357439,50453225.5,45.73688859751874,53.37398290613073,NaN,NaN,-94.59360775053437,-114.70207800073959,-0.1265818385599959,-0.01345759928809187,0.11312423927190404,1033191088,1027195309.6,52.0103686488374,65.35861328976941,NaN,NaN,-0.5559320144072992,12.729145007963451
2019-05-21T09:30:00-04:00,27.02,27.19,27.02,27.19,36851389,49583278.95,51.07444855568804,52.267344258625656,NaN,NaN,-46.82851782952309,-96.6946309541243,-0.0961902657531194,-0.007113592919495204,0.0890766728336242,1070042477,1030056965.2,52.55706522550963,63.50900971373115,NaN,NaN,-0.21471858955497453,10.88002163688939
2019-05-22T09:30:00-04:00,27.05,27.11,26.9535,27.03,25867584,48901396.8,48.15927352095112,50.92061635660101,NaN,NaN,-59.78951662002359,-76.9162793884052,-0.08312188525652883,-0.014825683737036854,0.06829620151949198,1044174893,1037557443.4,54.035089710717905,61.65143930811087,NaN,NaN,-0.833315231994494,9.206687798477407
2019-05-23T09:30:00-04:00,26.77,26.78,26.42,26.65,51832904,49266426.9,42.02433645532679,48.883718481035125,NaN,NaN,-117.3521693114627,-83.59981922145111,-0.09544684664368866,-0.05101235678511884,0.04443448985856981,992341989,1025716819.2,51.317131454327836,59.50021586064026,NaN,NaN,-3.382690262926428,7.408205218276859
2019-05-24T09:30:00-04:00,26.75,26.87,26.67,26.86,30582000,48719130.8,46.10996633776456,47.54415622684242,NaN,NaN,-79.05062528980888,-79.52288736027053,-0.08517180360801381,-0.06203026465144745,0.023141538956566357,1022923989,1032534887.2,52.78969855383314,57.44246868610598,NaN,NaN,-4.176911747765448,5.7531885088422445
2019-05-28T09:30:00-04:00,26.78,26.86,26.535,26.55,35177714,47395857.95,41.46462031957024,46.67634948031138,NaN,NaN,-96.6342442227196,-79.93101465470758,-0.09426121178586372,-0.09468497577576329,-0.00042376398989957265,987746275,1023445924.6,50.5927257423144,55.54588151764723,NaN,NaN,-6.382237947649825,4.019556157914806
2019-05-29T09:30:00-04:00,26.34,26.545,26.215,26.5,39700572,47435123.2,40.75150476824898,45.84868543274741,NaN,NaN,-127.41559747983281,-96.04843058476952,-0.09820396807503529,-0.12317872408369368,-0.024974756008658394,948045703,999046569.8,45.15932596308088,53.48521073736025,NaN,NaN,-8.349743969513849,2.2525132825678558
2019-05-30T09:30:00-04:00,26.56,26.71,26.28,26.41,40641219,46068708.05,39.43676240500023,45.02047281609584,NaN,NaN,-112.27827068181453,-106.5461813971277,-0.10104309671267106,-0.15127862689949723,-0.050235530186826166,907404484,971692488,39.97596956900606,51.62291589234423,NaN,NaN,-10.35233807270972,0.4518202318139164
2019-05-31T09:30:00-04:00,26.07,26.2,25.99,26.01,49259252,45983026.3,34.16158378854702,43.55432552921657,NaN,NaN,-171.2574915524264,-117.32724584532043,-0.12259483923166854,-0.20347907922641184,-0.0808842399947433,858145232,944853136.6,35.65200490826044,49.865107416860845,NaN,NaN,-13.844091572619607,-1.5904528831051585
2019-06-03T09:30:00-04:00,25.97,26.29,25.92,26.18,63329348,47419548.95,37.959825011270084,43.38786418368513,NaN,NaN,-150.7627349383256,-131.6696677750238,-0.11809002083945905,-0.2284967660440671,-0.11040674520460805,921474580,924563254.8,32.76660044425603,48.30226066808416,NaN,NaN,-15.549600283818114,-3.584616797492724
2019-06-04T09:30:00-04:00,26.5,26.92,26.43,26.89,45454397,47566399.95,50.741282476845655,43.838937670411504,NaN,NaN,-20.15112879572682,-116.37304468962523,-0.06275891538536091,-0.1888553894363092,-0.1260964740509483,966928977,920399795.2,32.190875493594774,46.79809573086583,NaN,NaN,-12.623092214615875,-4.87582757136746
2019-06-05T09:30:00-04:00,26.94,27.08,26.71,27.06,46599718,46891845.3,53.22605492252509,44.5763503231322,NaN,NaN,35.03419253025456,-83.88308668760776,-0.01278992404645718,-0.14208387910901976,-0.12929395506256258,1013528695,933496393.6,36.00022608450796,45.679887229456995,NaN,NaN,-9.451426645226462,-5.529484581918746
2019-06-06T09:30:00-04:00,27.07,27.2675,26.9233,27.16,37297602,46543998.2,54.67443489602204,45.04731727648326,NaN,NaN,83.96546084369793,-44.634340382505265,0.02676065530742848,-0.09584313592827698,-0.12260379123570546,1050826297,962180756.2,43.488337049271045,44.96070514746797,NaN,NaN,-6.468816393253777,-5.663674840680893
2019-06-07T09:30:00-04:00,27.16,27.25,27.08,27.12,33054778,45373320.15,53.95473286014065,45.67683677967285,NaN,NaN,93.56076261867028,8.329310451714075,0.04871240326227827,-0.06171328715785762,-0.11042569042013589,1017771519,994106013.6,50.438741039877264,44.92672570624249,NaN,NaN,-4.3169614336693165,-5.471287211107811
2019-06-10T09:30:00-04:00,27.28,27.55,27.28,27.35,37081389,44054698.4,57.425093870724645,46.51170858490184,NaN,NaN,153.75619328444,69.23309609626719,0.07560254155112278,-0.015922513481232414,-0.0915250550323552,1054852908,1020781679.2,55.37722939060261,45.16721575922572,NaN,NaN,-1.4088609646840582,-4.890940604475846
2019-06-11T09:30:00-04:00,27.5,27.61,27.275,27.36,34273450,43020243.9,57.57481058788394,46.976020158630114,NaN,NaN,137.4557882231694,100.75447950004644,0.08996614222094959,0.020932622743831786,-0.0690335194771178,1089126358,1045221155.4,59.37155292385999,45.65396488053646,NaN,NaN,0.969499920037185,-4.053734815259698
2019-06-12T09:30:00-04:00,27.33,27.38,27.03,27.09,36866039,42243628,52.23387556620309,47.267063161862396,NaN,NaN,72.99628295040937,108.3468975840774,0.07765139120335036,0.028030719527070147,-0.04962067167628022,1052260319,1052967480.2,60.57612962239845,46.12118201708507,NaN,NaN,1.4932942594181855,-3.261302090305715
2019-06-13T09:30:00-04:00,27.14,27.27,27.07,27.18,31020047,41341545.5,53.77324072733589,48.106270609863046,NaN,NaN,67.99026826207741,105.15185906775329,0.07205810153768391,0.04045195524582468,-0.03160614629185923,1083280366,1059458294,61.60340085474951,46.855915545686614,NaN,NaN,2.371989409693418,-2.45654616173441
2019-06-14T09:30:00-04:00,27.21,27.33,27,27.24,29724061,40584118.15,54.818621597174506,48.72831741410662,NaN,NaN,68.71473385867124,100.18265331575348,0.06889213821402126,0.054509026475667355,-0.014383111738353913,1113004427,1078504875.6,64.52456630733818,47.69412038522269,NaN,NaN,3.3942342485034125,-1.6207203888432926
2019-06-17T09:30:00-04:00,27.23,27.305,26.96,26.99,40981591,39497624.65,49.768423375824646,49.32144620383907,NaN,NaN,43.3515625441309,78.10172716769166,0.04747304614341752,0.04495819594091799,-0.0025148502024995335,1072022836,1081938861.2,65.04096946339234,48.72613779387111,NaN,NaN,2.8552466033123576,-0.981296532821057
2019-06-18T09:30:00-04:00,26.93,27.46,26.93,27.35,46237423,39591623.85,56.047693417565945,50.414031107361716,NaN,NaN,70.92781035295445,64.79613159364867,0.05455664504961915,0.0656809561095244,0.011124311059905254,1118260259,1087765641.4,65.94677357956054,50.210955480762514,NaN,NaN,4.2803819219743415,-0.22962818213600011
2019-06-19T09:30:00-04:00,27.4,27.59,27.27,27.3,58118501,40654979.45,55.01897379616559,51.527046206730674,NaN,NaN,93.88310723158394,68.97349644988358,0.05284425671645487,0.07717963195547384,0.02433537523901897,1060141758,1089341929.2,66.20190193694538,52.08423636418676,NaN,NaN,5.140115337336059,0.537478034931437
2019-06-20T09:30:00-04:00,27.45,27.53,27.12,27.42,50584217,41890811.1,57.05618397653516,53.16237479158696,NaN,NaN,81.62925986757318,71.70129477098274,0.05643704031291196,0.09488167563015892,0.03844463531724696,1110725975,1094831051,67.12555925815191,54.332347389179,NaN,NaN,6.452174556111832,1.3824346808143506
2019-06-21T09:30:00-04:00,27.3,27.48,27.18,27.22,65322286,42565280.2,52.76674753376011,54.22001211462197,NaN,NaN,64.34804885176673,70.82795776960185,0.0426163793911094,0.09171510955613371,0.049098730165024314,1045403689,1081310903.4,62.588480950553226,56.46248171105737,NaN,NaN,6.347136659672568,2.0916778206512388
2019-06-24T09:30:00-04:00,27.17,27.355,27.08,27.11,48378025,43455081.45,50.51725462293943,54.204010125057245,NaN,NaN,39.40280229129148,70.03820571903397,0.02425226907737396,0.07941406651174177,0.055161797434367804,997025664,1066311469,57.9118417237825,58.29969358464221,NaN,NaN,5.613354168556029,2.5947744417804945
2019-06-25T09:30:00-04:00,27.11,27.15,26.89,27.02,47748490,44083620.25,48.688379181847495,53.879890429294555,NaN,NaN,4.623132572542622,56.77727016295161,0.0052241671633151965,0.0616920063885118,0.0564678392251966,949277174,1032514852,49.02339503763567,59.22991993843704,NaN,NaN,4.47986425701072,2.864072986813384
2019-06-26T09:30:00-04:00,27.08,27.21,26.96,26.97,31448023,43670992.8,47.65615142603486,53.378584467152606,NaN,NaN,4.191446776744119,38.838938071983634,-0.01068182765839163,0.043115554652207067,0.0537973823105987,917829151,1004052330.6,43.03312738472617,59.19740496239813,NaN,NaN,3.2477720870415316,2.9188871439888335
2019-06-27T09:30:00-04:00,27.07,27.29,27.07,27.21,59459807,44611922.2,52.82601090223107,53.297961470159066,NaN,NaN,34.19907129429791,29.352900357328576,-0.005265659154844185,0.04721530836704346,0.05248096752188765,977288958,977364927.2,38.30667842067209,58.330829061026336,NaN,NaN,3.5940558686888666,3.0153398189459812
2019-06-28T09:30:00-04:00,27.53,27.7,27.2357,27.6,76728103,45985364.75,59.77807800998114,53.46603176582024,NaN,NaN,133.652254238274,43.21374143463002,0.022815554814272276,0.08100041103972799,0.05818485622545572,1054017061,979087601.6,38.77414277591685,57.14489430283449,NaN,NaN,6.067754249984756,3.451399023380092
2019-07-01T09:30:00-04:00,27.92,28.05,27.78,27.93,49145249,45276159.8,64.54001763499531,53.963546554899594,NaN,NaN,270.5823783214124,89.44965664065421,0.0597496554544477,0.13287192554351535,0.07312227008906765,1103162310,1000314930.8,44.368005643225764,56.073212354217766,NaN,NaN,9.802685496445305,4.358725662389408
2019-07-02T09:30:00-04:00,27.89,27.975,27.71,27.86,56626803,45834780.1,62.84048550006364,54.72116155017534,NaN,NaN,202.03921428700468,128.93287298354662,0.07463318028690193,0.16641374544769505,0.09178056516079312,1046535507,1019766597.4,48.96905310675588,55.24413546024329,NaN,NaN,12.288195745032688,5.491507102767019
2019-07-03T09:30:00-04:00,27.95,28.09,27.87,28.08,23706812,44690134.8,65.88137825723535,55.586028516596734,NaN,NaN,208.9837830618649,169.89134024057077,0.0932526308206545,0.20834635368661125,0.11509372286595675,1070242319,1050249231,55.219377559938145,54.78813379632819,NaN,NaN,15.36800090565786,6.902434788894283
2019-07-05T09:30:00-04:00,28.17,28.2651,28.03,28.16,40683108,44859410.1,66.94081541263368,56.45189950341524,NaN,NaN,200.34968577189005,203.1214631360892,0.10409061029972444,0.24520698574061228,0.14111637544088784,1110925427,1076976524.8,59.8615063978653,54.4550580885087,NaN,NaN,18.206997014754624,8.517372249731475
2019-07-08T09:30:00-04:00,28.01,28.13,27.94,28.02,26286734,44521007.9,63.23999283450796,57.414154464749764,NaN,NaN,138.21344569099546,204.0337014266335,0.09520604008453662,0.2601239255465586,0.164917885462022,1084638693,1083100851.2,60.8626727651915,54.156608324351495,NaN,NaN,19.511885658025836,10.088017022344955
2019-07-09T09:30:00-04:00,27.83,28.12,27.81,28.07,25895770,43961726.95,64.0053633239304,57.982559458061516,NaN,NaN,110.63460374579581,172.04414651151018,0.08633386396381221,0.27283521541678724,0.18650135145297503,1110534463,1084575281.8,61.11414355232487,53.81142046526323,NaN,NaN,20.804626069443767,11.618961171930499
2019-07-10T09:30:00-04:00,28.08,28.23,27.93,27.97,36566724,44076390.65,61.25825717228057,58.428222556355436,NaN,NaN,102.62752714950469,152.16180908401017,0.0681651284420354,0.27170776200551927,0.20354263356348387,1073967739,1090061728.2,62.090253517055906,53.51773129241399,NaN,NaN,21.129896691193622,12.977666246110944
2019-07-11T09:30:00-04:00,28.01,28.17,27.96,28.13,40907527,44278465.05,63.92608053625086,58.918929453477986,NaN,NaN,96.54871430695124,129.67479533302745,0.06155915520691563,0.2804915775721284,0.21893242236521276,1114875266,1098988317.6,63.68739568654284,53.2721481801562,NaN,NaN,22.16703296697051,14.290432920519454
2019-07-12T09:30:00-04:00,28.17,28.32,28.0987,28.32,31109913,44282958.35,66.84576074896597,59.924573254564116,NaN,NaN,108.75536177282665,111.35593053321477,0.06432101754565517,0.29933369429728174,0.23501267675162657,1145985179,1106000268,64.93702003840667,53.43990097214573,NaN,NaN,23.92277883244322,15.666482336508563
2019-07-15T09:30:00-04:00,28.33,28.35,28.08,28.16,28346133,44214061.95,62.2748208880767,60.76439941635964,NaN,NaN,89.87510698452223,101.68826279192011,0.05032689340342808,0.2979212935059117,0.2475944001024836,1117639046,1112600338.6,66.11890169401887,54.026119541448324,NaN,NaN,24.102842667778525,16.871676669547128
2019-07-16T09:30:00-04:00,28.21,28.255,28.025,28.09,47288109,44529387.85,60.33109254289239,61.596021799291414,NaN,NaN,71.1194248065699,93.78522700407493,0.03219292123749706,0.2878355516493549,0.25564263041185786,1070350937,1104563633.4,63.320045858379174,55.04730888578714,NaN,NaN,23.698533516364513,17.846941933378183
2019-07-17T09:30:00-04:00,27.99,28.075,27.81,27.85,35062571,43970645.25,54.09673095257835,62.05606319404452,NaN,NaN,31.9327025281494,79.64626207980386,0.0014924082899382962,0.25750814077428075,0.25601573248434245,1035288366,1096827758.8,60.65833163042199,56.306252046194,NaN,NaN,21.477271722842932,18.36556047473029
2019-07-18T09:30:00-04:00,27.81,28.11,27.78,28.06,46385357,43383988.05,58.16990001584889,62.437769559302936,NaN,NaN,40.60370849504564,68.45726091742274,-0.006760650128713963,0.24756491982344997,0.25432556995216393,1081673723,1090187450.2,58.38941843744269,57.740733475963324,NaN,NaN,20.756575497399744,18.707134049397357
2019-07-19T09:30:00-04:00,28.13,28.18,27.92,27.94,29338522,42321703.3,55.157977538724516,62.10776238278461,NaN,NaN,42.43157311593357,55.192503186044135,-0.021555860138919497,0.22738074477851455,0.24893660491743405,1052335201,1071457454.6,52.43200204810568,58.71629485254823,NaN,NaN,19.247519338764985,18.784331947878446
2019-07-22T09:30:00-04:00,27.88,28.045,27.83,28,26683328,40389755.4,56.37428322046555,61.524495638889626,NaN,NaN,28.297661029404047,42.87701399502049,-0.028139665014775578,0.21376202364896457,0.24190168866374015,1079018529,1063733351.2,50.159160537398314,59.12994877356056,NaN,NaN,18.347691865427368,18.721954793242578
2019-07-23T09:30:00-04:00,28.07,28.33,28.0601,28.29,45307569,40236232.6,61.77156937243194,61.44814448691594,NaN,NaN,84.58487376037267,45.57010378578104,-0.014489387636256235,0.22378995411841984,0.23827934175467608,1124326098,1074528383.4,53.211760948519725,59.432999333686546,NaN,NaN,19.17216845930722,18.78627103125181
2019-07-24T09:30:00-04:00,28.23,28.58,28.21,28.58,36374227,39667519.45,66.2660978149984,61.47562445532758,NaN,NaN,150.14923728630185,69.21341073741155,0.011160674649116548,0.25223018506607175,0.2410695104169552,1160700325,1099610775.2,59.42940276280213,59.733715419605396,NaN,NaN,21.34168234564885,19.15132979045139
2019-07-25T09:30:00-04:00,28.57,28.61,28.315,28.38,34180350,39804135.8,60.94442321127715,61.047310726659255,NaN,NaN,152.73932944482874,91.64053492736818,0.011691258284171474,0.25568358327216956,0.24399232498799808,1126519975,1108580025.6,61.40453925853714,59.843932052510524,NaN,NaN,21.471754745609385,19.482819069759675
2019-07-26T09:30:00-04:00,28.44,28.71,28.38,28.69,33642786,38513284.75,65.56103532841455,61.213099476224,NaN,NaN,194.96402045844255,122.14702439586998,0.028969987079959292,0.2802048088379472,0.2512348217579879,1160162761,1130145537.6,65.72518925181171,60.19125465869769,NaN,NaN,23.117570078613888,20.002069213881704
2019-07-29T09:30:00-04:00,28.64,28.72,28.44,28.47,35955119,36474635.55,60.12891514731939,60.9362103207518,NaN,NaN,155.14947531090925,147.517387252171,0.021950958997841608,0.27867352050528993,0.2567225615074483,1124207642,1139183360.2,67.37361914138849,60.63836005791652,NaN,NaN,22.687984281158464,20.38577136634981
2019-07-30T09:30:00-04:00,28.25,28.42,28.19,28.39,30726087,35553677.45,58.23922270536544,60.72056500168643,NaN,NaN,66.00522663098903,143.8014578262943,0.008954958939577373,0.26791626018192005,0.2589613012423427,1093481555,1133014451.6,65.07309863373445,60.851420423393556,NaN,NaN,21.743741801360574,20.57976714277992
2019-07-31T09:30:00-04:00,28.39,28.5268,28.195,28.25,64485396,35946607.1,54.98268271339265,60.08175087148227,NaN,NaN,54.95111481570676,124.76183333217526,-0.010955489554099751,0.245266939299718,0.25622242885381774,1028996159,1106673618.4,56.24220898868311,60.31962137354642,NaN,NaN,19.942998244124016,20.48880015725765
2019-08-01T09:30:00-04:00,28.23,28.42,27.57,27.61,107976336,40160083.3,43.114144326403384,58.3866354127278,NaN,NaN,-116.60357941285868,70.89325156063778,-0.06603990389354825,0.17367254898688245,0.2397124528804307,921019823,1065573588,45.79856303672976,58.95258873056951,NaN,NaN,13.933389615941833,19.552312937069676
2019-08-02T09:30:00-04:00,27.56,27.735,27.23,27.6,66036364,41427746.1,42.95810962864491,57.006870322768386,NaN,NaN,-202.29797721504758,-8.559147974060238,-0.09992741606521477,0.11480318279891222,0.214730598864127,854983459,1004537727.6,35.31187850372052,56.75208707411962,NaN,NaN,9.30873695755591,18.08894493999628
2019-08-05T09:30:00-04:00,26.99,27.12,26.475,26.68,85527893,44389804.05,31.620093444056323,54.956084672851524,NaN,NaN,-329.88508040380253,-105.56605911700258,-0.17659900050547708,-0.00601815176771936,0.17058084873775772,769455566,933587312.4,27.444976103820082,54.18958209165112,NaN,NaN,0.19864929631502787,15.533188419470388
2019-08-06T09:30:00-04:00,26.85,27.13,26.59,27.11,53444990,45767265.05,39.6389754806327,53.92338785342684,NaN,NaN,-221.22759366952965,-163.01262317710635,-0.18951121043002755,-0.0663081642997767,0.12320304613025083,822900556,879471112.6,23.199564466421236,51.51395586565106,NaN,NaN,-3.991506508582298,12.743946286891433
2019-08-07T09:30:00-04:00,26.6,26.87,26.24,26.75,82354607,48056659.2,35.84864723127889,52.329012654528974,NaN,NaN,-216.31124211469498,-217.26509456318666,-0.21176742028502882,-0.14150622922603517,0.07026119105899363,740545949,821781070.6,19.70090705719433,48.7504907670619,NaN,NaN,-8.759161324591236,9.672073770965337
2019-08-08T09:30:00-04:00,27.01,27.27,26.79,27.26,66653170,49343941.35,44.01582555754192,51.53314465587308,NaN,NaN,-115.34903893391304,-217.01418646739756,-0.18270953266749126,-0.15812572477537046,0.024583807892120807,807199119,799016929.8,18.514410284359215,46.32780564108,NaN,NaN,-9.482719276020017,6.935674764253143
2019-08-09T09:30:00-04:00,27.11,27.31,26.9,27.17,53782734,50477582.4,42.97602632351616,50.57612630609098,NaN,NaN,-96.03454754092029,-195.76150053257211,-0.1608863916655393,-0.17652418168980333,-0.01563779002426402,753416385,778703515,17.501497821789627,43.99511544710795,NaN,NaN,-10.393596196090478,4.460064627061197
2019-08-12T09:30:00-04:00,26.85,26.95,26.57,26.65,56837635,51902157.5,37.46854550372121,48.8401960297545,NaN,NaN,-124.51633479205455,-154.6877514102225,-0.17181675760527398,-0.23040873703085651,-0.05859197942558252,696578750,764128151.8,16.791632306698716,41.39367768697788,NaN,NaN,-13.17930129127333,1.9401552101562647
2019-08-13T09:30:00-04:00,26.6,27.17,26.5,26.98,72404973,53158000.7,42.504223585547074,47.142919299079416,NaN,NaN,-91.82981753409258,-128.80819618313507,-0.14806677992049777,-0.24367545432620474,-0.09560867440570697,768983723,753344785.2,16.26597743482874,38.310575877836925,NaN,NaN,-13.59435705011853,-0.27906082702584856
2019-08-14T09:30:00-04:00,26.38,26.52,25.96,25.98,92067291,56008236.7,33.65863604465275,45.19393450146338,NaN,NaN,-144.200658623302,-114.38607948485651,-0.1883648665322168,-0.331064757570978,-0.14269989103876118,676916432,740618881.8,15.64358679893111,35.0419364164365,NaN,NaN,-17.478909725034157,-2.7361820981698926
2019-08-15T09:30:00-04:00,26.11,26.275,25.915,26.11,59686955,56673316.6,35.536804168450104,43.04934656146592,NaN,NaN,-129.10024098879347,-117.1363198958326,-0.1941512649910821,-0.3853889722776138,-0.19123770728653172,736603387,726499735.4,14.959660770145945,31.415827239174657,NaN,NaN,-19.666463787019474,-5.154793768005547
2019-08-16T09:30:00-04:00,26.24,26.64,26.24,26.57,49339086,57673344.8,41.81402683520923,41.74114025345805,NaN,NaN,-84.59127480999082,-114.84766534964669,-0.15650073428395284,-0.38686362514147277,-0.23036289085751993,785942473,733004953,16.765236125295786,27.800942738025178,NaN,NaN,-19.152778842273094,-7.154505921472339
2019-08-19T09:30:00-04:00,26.98,27.03,26.785,26.84,38298798,58254118.3,45.18785614420582,40.808899784803785,NaN,NaN,-45.17017787191774,-98.97843396561933,-0.10536714021803328,-0.36207181613006156,-0.2567046759120283,824241271,758537457.2,23.619913911122595,24.840000972124333,NaN,NaN,-17.56324187440073,-8.641468200462109
2019-08-20T09:30:00-04:00,26.69,26.74,26.45,26.48,40587187,58018099.2,41.71475137903477,39.86119040377823,NaN,NaN,-67.8381608411573,-94.18010262703228,-0.08842810592335393,-0.3672398083162207,-0.2788117023928668,783654084,761471529.4,24.390499231587697,22.564878846617518,NaN,NaN,-17.455497721064134,-9.900615274833827
2019-08-21T09:30:00-04:00,26.65,26.69,26.53,26.6,44922814,58445528.55,43.279693023459124,39.873015310710784,NaN,NaN,-59.025616260840934,-77.14509415454006,-0.06297550722968726,-0.3575310864299759,-0.29455557920028863,828576898,791803622.6,32.02540190235946,21.58108162273393,NaN,NaN,-16.86205875812899,-10.89510720101885
2019-08-22T09:30:00-04:00,26.74,26.85,26.57,26.78,43902626,58931642.35,45.63753438938142,40.06440279362054,NaN,NaN,-43.201221247854015,-59.965290206352165,-0.029548444839164634,-0.33149113524924445,-0.3019426904100798,872479524,818978850,38.060069291926105,21.77738096474861,NaN,NaN,-15.640697291100405,-11.573048642459073
2019-08-23T09:30:00-04:00,26.59,26.79,25.92,26.1,86262189,61562612.5,39.035772200380215,40.594094133357956,NaN,NaN,-89.57461092847522,-60.961957430049054,-0.04769128894096741,-0.3615568015862891,-0.3138655126453217,786217335,819033822.4,38.07204633506108,22.536457409837254,NaN,NaN,-16.730702501472138,-12.309856336603795
2019-08-26T09:30:00-04:00,26.27,26.37,26.11,26.35,34237158,61476714.45,42.33826002683728,40.78690017237257,NaN,NaN,-87.97046964787296,-69.52201578524009,-0.03774694804472167,-0.3610491977012238,-0.3233022496565021,820454493,818276466.8,37.96313307139618,23.59099802447832,NaN,NaN,-16.545032812249158,-12.914881547410276
2019-08-27T09:30:00-04:00,26.45,26.53,26.03,26.19,54243969,62652608.55,40.814402892028156,41.14159700528323,NaN,NaN,-89.18981252676515,-73.79234612236166,-0.03679861174814614,-0.36930051434168476,-0.3325019025935386,766210524,814787754.8,37.43192257581524,24.85749913295124,NaN,NaN,-16.867261132076095,-13.479507202362536
2019-08-28T09:30:00-04:00,26.05,26.465,26.03,26.43,51879555,62022316.5,44.06646942845012,41.145214424633814,NaN,NaN,-77.09837907237105,-77.40689868466768,-0.015927573201957756,-0.3524113690959858,-0.33648379589402805,818090079,812690391,37.095857527469846,26.184745364602,NaN,NaN,-16.140444639909838,-13.85964112201215
2019-08-29T09:30:00-04:00,26.67,26.915,26.62,26.83,49830058,59115002.6,49.087588182691334,41.581754557432035,NaN,NaN,30.472388556229205,-62.672176723851045,0.02658366319102945,-0.30325421690524124,-0.3298378800962707,867920137,811778513.6,36.94057156731271,27.57325063213936,NaN,NaN,-13.947552092068275,-13.872199832020167
2019-08-30T09:30:00-04:00,26.98,27.055,26.82,26.92,40565540,57841461.4,50.17144949595858,42.48910484259186,NaN,NaN,77.74606195159154,-29.208042147837688,0.06058598176666957,-0.2541054028879337,-0.3146913846546033,908485677,836232182,43.741765037446406,29.498260112907055,NaN,NaN,-11.848907024955919,-13.58315800243956
2019-09-03T09:30:00-04:00,26.7,26.73,26.405,26.64,60003508,56565242.15,46.83115241173241,42.798171187319376,NaN,NaN,-6.543569808865754,-12.922662180036241,0.06372199445336135,-0.2350388915879016,-0.29876088604126294,848482169,841837717.2,45.20080447447958,31.565033472882114,NaN,NaN,-11.040158562115645,-13.219872368107573
2019-09-04T09:30:00-04:00,26.84,26.95,26.78,26.9,43946483,56090316.8,50.15004513941847,43.97612897980264,NaN,NaN,69.07340553550999,18.729981432418782,0.0816635127680696,-0.19668149508117594,-0.27834500784924554,892428652,867081342.8,51.32321120795876,34.113578073526945,NaN,NaN,-9.368770205748426,-12.66971491634198
2019-09-05T09:30:00-04:00,27.28,27.68,27.27,27.45,68642748,55404723.85,56.356324384383086,45.463237566654996,NaN,NaN,182.44725738397574,70.63910872368814,0.12626530598579322,-0.12051337536700402,-0.24677868135279724,961071400,895677607,57.16196059772261,37.128028061211,NaN,NaN,-5.917036699943547,-11.705046599713633
2019-09-06T09:30:00-04:00,27.48,27.56,27.335,27.44,35660801,53855105.4,56.21927604248571,46.49218393860331,NaN,NaN,164.37821536279037,97.42027408500037,0.14921346740485147,-0.06026184709673288,-0.20947531450158435,925410599,907175699.4,59.27709441593495,40.164589367685224,NaN,NaN,-3.2078566589834185,-10.49116232246646
2019-09-09T09:30:00-04:00,27.63,27.97,27.57,27.86,67798105,54555873.95,60.55765807429389,47.590026933609614,NaN,NaN,210.1874098990953,123.9085436745011,0.18448807913803988,0.021134784420965502,-0.16335329471707438,993208704,924120304.8,62.23628744345361,42.92290176285172,NaN,NaN,0.5048791101288685,-8.920299260667127
2019-09-10T09:30:00-04:00,27.95,28.075,27.7,27.96,77546615,55591322.95,61.534998802362985,49.00575889241876,NaN,NaN,186.52449075111153,162.52215578649657,0.2047973796174018,0.09264342980467788,-0.11215394981272392,1070755319,968574934.8,68.66881410187152,46.085638539300575,NaN,NaN,3.8349159312372754,-7.098125661823641
2019-09-11T09:30:00-04:00,27.98,28.15,27.73,28.12,53285947,54635371.65,63.110054733455144,50.42221330027562,NaN,NaN,165.62412145066867,181.8322989695283,0.21802435101312923,0.1603764889536876,-0.05764786205944161,1124041266,1014897457.6,73.69661858803255,49.062154016848645,NaN,NaN,7.089471156612209,-5.071326116332806
2019-09-12T09:30:00-04:00,28.04,28.38,27.95,28.27,72872161,53675615.15,64.57459401910656,51.774860416684554,NaN,NaN,160.90504490019845,177.52385647277285,0.2249837778137204,0.22358186020770887,-0.0014019176060115143,1196913427,1062065863,77.63265924591438,51.88876758499067,NaN,NaN,10.255207232160654,-2.8818213522623117
2019-09-13T09:30:00-04:00,28.49,28.6,28.36,28.49,56248735,53503704.15,66.66490461654153,53.74836987498179,NaN,NaN,159.90487690906232,176.62918878202726,0.23160445735986557,0.28810365409382044,0.05649919673395488,1253162162,1127616175.6,81.7253221822383,55.0068587169319,NaN,NaN,13.582633277931219,-0.5297564050918075
2019-09-16T09:30:00-04:00,28.25,28.43,28.21,28.39,36693589,52871429.3,64.79340897960542,55.3523090858938,NaN,NaN,122.67107046071014,159.12592089435023,0.21671622389884612,0.32739447660751253,0.11067825270866641,1216468573,1172268149.4,83.88799925086113,58.28720630117939,NaN,NaN,15.873654278810326,1.8135879783227828
2019-09-17T09:30:00-04:00,28.29,28.42,28.19,28.42,41036022,53008290.5,65.10985545560641,57.087698554720816,NaN,NaN,106.33227860463757,143.08747846505543,0.19692944244633573,0.35684005576658606,0.15991061332025033,1257504595,1209618004.6,85.4401431943333,61.716364916787825,NaN,NaN,17.870611473089383,4.107448477575154
2019-09-18T09:30:00-04:00,28.31,28.59,28.23,28.52,57487672,53853314.75,66.20041914026567,58.66869496270765,NaN,NaN,102.92660963530368,130.5479761019824,0.17912799622642359,0.3838206086032798,0.20469261237685624,1314992267,1247808204.8,86.83651508342247,65.26926902792731,NaN,NaN,19.871592430891855,6.359469042334682
2019-09-19T09:30:00-04:00,28.5,28.67,28.375,28.39,43068798,53760613.95,63.424949819933,59.69279222251061,NaN,NaN,95.4778122458627,117.46252957111525,0.1484177692789787,0.3902148239755796,0.2417970546966009,1271923469,1262810213.2,87.34976028910565,68.86992536519823,NaN,NaN,20.897589069273216,8.43634333189733
2019-09-20T09:30:00-04:00,28.29,28.4,28.06,28.08,83159933,55723479.3,57.25999340591915,60.1991167875078,NaN,NaN,63.22542366596596,98.12663892249597,0.09940099589379386,0.3660482995638432,0.26664730367004935,1188763536,1249930488,84.31043470542959,71.76768748433987,NaN,NaN,20.15366431588308,10.11024632960958
2019-09-23T09:30:00-04:00,27.94,28.21,27.89,28.13,35999922,53210365.95,57.96961406397296,60.99472119123926,NaN,NaN,48.492099799419734,83.29084479023791,0.06422737811336571,0.3469315263117565,0.2827041481983908,1224763458,1251589465,84.38579694264601,74.56661551778033,NaN,NaN,19.711001792024284,11.481782824240252
2019-09-24T09:30:00-04:00,28.21,28.27,27.78,27.86,61938301,54595423.1,52.865263331916154,61.18866534784623,NaN,NaN,33.38462853723592,68.70131477675758,0.019006201636969755,0.30646190024460296,0.2874556986076332,1162825157,1232653577.4,79.6811355485813,76.59218154211052,NaN,NaN,17.900247037058268,12.398706283214254
2019-09-25T09:30:00-04:00,27.92,28.14,27.81,28.09,53843910,54575420.15,56.38811016081542,61.190935760448546,NaN,NaN,32.69678033338193,54.65534891637323,0.001723491749587247,0.28961006329461725,0.28788657154503,1216669067,1212988937.4,75.00452203951565,77.86665021652432,NaN,NaN,17.2706027854979,13.094691497826204
2019-09-26T09:30:00-04:00,28.05,28.0835,27.92,27.96,53294733,54646179.05,53.9344245033399,61.02773207908099,NaN,NaN,23.68080675975602,40.29594781915189,-0.02012022748791059,0.26273628718514175,0.28285651467305234,1163374334,1191279110.4,70.1120992372943,78.64057913233569,NaN,NaN,16.04792930382079,13.516582612968287
2019-09-27T09:30:00-04:00,28.19,28.29,27.92,28.07,73400527,55824702.5,55.691352232564675,60.680138804671756,NaN,NaN,33.707984631194684,34.39246001219764,-0.028315517782569743,0.24746211744484015,0.2757776352274099,1236774861,1200881375.4,71.01272815054482,79.26746775427078,NaN,NaN,15.477661163495931,13.796736691615093
2019-09-30T09:30:00-04:00,28.14,28.17,27.984,28,30702989,55331574.95,54.27278621481641,60.16140933413272,NaN,NaN,21.37487332972638,28.96901471825897,-0.03894926926505771,0.22709104864608776,0.26604031791114546,1206071872,1197143058.2,70.1267533884406,79.37160627474,NaN,NaN,14.612906635943418,13.91333239794771
2019-10-01T09:30:00-04:00,28.13,28.15,27.41,27.41,55856502,55124224.65,44.080969944796514,58.802188992085675,NaN,NaN,-79.22364967535796,6.44735907574019,-0.08365037407698478,0.1614773503149145,0.24512772439189928,1150215370,1194621100.8,69.4968175005187,79.07162048277473,NaN,NaN,10.621168565076635,13.443023278966129
2019-10-02T09:30:00-04:00,27.24,27.25,26.79,26.85,79284340,56891117.5,36.982202631656136,56.83130389298207,NaN,NaN,-249.03995013770506,-49.899987018477205,-0.14525574414439563,0.06355804421140476,0.2088137883558004,1070931030,1165473493.4,62.508081490308285,77.99129350023144,NaN,NaN,4.529893785939048,12.169719065676546
2019-10-03T09:30:00-04:00,26.81,26.96,26.45,26.96,81616880,57539824.1,39.05824446747295,54.85939959662003,NaN,NaN,-243.8328607722032,-103.40272052486905,-0.1711380229059664,-0.005108740276657642,0.16602928262930877,1152547910,1163308208.6,62.009212243598206,76.58299993318572,NaN,NaN,0.30504537169724194,10.47476568082236
2019-10-04T09:30:00-04:00,26.99,27.48,26.97,27.46,41513512,57832459.65,47.521144976425724,53.625666453535764,NaN,NaN,-131.4645203071364,-136.43722151253527,-0.14799402122645122,-0.018963243903755256,0.12903077732269597,1194061422,1154765520.8,59.97550395060349,74.87496455459588,NaN,NaN,-0.6266536051010182,8.888848639976164
2019-10-07T09:30:00-04:00,27.35,27.57,27.29,27.32,36987430,56291925.9,45.61120999601013,52.2329060635646,NaN,NaN,-100.52885471592981,-160.81796712166653,-0.13584054010785476,-0.04076989781212248,0.09507064229573228,1157073992,1144965944.8,57.64013827297552,72.88924991735605,NaN,NaN,-1.991432969346182,7.334522695787258
2019-10-08T09:30:00-04:00,27.05,27.06,26.76,26.78,60876208,55458405.55,39.085886319010896,50.296153719189256,NaN,NaN,-156.7329770196875,-176.3198325905324,-0.15643026737643126,-0.1004671919248068,0.05596307545162446,1096197784,1134162427.6,55.093182445116604,70.62186901461992,NaN,NaN,-5.447986080091607,5.508450013518848
2019-10-09T09:30:00-04:00,26.95,27.155,26.925,27.03,45674200,55077818.2,43.14150188672204,48.84733600967419,NaN,NaN,-110.10119319930169,-148.53208120285174,-0.14569096515650323,-0.1261506309940046,0.019540334162498653,1141871984,1148350618.4,57.73454767151613,68.5064966847921,NaN,NaN,-6.9023905536144055,3.735472789642669
2019-10-10T09:30:00-04:00,27.1,27.51,27.1,27.31,55462104,54207315.35,47.36809685973848,48.140771970661284,NaN,NaN,-64.37751539812034,-112.64101212803516,-0.11363161707119714,-0.12249918717649777,-0.008867570105300631,1197334088,1157307854,59.35973838871284,66.7243040907409,NaN,NaN,-6.697481145007337,2.245050798978383
2019-10-11T09:30:00-04:00,27.74,27.99,27.64,27.65,79325703,55361163.75,52.031049789846314,47.71658880822367,NaN,NaN,0.9853902617545063,-86.15103001425697,-0.06580183200790769,-0.09111986011518525,-0.025318028107277554,1276659791,1173827527.8,62.24327384055788,65.14269529773459,NaN,NaN,-4.963972969435745,1.2151902606335077
2019-10-14T09:30:00-04:00,27.56,27.75,27.53,27.69,38557294,55454349,52.56351376131533,47.69503526746647,NaN,NaN,-9.20149671087548,-67.88555841324612,-0.02959008239875606,-0.062305631105722625,-0.032715548706966566,1315217085,1205456146.4,67.06197308119022,64.2413265500638,NaN,NaN,-3.4349137824288825,0.5508896830531663
2019-10-15T09:30:00-04:00,27.85,28.2561,27.74,28.09,66547206,56729908.2,57.62860693868299,47.78364218017129,NaN,NaN,49.8796486368107,-26.563033281946467,0.020483228672505748,-0.00711151286633438,-0.027594741538840128,1381764291,1262569447.8,73.61128237468886,64.1418094311476,NaN,NaN,-0.46096090047413363,0.4063395996921235
2019-10-16T09:30:00-04:00,28.09,28.16,27.95,28.02,44758084,56093428.8,56.49180934975947,47.96631252634412,NaN,NaN,57.61059092709896,6.979323543333654,0.046578784800790904,0.030628739462148502,-0.015950045338642402,1337006207,1301596292.4,76.9796582256599,64.63234935888799,NaN,NaN,1.575570242973386,0.5733725487323038
2019-10-17T09:30:00-04:00,28.17,28.25,27.97,28.04,32164074,55548192.6,56.754294445362795,48.04223697011542,NaN,NaN,70.64916343542635,33.98465931004298,0.06191500375512725,0.06144370935526666,-0.0004712943998605879,1369170281,1335963531,79.46539171896677,65.23611104234672,NaN,NaN,3.292896272917236,0.9618759379015798
2019-10-18T09:30:00-04:00,27.96,28.22,27.9566,28.11,40525653,53416478.6,57.71582743612048,48.288168485922846,NaN,NaN,73.53266925459714,48.49411510861151,0.07275329504555152,0.0904703244070788,0.01771702936152729,1409695934,1362570759.6,81.1614112482568,66.02430088947645,NaN,NaN,4.990192373523934,1.5373497144190589
2019-10-21T09:30:00-04:00,28.35,28.54,28.34,28.5,44952222,53864093.6,62.69279860258271,49.617584818621864,NaN,NaN,126.19738043144572,75.57389053707575,0.10046004422247022,0.14329208463961507,0.04283204041714485,1454648156,1390456973.8,82.7678307879433,66.97223041000677,NaN,NaN,8.018117468724036,2.4631736793197696
2019-10-22T09:30:00-04:00,28.45,28.61,28.33,28.42,50580987,53296227.9,61.10400662003608,51.34057081779186,NaN,NaN,115.15625003993748,88.6292108177011,0.10706391167516152,0.17666193001109676,0.06959801833593524,1404067169,1394917549.4,83.0172923145383,68.43717404030892,NaN,NaN,10.073506856456017,3.5503641331963767
2019-10-23T09:30:00-04:00,28.36,28.54,28.35,28.54,30900020,52149033.4,62.63370349857181,53.02453217715606,NaN,NaN,109.91087351853793,99.0892673359889,0.11261422850163802,0.21036580396298277,0.09775157546134475,1434967189,1414509745.8,84.10567733293752,70.01549297526172,NaN,NaN,12.24429248120055,4.792353897196973
2019-10-24T09:30:00-04:00,28.57,28.62,28.39,28.5,33507175,51159655.5,61.76176938180557,54.04171963468319,NaN,NaN,104.71011377690705,105.90145740428504,0.10674574660966714,0.23118375872342867,0.12443801211376153,1401460014,1420967692.4,84.45922207475132,71.76432998412943,NaN,NaN,13.818849190489319,6.081853224810165
2019-10-25T09:30:00-04:00,28.47,28.73,28.2282,28.64,28330218,48906140.05,63.66817588015265,55.33150291212194,NaN,NaN,101.28188458705381,111.45130047077637,0.10527170275606079,0.25602764055883753,0.15075593780277674,1429790232,1424986552,84.68748840444351,73.69628356494857,NaN,NaN,15.701651775237169,7.456110160585451
2019-10-28T09:30:00-04:00,28.75,28.92,28.7401,28.79,50104567,49876218.95,65.64451605439791,57.22854789322101,NaN,NaN,124.51560290277601,111.11494496504243,0.1070275204783579,0.2845403384007241,0.17751281792236623,1479894799,1430035880.6,84.98587857245195,75.83147614547252,NaN,NaN,17.880520836326784,8.945311685691356
2019-10-29T09:30:00-04:00,28.73,29,28.7,28.86,48458100,49506298.85,66.55873180433014,58.90120717305017,NaN,NaN,113.54738496435779,110.7931719499265,0.10536635952323664,0.309220767326412,0.20385440780317537,1528352899,1454893026.6,86.39174138854787,77.87841855383193,NaN,NaN,19.978310109835135,10.521454317711896
2019-10-30T09:30:00-04:00,28.86,28.9165,28.64,28.84,51106706,48097417.15,66.01818556347033,60.23335636617388,NaN,NaN,99.63735717834554,108.73846868188801,0.0956668423428273,0.3234379607317095,0.2277711183888822,1477246193,1463348827.4,86.84306284831871,79.84151315808948,NaN,NaN,21.609913910413976,12.105519973812193
2019-10-31T09:30:00-04:00,28.74,28.75,28.47,28.7,56795530,46856349.65,62.209565057235096,60.96039317098736,NaN,NaN,76.3102095715102,103.05848784080865,0.07356134018429916,0.31972279361925615,0.246161453434957,1420450663,1467146957.2,87.05080562053409,81.61347971380208,NaN,NaN,22.06977986791518,13.528985672969762
2019-11-01T09:30:00-04:00,28.92,29.15,28.86,29.12,42302273,46895787.7,68.1465567403317,62.07346766948854,NaN,NaN,116.55090832824557,106.112292589047,0.08040904449980035,0.3466727590597074,0.26626371455990705,1462752936,1473739498,87.42204070588001,83.06777025842278,NaN,NaN,24.220762728077393,15.056382395127995
2019-11-04T09:30:00-05:00,29.37,29.42,29.29,29.37,37319056,46912369,71.06092602897334,63.0329190330807,NaN,NaN,141.086720239386,109.426516056369,0.0940128184143913,0.3837797375778962,0.2897669191635049,1500071992,1477774936.6,87.65533713908432,84.07091702730817,NaN,NaN,26.98768603863117,16.760854344199878
2019-11-05T09:30:00-05:00,29.46,29.62,29.41,29.48,39516122,45844364.7,72.26340821485701,64.1594618091591,NaN,NaN,151.70677813338412,117.05839469017425,0.1019892863946294,0.41725352715679165,0.31526424076216225,1539588114,1480021979.6,87.79113054677333,84.84316505024483,NaN,NaN,29.657954205457504,18.603297181522397
2019-11-06T09:30:00-05:00,29.46,29.63,29.42,29.63,40179892,45569649.3,73.85857651735526,65.38119624287285,NaN,NaN,153.0416617085218,127.73925559620952,0.10834078074093079,0.45069021668832576,0.342349435947395,1579768006,1500526342.2,88.982142642714,85.52293297336963,NaN,NaN,32.40491885773301,20.574957420981054
2019-11-07T09:30:00-05:00,29.81,30.03,29.74,29.85,61738567,45883472.45,76.03547578192817,66.68974255328769,NaN,NaN,172.9445449745554,147.06612267681857,0.11756112317831591,0.48930083992028983,0.3717397167419739,1641506573,1544737524.2,91.01699498536976,86.2269032403063,NaN,NaN,35.45449879998288,22.700606189409886
2019-11-08T09:30:00-05:00,29.82,29.85,29.64,29.84,53810453,44607709.95,75.7267871513798,67.62074173534462,NaN,NaN,138.90521823271993,151.53698465771342,0.11315025017594571,0.5131775294619061,0.4000272792859604,1587696120,1569726161,91.92478419178677,86.88097134058083,NaN,NaN,37.849385063560476,24.864717457145684
2019-11-11T09:30:00-05:00,29.66,29.82,29.6217,29.76,19702774,43664983.95,73.1676239144738,68.48242868494731,NaN,NaN,119.11148206795997,147.14193702342823,0.0957016918925439,0.5196543941516403,0.42395270225909637,1567993346,1583310431.8,92.37584347513598,87.5494392806235,NaN,NaN,39.172625633458104,26.908704339476028
2019-11-12T09:30:00-05:00,29.77,29.89,29.69,29.8,44640587,42569653,73.64717005940773,69.26910486786416,NaN,NaN,110.19685153656759,138.8399517040649,0.07843604345835664,0.5219977565820422,0.44356171312368553,1612633933,1597919595.6,92.83909926187494,88.17325513269047,NaN,NaN,40.412763657636965,28.837855670641876
2019-11-13T09:30:00-05:00,29.57,29.71,29.45,29.61,43932498,42528373.7,67.47819490689659,69.67742097679923,NaN,NaN,75.14658296870019,123.2609359561006,0.0473332989080687,0.5027283367587714,0.4553950378507027,1568701435,1595706281.4,91.92776406952507,88.70672241803145,NaN,NaN,39.81440556111806,30.405934226424186
2019-11-14T09:30:00-05:00,29.53,29.67,29.47,29.67,46171953,43228767.65,68.37896784892533,70.01390611742586,NaN,NaN,68.82309581964721,102.43664612511895,0.02503472163714704,0.4866884398971365,0.46165371825998947,1614873388,1590379644.4,89.64701364455173,89.06097422089633,NaN,NaN,39.545171288302285,31.7115395209782
2019-11-15T09:30:00-05:00,29.77,29.8,29.66,29.75,30098954,42707432.7,69.58845857449955,70.29561629743311,NaN,NaN,77.86809749170968,90.22922197691689,0.010642648200796745,0.4749570285109854,0.4643143803101887,1644972342,1601834888.8,90.20957335621696,89.43409527687955,NaN,NaN,39.630663919276174,32.842843006449336
2019-11-18T09:30:00-05:00,29.75,29.82,29.66,29.81,25470007,41733321.95,70.49983317215154,70.5771235379918,NaN,NaN,74.33761653241311,81.27444886980754,0.0006600644404442524,0.465139460860744,0.46447939642029973,1670442349,1622324689.4,91.13723630455674,89.77305919945161,NaN,NaN,39.93992874671634,33.85671239791605
2019-11-19T09:30:00-05:00,29.88,29.97,29.7935,29.87,30772211,40742883.15,71.42213475459573,70.96311990878645,NaN,NaN,83.65930959655633,75.96694048180527,-0.006036937501228357,0.4569332245437643,0.46297016204499264,1701214560,1640040814.8,91.85578091784926,90.13111049013237,NaN,NaN,40.4428967122563,34.79759587139323
2019-11-20T09:30:00-05:00,29.75,29.81,29.52,29.73,46723879,41534076.1,66.21980532099889,71.24956564191244,NaN,NaN,52.10037763684214,71.35769941543367,-0.023073305865017157,0.4341285297137212,0.45720183557873834,1654490681,1657198664,92.49075988978416,90.51967865222164,NaN,NaN,39.498337969487615,35.46913045683528
2019-11-21T09:30:00-05:00,29.79,29.84,29.595,29.7,37192681,41718351.4,65.12511462628694,71.0337483480521,NaN,NaN,51.836983021120105,67.96047685572825,-0.03862458246321848,0.4089211074997152,0.4475456899629337,1617298000,1657683586.4,92.50853738600006,90.8829998436588,NaN,NaN,38.40895799317717,35.889105819169835
2019-11-22T09:30:00-05:00,29.74,29.9478,29.74,29.92,35195027,42061591.85,69.1523886168849,70.89742424718864,NaN,NaN,77.19859188691277,67.82657573476885,-0.036387359506415584,0.40206149057991425,0.43844885008632983,1652493027,1659187723.4,92.5673161025367,91.23385548390539,NaN,NaN,38.49178584269401,36.26091725110186
2019-11-25T09:30:00-05:00,29.96,30.15,29.95,30.11,50100339,42061380.45,72.14417149247527,70.88890733844708,NaN,NaN,115.18266521895225,75.9955854720767,-0.02494952433508102,0.40726194466747856,0.4322114690025596,1702593366,1665617926.8,92.82644158344792,91.5935205579536,NaN,NaN,39.422818113693516,36.71261737432924
2019-11-26T09:30:00-05:00,30.11,30.11,29.9325,30.08,33519997,41314475.3,70.97370669758193,70.68284520846328,NaN,NaN,107.81696522634643,80.82711659803472,-0.022327534920122738,0.4043020503524062,0.4266295852725289,1669073369,1659189688.6,89.46840005394068,91.62825323018407,NaN,NaN,39.86833908367733,37.163434761378966
2019-11-27T09:30:00-05:00,30.16,30.21,30.06,30.2,31017287,40310004.35,72.86977988670388,70.45672407309011,NaN,NaN,136.08392373490585,97.62382581764746,-0.015745057310581678,0.4069482636343018,0.4226933209448835,1700090656,1668309683.6,90.02000963947215,91.55703999119137,NaN,NaN,40.78680161610249,37.68105859776804
2019-11-29T09:30:00-05:00,30.14,30.2365,30.09,30.15,19444153,38442435.5,70.79468661074094,70.1044311773302,NaN,NaN,143.11845081477296,115.88011937637802,-0.01783840345989607,0.4003953166200134,0.41823372007990944,1680646503,1680979384.2,90.74521378365067,91.4727849620388,NaN,NaN,40.9911690205436,38.153931515307406
2019-12-02T09:30:00-05:00,30.2,30.26,29.93,29.96,52431092,38948876.45,63.405671544844,69.40714886521378,NaN,NaN,97.9357282738103,120.02754665375753,-0.034153666803037275,0.37554163657611284,0.4096953033791501,1628215411,1676123861,88.10295709735107,91.16757879219702,NaN,NaN,39.034125138105615,38.27967346142144
2019-12-03T09:30:00-05:00,29.61,29.62,29.35,29.54,67909997,40478423.5,50.78687933136907,67.77427095606816,NaN,NaN,-119.38108045288732,73.11479751938961,-0.07312789881764681,0.31828542985709163,0.39141332867473844,1560305414,1647666270.6,74.42511553133953,89.85229424001592,NaN,NaN,32.90665127802407,37.51209886379324
2019-12-04T09:30:00-05:00,29.57,29.9,29.55,29.82,41793964,40592315.6,56.939525226596494,67.02150883604673,NaN,NaN,-25.00265083233603,46.550874307653125,-0.07942220182827198,0.29213557638939847,0.37155777821767044,1602099378,1634271472.4,68.99548254940143,88.21427413143567,NaN,NaN,29.653254184613974,36.389406766767635
2019-12-05T09:30:00-05:00,29.94,30.01,29.83,29.96,44969722,40831807.1,59.65546665525693,66.39840160792755,NaN,NaN,43.39872717516855,28.01383499570566,-0.07365685436101865,0.27948671026639715,0.3531435646274158,1647069100,1623667161.2,64.95533911523168,86.45058309362709,NaN,NaN,27.91355678409352,35.17857105495705
2019-12-06T09:30:00-05:00,30.29,30.46,30.28,30.36,40811264,39785441.95,66.21258713745117,66.15726793385268,NaN,NaN,188.78962812852265,37.14807045845563,-0.04387450918657099,0.2983004281442021,0.3421749373307731,1687880364,1625113933.4,65.25427624754637,84.6680618715792,NaN,NaN,28.714528562974667,34.25513641324528
2019-12-09T09:30:00-05:00,30.3,30.42,30.28,30.29,22101506,38199994.6,64.24475136191495,65.71047637597863,NaN,NaN,146.81081200404807,46.92308720450319,-0.030494317995821585,0.3040570398359961,0.33455135783181766,1665778858,1632626622.8,66.83625807846812,82.93227771257287,NaN,NaN,28.668861826127955,33.45709718651423
2019-12-10T09:30:00-05:00,30.21,30.36,30.13,30.3,37369837,39083347.75,64.40749107288788,65.20943039871378,NaN,NaN,108.50863937829882,92.5010311707404,-0.022921175066972554,0.30589988899810194,0.3288210640650745,1703148695,1661195279,72.04809281896115,81.51744284836657,NaN,NaN,28.684710694043293,32.775327687589815
2019-12-11T09:30:00-05:00,30.29,30.34,30.2,30.23,24491884,38075912.6,62.27089907516683,64.92736566686862,NaN,NaN,94.23713177401599,116.34898769201081,-0.024437945264776217,0.2982736324841042,0.32271157774888043,1678656811,1676506765.6,74.3726637670371,80.22329312531319,NaN,NaN,28.0487558397111,32.10010313789286
2019-12-12T09:30:00-05:00,30.27,30.91,30.25,30.82,68434041,39300989.75,71.00235396709272,65.34716847692621,NaN,NaN,181.97479077156567,144.06420041129024,0.01060277183083208,0.33596504253742054,0.32536227070658846,1747090852,1696511116,77.05720159072698,79.11962628279369,NaN,NaN,30.527898626508154,31.87550249340933
2019-12-13T09:30:00-05:00,30.79,30.97,30.53,30.71,48138027,39399293.45,67.84965045868603,65.25411575134058,NaN,NaN,178.0392966075084,141.9141341070874,0.022023590899453493,0.35289175933090533,0.33086816843145184,1698952825,1698725608.2,77.34018231698997,78.03197386954037,NaN,NaN,31.41257656548676,31.80937021799182
2019-12-16T09:30:00-05:00,30.96,31.02,30.79,30.82,45917698,40190230.65,69.31686878670675,65.0521655580714,NaN,NaN,179.32158836009924,148.41628937829762,0.03203090709194695,0.3709068022963855,0.33887589520443856,1744870523,1714543941.2,79.30386354787183,77.06607543842779,NaN,NaN,32.60367683593791,31.922842591984118
2019-12-17T09:30:00-05:00,30.84,31.04,30.83,30.94,30916898,40462575.2,70.8782186362093,65.04534498225907,NaN,NaN,164.98151911066392,159.71086532477065,0.04119283873639845,0.3903669436249366,0.3491741048885382,1775787421,1729071686.4,80.93771205984942,76.45674058170698,NaN,NaN,34.07537460813905,32.23034716572054
2019-12-18T09:30:00-05:00,31.04,31.04,30.81,30.81,39089750,40878452.15,66.90617906391986,64.61937349491734,NaN,NaN,132.16176274063199,167.29579151809384,0.03329631336143157,0.3907944965903276,0.35749818322889604,1736697671,1740679858.4,82.15027513180044,75.89461668830185,NaN,NaN,34.057087233667865,32.491310032570155
2019-12-19T09:30:00-05:00,30.82,30.89,30.77,30.8,36947081,40389612.25,66.5970094304681,64.31953941061214,NaN,NaN,106.13517186806918,152.12786773739455,0.022704057137285794,0.3858782546505033,0.3631741975132175,1699750590,1731211806,77.80309451147262,74.970179597432,NaN,NaN,33.951582742143636,32.69992041965208
2019-12-20T09:30:00-05:00,30.8,30.88,30.64,30.68,97417028,43400829.6,62.844157412180024,64.279431258279,NaN,NaN,79.49111726089316,132.4182318680715,0.0039057424572829236,0.3680563755848212,0.36415063312753826,1602333562,1711887953.4,69.69668512922806,73.65544588542322,NaN,NaN,32.76562128442977,32.709306257477465
2019-12-23T09:30:00-05:00,30.76,30.77,30.57,30.61,38323202,43557238.35,60.69551191147242,64.98719072828638,NaN,NaN,56.451860878753514,107.84428637180238,-0.015868550753039223,0.34431494468623924,0.36018349543927847,1564010360,1675715920.8,57.598811018677274,72.45356699166163,NaN,NaN,31.1596643865232,32.48792884734114
2019-12-24T09:30:00-05:00,30.67,30.69,30.6,30.68,12315909,41668016.85,62.09131223669451,65.35517551472195,NaN,NaN,51.65864369157725,85.17971128798503,-0.02624732670124552,0.32737433706272157,0.3536216637639671,1576326269,1635823690.4,47.75401131872307,70.93631904661318,NaN,NaN,30.18930245444921,32.15955364835658
2019-12-26T09:30:00-05:00,30.71,30.85,30.71,30.85,15903421,40787188.05,65.31300005698611,65.75928504341691,NaN,NaN,71.88456980139624,73.12427270013787,-0.0237515125170491,0.3239322731176557,0.3476837856347048,1592229690,1606930094.2,42.13643343431195,69.30639721226177,NaN,NaN,30.24748394666601,31.886400833829352
2019-12-27T09:30:00-05:00,30.9,30.91,30.75,30.77,19423051,40207476.25,62.61614991969459,65.50239667072002,NaN,NaN,66.46647880292778,65.19053408710957,-0.029217270816747742,0.31116219711377013,0.3403794679305179,1572806639,1581541304,37.91573944700577,67.35364458365173,NaN,NaN,29.537268915977144,31.550810559850465
2019-12-30T09:30:00-05:00,30.91,30.96,30.65,30.68,18825595,40176548.35,59.632960977423465,65.17298307182776,NaN,NaN,52.7702789561734,59.846366426165616,-0.03995824899419348,0.29043165668777604,0.3303899056819695,1553981044,1571870800.4,36.41933208159246,65.18100701244633,NaN,NaN,28.094447356144347,31.057044387892446
2019-12-31T09:30:00-05:00,30.66,30.79,30.62,30.78,15788138,38344400.65,61.81009493944041,64.98745477658152,NaN,NaN,42.251117709303294,57.00621779227557,-0.041226143910794266,0.2788572257934767,0.320083369704271,1569769182,1573022564.8,36.73956188261765,62.658969088421784,NaN,NaN,27.454002103918786,30.542324061610493
2020-01-02T09:30:00-05:00,30.89,31.08,30.8,31.08,28823589,36390080.25,67.47709843905449,65.35932615971635,NaN,NaN,96.71268084401382,66.0170252227629,-0.02363253313229724,0.2905427032888994,0.31417523642119666,1598592771,1577475865.2,38.03900732697485,60.063707914131626,NaN,NaN,28.57871741204216,30.261808825957875
2020-01-03T09:30:00-05:00,30.68,30.88,30.59,30.75,51384939,36869629,57.388968064672035,64.38694145240058,NaN,NaN,29.736211031189164,57.58735346872148,-0.03529044702302192,0.27006217764241924,0.30535262466544116,1547207832,1568471493.6,36.410432224074505,57.16036724508502,NaN,NaN,26.29796875394877,29.695545958528
2020-01-06T09:30:00-05:00,30.47,30.75,30.46,30.73,27956661,36018975.95,56.83438552161227,63.60013681403818,NaN,NaN,-14.711892112764454,41.35167928558304,-0.04480761291950369,0.24934310851606156,0.29415072143556525,1519251171,1557760400,34.51730176167443,54.10159006256248,NaN,NaN,24.32669045151786,28.928566600383697
2020-01-07T09:30:00-05:00,30.66,30.71,30.53,30.53,39654652,35961145.35,51.47719226249166,62.32587420516567,NaN,NaN,-46.23033541106778,21.551556412134808,-0.06386914775739683,0.21431428673881925,0.2781834344962161,1479596519,1542883495,32.02656128399991,50.72463990085735,NaN,NaN,20.927099463900717,27.785499866600414
2020-01-08T09:30:00-05:00,30.56,30.9,30.56,30.73,47982982,37255219.15,55.94884554787215,61.259490413141584,NaN,NaN,8.463115648067859,14.793955999887718,-0.06224103475451476,0.20038214105307262,0.2626231758075874,1527579501,1534445558.8,30.67455639780742,47.13441449642577,NaN,NaN,19.432069185069132,26.592152626381658
2020-01-09T09:30:00-05:00,30.95,30.975,30.83,30.92,27705899,36772022.25,59.744252778573404,60.74792424990255,NaN,NaN,100.44107405405346,15.53963464189565,-0.048226716413964754,0.20233978029013144,0.2505664967040962,1555285400,1525784084.6,29.306896709391538,43.35988746625371,NaN,NaN,19.3862777349296,25.562741927602794
2020-01-10T09:30:00-05:00,30.94,30.95,30.65,30.69,33460368,37220446.45,53.711353169804205,59.8275202312837,NaN,NaN,-6.288085051173051,8.334775425423212,-0.05387711861486122,0.18322009843551967,0.2370972170503809,1521825032,1520707524.6,28.504704051838857,39.838573861994156,NaN,NaN,17.368079021681748,24.392075798185502
2020-01-13T09:30:00-05:00,30.76,30.93,30.68,30.9,27553174,35176403.1,57.89223854302763,59.47381174062996,NaN,NaN,44.62902534695627,20.20295891736735,-0.0433542143306605,0.18290444913705528,0.22625866346771578,1549378206,1526732931.6,30.92157157022612,37.06892289349402,NaN,NaN,17.0483455832922,23.342971481772175
2020-01-14T09:30:00-05:00,30.9,31.08,30.8,30.84,37576195,34648311.5,56.32683692483377,59.161763527298625,NaN,NaN,88.90983349046088,47.23099269767308,-0.040377779108119544,0.17578643958256635,0.2161642186906859,1511802011,1533174030,33.50916129270033,35.348233627352805,NaN,NaN,16.30178885586333,22.337088249499484
2020-01-15T09:30:00-05:00,30.69,30.79,30.57,30.67,41457270,34425290.1,52.03372046887531,58.443364115311546,NaN,NaN,-76.79047171285768,30.180275225487975,-0.04921526804048984,0.1546451336400736,0.20386040168056344,1470344741,1521727078,31.267544570551124,34.170628859626234,NaN,NaN,14.319896316110201,21.19177511615816
2020-01-16T09:30:00-05:00,30.82,30.94,30.7542,30.94,34444000,34601645.2,57.56562460845999,57.889980154702535,NaN,NaN,79.8159814108442,26.055256696846122,-0.036802276355460795,0.15785755623623743,0.19465983259169822,1504788741,1511627746.2,29.398941912857936,33.26080803666524,NaN,NaN,14.391362954644283,20.220287664513318
2020-01-17T09:30:00-05:00,31.03,31.1,30.9106,31.03,38819425,34588128.95,59.25257461968413,57.649724776130356,NaN,NaN,166.9703650515203,60.70694671738479,-0.02312390430032124,0.16575495221629666,0.1888788565166179,1543608166,1515984373,31.306087462946238,32.78869003780384,NaN,NaN,14.982639701247603,19.472052241189644
2020-01-21T09:30:00-05:00,30.88,31.02,30.77,30.77,41276452,34804597.5,52.730820108925315,57.156714714094775,NaN,NaN,49.1817005674338,61.617481761480306,-0.031652937490055016,0.14931268465404912,0.18096562214410414,1502331714,1506575074.6,29.455415888407785,32.29126745257636,NaN,NaN,13.386915469014005,18.602746988021696
2020-01-22T09:30:00-05:00,30.87,30.94,30.815,30.86,27391018,31303297,54.593874406255075,56.641270390295816,NaN,NaN,56.14765473220901,55.06504600982993,-0.03124571026152434,0.1419084843171987,0.17315419457872305,1529722732,1510159218.8,31.125626120454854,31.890272040993306,NaN,NaN,12.67613047466404,17.756087486113458
2020-01-23T09:30:00-05:00,30.7,30.85,30.49,30.78,43072312,31540752.5,52.60897084121552,55.579261276164466,NaN,NaN,-62.13865255828624,57.995409840744216,-0.03603654320614985,0.12810851557103575,0.1641450587771856,1486650420,1513420354.6,32.68723751714167,31.50800276886236,NaN,NaN,11.494258265495683,16.861540454596632
2020-01-24T09:30:00-05:00,30.79,30.79,30.1962,30.39,58924941,33871204.1,44.17664257177681,54.63552374095766,NaN,NaN,-210.031347962349,0.0259439661055751,-0.06353561739677951,0.08472553703121122,0.14826115442799073,1427725479,1498007702.2,29.305376227825178,31.000498769130267,NaN,NaN,7.619279060012804,15.541217398227515
2020-01-27T09:30:00-05:00,29.79,30.06,29.75,29.92,50289300,35590498.05,36.569455048654405,53.188028707174965,NaN,NaN,-377.6669248173435,-108.90151400766717,-0.10878683294096067,0.012277613251789887,0.12106444619275056,1377436179,1464773304.8,23.6285062524899,30.222727661331373,NaN,NaN,1.360267548623364,13.515367419712636
2020-01-28T09:30:00-05:00,30.08,30.4,30.03,30.27,34257892,36332240.1,44.26616643956261,52.67295543410861,NaN,NaN,-181.73849246802257,-155.08555261475846,-0.11021417174843273,-0.016703268492790357,0.09351090325564237,1411694071,1446645776.2,21.21454227302877,29.45044058911915,NaN,NaN,-1.0818052525924695,11.430057037954764
2020-01-29T09:30:00-05:00,30.37,30.475,30.1701,30.22,41168268,37449373.75,43.4549574923961,51.78053485871745,NaN,NaN,-132.6046879480345,-192.83602115080717,-0.1093745953036783,-0.0432073408739555,0.0661672544297228,1370525803,1414806390.4,17.778885193998278,28.529321217418495,NaN,NaN,-3.2180914777325027,9.337464392856583
2020-01-30T09:30:00-05:00,29.95,30.62,29.93,30.6,51209980,39220465.85,50.82992285200832,51.14379700681995,NaN,NaN,-87.66121637533801,-197.94053391421753,-0.07946729001234096,-0.03316685808570341,0.04630043192663755,1421735783,1401823463,16.598464820940535,27.621576082529142,NaN,NaN,-2.4557808734792554,7.652715069094321
2020-01-31T09:30:00-05:00,30.34,30.3843,29.85,29.96,58958779,40727225.35,41.105814875009514,50.24340141433462,NaN,NaN,-152.9940226432217,-186.53306885039206,-0.09782158084380688,-0.07597654412812105,0.02184503671568583,1362777004,1388833768,15.49030321655708,26.69197602286616,NaN,NaN,-5.498330432050705,5.77399428321646
2020-02-03T09:30:00-05:00,30.17,30.47,30.1493,30.17,40168745,40166415.65,44.83503221643553,49.310743819578036,NaN,NaN,-86.11467721034364,-128.2226193289921,-0.09099517347311262,-0.09189893012570494,-0.000903756652592326,1402945749,1393935682,17.811256403770756,25.75552493954792,NaN,NaN,-6.476783298467162,4.0238832001188
2020-02-04T09:30:00-05:00,30.58,30.75,30.45,30.46,79273314,42732248.3,49.58277919893135,48.82902541058501,NaN,NaN,-10.532041444977,-93.98132912438297,-0.06343103434278269,-0.0801925495810707,-0.016761515238288,1482219063,1408040680.4,24.02370144845834,25.077992093530636,NaN,NaN,-5.538865068395818,2.6577763046167124
2020-02-05T09:30:00-05:00,30.87,31.1,30.8,31.07,51086871,43303859.25,57.808368749427444,49.2415002877673,NaN,NaN,90.66905872042219,-49.32657979069164,-0.003747619843231801,-0.021446040042327752,-0.01769842019909595,1533305934,1440596706.6,36.04072196784447,25.41893333619445,NaN,NaN,-1.5544310260453222,2.056032400236422
2020-02-06T09:30:00-05:00,31.24,31.27,30.965,31.03,37044389,42756929.6,57.14992506287461,49.21180746308264,NaN,NaN,104.6534404226131,-10.86364843110141,0.0314658910959535,0.021633943670845923,-0.009831947425107575,1496261545,1455501859,40.667721076325726,26.223846133585006,NaN,NaN,1.1770991380123577,1.930470505632984
2020-02-07T09:30:00-05:00,30.86,31.01,30.79,30.92,27982485,42770758.9,55.28503643492491,48.92841187845698,NaN,NaN,62.98678985220595,32.33251406798413,0.04495723651537147,0.04636459821910677,0.001407361703735295,1468279060,1476602270.2,46.56144453348811,27.313514495766572,NaN,NaN,2.70182722760451,2.040664323057488
2020-02-10T09:30:00-05:00,30.82,31.01,30.8101,31.01,17723704,41983925.7,56.53475962507218,49.20012184389604,NaN,NaN,67.66797132004116,63.08904377406109,0.05678737692259869,0.07239158285698366,0.01560420593438497,1486002764,1493213673.2,50.71229774805146,28.831863200026834,NaN,NaN,4.311036913937234,2.365003264611737
2020-02-11T09:30:00-05:00,31.09,31.26,31.09,31.12,27997359,42006134.95,58.07698661198993,49.448915572877105,NaN,NaN,107.25713545169228,86.64687915339495,0.06810307405999,0.10073304850937248,0.032629974449382475,1514000123,1499569885.2,52.24097178630498,30.340102176158982,NaN,NaN,6.093746646866749,2.8976808906481675
2020-02-12T09:30:00-05:00,31.28,31.38,31.1,31.14,26964157,41475533.05,58.366236948428515,49.86014886624946,NaN,NaN,110.50264949647611,90.61359730860573,0.07260433015481671,0.12338538714290337,0.05078105698808665,1540964280,1501101554.4,52.62230230050137,31.764035374970394,NaN,NaN,7.614621309404644,3.571529521899093
2020-02-13T09:30:00-05:00,31.04,31.2,30.9534,31.13,22758975,40540618.3,58.150200373034394,50.858260137767864,NaN,NaN,78.88943721463633,85.46079666701038,0.07051845347006297,0.13892912382566536,0.06841067035560239,1518205305,1505490306.4,53.76152933780842,33.51090345425491,NaN,NaN,8.800999286166828,4.318596631080197
2020-02-14T09:30:00-05:00,31.1,31.19,31.015,31.17,22080227,39922429.65,58.807001175176126,52.44665628966227,NaN,NaN,80.13092997857984,88.88962469228515,0.06744339204660847,0.15271491041386298,0.08527151836725451,1540285532,1519891600.8,57.38284172369387,35.92192741648376,NaN,NaN,9.97084270551659,5.126060355999682
2020-02-18T09:30:00-05:00,31.08,31.16,30.72,30.9,37795921,39871254.45,52.78501944468877,53.055145790028426,NaN,NaN,43.503150831472844,84.0566605945715,0.0439723356773975,0.14023693796400138,0.09626460228660388,1502489611,1523188970.2,58.19024573332509,38.56304909221922,NaN,NaN,9.37434435015124,5.7329580694499045
2020-02-19T09:30:00-05:00,31.01,31.21,30.97,31.13,25643251,39089594.4,56.839588761393124,54.01119088067107,NaN,NaN,72.92223294275671,77.18968009278437,0.040756466432363275,0.14721018532705799,0.10645371889469471,1528132862,1526015518,58.908912340134705,41.5009081740861,NaN,NaN,9.99840030659448,6.342306960470558
2020-02-20T09:30:00-05:00,31.02,31.28,30.86,31.07,50344301,40237258.55,55.50061879024479,54.34481201911654,NaN,NaN,63.242579003021646,67.73766599409348,0.03180472251006303,0.1462096220322735,0.11440489952221047,1477788561,1513380374.2,54.40684553338083,44.20150679640327,NaN,NaN,10.149577232144875,6.886202713566889
2020-02-21T09:30:00-05:00,30.92,30.99,30.6,30.77,51128175,40640051.7,49.25309237679842,54.92676041210145,NaN,NaN,10.733623919481394,54.1065033350625,0.004338379958604907,0.11982787447046661,0.1154894945118617,1426660386,1495071390.4,48.609599778805006,46.56717083656383,NaN,NaN,8.464018993067954,7.111605039209898
2020-02-24T09:30:00-05:00,29.8,30.06,29.63,29.77,70455449,41216577.1,35.07840376716102,54.22985838001042,NaN,NaN,-144.1702927242172,9.246258794503081,-0.07797497598155788,0.018020774534914352,0.09599575051647223,1356204937,1458255271.4,39.496174354528584,48.11609354733225,NaN,NaN,1.4385817572416262,6.30117314178586
2020-02-25T09:30:00-05:00,29.78,29.84,28.62,28.76,111826875,44293455.85,26.71561309154987,52.59648937234032,NaN,NaN,-231.50956947492398,-45.75628526677628,-0.19081083111098268,-0.14251778837225615,0.048293042738726547,1244378062,1406632961.6,30.781776396526837,48.59881318648,NaN,NaN,-8.62733302320318,4.1685294039302825
2020-02-26T09:30:00-05:00,28.95,29.215,28.55,28.55,95015741,47331348.3,25.36175450908854,50.27887406945897,NaN,NaN,-222.17992063948975,-104.77671598322559,-0.2653735278995747,-0.28342386713574186,-0.01805033923616714,1149362321,1330878853.4,22.823513259876947,47.6547268501966,NaN,NaN,-16.606812879474187,1.2006233634439298
2020-02-27T09:30:00-05:00,27.94,28.39,27.31,27.33,143536169,52449743.35,19.256425737159503,47.5721955461936,NaN,NaN,-260.47920148893024,-169.52107208161596,-0.37588965124596263,-0.4879124032936204,-0.1120227520476578,1005826152,1236486371.6,16.944853426806205,45.96023630380235,NaN,NaN,-26.543957763738025,-2.762888226153492
2020-02-28T09:30:00-05:00,26.4,26.85,25.97,26.59,192064175,59492453.1,16.63983734523545,44.81182418264435,NaN,NaN,-261.43215416512857,-223.95422769853795,-0.4716580408377778,-0.70159530309488,-0.22993726225710226,813761977,1113906689.8,12.457483124662915,43.524239060314834,NaN,NaN,-35.407990480970994,-7.426474262555992
2020-03-02T09:30:00-05:00,26.64,27.95,26.36,27.95,127115541,62900291.2,34.30712474206396,43.224135976715196,NaN,NaN,-156.62609634441336,-226.44538842257717,-0.4180704012923688,-0.7525252638725632,-0.33445486258019447,940877518,1030841206,10.43987746777212,40.647637611723454,NaN,NaN,-34.610495479067744,-11.309905864914814
2020-03-03T09:30:00-05:00,27.86,28.25,26.625,26.9,256525000,73718103.95,29.167357226417977,41.15916244917434,NaN,NaN,-135.87911341660035,-207.31929721091245,-0.42652615159428847,-0.8676125520730551,-0.4410864004787666,684352518,918836097.2,8.452082363703155,37.51985979582332,NaN,NaN,-36.3472771160653,-14.88667318650774
2020-03-04T09:30:00-05:00,27.26,27.8,26.8,27.79,124407986,75974837.55,37.688757327622874,39.682199619116794,NaN,NaN,-107.57567189813733,-184.39844746264197,-0.34864782508589676,-0.8768961818361376,-0.5282483567502408,808760504,850715733.8,7.51490168647247,34.29790260910698,NaN,NaN,-33.83687656782835,-17.59384509812497
2020-03-05T09:30:00-05:00,26.87,26.94,26.15,26.45,130265661,79933777.05,31.537021699106617,37.78125828526481,NaN,NaN,-127.52763092344681,-157.80813334954527,-0.36225823376103583,-0.9810711489515356,-0.6188129151904997,678494843,785249472,6.741282227807218,30.93931352982118,NaN,NaN,-34.61200616265251,-20.025010964486047
2020-03-06T09:30:00-05:00,25.25,25.84,25.03,25.55,160607013,86111908.25,28.206876041144824,35.595535061405435,NaN,NaN,-144.6456267377,-134.45082786405956,-0.40359309723316394,-1.1233042867319547,-0.7197111894987908,517887830,726074642.6,6.1272722685429954,27.278201425881832,NaN,NaN,-36.623071815360916,-22.396162514611028
2020-03-09T09:30:00-04:00,23,23.88,22.52,22.81,134165747,91421071.35,20.952858895472232,33.32180930788997,NaN,NaN,-193.35961354348998,-141.7975313038749,-0.5766429011316869,-1.4405148159133994,-0.8638719147817124,383722083,614643555.6,5.17196604545191,23.491181448176604,NaN,NaN,-41.876055752444465,-25.17900440573009
2020-03-10T09:30:00-04:00,23.87,24.17,22.84,24.15,149282272,97998999.75,30.382227824836292,31.431997812421628,NaN,NaN,-146.83431759385948,-143.98857213932672,-0.5614871670848252,-1.5657308736377438,-1.0042437065529186,533004355,584373923,4.9463620456560164,19.636713569999557,NaN,NaN,-41.33339605688161,-27.48677464160888
2020-03-11T09:30:00-04:00,23.41,23.65,22.52,22.84,146956334,103946948.5,26.992320237128638,29.395690772913333,NaN,NaN,-146.35207487140548,-151.74385273398033,-0.5969994029092116,-1.7504929601894332,-1.1534935572802216,386048021,499831426.4,4.372656445598139,16.062842920872217,NaN,NaN,-42.42576080372384,-29.620915521911016
2020-03-12T09:30:00-04:00,20.94,22.21,20.3,20.37,161437526,110670616.95,22.006566040733063,27.449510320337243,NaN,NaN,-177.79078979703743,-161.79648450869848,-0.7350755381927994,-2.0723379800212207,-1.3372624418284214,224610495,409054556.8,3.8555558862628345,12.86612549997635,NaN,NaN,-45.581377653204214,-31.900981540667185
2020-03-13T09:30:00-04:00,21.9,23.09,20.9,23.05,160945700,117579953.2,35.8517303973577,27.504747936779857,NaN,NaN,-124.20494850282843,-157.70834886172415,-0.5998622049899214,-2.087090198065823,-1.4872279930759018,385556195,382588229.8,3.7175218045073137,10.31050746068912,NaN,NaN,-41.59540169013925,-33.28589870487748
2020-03-16T09:30:00-04:00,19.35,21.34,18.93,19.89,110661583,122009021,29.256878666027276,27.686266906385384,NaN,NaN,-155.75470621341992,-150.18736739571017,-0.6717723831828262,-2.3269434720544346,-1.6551710888716085,274894612,360822735.6,3.6032718849721874,8.369185709863784,NaN,NaN,-41.601204579063165,-34.47379954404686
2020-03-17T09:30:00-04:00,20.35,21.19,19.54,20.97,122295136,126233981.75,33.74277770790572,28.284911420586614,NaN,NaN,-124.25379244636784,-145.67126236621183,-0.597615915568829,-2.4021909833326447,-1.8045750677638157,397189748,333659814.2,3.460344848881249,6.986102251935525,NaN,NaN,-39.65033141982405,-35.21330409772932
2020-03-18T09:30:00-04:00,19.65,20.05,18.28,19.19,145056421,132204640.25,30.32921858887792,29.075825195709353,NaN,NaN,-134.8683454978792,-143.37451649150657,-0.6169515396759793,-2.5757644923587897,-1.9588129526828104,252133327,306876875.4,3.3204873924068465,6.012933249478428,NaN,NaN,-39.604634556196224,-35.84063702036745
2020-03-19T09:30:00-04:00,18.79,19.89,18.11,19.61,105652811,134970065.75,32.075314932132,30.178359309059108,NaN,NaN,-118.15784009376428,-131.44792655085195,-0.5520675725105937,-2.6488974183210523,-2.0968298458104586,357786138,333512004,7.331726654600089,5.646807787331085,NaN,NaN,-38.90704398867226,-36.27869515869671
2020-03-20T09:30:00-04:00,19.82,19.92,18.67,18.91,157840916,140305702.8,30.694572889799332,29.920319891040208,NaN,NaN,-107.06591764160055,-128.02012037860635,-0.5080152317209263,-2.7318488854616163,-2.22383365374069,199945222,296389809.4,6.901915873308937,5.394096244869426,NaN,NaN,-38.867360962916145,-36.64850455929949
2020-03-23T09:30:00-04:00,18.44,18.6,17.49,17.66,144547917,144010326.2,28.34786700366638,29.86178487512938,NaN,NaN,-120.95203626148148,-121.05958638821869,-0.5132708928908363,-2.8654222698542355,-2.3521513769633993,55397305,252490348,6.422425032351924,5.249120721201483,NaN,NaN,-39.65374454707442,-37.07782455755305
2020-03-24T09:30:00-04:00,18.71,19.96,18.575,19.85,158551111,146346538,37.38070146999005,29.839780885298467,NaN,NaN,-81.66458824566018,-112.54174554807715,-0.32845373226948515,-2.762718542300256,-2.4342648100307707,213948416,215842081.6,6.044873040791558,5.144118675081415,NaN,NaN,-37.08131402052629,-37.078323052263514
2020-03-25T09:30:00-04:00,20.14,21.23,19.3874,20.39,162949598,149743230.85,39.40902485867854,30.40206682526789,NaN,NaN,-57.21565000080984,-97.01120644866327,-0.13874156303144058,-2.607691763820071,-2.4689502007886306,376898014,240795019,9.927475983914434,5.371703943374789,NaN,NaN,-34.404933609231215,-36.69641027468747
2020-03-26T09:30:00-04:00,20.66,21.82,20.625,21.67,129753949,149054119.85,44.03640814945083,31.53274769014689,NaN,NaN,-28.53798262502808,-79.08723495491604,0.09163496869127297,-2.354406489924539,-2.446041458615812,506651963,270568184,14.469123538290205,5.967550462642445,NaN,NaN,-30.658422547679514,-35.833840599400624
2020-03-27T09:30:00-04:00,20.79,21.67,20.55,21.01,109305622,144916192.2,42.24489335330697,33.053607294277946,NaN,NaN,-31.071992002784178,-63.88844982715277,0.21140729411192405,-2.181782340975907,-2.3931896350878312,397346341,310048407.8,20.214078721044544,7.0419870823276325,NaN,NaN,-28.224821725410127,-34.746837903116266
2020-03-30T09:30:00-04:00,21.04,21.525,20.6,21.41,67297220,141925276.15,43.73878251428048,34.00764691495253,NaN,NaN,-22.698271472812745,-44.237696869419025,0.32274126622920285,-1.9897630523013277,-2.3125043185305305,464643561,391897659,30.618693060584405,8.875725011965374,NaN,NaN,-25.814218968292618,-33.47074948385574
2020-03-31T09:30:00-04:00,21.21,21.45,20.635,20.82,83819894,133290020.85,42.012609407247425,35.08052471281816,NaN,NaN,-22.72315434482493,-32.44941008925197,0.3590348513758741,-1.863710754310688,-2.222745605686562,380823667,425272709.2,34.37663543858763,11.01886636860748,NaN,NaN,-24.331164611632808,-32.16509450210961
2020-04-01T09:30:00-04:00,19.72,19.94,19.37,19.55,79185017,131028872.4,38.491207580627815,36.25799910852492,NaN,NaN,-65.48373308167108,-34.10302670542421,0.3021776815899728,-1.845023503699096,-2.147201185289069,301638650,410220836.4,33.495490645381494,13.136004565687387,NaN,NaN,-24.101185801053127,-31.013107544815828
2020-04-02T09:30:00-04:00,19.43,20.2,19.365,20.04,68398263,127935502.5,40.561265631376536,36.59439448238341,NaN,NaN,-50.75668564175277,-38.54676730876914,0.3015463342930236,-1.7702682674227894,-2.071814601715813,370036913,382897826.4,31.89718808586572,15.1488378714987,NaN,NaN,-23.31029212298832,-29.912705341697613
2020-04-03T09:30:00-04:00,19.85,20.14,19.355,19.64,68418105,123326057.1,39.395684341388865,37.31859488776638,NaN,NaN,-51.72436081111161,-42.67724107043463,0.27870433363539027,-1.723434184671575,-2.0021385183069653,301618808,363752319.8,30.788562078730422,17.09064431391,NaN,NaN,-22.981388104719123,-28.9225171649864
2020-04-06T09:30:00-04:00,20.62,21.2176,20.4716,21.05,69015063,120068522.9,45.356595190603244,38.14815327938764,NaN,NaN,23.604777885151215,-33.41663119884184,0.3580132891197547,-1.554621906907272,-1.9126351960270267,370633871,344950381.8,29.696958205279955,18.96468812508134,NaN,NaN,-20.948134589363622,-27.783319654183146
2020-04-07T09:30:00-04:00,22.2,22.22,21.25,21.26,70950941,116151956.35,46.205255304410485,39.282155901925684,NaN,NaN,79.04172050677049,-13.063656228522749,0.4197937971369705,-1.3878929496058134,-1.807686746742784,441584812,357102610.8,31.39012712647194,20.969662391800277,NaN,NaN,-19.04037389361207,-26.534327402672993
2020-04-08T09:30:00-04:00,21.58,22.33,21.34,22.19,80003402,112804309.75,49.91506387677038,40.556423683685566,NaN,NaN,114.6501261432349,22.963115616458445,0.5123411005160126,-1.1672603710977683,-1.6796014716137808,521588214,401092523.6,37.27886125146254,23.108743434433308,NaN,NaN,-16.32713657385787,-25.07615728427083
2020-04-09T09:30:00-04:00,22.77,23.655,22.73,23.38,147892930,112127079.95,54.261581910903985,42.23978147090732,NaN,NaN,178.4044273501016,68.79533821482933,0.6347458161942412,-0.8861692013709792,-1.5209150175652204,669481144,460981369.8,44.289389992573604,25.779277300095067,NaN,NaN,-12.666993234516468,-23.30341956287735
2020-04-13T09:30:00-04:00,23.31,23.33,22.325,22.53,66236307,107391610.3,50.86596786090873,43.84821724642463,NaN,NaN,140.6501159226893,107.27023356158949,0.6378131737083303,-0.7236485504298074,-1.3614617241381377,603244837,521306575.6,50.313746192345775,28.91437166866606,NaN,NaN,-10.509891053012211,-21.475772632896618
2020-04-14T09:30:00-04:00,23.07,23.135,22.21,22.63,96168982,106666980.25,51.25246323851594,44.83905737274791,NaN,NaN,119.06636769717429,126.36255152399413,0.6250944665120581,-0.580093640998065,-1.2051881075101232,699413819,587062565.2,55.910418673035736,32.4761963566835,NaN,NaN,-8.636745076701018,-19.64162583915439
2020-04-15T09:30:00-04:00,21.73,21.86,21.54,21.65,63481951,103726321,47.323737647551695,45.40439400052457,NaN,NaN,56.24473104774088,121.8031536321882,0.5328003017742546,-0.5391877302923049,-1.0719880320665596,635931868,625931976.4,58.86034780019297,35.97140148641768,NaN,NaN,-8.09388284251459,-17.991948268205846
2020-04-16T09:30:00-04:00,21.6,21.64,21.06,21.27,68907624,99918881.15,45.8559119324535,45.53435855645332,NaN,NaN,31.508338476592048,105.17479609885963,0.43254423313508084,-0.5313077406477085,-0.9638519737827893,567024244,635019182.4,59.54188311864185,39.19088431358565,NaN,NaN,-8.042251173797245,-16.570562969004616
2020-04-17T09:30:00-04:00,22.1,22.515,21.92,22.39,88698630,99071172.1,50.708633986189675,46.13891145880209,NaN,NaN,83.02038592941975,86.09798781472325,0.42729402608608047,-0.42973444117518866,-0.8570284672612691,655722874,632267528.4,59.22195044801058,41.9771608655118,NaN,NaN,-6.623032359323107,-15.149487167621544
2020-04-20T09:30:00-04:00,21.95,22.36,21.75,22,59063101,94132281.35,49.059746796512925,46.518980336104406,NaN,NaN,62.810662396782135,70.53009710954181,0.3845283151586527,-0.3763680733129533,-0.760896388471606,596659773,630950515.6,59.058382415934254,44.00856724803679,NaN,NaN,-5.887045540025939,-13.826281220822171
2020-04-21T09:30:00-04:00,21.33,21.71,21.21,21.29,71957895,90502780.25,46.119574702320364,46.81233500003818,NaN,NaN,10.719708826386928,48.86076533538435,0.2991923921961318,-0.3869058982264413,-0.6860982904225731,524701878,596008127.4,54.73864787289758,45.46299670763035,NaN,NaN,-6.071271986571439,-12.718422758786353
2020-04-22T09:30:00-04:00,21.73,21.79,21.47,21.52,47510291,84950739.25,47.22300841917334,47.43603505993429,NaN,NaN,19.53723645517639,41.51926641687145,0.2509544191510845,-0.3724052664837174,-0.6233596856348019,572212169,583264187.6,53.210009838276015,46.87117664997997,NaN,NaN,-5.929221158600498,-11.748536815902659
2020-04-23T09:30:00-04:00,21.58,21.86,21.4,21.43,71740225,80390270.6,46.81895728594481,47.8830130352606,NaN,NaN,12.041530463840619,37.625904814321174,0.20750380835832438,-0.3639799251868965,-0.5714837335452209,500471944,569953727.6,51.58952069604228,48.27777183642115,NaN,NaN,-5.9158499432337575,-10.915295834092817
2020-04-24T09:30:00-04:00,21.66,21.825,21.33,21.74,33836725,75594409.4,48.45492132389934,48.53010139115421,NaN,NaN,17.227705189555504,24.467368666348325,0.1943856986692759,-0.328501610208626,-0.5228873088779019,534308669,545670886.6,48.6770083174326,49.55551799632845,NaN,NaN,-5.486189026546037,-10.139709147300419
2020-04-27T09:30:00-04:00,21.96,22.6,21.92,22.48,109435148,75600885.7,52.23242429270212,49.02123204130413,NaN,NaN,76.70362730895361,27.24596164878261,0.22796563713453122,-0.23793026245973792,-0.46589589959426914,643743817,555087695.4,49.85919623958146,50.995677855921414,NaN,NaN,-4.105868335387816,-9.277731888455762
2020-04-28T09:30:00-04:00,23.16,23.325,22.67,22.72,46452303,74558639.85,53.42459501670012,49.536899163610535,NaN,NaN,116.62667185035899,48.42735425357702,0.25662627992023496,-0.14511304969397543,-0.4017393296142104,690196120,588186543.8,53.88038143854345,52.60212459249795,NaN,NaN,-2.615792705408799,-8.326026290877625
2020-04-29T09:30:00-04:00,23.42,23.655,23.18,23.38,70064449,73870867.6,56.6302003034598,50.016551765516915,NaN,NaN,139.33721076392706,72.38734911532715,0.30691968082362114,-0.01808972858468394,-0.3250094094083051,760260569,625796223.8,58.001957081539565,54.082345723217735,NaN,NaN,-0.4350029312247622,-7.198737239498644
2020-04-30T09:30:00-04:00,22.91,23.16,22.675,22.79,56745740,72748903.75,53.11110139781695,49.9343745860107,NaN,NaN,87.11935278611699,87.40291357978244,0.2876640004295943,0.034570591128687767,-0.2530934093009065,703514829,666404800.8,61.955382964272175,55.344202364053345,NaN,NaN,0.5469404144822528,-6.092211860358516
2020-05-01T09:30:00-04:00,22.25,22.31,21.9115,22.06,37534293,71205705.25,49.049705625494894,49.804641569195425,NaN,NaN,9.880087695183263,85.93339008090798,0.2162356004728201,0.017201091290118597,-0.1990345091827015,665980536,692739174.2,64.30218311266839,56.34337642979068,NaN,NaN,0.2993968492576175,-5.179124901841925
2020-05-04T09:30:00-04:00,21.77,21.8902,21.44,21.86,50177200,70293660,47.9674534040529,49.56999800959092,NaN,NaN,-43.19998146908473,61.952668325300316,0.14918126255314731,-0.012557930991267341,-0.16173919354441466,615803336,687151078,63.408353102732306,56.878943174769006,NaN,NaN,-0.2018409636975977,-4.468084339249879
2020-05-05T09:30:00-04:00,22.16,22.275,21.79,21.79,65122828,70099048.25,47.571818534066786,49.587718072913425,NaN,NaN,-25.05499655105516,33.61633464501749,0.09633988319712444,-0.041314339548009116,-0.13765422274513356,550680508,659247955.6,58.9983141110491,56.88879791125873,NaN,NaN,-0.7268611237668746,-3.933623879895164
2020-05-06T09:30:00-04:00,21.99,22.05,21.3,21.32,63738410,69738421.7,44.89435166828769,49.519035196901584,NaN,NaN,-75.0221681837411,-9.255541144516148,0.029430299731691673,-0.10086634808051897,-0.13029664781221065,486942098,604584261.4,51.449056763656955,56.31073888590266,NaN,NaN,-1.8980067377247105,-3.6428214310136706
2020-05-07T09:30:00-04:00,21.6,22.18,21.6,21.82,61339041,68805203.65,48.23237539103626,49.342159582962054,NaN,NaN,-34.89758538893042,-33.658928779525624,0.019046605701889624,-0.10648839068484861,-0.12553499638673823,548281139,573537523.4,47.7146784532496,55.48879088627688,NaN,NaN,-2.0570462285945617,-3.4162821163823693
2020-05-08T09:30:00-04:00,22.24,22.32,22.01,22.29,42240657,63522590,51.22338298211615,49.496705024790856,NaN,NaN,16.538976651575485,-32.32715098824717,0.04267863349951548,-0.07218670451234388,-0.11486533801185936,590521796,558445775.4,45.96803180250584,54.553765842460564,NaN,NaN,-1.3988652833137032,-3.128079711658274
2020-05-11T09:30:00-04:00,21.98,22.05,21.74,21.86,54994912,62960520.25,48.46446985772661,49.66419753589131,NaN,NaN,-25.286149435026005,-28.74438458143543,0.0288590561226634,-0.07879151785853011,-0.10765057398119351,535526884,542390485,44.1177833834749,53.795132664644655,NaN,NaN,-1.5678968325061808,-2.9051964432079753
2020-05-12T09:30:00-04:00,21.95,22.03,21.27,21.29,62202694,61262205.85,45.00417094134544,49.50570914461788,NaN,NaN,-73.5376994130501,-38.44092515383442,-0.016710265298487473,-0.12853840560430285,-0.11182814030581538,473324190,526919221.4,42.348863372166,53.01933648849394,NaN,NaN,-2.674726012343132,-2.872272095941569
2020-05-13T09:30:00-04:00,21.11,21.14,20.5,20.66,86848318,62430524.2,41.47908510835963,49.1242897033618,NaN,NaN,-172.36543662933622,-57.909578842953444,-0.08358186581752888,-0.21630547257772648,-0.1327236067601976,386475872,506825976.2,40.1000745558116,52.19866176419175,NaN,NaN,-4.6587385411417,-3.1274815881130165
2020-05-14T09:30:00-04:00,20.3,21.21,20.085,21.19,103763104,64173298.2,45.35677652307183,48.90299364615983,NaN,NaN,-152.30645851563622,-81.3913534682946,-0.08608081237454746,-0.2403246222283819,-0.15424380985383446,490238976,495217543.6,38.81761423342934,51.49441932962009,NaN,NaN,-5.292550654634383,-3.4367771690446403
2020-05-15T09:30:00-04:00,20.99,21.23,20.795,21.05,70284975,63252615.45,44.51764285101432,48.35193782889642,NaN,NaN,-112.03517500773931,-107.10618380015755,-0.0906628667999601,-0.2675723933537846,-0.17690952655382447,419954001,461103984.6,35.24986482053028,50.45089565683072,NaN,NaN,-6.0534502217902535,-3.8105876051511562
2020-05-18T09:30:00-04:00,21.83,22.3,21.6773,22.13,79563572,64277639,51.90913261658833,48.243690514602726,NaN,NaN,23.708797235177276,-97.3071944661169,-0.018246185146111538,-0.1997172579864639,-0.18147107284035235,499517573,453902122.4,34.52835238816347,49.06860786751786,NaN,NaN,-4.574755813258145,-3.9197544920235834
2020-05-19T09:30:00-04:00,22,22.11,21.58,21.59,56673196,63513404.05,48.43466652281683,47.65829524455679,NaN,NaN,-16.272819942534532,-85.85421857201378,-0.004707418184219325,-0.1873553455706265,-0.18264792738640717,442844377,447806159.8,33.895917346918,47.346747886473466,NaN,NaN,-4.337572164593488,-3.979442730962141
2020-05-20T09:30:00-04:00,21.95,22.2,21.93,22.07,50402631,63658021.05,51.53967499321593,47.546050501371,NaN,NaN,23.209082220212462,-46.73931480210405,0.03632283421988958,-0.1372443846115452,-0.17356721883143478,493247008,469160387,38.168367745619356,45.6476753708554,NaN,NaN,-3.2148575618588686,-3.8702162782331024
2020-05-21T09:30:00-04:00,22,22.21,21.88,22,49939856,62568002.6,51.05683819514793,47.68941711348908,NaN,NaN,15.147615370693952,-13.248500024838012,0.057250841284046144,-0.1020036672263771,-0.15925450851042325,443307152,459774022.2,37.035282304491695,43.700039598842785,NaN,NaN,-2.432717980351902,-3.664859378535788
2020-05-22T09:30:00-04:00,21.99,22.02,21.7,21.92,37584497,62755391.2,50.47485506424923,47.86851723207453,NaN,NaN,-8.29764781637808,7.499005413434237,0.06371340681601609,-0.07961274999040313,-0.14332615680641922,405722655,456927753,36.67969356644574,41.790849631965166,NaN,NaN,-1.9402954919126125,-3.4184931090181916
2020-05-26T09:30:00-04:00,22.75,23.3,22.73,23.06,108349163,62701091.95,57.84830983944877,48.602552325316104,NaN,NaN,143.85994711782044,31.529235389962842,0.1384828695892329,0.02977743018012191,-0.10870543940911098,514071818,459838602,37.34226909065463,40.243989273365564,NaN,NaN,0.7261997105858196,-2.826394134789047
2020-05-27T09:30:00-04:00,24.09,24.1,23.54,24.06,121521218,66454537.7,63.04574991994813,49.89908077186328,NaN,NaN,229.69845150775524,80.72348968002079,0.2428961300330347,0.1949147231321824,-0.04798140690085231,635593036,498388333.8,45.47887948243355,39.81754803899246,NaN,NaN,4.774580063322573,-1.7405406779159585
2020-05-28T09:30:00-04:00,24.33,24.34,23.61,23.68,101593968,68031013.65,60.01730773026018,50.740861653236415,NaN,NaN,212.91564127374124,118.66480149072655,0.2717940474322146,0.2917611523894159,0.01996710495720134,533999068,506538745.8,47.04462714887753,39.76968723153731,NaN,NaN,7.19817159337996,-0.46358178201654177
2020-05-29T09:30:00-04:00,23.4,23.62,23.17,23.41,86971072,69542280.25,57.88952013204631,51.21701430680286,NaN,NaN,145.69231528121162,144.77374147283007,0.2582460036122811,0.3427746094725528,0.08452860586027164,447027996,507282914.6,47.19374134014663,39.857237912797366,NaN,NaN,8.564380953335974,0.8261271801766747
2020-06-01T09:30:00-04:00,23.5,23.79,23.34,23.68,52629291,70297030.15,59.43817256748612,52.00085021464282,NaN,NaN,136.06736632385537,173.64674430087678,0.25267680804076015,0.4003746159112218,0.14769780787046166,499657287,526069841,50.94888688184937,40.34517387696697,NaN,NaN,10.154251599926761,2.1587163829981155
2020-06-02T09:30:00-04:00,23.89,24.04,23.7,23.87,52550514,70415695.85,60.537982344511654,53.11040817201183,NaN,NaN,132.08120109051066,171.29099509541481,0.24671923174768112,0.4560968475550631,0.20937761580738196,552207801,533697037.6,52.42795140293396,41.065108736307536,NaN,NaN,11.79102752439439,3.5347608317690122
2020-06-03T09:30:00-04:00,24.4,24.87,24.34,24.76,77622930,71040700.95,65.28612970120363,54.81091135721498,NaN,NaN,157.2359058537589,156.79848596461557,0.2849405735732702,0.5655533327739697,0.2806127592006995,629830731,532544576.6,52.17196234367441,41.92738643544059,NaN,NaN,14.706147784209811,5.130673253546269
2020-06-04T09:30:00-04:00,24.72,25.3,24.52,25.3,97575087,72732534.8,67.81640563321707,56.4151705793682,NaN,NaN,151.86865658710255,144.5890890272878,0.3258631599505895,0.6879417091389364,0.36207854918834687,727405818,571225926.6,59.34681744866624,43.39375809367179,NaN,NaN,17.975825415567815,6.965694990977918
2020-06-05T09:30:00-04:00,26.78,26.825,26.15,26.24,135859288,76458547.15,71.68536832404932,58.355722398870704,NaN,NaN,190.16376024332135,153.48337801970976,0.3911179619520623,0.8509760016284247,0.4598580396763624,863265106,654473348.6,69.83477633237082,45.86410891594609,NaN,NaN,22.127641013588903,9.131687279922344
2020-06-08T09:30:00-04:00,26.67,26.795,26.3701,26.74,80298387,78361433.65,73.50958174038715,59.898611621999194,NaN,NaN,168.8822920841487,160.04636317176843,0.4392317517339477,1.008897729343797,0.5696659776098494,943563493,743254589.8,76.72974957901933,48.87849442957865,NaN,NaN,26.177750376559437,11.5668391508705
2020-06-09T09:30:00-04:00,26.11,26.4,25.92,26.17,92833147,80253345.4,68.12145067343707,61.304810489900646,NaN,NaN,128.03662160867003,159.2374472754003,0.4047936844740023,1.0756580832023523,0.67086439872835,850730346,802959098.8,80.03474915933174,52.17412527332249,NaN,NaN,27.915141299624413,13.902310886406774
2020-06-10T09:30:00-04:00,26.02,26.1597,25.17,25.19,110848913,82685656.35,59.98107664322379,61.907767750615484,NaN,NaN,90.05659306505567,145.80158471765967,0.2933311640539428,1.0375283537957785,0.7441971897418357,739881433,824969239.2,81.10041950602206,55.24070039906554,NaN,NaN,26.769770339603095,15.740519379720533
2020-06-11T09:30:00-04:00,24,24.36,23.09,23.13,233116601,89999070.5,47.21016688871434,61.633005514441656,NaN,NaN,-1.675799222294452,115.09269355578026,0.06984262012750597,0.8315004649012181,0.7616578447737121,506764832,780841042,72.719752962726,57.78959116036799,NaN,NaN,20.88804189742917,16.475879739393196
2020-06-12T09:30:00-04:00,24.06,24.06,23.22,23.83,127502925,91186061.55,51.02599418595427,61.67237259456345,NaN,NaN,-0.12430285756637335,77.03508093560272,-0.0361684595802958,0.7164472702983424,0.7526157298786382,634267757,735041572.2,65.19023839349373,59.826058648014275,NaN,NaN,17.57683091172763,16.633158478298114
2020-06-15T09:30:00-04:00,23.01,24.238,22.96,24.16,92469468,92295286.2,52.759608533209935,61.3088939298321,NaN,NaN,-3.3597543969167285,42.58667163938963,-0.08651976503628034,0.6444660235832878,0.7309857886195681,726737225,691676318.6,58.96475336687685,61.37052181060157,NaN,NaN,15.583411052062907,16.48319456026451
2020-06-16T09:30:00-04:00,25.12,25.12,23.95,24.54,108121252,93723170.2,54.74614606630276,60.71606508314314,NaN,NaN,33.917802770015726,23.762907871658758,-0.09595702443010468,0.6110395080819373,0.706996532512042,834858477,688501944.8,58.524171360999425,62.302328373356275,NaN,NaN,14.63302739865249,16.218884965748508
2020-06-17T09:30:00-04:00,24.61,24.61,24.13,24.17,56320875,93705554.15,52.43408249566416,60.174406137814856,NaN,NaN,13.19286896708399,8.39016305206441,-0.1268999780516582,0.5483715599474692,0.6752715379991274,778537602,696233178.6,59.3213870372941,63.17923979395746,NaN,NaN,13.129776352400386,15.777583735270206
2020-06-18T09:30:00-04:00,23.93,24.37,23.8602,24.14,61206472,94245746.2,52.24143404390962,59.77097141723367,NaN,NaN,-5.205636447735027,7.684195606976301,-0.14771296700376202,0.49063032924442496,0.638343296248187,717331130,738346438.2,63.44333121795731,64.33992478522966,NaN,NaN,11.875832881692364,15.220190756187657
2020-06-19T09:30:00-04:00,24.6,24.61,23.71,23.98,99903907,96743948.75,51.16178902878848,59.17980116446955,NaN,NaN,-15.276802368163379,4.653695704856901,-0.16904526764361327,0.4270367116936704,0.5960819793372837,617427223,734978331.4,62.89442293164173,65.19317736021482,NaN,NaN,10.534218751037432,14.55076618402334
2020-06-22T09:30:00-04:00,23.68,23.88,23.53,23.71,47929500,97261198.9,49.309844427434655,58.37779131324976,NaN,NaN,-55.93393992440904,-5.861141400641547,-0.19621944299975003,0.3508076755875962,0.5470271185873462,569497723,703530431,57.8607141894483,65.58123184496584,NaN,NaN,8.881964590705149,13.740937384977885
2020-06-23T09:30:00-04:00,24.07,24.22,23.8,23.82,47218930,94204687.25,50.102302652721825,57.2932322383582,NaN,NaN,-41.760942332946755,-20.996890421234042,-0.2009327410243501,0.29586119230690855,0.49679393333125865,616716653,659902066.2,51.68099454668721,65.54616271660962,NaN,NaN,7.712916690930703,12.879791571542572
2020-06-24T09:30:00-04:00,23.51,23.52,22.91,22.98,90217541,92639503.4,44.39468332305892,55.6202520733469,NaN,NaN,-103.64785028856016,-44.36503427236287,-0.2514897316717117,0.18243176874161904,0.4339215004133307,526499112,609494368.2,45.61865728660301,64.5655798478908,NaN,NaN,5.001493325665668,11.754320393560157
2020-06-25T09:30:00-04:00,22.9,23.64,22.86,23.59,110208940,93070252,48.94335720304289,53.99582270756073,NaN,NaN,-81.17394703606075,-59.55869639002801,-0.23502157121867007,0.14014453638999314,0.3751661076086632,636708052,593369752.6,43.846817316281985,62.70929706102732,NaN,NaN,3.9393949848790606,10.637902478034286
2020-06-26T09:30:00-04:00,23.19,23.26,22.52,22.58,123959144,94919655.6,42.713102239072725,51.79607417175256,NaN,NaN,-121.81118211486725,-80.86557233936878,-0.28025558641597836,0.024846624588690247,0.3051022110046686,512748908,572434089.6,41.58824193448163,60.19918937213176,NaN,NaN,1.0401979652907944,9.266801833356645
2020-06-29T09:30:00-04:00,22.82,22.98,22.63,22.83,69107072,95743544.65,44.59319170313826,50.11548424530264,NaN,NaN,-112.97621301028182,-92.27402695654334,-0.2807430725372562,-0.04582662966690165,0.23491644287035457,581855980,574905741,41.96829742424683,57.48015710533999,NaN,NaN,-0.7777912766690394,7.831859960495834
2020-06-30T09:30:00-04:00,22.71,23.3,22.69,23.14,60653071,96148672.5,46.91948622172087,49.18251350090957,NaN,NaN,-89.10753779113928,-101.74334604818185,-0.24868981621013747,-0.07594582739231726,0.17274398881782022,642509051,580064220.6,42.80472068176546,54.74475004646452,NaN,NaN,-1.617875435756019,6.481897761031283
2020-07-01T09:30:00-04:00,23.24,23.35,22.87,22.94,60500278,95292539.9,45.58958261061537,49.066757481045364,NaN,NaN,-81.0301064865381,-97.21979728777744,-0.229901131748553,-0.11463242586787104,0.11526870588068197,582008773,591166152.8,44.65361292601361,52.74002575812791,NaN,NaN,-2.6942636364721153,5.1710175613879406
2020-07-02T09:30:00-04:00,23.45,23.53,22.915,22.97,50841858,92955878.45,45.83757648216054,48.69615621648866,NaN,NaN,-69.92731766886459,-94.9704714143382,-0.2052093039795989,-0.14124292409381667,0.06396637988578224,632850631,590394668.6,44.545849396131054,51.26542654403058,NaN,NaN,-3.5142770221891437,3.9302611923055
2020-07-06T09:30:00-04:00,23.48,23.66,23.28,23.41,60271743,89176501.2,49.47490193312815,48.46153431648282,NaN,NaN,-42.053047233324065,-79.01884443802956,-0.15147893108284488,-0.12538228396777384,0.026096647115071023,693122374,626469361.8,50.55481236977945,50.664716472809346,NaN,NaN,-3.2354143053782938,2.9065932640649583
2020-07-07T09:30:00-04:00,23.22,23.225,22.87,22.93,43810905,87352127.1,45.85695239237495,47.82659191120227,NaN,NaN,-78.4298070108908,-72.10956323815137,-0.14073139518984823,-0.14981759687223928,-0.009086201682391042,649311469,639960459.6,52.62241792670498,50.24316265607403,NaN,NaN,-3.9975172316978203,1.9202917646702757
2020-07-08T09:30:00-04:00,22.92,23.23,22.84,23.17,53046101,85362774.8,47.90812514914059,47.503309243593435,NaN,NaN,-66.59531582460048,-67.6071188448436,-0.11121859914045631,-0.14810945060796143,-0.03689085146750512,702357570,651930163.4,54.442634480336665,49.89468033057706,NaN,NaN,-4.079843995785494,1.0631295131765945
2020-07-09T09:30:00-04:00,23.16,23.21,22.49,22.68,71163738,83378516.05,44.22437029290176,46.93066183280717,NaN,NaN,-100.17561119084279,-71.43621978570454,-0.11782461600727381,-0.18417162147659738,-0.06634700546932357,631193832,661767175.2,55.94077147189627,49.358783205858415,NaN,NaN,-5.18655695128288,0.1703171611109553
2020-07-10T09:30:00-04:00,22.67,23.49,22.67,23.46,94440587,76444715.35,50.72018754587326,46.89911886974179,NaN,NaN,-36.04237776410048,-64.65923180475173,-0.06540592757042243,-0.1481044149323516,-0.08269848736192917,725634419,680323932.8,58.69987429196884,49.059172588738925,NaN,NaN,-4.256216803921572,-0.46204483389369144
2020-07-13T09:30:00-04:00,23.76,23.91,23.42,23.56,102487105,75193924.35,51.5000547287279,47.0555624626913,NaN,NaN,26.4436354075729,-50.95989527657233,-0.021986509670249205,-0.11018162444974067,-0.08819511477949146,828121524,707323762.8,62.3902846568848,49.38271333641296,NaN,NaN,-3.2694004416207982,-0.8630956349975638
2020-07-14T09:30:00-04:00,23.46,23.745,23.25,23.68,102468252,75693863.55,52.47205539294886,47.224830515564655,NaN,NaN,18.073267768309307,-31.659280320732307,0.014842687148171746,-0.06964175584427679,-0.08448444299244853,930589776,763579424.2,68.67160957522671,50.59632869559436,NaN,NaN,-2.1764845748346353,-1.0507226264028597
2020-07-15T09:30:00-04:00,24.25,24.26,23.89,24.15,90549316,74815266.75,56.176583080148994,48.06639478392823,NaN,NaN,109.31983123445106,3.5237490910779967,0.06791296656156816,0.0004067652095116614,-0.0675062013520565,1021139092,827335728.6,73.97631822383208,52.62187590539643,NaN,NaN,-0.15682890841633132,-0.9230235238333557
2020-07-16T09:30:00-04:00,23.94,24.4,23.85,24.15,74678528,75733149.4,56.176583080148994,48.583053775150105,NaN,NaN,118.68096357869726,47.295064044986006,0.09823172077963407,0.0552834496224861,-0.04294827115714797,1021139092,905324780.6,78.72245420215114,55.11299282581565,NaN,NaN,1.5065445370699169,-0.5759423722757454
2020-07-17T09:30:00-04:00,24.2,24.22,23.94,23.95,47033680,75024509.8,54.09569823617477,49.39609634637168,NaN,NaN,104.78932361247688,75.46140432030148,0.09971347785465287,0.08169357616116812,-0.01801990169348475,974105412,955018979.2,81.08913440742413,57.93448514531155,NaN,NaN,2.3907022516967644,-0.15213599742252976
2020-07-20T09:30:00-04:00,23.82,23.98,23.75,23.84,40127636,72035696.25,52.934310173345374,49.99189052281504,NaN,NaN,79.62863774327496,86.09840478744188,0.08855941018911986,0.09267936104291508,0.004119950853795216,933977776,976190229.6,82.00733795818377,60.79441661202132,NaN,NaN,2.8447287929512894,0.2759875440594444
2020-07-21T09:30:00-04:00,24,24.4299,23.97,24.31,46494919,71963967.2,57.16581633640818,50.7237712452927,NaN,NaN,130.43752674924644,108.57125658362932,0.1068825672357603,0.1377231598984956,0.030840592662735294,980472695,986166813.4,82.44002266018391,63.62550961047979,NaN,NaN,4.40648161183468,0.8660581251701924
2020-07-22T09:30:00-04:00,24.19,24.325,24.105,24.31,44434169,71824729.15,57.16581633640817,51.55064508284933,NaN,NaN,124.7235526083303,111.65200085840516,0.11248303850813032,0.1714443907978982,0.05896135228976788,980472695,978033534,80.73547540712504,66.20278550198775,NaN,NaN,5.709079636563379,1.557918341083505
2020-07-23T09:30:00-04:00,24.26,24.47,24.18,24.33,49916070,69809655.6,57.35503319783812,52.37332056254059,NaN,NaN,118.56109807531486,111.62802775772869,0.11083557253674826,0.1975058179607032,0.08667024542395495,1030388765,979883468.6,80.83255112772078,68.79469276852987,NaN,NaN,6.860823106685729,2.315476164740965
2020-07-24T09:30:00-04:00,24.35,24.475,24.19,24.27,41245574,66361487.3,56.54799793459831,52.87854170550275,NaN,NaN,102.17567243792203,111.10529752281771,0.09937357301043176,0.21088721168699465,0.11151363867656289,989143191,982891024.4,81.00017808394541,70.96936174811314,NaN,NaN,7.657149645987111,3.0785723763475574
2020-07-27T09:30:00-04:00,24.16,24.18,23.86,24.07,43060247,62316542.45,53.829048637303444,53.44797715156907,NaN,NaN,59.183870751302564,107.01634412442324,0.07319990553764896,0.2030135205986241,0.12981361506097513,946082944,985312058,81.14314012045266,73.0065561905237,NaN,NaN,7.694654376781056,3.7380126621237717
2020-07-28T09:30:00-04:00,23.98,24.12,23.9,24.01,35370511,60629714.4,53.00564657554607,53.812085824883745,NaN,NaN,49.59565331781947,90.84796943813784,0.0479449520501844,0.18974480512370562,0.14179985307352122,910712433,971360005.6,77.52301313055796,74.6551546655395,NaN,NaN,7.52635849199547,4.279204923534015
2020-07-29T09:30:00-04:00,23.97,24.49,23.9314,24.46,36491582,59421639.95,58.17331498140126,54.80843901691942,NaN,NaN,82.2070944283668,82.34467780214514,0.057027469386935564,0.21308418980719068,0.15605672042025512,947204015,964706269.6,75.78650811327199,76.07270728278061,NaN,NaN,8.71228145228853,4.912501570498945
2020-07-30T09:30:00-04:00,24,24.07,23.71,24.02,53994587,59096355.4,52.13640266392842,54.90959723963765,NaN,NaN,25.48320890497883,63.72909996807793,0.030228229706083687,0.19384200755285974,0.16361377784677605,893209428,937270402.2,68.93016519465739,76.80344234725838,NaN,NaN,8.139642698039806,5.3735217315762105
2020-07-31T09:30:00-04:00,24.01,24.06,23.71,24.03,50186863,59063605.65,52.257665219371994,54.96371227468366,NaN,NaN,21.035674739943794,47.50110042848229,0.010992912767367413,0.1773549188059853,0.1663620060386179,943396291,928121022.2,66.76105566508372,77.11564027641545,NaN,NaN,7.694869513242801,5.705142843242866
2020-08-03T09:30:00-04:00,24.13,24.285,23.955,24.1,42985843,58199310.65,53.15239419886868,55.01230790367793,NaN,NaN,47.84472652487462,45.2332715831967,0.0013108679218931107,0.1680005909409843,0.16668972301909118,986382134,936180860.2,67.72458152605456,77.0479954157603,NaN,NaN,7.5450039583293425,5.967980145398077
2020-08-04T09:30:00-04:00,24,24.04,23.87,24,30754518,57546491.3,51.662851801596474,54.689898526638466,NaN,NaN,16.504358439574673,38.61501260754774,-0.012727812845706094,0.15077995696195856,0.16350776980766465,955627616,945163896.8,68.80979679924948,76.67895817114724,NaN,NaN,7.034091803120504,6.120281810786995
2020-08-05T09:30:00-04:00,24.16,24.39,24.125,24.33,34866481,56637510.3,56.0408717135737,54.68020485759737,NaN,NaN,80.54962961973345,38.28351964582107,-0.0012906130619333989,0.16189450348024792,0.16318511654218132,990494097,953821913.2,69.861622555662,76.04604162496945,NaN,NaN,7.730905223778096,6.350370869785724
2020-08-06T09:30:00-04:00,24.25,24.42,24.1501,24.32,33115354,54735091.1,55.87571715634576,54.80734906618101,NaN,NaN,85.79500260568233,50.34587838596177,0.0038197540601027646,0.1679598091173098,0.16414005505720702,957378743,966655776.2,71.40118501769888,75.35404523998908,NaN,NaN,8.274605788479944,6.625261572456327
2020-08-07T09:30:00-04:00,24.2,24.86,24.15,24.84,63302841,53178203.8,62.12618790472423,55.4639117612795,NaN,NaN,182.65647697848053,82.67003883366911,0.03851134698306241,0.21227923878603505,0.17376789180297264,1020681584,982112834.8,73.17830904201739,74.72340031740578,NaN,NaN,10.56588882558764,7.188208322903657
2020-08-10T09:30:00-04:00,24.98,25.11,24.8701,25.02,45436106,50325653.85,64.02586286354428,55.95391508464636,NaN,NaN,261.59861908623367,125.42081734594092,0.06813950768048041,0.25894227640357315,0.19080276872309274,1066117690,998059946,74.91052160846078,74.18557881371126,NaN,NaN,13.076087047520272,8.029333854991744
2020-08-11T09:30:00-04:00,25.49,25.72,25.25,25.31,73758559,48890169.2,66.90591794237264,56.64963662792953,NaN,NaN,312.93122684879023,184.70619102778403,0.09990548931067106,0.3156846303614316,0.21577914105076051,1139876249,1034909672.6,78.38443201275332,74.01764714268471,NaN,NaN,16.130840744751165,9.186691982100232
2020-08-12T09:30:00-04:00,25.76,25.77,25.06,25.24,58794997,47302453.25,65.54191822364612,57.234414129772965,NaN,NaN,221.15585636803252,212.82743637744383,0.10814412664389814,0.3509592993556332,0.24281517271173506,1081081252,1053027103.6,79.86086843189582,73.94824123584007,NaN,NaN,18.300582139675978,10.488676290325339
2020-08-13T09:30:00-04:00,25.05,25.26,24.93,25.08,35222516,45329652.65,62.409999025089256,57.65312849337946,NaN,NaN,131.869554917235,222.04234683975437,0.09521432530596446,0.3618330793441906,0.26661875403822616,1045858736,1070723102.2,81.21082255033463,73.9632872691536,NaN,NaN,19.302884876250477,11.747848945457502
2020-08-14T09:30:00-04:00,24.96,25.3,24.925,25.18,28276928,44391815.05,63.58133145122071,58.34972012294497,NaN,NaN,116.1441560579728,208.73988265565285,0.08606993814671049,0.37420617672161427,0.2881362385749038,1074135664,1081413918.2,81.99599985828948,74.02420582185621,NaN,NaN,20.473795154069503,12.99441268954493
2020-08-17T09:30:00-04:00,25.09,25.11,24.75,24.76,53396992,45055282.85,55.72702786089383,58.544104500469814,NaN,NaN,63.660586812656355,169.15227620093737,0.046396183159887805,0.34613146752476354,0.29973528436487573,1020738672,1072338114.6,78.9786304171474,74.12817848518402,NaN,NaN,19.2609214123479,13.889628221373925
2020-08-18T09:30:00-04:00,24.78,24.84,24.58,24.6,35502548,44505664.3,53.039029437428496,58.17736981875748,NaN,NaN,28.09428831806294,112.1848884947919,0.006153821971252416,0.30742756182894126,0.30127373985768885,985236124,1041410089.6,69.58176428631909,73.68498249754454,NaN,NaN,17.445576440141007,14.397620824054938
2020-08-19T09:30:00-04:00,24.69,24.935,24.52,24.59,59847178,45276314.75,52.867390544713665,58.22958323881357,NaN,NaN,26.02959586047261,73.15963639327992,-0.022776735730497544,0.2728028201945669,0.29557955592506446,925388946,1010271628.4,61.631106692975784,73.16362117599586,NaN,NaN,15.905116930036222,14.612977410623692
2020-08-20T09:30:00-04:00,24.31,24.5,24.29,24.36,45586098,45059816.15,48.944246099796416,57.99291044455817,NaN,NaN,-22.009760302827157,42.38377334926749,-0.05708865976441635,0.22421873121954405,0.2813073909839604,879802848,977060450.8,54.48082573586217,72.28646189533717,NaN,NaN,13.428525454260608,14.443769988286109
2020-08-21T09:30:00-04:00,24.32,24.53,24.23,24.31,35349229,44764998.9,48.10846078240462,57.6326294862393,NaN,NaN,-26.767705601865178,13.80140101729991,-0.08135753611468505,0.1796104708406041,0.26096800695528916,844453619,931124041.8,46.45305640814215,70.76706724405771,NaN,NaN,11.121970981363633,13.96922727301147
2020-08-24T09:30:00-04:00,24.45,24.89,24.39,24.89,51010918,45162532.45,57.23185049118944,58.030415106924515,NaN,NaN,27.632674817615367,6.595818618291699,-0.057668851655442166,0.18888194238598643,0.2465507940414286,895464537,906069214.8,42.752776498796614,68.90585150831109,NaN,NaN,11.646626486887788,13.637427160708086
2020-08-25T09:30:00-04:00,25.1,25.17,24.8,24.96,55236875,46155850.65,58.18733199246896,58.18373369827418,NaN,NaN,63.56586888694465,13.690134732068028,-0.037578666725070375,0.19957746063509063,0.237156127360161,950701412,899162272.4,41.76510400226352,66.89895732592548,NaN,NaN,12.357982138252428,13.454649300357277
2020-08-26T09:30:00-04:00,24.9,24.96,24.75,24.84,30646631,45863603.1,55.88246806163184,58.18421590579461,NaN,NaN,37.795711976240916,16.04335795522169,-0.03283681901888452,0.19611010358655534,0.22894692260543986,920054781,898095439.4,41.605224863680235,64.77067445778128,NaN,NaN,12.291832878971144,13.288532668730687
2020-08-27T09:30:00-04:00,24.82,25.375,24.82,25.26,66463903,46487068.9,61.61367524113896,58.14760785839566,NaN,NaN,83.76790349673017,37.19889071513315,-0.0034272070161209256,0.2246629138352887,0.22809012085140962,986518684,919438606.6,46.054417674789235,62.833253645836415,NaN,NaN,13.99706193749301,13.389751135696732
2020-08-28T09:30:00-04:00,25.44,25.45,25.15,25.36,49170562,46436253.85,62.85109296776177,58.06369572298263,NaN,NaN,104.68956862746316,63.49034556099882,0.019488140171858293,0.2524502960662325,0.2329621558943742,1035689246,957685732,52.969695648853154,61.266051791578725,NaN,NaN,15.77262005456776,13.730160981249737
2020-08-31T09:30:00-04:00,25.34,25.34,25.055,25.06,52259043,46899913.85,56.922771132780504,57.35061380801176,NaN,NaN,66.68095913018408,71.30000242351257,0.011560264682773352,0.2474124867478409,0.23585222206506753,983430203,975278865.2,55.77786039167157,59.65129667578717,NaN,NaN,15.516988863272111,13.985422107252933
2020-09-01T09:30:00-04:00,24.93,25.215,24.85,25.13,42040016,47464188.75,57.920137499478344,56.80620089914264,NaN,NaN,43.640968165495714,67.31502227922279,0.008302234516476825,0.24623001521066357,0.23792778069418674,1025470219,990232626.6,58.06960233755817,58.09477766904877,NaN,NaN,15.60019974594096,14.216104627065508
2020-09-02T09:30:00-04:00,25.12,25.58,25.0499,25.49,48429949,48142362.15,62.70282537558506,56.82711706703519,NaN,NaN,104.08844667359743,80.57356921869408,0.0266301642888144,0.27121548605520474,0.24458532176639033,1073900168,1021001704,62.38869994288132,56.750340339944955,NaN,NaN,17.14813463125895,14.634966056236001
2020-09-03T09:30:00-04:00,25.64,26.01,24.94,25.1,98391267,51406157.8,55.36182994456862,56.24000981656004,NaN,NaN,93.12943678270491,82.44587587588903,0.009603031802623646,0.2565891115196699,0.24698607971704625,975508901,1018799747.4,61.897322894545304,55.31472055682037,NaN,NaN,16.153864389321704,14.851951532391102
2020-09-04T09:30:00-04:00,25.55,25.69,24.89,25.29,111105512,53796291.35,57.945034520946564,56.39843886370666,NaN,NaN,71.86326417866312,75.88061498612902,0.008300979417371013,0.25736230398876003,0.24906132457138902,1086614413,1028984780.8,63.33575721761139,54.197372471139225,NaN,NaN,16.144003513206933,15.036530386793363
2020-09-08T09:30:00-04:00,25.04,25.1,24.55,24.64,84683037,55758637.9,47.76195851838704,56.021505226632264,NaN,NaN,-58.019865241496774,50.940450111792856,-0.03670239888651525,0.20318332596324495,0.2398857248497602,1001931376,1032685015.4,63.869412794782825,53.78934736460092,NaN,NaN,12.578300982344187,14.685354757586337
2020-09-09T09:30:00-04:00,24.87,25.07,24.71,24.89,52320985,54686759.2,51.30638606229394,55.910004906459434,NaN,NaN,-21.551276032677304,37.90200127215825,-0.04921822055848987,0.17836294915164785,0.22758116971013773,1054252361,1038441443.8,64.72949225235553,54.01066061884238,NaN,NaN,10.883401168625877,14.142218530591986
2020-09-10T09:30:00-04:00,24.97,25.14,24.49,24.54,55515302,54522774.45,46.544884880596,55.73862196223082,NaN,NaN,-58.241334501271204,5.436045037184523,-0.07889379107880606,0.12896393086163016,0.20785772194043622,998737059,1023408822,60.667965714304714,54.45259918873113,NaN,NaN,7.832350065695895,13.240808749892544
2020-09-11T09:30:00-04:00,24.58,24.84,24.5,24.71,69285693,56225933.3,49.019687273784456,55.80370956875795,NaN,NaN,-62.64500088722063,-25.71884249680059,-0.0844041172008255,0.10235257543940435,0.18675669264022984,1068022752,1041911592.2,63.688077671089026,55.683672136084475,NaN,NaN,6.195808060783655,12.234380080019847
2020-09-14T09:30:00-04:00,24.93,25.27,24.86,25.05,51020975,57363135.65,53.64230297385992,55.547313317520135,NaN,NaN,38.35909912606438,-32.419675507320335,-0.06343789898657187,0.10745931890701499,0.17089721789358686,1119043727,1048397455,64.71097484980172,57.25211487544199,NaN,NaN,6.343822171377633,11.392871807356673
2020-09-15T09:30:00-04:00,25.1,25.12,24.69,24.71,48459911,57116281.6,48.87015707341419,54.88180082330194,NaN,NaN,-20.085913619309206,-24.832885182882823,-0.07022720311412417,0.08311321400093163,0.1533404171150558,1070583816,1062127943,66.84054993946333,59.04321815667055,NaN,NaN,4.882333469711396,10.462794901978777
2020-09-16T09:30:00-04:00,24.76,25.27,24.71,24.99,62122241,58447266.25,52.60922940484426,54.64799806210282,NaN,NaN,16.230456761790936,-17.276538623989175,-0.05433021082218831,0.0854276535873204,0.13975786440950871,1132706057,1077818682.2,69.13295061609477,61.009484281843015,NaN,NaN,4.902914820565813,9.668526318919781
2020-09-17T09:30:00-04:00,24.65,24.8799,24.58,24.73,47334182,57821616.45,49.02414460554576,53.748745873846154,NaN,NaN,-56.736561012403286,-16.975583926215563,-0.0593849429667912,0.06552668570101972,0.12491162866781091,1085371875,1095145645.4,71.47787488670085,62.82544551126527,NaN,NaN,3.757161042783684,8.824045565186053
2020-09-18T09:30:00-04:00,24.73,24.9278,24.63,24.68,61707172,58627670.15,48.34189622475492,52.71237467791709,NaN,NaN,-62.04072198100504,-16.854728144972444,-0.06376977297522668,0.045199412448777565,0.10896918542400424,1023664703,1086274035.6,68.6041273516912,63.942190632896555,NaN,NaN,2.6377191175790133,7.940284644099333
2020-09-21T09:30:00-04:00,24.03,24.165,23.56,23.93,72307333,60475575.35,39.469014139376725,51.46567774981683,NaN,NaN,-284.18810986543986,-81.3641699432733,-0.1120318817286993,-0.031070666736869867,0.08096121499182943,951357370,1052736764.2,58.954626498769635,64.16910249768928,NaN,NaN,-1.447757485664825,6.599135768418739
2020-09-22T09:30:00-04:00,23.87,24.1,23.53,23.73,84561453,62153102.1,37.49276404928828,50.00657964623182,NaN,NaN,-249.56662433604433,-127.26031208662032,-0.14991038084530886,-0.10642676106480664,0.04348361978050221,866795917,1011979184.4,49.7891568837767,63.57764210813347,NaN,NaN,-5.388163188848054,4.886664488809197
2020-09-23T09:30:00-04:00,23.78,23.945,23.2,23.2,54274638,62104990.25,32.80508991576005,47.87102711338718,NaN,NaN,-246.2113580909937,-179.74867505717725,-0.20001313406866325,-0.20653279780532685,-0.0065196637366636,812521279,947942228.8,39.41967907306945,61.93699776028975,NaN,NaN,-10.427633267602053,2.698907666464733
2020-09-24T09:30:00-04:00,23.21,23.58,22.94,23.25,56512283,63398272.85,33.64792629668541,46.32003399568124,NaN,NaN,-214.3267526672457,-211.26671338814572,-0.2176812284228427,-0.278621199265217,-0.06093997084237429,869033562,904674566.2,34.23201319863243,59.960904210581695,NaN,NaN,-14.082639193094726,0.3015438293848103
2020-09-25T09:30:00-04:00,23.08,23.57,23.03,23.49,46018752,62376015.3,37.6881329669818,44.873112456112324,NaN,NaN,-155.96835183151737,-230.0522393582482,-0.20147222058308115,-0.3127802465712257,-0.11130802598814457,915052314,882952088.4,31.95811665829659,57.719644170630644,NaN,NaN,-15.84766465446693,-2.005485954022581
2020-09-28T09:30:00-04:00,23.82,24.22,23.82,24.05,62803502,63057662.3,45.95706589607812,44.74419155451883,NaN,NaN,-63.78181863885336,-185.9709811129309,-0.1439985560057662,-0.2913062209953523,-0.1473076649895861,977855816,888251777.6,33.12526499796586,55.52363361371515,NaN,NaN,-14.665610422888772,-3.814075163860608
2020-09-29T09:30:00-04:00,23.98,24.015,23.62,23.75,53262864,63107853.35,42.688847667099054,44.1286530977192,NaN,NaN,-79.25645750057919,-151.90894774583788,-0.11822885752860696,-0.2950937369003448,-0.17686487937173784,924592952,899811184.6,35.715423580760344,53.451200137172634,NaN,NaN,-14.750073476779946,-5.376360637134799
2020-09-30T09:30:00-04:00,23.85,24.27,23.84,24.07,66732154,64342460.25,47.017056836347884,44.16237966598719,NaN,NaN,-43.68504902776793,-111.40368593319272,-0.07384506192321996,-0.2691712067757628,-0.19532614485254282,991325106,935571950,43.0625607062059,52.193671208022714,NaN,NaN,-13.404227994145218,-6.52319883099343
2020-10-01T09:30:00-04:00,24.17,24.33,23.92,24.11,65766067,65209266.15,47.5502775244145,44.05742182674647,NaN,NaN,-31.259324604700193,-74.79020032068361,-0.03782162079472837,-0.2426031708459533,-0.20478155005122492,1057091173,973183472.2,49.5884565969157,51.18655541701033,NaN,NaN,-12.175865391969701,-7.330722625418612
2020-10-02T09:30:00-04:00,23.79,24.44,23.73,24.3,63367823,63458093.95,50.11825293264503,43.80570396665969,NaN,NaN,-21.479305565393847,-47.89239106745892,0.0007321565017252007,-0.20386635442406842,-0.20459851092579362,1120458996,1014264808.6,55.577452381295096,50.53416095497415,NaN,NaN,-10.375889461394292,-7.765746459129423
2020-10-05T09:30:00-04:00,24.53,24.78,24.465,24.7,58911741,60848405.4,55.102100627118986,44.25084279192431,NaN,NaN,45.81450546186674,-25.973126247314894,0.05225088744346537,-0.1392849016214619,-0.19153578906492727,1179370737,1054567792.8,60.5314167176241,50.08350858198563,NaN,NaN,-7.243742756128574,-7.691174501557874
2020-10-06T09:30:00-04:00,24.91,25.08,24.36,24.45,88404884,61034497.75,51.63001776477423,44.18089910334788,NaN,NaN,44.87350184997341,-1.1471343772043696,0.06759453132731189,-0.10704262490578742,-0.1746371562330993,1090965853,1087842373,64.09184744088202,49.723429783756146,NaN,NaN,-5.662085601849147,-7.401304658742341
2020-10-07T09:30:00-04:00,24.68,24.98,24.68,24.86,53810732,61108985.1,56.47396660858036,44.71302924642178,NaN,NaN,73.46198295721572,22.282272019792355,0.10142558881440442,-0.04785517021509378,-0.1492807590294982,1144776585,1118532668.8,67.04474793565734,49.40677785868161,NaN,NaN,-2.7507057495126888,-6.736933385995248
2020-10-08T09:30:00-04:00,25,25.26,24.94,25.2,57646316,61215535.8,60.04711844634527,45.54911654796395,NaN,NaN,105.54688326383963,49.64351359350032,0.14037231315021773,0.026184632408273956,-0.11418768074194377,1202422901,1147599014.4,69.59495499519727,49.47755126178919,NaN,NaN,0.865039623478563,-5.650937241784703
2020-10-09T09:30:00-04:00,25.34,25.37,25.0317,25.23,52025758,60352539.05,60.35636358845062,47.041070080040654,NaN,NaN,106.66170420041063,75.27171554666123,0.1603803740342313,0.08628778680084537,-0.07409258723338594,1254448659,1174396947,71.76437551706884,50.39253333452484,NaN,NaN,3.8398767431389986,-4.295106672509889
2020-10-12T09:30:00-04:00,25.21,25.59,25.205,25.51,45931404,60098060.5,63.217982425023386,48.87858567830745,NaN,NaN,127.38877549817381,91.58656955392263,0.18305806859662696,0.15472999851239777,-0.02832807008422919,1300380063,1198598812.2,73.59664535777443,52.09306822552468,NaN,NaN,7.256762202743629,-2.6448396903308153
2020-10-13T09:30:00-04:00,25.43,25.51,24.943,25.02,60377774,60693953.65,55.64775875866318,50.51020488137196,NaN,NaN,90.25840519756515,100.66355022344098,0.15666340810038049,0.16750119004124642,0.010837781940865931,1240002289,1228406099.4,75.68907922895254,54.68373966523062,NaN,NaN,7.940865700817086,-1.1325960630239724
2020-10-14T09:30:00-04:00,25.04,25.13,24.75,24.78,49035086,60039595.9,52.341662904770715,51.84547178194948,NaN,NaN,60.28934160024413,98.02902195204666,0.11649214621880785,0.15645296471437575,0.0399608184955679,1190967203,1237644223,76.31555157833671,57.68970669235234,NaN,NaN,7.484780005121608,0.09845766099682463
2020-10-15T09:30:00-04:00,24.55,24.98,24.51,24.97,41640087,59754891.15,54.639265354346605,53.05626695247554,NaN,NaN,51.645484789744906,87.24874225722772,0.096967907690155,0.16117070310826165,0.06420279541810665,1232607290,1243681100.8,76.73741490575821,60.88822799574246,NaN,NaN,7.799840285151294,1.1986551787331774
2020-10-16T09:30:00-04:00,25.02,25.15,24.87,24.99,40103579,58674711.5,54.88581828175147,53.69403498002364,NaN,NaN,69.68364442522035,79.85313030218967,0.08033830392052271,0.16462567531876005,0.08428737139823733,1272710869,1247333542.8,77.00429176331873,64.02244419326767,NaN,NaN,8.12460228953334,2.188076194561772
2020-10-19T09:30:00-04:00,25.08,25.09,24.565,24.61,42989046,57208797.15,49.39256130815163,54.17287166867025,NaN,NaN,37.560353886018696,61.88744597975864,0.040684579675706045,0.1351430959928699,0.09445851631716384,1229721823,1233201894.8,73.49125441272855,66.72071782412254,NaN,NaN,6.7767232895101515,2.8435972081258263
2020-10-20T09:30:00-04:00,24.77,25.095,24.76,24.81,67293885,56345418.75,52.109324695416724,54.53660508717517,NaN,NaN,48.165982060399514,53.468961352325515,0.025600013145484546,0.12645853274901953,0.10085851960353498,1297015708,1244604578.6,74.50206951661443,68.966397024866,NaN,NaN,6.431591579233556,3.3561678325697875
2020-10-21T09:30:00-04:00,24.77,24.93,24.675,24.68,44307200,55847046.85,50.22207170614265,54.727447528727176,NaN,NaN,28.25475582203925,47.06204419668454,0.005587499922528855,0.10784289450669604,0.10225539458416719,1252708508,1256952839.6,75.58768233001656,70.82348457723035,NaN,NaN,5.599970659227921,3.6767110935209493
2020-10-22T09:30:00-04:00,24.67,25.2,24.66,25.17,39511826,54997024,56.602076921292586,55.190577813630576,NaN,NaN,58.21371332129465,48.37568990299448,0.02308955071941228,0.13111733298343253,0.10802778226402025,1292220334,1268875448.4,76.62262421414704,72.32671113671977,NaN,NaN,6.784012791357184,4.120611336068983
2020-10-23T09:30:00-04:00,25.33,25.405,25.05,25.25,45092704,54950721.6,57.558507503067744,55.36603544762691,NaN,NaN,92.15356692530509,52.86967440301142,0.03696964912064425,0.15423984366482557,0.11727019454418132,1337313038,1281795882.2,77.72472305862385,73.55480444679118,NaN,NaN,8.03108558827418,4.67925051495544
2020-10-26T09:30:00-04:00,24.89,24.93,24.45,24.68,53980959,54509594.45,49.23300583430907,55.19482030973655,NaN,NaN,-15.423326560313477,42.272938313744994,0.006286217445172229,0.1251279663506466,0.11884174890547437,1283332079,1292517933.4,78.62527902531694,74.59290670282225,NaN,NaN,6.548500389374314,4.946286211300993
2020-10-27T09:30:00-04:00,24.67,24.67,24.21,24.23,46083326,54150617.55,43.841515976573234,54.29250240745033,NaN,NaN,-95.80814897402529,13.478112106860033,-0.04307650325594645,0.06499611983554132,0.10807262309148777,1237248753,1280564542.4,74.98559749789348,75.16011024298197,NaN,NaN,3.48988150036788,4.7382283954534055
2020-10-28T09:30:00-04:00,23.72,23.93,23.47,23.61,89288268,55278423.25,37.71358193019294,52.697249799153724,NaN,NaN,-233.74876078620528,-38.92259121478887,-0.11231018783779526,-0.032315111705756294,0.07999507613203896,1147960485,1259614937.8,68.96041201977626,75.1147857447376,NaN,NaN,-1.3441232446592097,3.8693210182944604
2020-10-29T09:30:00-04:00,23.55,23.9617,23.25,23.79,60901968,55035218.3,40.32160341377693,51.26619550096275,NaN,NaN,-211.4081884885301,-92.84697157675382,-0.13905915477629896,-0.09382886733833473,0.04523028743796422,1208862453,1242943361.6,64.51761584564386,74.59716005392154,NaN,NaN,-4.3368879041643,2.697005457943209
2020-10-30T09:30:00-04:00,23.65,23.9001,23.47,23.86,66227901,55178222.2,41.35008242337839,49.704202643702395,NaN,NaN,-178.41818125510937,-146.9613212128367,-0.14448029779164884,-0.13537008480159685,0.009110212990052005,1275090354,1230498824.8,61.340795167027316,73.72174218315388,NaN,NaN,-6.389499749055659,1.3989332855147993
2020-11-02T09:30:00-05:00,24.26,24.42,23.9643,24.31,65135953,55489432.8,47.601728768934585,49.12948621586464,NaN,NaN,-80.25203593131242,-159.92706308703652,-0.111669376610962,-0.1304765077736505,-0.018807131162688492,1340226307,1241877670.4,63.12855313464236,72.82456174784602,NaN,NaN,-6.180009858855463,0.3162271220333335
2020-11-03T09:30:00-05:00,24.76,25.1,24.73,24.85,79828378,55060607.5,53.94572447348166,49.24406204220113,NaN,NaN,29.25986671887299,-134.91345994845685,-0.05061723413485596,-0.08207867383125844,-0.031461439696402485,1420054685,1278438856.8,68.2146998232631,72.24592947962647,NaN,NaN,-3.874921542263859,-0.28250840143769396
2020-11-04T09:30:00-05:00,24.41,25,24.19,24.56,87397396,56739940.7,50.415525825616676,48.94236636157757,NaN,NaN,-20.639382258256912,-92.29158424286717,-0.02791778951988818,-0.06635867659626271,-0.03844088707637453,1332657289,1315378217.6,72.36277746229884,71.93345537652223,NaN,NaN,-3.130225041932286,-0.6893250643654927
2020-11-05T09:30:00-05:00,24.77,25.335,24.77,25.16,65942296,57154739.7,56.72530380198682,49.07375818445151,NaN,NaN,64.20507943737259,-37.16893065768663,0.026414335782398206,-0.005422967348376773,-0.03183730313077498,1398599585,1353325644,75.8495486282215,71.85097372401529,NaN,NaN,-0.32059773053691404,-0.63664973096141
2020-11-06T09:30:00-05:00,25.28,25.3093,24.88,24.96,60783529,57592628.25,54.24725660122566,49.42052213395681,NaN,NaN,59.941376464323916,10.502980886200032,0.04661069805626136,0.026426069439551725,-0.020184628616709638,1337816056,1365870784.4,76.88767578853991,72.09357525085896,NaN,NaN,1.1185181831607247,-0.38591145751539074
2020-11-09T09:30:00-05:00,26.98,27.44,26.66,27.01,162965451,63444330.6,69.13219497701537,50.63644143978529,NaN,NaN,333.05649574709605,93.16468722188174,0.1878362070807287,0.21461063023420124,0.02677442315347254,1500781507,1397981824.4,79.33617286745901,72.43886834734785,NaN,NaN,8.929045585689737,0.9447966915139132
2020-11-10T09:30:00-05:00,27.04,27.245,26.79,27.15,85851219,64718002.85,69.85351086836563,52.038687094229786,NaN,NaN,268.71576484257196,141.05586684662154,0.2751973114140783,0.3707710624210705,0.09557375100699214,1586632726,1431297432.6,81.52322978171037,72.86283602246884,NaN,NaN,14.843485292552442,2.930323634519417
2020-11-11T09:30:00-05:00,27.3,27.32,26.875,27.04,65062441,65519370.6,68.49908923494837,52.88847368806234,NaN,NaN,208.32087212867603,186.8479177240081,0.30763599067361114,0.48011873934900606,0.17248274867539493,1521570285,1469080031.8,83.63822120435967,73.36395009319833,NaN,NaN,18.801477051349362,5.197631265495123
2020-11-12T09:30:00-05:00,26.71,26.765,26.35,26.59,62749613,66574846.9,63.108251008446636,53.28488393844655,NaN,NaN,130.58826022943336,200.12455388242026,0.28155069840279134,0.5244211216788841,0.24287042327609276,1458820672,1481124249.2,84.25687123432537,73.83053210574842,NaN,NaN,20.157805058876598,7.334798950263905
2020-11-13T09:30:00-05:00,26.84,27.14,26.77,27.03,45051630,66822249.45,65.93150107464552,54.4776335984706,NaN,NaN,134.94068793506995,215.12441617656947,0.27630715850343,0.5882543714053803,0.31194721290195027,1503872302,1514335498.4,85.8460853127819,74.34630398342449,NaN,NaN,22.22485314679431,9.46194954976825
2020-11-16T09:30:00-05:00,27.71,27.73,27.36,27.63,67556101,68050602.2,69.37342873310897,56.30134165250886,NaN,NaN,144.5303807222562,177.4191931716015,0.29398276655012834,0.6794256710896107,0.3854429045394824,1571428403,1528464877.6,86.47176911982652,75.16674481356257,NaN,NaN,25.141797986186674,11.701927897828025
2020-11-17T09:30:00-05:00,27.32,27.64,27.13,27.59,63679673,67869891.6,68.87385847175331,58.52707569119174,NaN,NaN,114.96390753327202,146.6688217097415,0.2835837168954998,0.7399225506588571,0.4563388337633573,1507748730,1512688078.4,82.10721231864855,76.10580197776774,NaN,NaN,27.23544983619215,13.92100246045147
2020-11-18T09:30:00-05:00,27.72,27.94,27.32,27.33,71578423,69233452.75,65.56865838533062,60.33043676058844,NaN,NaN,102.7792472680675,125.56049673761981,0.2414469203629127,0.7581474842169982,0.5167005638540855,1436170307,1495608082.8,77.54403107092101,77.03626020814467,NaN,NaN,27.926183432839775,15.921742599364086
2020-11-19T09:30:00-05:00,27.19,27.45,27.0233,27.42,47194764,69617599.65,66.173790936639,62.1035587972499,NaN,NaN,80.17083867942127,115.47701242761741,0.2034122754165295,0.7709659081247473,0.5675536327082178,1483365071,1500516962.6,77.92377475142332,78.22075874988725,NaN,NaN,28.661536896346153,17.741713213218667
2020-11-20T09:30:00-05:00,27.28,27.385,27.1218,27.18,39976918,69361810.35,62.99434426493742,63.203031332678684,NaN,NaN,68.97139692226469,102.28315422505636,0.14841917176828245,0.7530775974185708,0.6046584256502884,1443388153,1488420132.8,74.57691859595037,79.03849913998067,NaN,NaN,28.35399964568432,19.25775413214233
2020-11-23T09:30:00-05:00,27.53,27.77,27.39,27.69,51870485,69256286.65,66.66017542237961,64.11120640045712,NaN,NaN,79.30219074027498,89.2375162286601,0.13320463465936183,0.7711642189744907,0.6379595843151289,1495258638,1473186179.8,70.47195679485414,79.1997317808086,NaN,NaN,29.17413858286597,20.67438048224571
2020-11-24T09:30:00-05:00,28.17,28.69,28.095,28.66,60991150,70001677.85,72.28388570553741,65.67323210616574,NaN,NaN,109.80772629935917,88.20627998187754,0.1727726286436828,0.8539253701197325,0.6811527414760497,1556249788,1482886391.4,71.5459512434139,79.14138705088826,NaN,NaN,31.79196459727236,22.262606784392375
2020-11-25T09:30:00-05:00,28.5,28.58,28.22,28.56,45204616,67797495.25,70.95509625576224,66.68964585286399,NaN,NaN,103.03912788856346,88.25825610597673,0.17592434812169822,0.9010581766281724,0.7251338285064742,1511045172,1497861364.4,73.16844394486749,78.94987957350581,NaN,NaN,33.448609423870415,23.860607161460667
2020-11-27T09:30:00-05:00,28.56,28.59,28.36,28.47,26981175,66101455.6,69.71299889478428,67.79434173097532,NaN,NaN,101.29436263263901,92.48296089662028,0.15632304335960145,0.920537632705976,0.7642145893463745,1484063997,1498001149.6,73.18381541814232,78.68531811847743,NaN,NaN,34.41626274505313,25.368557959116732
2020-11-30T09:30:00-05:00,28.3,28.38,27.83,27.88,72524240,66416272.55,62.045141765843006,67.288123644463,NaN,NaN,75.13893951703146,93.71646941557364,0.09122299284282942,0.8782433303999113,0.7870203375570819,1411539757,1491631470.4,71.1826417138799,78.1029230360789,NaN,NaN,32.90164485334067,26.44471322972015
2020-12-01T09:30:00-05:00,28.4,28.565,28.29,28.31,53977316,65858340.7,65.06138946579705,66.94582925856524,NaN,NaN,98.49768349085221,97.55556796568908,0.06590396360584738,0.8694002920643911,0.8034963284585437,1465517073,1485683157.4,69.27751879807144,77.22822939439041,NaN,NaN,32.536687715966714,27.314995299183945
2020-12-02T09:30:00-05:00,28.27,28.67,28.22,28.62,57471766,64740510.1,67.0917904085383,66.84530791382166,NaN,NaN,102.2280670777102,96.03963612135928,0.05903784504872023,0.877293634769444,0.8182557897207238,1522988839,1479030967.6,67.11420822477554,76.04794275299155,NaN,NaN,32.84937531377607,28.10562101555425
2020-12-03T09:30:00-05:00,28.64,28.7976,28.46,28.63,49566017,62848941.15,67.15809254748598,67.13458230946733,NaN,NaN,107.72714892791976,96.97724032923055,0.04481772835763942,0.8742779501677731,0.8294602218101337,1572554856,1491332904.4,69.03963147794808,74.96099705610746,NaN,NaN,33.118995327903455,28.82181734588985
2020-12-04T09:30:00-05:00,28.82,29.03,28.8,28.98,52713126,62187482.65,69.47610598498603,67.38776837449166,NaN,NaN,126.4833259766859,102.01503299803993,0.048329567150770636,0.889872180748597,0.8415426135978263,1625267982,1519573701.4,72.95437309915303,74.04016046941969,NaN,NaN,34.02291801547757,29.564831727259527
2020-12-07T09:30:00-05:00,28.81,28.86,28.61,28.78,34630698,60879841.1,66.58406453256804,67.188528074453,NaN,NaN,98.37445759602885,106.66213661383941,0.027561487764450776,0.8759944733033898,0.848432985538939,1590637284,1555393206.8,76.93755115841913,73.35914490074774,NaN,NaN,33.95833463913623,30.19247500038477
2020-12-08T09:30:00-05:00,28.51,28.84,28.51,28.77,31628548,54312995.95,66.43515527900462,67.01433498925668,NaN,NaN,84.29611536072414,103.82182298781379,0.004726461002112492,0.8543410617915796,0.8496146007894672,1559008736,1574091539.4,78.70098873539334,73.1158432162295,NaN,NaN,33.864857369244085,30.71710105307896
2020-12-09T09:30:00-05:00,28.93,28.95,28.59,28.7,47589551,52399912.55,65.33368879435233,66.99755144704395,NaN,NaN,80.57959010538485,99.49212759334873,-0.022046870885863434,0.8220560121821379,0.8441028830680013,1511419185,1571777608.6,77.90709232879479,73.14177616322048,NaN,NaN,33.49568446255962,31.114041540147625
2020-12-10T09:30:00-05:00,28.48,28.78,28.39,28.75,41296702,51211625.6,65.77023865255637,66.96872628389518,NaN,NaN,63.85749755223575,90.71819731821192,-0.0421767848940483,0.7913819019504409,0.8335586868444892,1552715887,1567809814.8,76.48237590950683,73.0388191030836,NaN,NaN,33.293239359736525,31.425355514374612
2020-12-11T09:30:00-05:00,28.43,28.525,28.23,28.46,48216339,50484961.9,60.974176110596474,66.82442855858513,NaN,NaN,32.4483249666836,71.91119711621147,-0.07868936619789957,0.7351969790971147,0.8138863452950142,1504499548,1543656128,68.29475368703442,72.59009303816103,NaN,NaN,31.84922037992773,31.485907638025058
2020-12-14T09:30:00-05:00,28.84,28.84,28.11,28.13,38302861,50147523.45,55.97233945703667,66.06101170391777,NaN,NaN,21.060840879970787,56.448473772999854,-0.12592959370146295,0.6564743531681856,0.7824039468696485,1466196687,1518768008.6,61.043259917504855,71.91661468977894,NaN,NaN,29.183775073709832,31.157031557408597
2020-12-15T09:30:00-05:00,28.35,28.69,28.1928,28.61,38637134,48701575.1,60.9856020593282,65.25399144347425,NaN,NaN,36.69302539643647,46.927855780142316,-0.1254379645181577,0.6256064912219514,0.7510444557401091,1504833821,1507933025.6,58.14858294187967,70.95965981109792,NaN,NaN,28.161135124923298,30.729046352767842
2020-12-16T09:30:00-05:00,28.66,28.68,28.52,28.66,55602812,48297732.05,61.47766526973527,64.57703208732947,NaN,NaN,52.57676984942864,41.32729172895107,-0.12221040124438942,0.5982814541846224,0.7204918554290118,1560436633,1517736515.2,59.996967961008615,70.01884009796514,NaN,NaN,27.450928665106044,30.260743825959015
2020-12-17T09:30:00-05:00,28.71,28.79,28.58,28.74,38510854,46644353.6,62.29702805970231,64.04731988482362,NaN,NaN,65.97325507665205,41.75044323383434,-0.1152441295470863,0.5764366934951539,0.6916808230422402,1598947487,1526982835.2,61.71444193609845,69.19959913496201,NaN,NaN,27.070930349358445,29.80505618644465
2020-12-18T09:30:00-05:00,28.78,28.78,28.315,28.49,56080100,47088620.4,58.135616904224065,63.768068108993695,NaN,NaN,24.121843985570408,40.08514703761169,-0.12709685569142248,0.5328097534279621,0.6599066091193846,1542867387,1534656403,63.129233681933385,68.6243557041087,NaN,NaN,25.600270172211253,29.20437247012559
2020-12-21T09:30:00-05:00,28.67,28.855,28.225,28.72,77664803,48973014.65,60.734332729810056,63.458992627851764,NaN,NaN,35.23326152313489,42.919631166244514,-0.11920146753248773,0.5109047747037749,0.6301062422362627,1620532190,1565523503.6,68.21708536853724,68.54861045914195,NaN,NaN,25.0227346812796,28.60699564314759
2020-12-22T09:30:00-05:00,28.74,28.78,28.42,28.44,42342404,48496610.6,56.163618641575184,62.678408930211546,NaN,NaN,-1.6106398676415823,35.25889811342891,-0.13161755749713966,0.46558429536483814,0.5972018528619778,1578189786,1580194696.6,70.3138984794937,68.77715976305039,NaN,NaN,23.227228398357973,27.838457465320502
2020-12-23T09:30:00-05:00,28.61,29.07,28.6,28.91,52681434,48081124.8,61.41307651824133,62.268050642408355,NaN,NaN,129.08342387491535,50.56022891852622,-0.10795038559809256,0.46226387086436205,0.5702142564624546,1630871220,1594281614,72.2097065019819,69.00359369333852,NaN,NaN,23.144285768528785,27.167861508635973
2020-12-24T09:30:00-05:00,28.97,28.98,28.71,28.95,16071006,46624444.3,61.8319916748964,61.72204247740195,NaN,NaN,122.27701427620474,61.82098075843676,-0.09010315114762035,0.4575853175279292,0.5476884686755495,1646942226,1603880561.8,73.4537531411878,69.03926369634101,NaN,NaN,23.195803358544193,26.60042463005143
2020-12-28T09:30:00-05:00,29.15,29.32,28.985,29.09,32824848,46916627.95,63.33243872493872,61.48978349114271,NaN,NaN,193.43908903009185,95.68442976734104,-0.0702521925708145,0.45987322796203145,0.530125420532846,1679767074,1631260499.2,76.66286315678268,69.01964312479554,NaN,NaN,23.659933437104954,26.180354459630507
2020-12-29T09:30:00-05:00,29.21,29.22,28.96,28.99,23607011,44470766.5,61.47349713642539,61.13537933810134,NaN,NaN,149.76916987376455,118.59161143746697,-0.06534207893977717,0.4484478218581245,0.5137899007979017,1656160063,1638386073.8,77.42763291398532,68.92868913755211,NaN,NaN,23.54590177062022,25.80400407548618
2020-12-30T09:30:00-05:00,29.09,29.205,29.02,29.12,16616701,42602735.75,62.99417646111319,60.96827131429854,NaN,NaN,150.52962471883913,149.0196643547631,-0.05522700324528279,0.44475614674129815,0.49998314998658094,1672776764,1657303469.4,79.36134031981244,69.03256399405338,NaN,NaN,23.859379499641495,25.526200564651226
2020-12-31T09:30:00-05:00,29.08,29.52,29,29.48,26239297,41041112.3,66.89145928506488,61.048358502334864,NaN,NaN,189.22213935294525,161.04740745036912,-0.027575870958831072,0.4655133112880421,0.49308918224687315,1699016061,1670932437.6,80.6476170727538,69.33008121999958,NaN,NaN,25.2583805597858,25.487940563956165
2021-01-04T09:30:00-05:00,29.59,29.6,28.83,29.08,47086344,40917128.65,59.40529764571539,60.936295754843364,NaN,NaN,115.82711627192622,159.7574278495134,-0.038821569689682256,0.4445622201347703,0.48338378982445257,1651929717,1671929935.8,80.7422174861781,70.21918577708128,NaN,NaN,24.289494971574612,25.3167340507588
2021-01-05T09:30:00-05:00,29.07,29.335,28.92,29.21,35265353,40044740,60.93546602001867,61.29080479505637,NaN,NaN,102.18813802793645,141.50723764908233,-0.039945686401746394,0.43345168182226956,0.47339736822401596,1687195070,1673415535,80.89202974821896,71.63695505070373,NaN,NaN,23.926772782542336,25.118168155299305
2021-01-06T09:30:00-05:00,29.77,30.74,29.77,30.5,102254861,43425948.15,72.15266715658332,62.08845230200317,NaN,NaN,303.6123516986536,172.27587401406012,0.039452670791477185,0.5227132067133624,0.4832605359218852,1789449931,1700073508.6,83.38916821184145,73.43985399855815,NaN,NaN,27.659860000750946,25.481266990363824
2021-01-07T09:30:00-05:00,30.95,31.26,30.88,30.94,64342738,45061657.65,74.80962211173365,63.04073493357448,NaN,NaN,306.46472290543016,203.46289365137835,0.11082382670314594,0.6217903193008176,0.5109664925976717,1853792669,1736276689.6,86.05457811226276,75.30111186650485,NaN,NaN,31.677941073337994,26.36650614507442
2021-01-08T09:30:00-05:00,31.09,31.1,30.51,30.92,54266408,45395500.5,74.46184867846146,63.90965069205727,NaN,NaN,216.88728201398618,208.99592218358652,0.14381357916159854,0.6907334665496698,0.5469198873880713,1799526261,1756378729.6,87.27550912529685,77.12690238001903,NaN,NaN,34.60222432954394,27.54303731428435
2021-01-11T09:30:00-05:00,30.62,31.07,30.49,31.02,56591307,46160230.75,75.08550554557094,65.12035702358205,NaN,NaN,172.9619712814204,220.42289318548538,0.15834757359078544,0.7448543543765531,0.5865067807857677,1856117568,1797216299.8,89.3209879548879,78.99774197094436,NaN,NaN,37.121437807921254,28.911380241946766
2021-01-12T09:30:00-05:00,31.2,31.49,31.105,31.34,60546586,46776743.1,77.01948013482257,66.2835818382258,NaN,NaN,171.3570589171659,234.25667736333125,0.17423094031966346,0.804295456185347,0.6300645158656836,1916664154,1843110116.6,91.06022953479825,80.62939512567729,NaN,NaN,39.868549383324925,30.476690119286502
2021-01-13T09:30:00-05:00,31.29,31.4,31.0924,31.32,55394727,47631336.4,76.61916610969608,67.74469237166299,NaN,NaN,136.3573051632419,200.80566805624892,0.16803232188006512,0.8401049182157649,0.6720725963356998,1861269427,1857474015.8,91.52543936083222,82.14450518863005,NaN,NaN,41.93457201322904,32.11353038984972
2021-01-14T09:30:00-05:00,31.41,31.62,31.29,31.46,49828818,48190920.6,77.50072527523704,68.89381014001984,NaN,NaN,125.82571879604893,164.67786723437266,0.15814593131716148,0.8697550104821516,0.7116090791649902,1911098245,1868935131,91.88816706027475,83.55010951422238,NaN,NaN,43.91418315402218,33.799337927588645
2021-01-15T09:30:00-05:00,31,31.19,30.71,30.94,68732671,48847413.55,67.34406781685888,69.28752986444572,NaN,NaN,79.34034792031976,137.1684804156394,0.10398627287441975,0.8415919202580149,0.7376056473835951,1842365574,1877502993.6,92.15837607798976,84.88615400970824,NaN,NaN,42.568428045728446,35.0520650873229
2021-01-19T09:30:00-05:00,31.1,31.18,30.83,31.02,97441489,51793945.3,68.03805205303345,69.62364510216678,NaN,NaN,74.27373484655888,117.43083312866709,0.06296971917094318,0.8163177963472741,0.7533480771763309,1939807063,1894240892.6,92.67192727349449,86.02965858947336,NaN,NaN,41.67840714936328,35.998685381900096
2021-01-20T09:30:00-05:00,31.12,31.12,30.78,30.89,55765702,51778225.4,65.59844915315777,69.91828453193337,NaN,NaN,62.08325335416547,95.576072016067,0.01879593428640125,0.7768429950343325,0.7580470607479313,1884041361,1887716334,90.19232406871282,86.94142224338248,NaN,NaN,40.227516619635914,36.60280413014807
2021-01-21T09:30:00-05:00,30.87,30.93,30.56,30.56,43733020,50081636.25,59.7423939499778,69.68601435256656,NaN,NaN,40.69838237459015,76.44428745833666,-0.03784745163913272,0.7107377461990154,0.7485851978381481,1840308341,1883524116.8,88.55281550038232,87.59795618485175,NaN,NaN,37.20209150093242,36.688416611688695
2021-01-22T09:30:00-05:00,30.25,30.46,30.2,30.34,37928042,49860918.15,56.14400266931486,68.918338880013,NaN,NaN,11.218578845071182,53.5228594681411,-0.09223099701388993,0.6332964515707857,0.7255274485846757,1802380299,1861780527.6,80.39037020491725,87.57958140857771,NaN,NaN,33.55272446595483,36.240460590869574
2021-01-25T09:30:00-05:00,30.04,30.16,29.74,30.12,68321478,50642920.35,52.72405654193701,68.44110737260024,NaN,NaN,-19.453718970596533,33.764046089957844,-0.142137029700104,0.5478561614595456,0.6899931911596496,1734058821,1840119177,73.15590734250377,87.03770211260097,NaN,NaN,29.421152770556485,35.26627375939628
2021-01-26T09:30:00-05:00,30.24,30.28,29.855,29.88,55504593,52614599.7,49.202941575409014,67.60306991227098,NaN,NaN,-26.42741020544195,13.623817079557677,-0.187572881712062,0.4555270890195722,0.6430999707316342,1678554228,1787868610,59.294512748865245,85.49502232693284,NaN,NaN,24.823264685909407,33.774415320326725
2021-01-27T09:30:00-05:00,29.47,29.5,28.935,29,84059225,55176318.55,38.935293873492,65.23040039205017,NaN,NaN,-103.87156082132985,-19.567145755541386,-0.2682408769413208,0.3077988745549831,0.5760397514963039,1594495003,1729959338.4,48.35823061275112,82.99281249842639,NaN,NaN,16.796794204461733,31.349040875203155
2021-01-28T09:30:00-05:00,29.37,29.88,29.28,29.54,62982771,57145106.55,46.33578351799903,63.19655477821198,NaN,NaN,-71.1755647459358,-41.941935179646585,-0.27553048953250037,0.23162663958067853,0.5071571291131789,1657477774,1693393225,42.96901033662576,79.91527194302375,NaN,NaN,12.485500800744617,28.654249435994792
2021-01-29T09:30:00-05:00,29.46,29.54,28.8231,28.95,78260672,60227305.1,40.55300964721447,60.774494847408626,NaN,NaN,-114.39688290424039,-67.0650275295089,-0.30793179031832435,0.12224239121527347,0.4301741815335978,1579217102,1648760585.6,37.47868225002762,76.35835573764737,NaN,NaN,6.733569785961683,25.52272377170435
2021-02-01T09:30:00-05:00,29.27,29.37,29.02,29.33,41947408,61012710.65,45.28899810288802,58.64617288721699,NaN,NaN,-100.45448697379463,-83.26518113014852,-0.29176910830103664,0.065462796157302,0.35723190445833863,1621164510,1626181723.4,35.039548507316866,72.48111006282089,NaN,NaN,3.7565284322296875,22.41326729463654
2021-02-02T09:30:00-05:00,29.67,30.19,29.655,30.04,54263012,61371544.05,52.847637931724904,56.919612729852865,NaN,NaN,-39.353871735096575,-85.85047343607944,-0.2242899073258916,0.07686952030097416,0.30115942762686576,1675427522,1625556382.2,34.97166453022153,68.47478399106541,NaN,NaN,3.9890478944895573,19.7812359517584
2021-02-03T09:30:00-05:00,30,30.22,29.94,30.21,46195153,61918034.05,54.469618074713274,55.33750215592552,NaN,NaN,-30.334342673048518,-71.14302980642317,-0.16213421404691114,0.09849166006822685,0.260625874115138,1721622675,1650981916.6,40.05662626849219,64.79844019875542,NaN,NaN,4.7326780658735315,17.631441968060564
2021-02-04T09:30:00-05:00,30.31,30.89,30.3,30.88,63061753,59958378.65,60.27017037693993,54.10674823461859,NaN,NaN,27.760304838952255,-51.35585588944556,-0.07429512782847447,0.1677569643295449,0.24205209215801937,1784684428,1676423247.4,44.71512322720425,61.4289370678218,NaN,NaN,7.455000094094872,16.177664557494037
2021-02-05T09:30:00-05:00,31.1,31.13,30.82,30.89,38461884,58664335.95,60.351361064231874,53.607269180859525,NaN,NaN,55.4596581591726,-17.384547676762963,-0.016913183027353007,0.2209106133738281,0.23782379640118112,1823146312,1725209089.4,52.36067595967574,58.58624420222794,NaN,NaN,9.550346481034968,15.230904832285598
2021-02-08T09:30:00-05:00,30.99,31.29,30.99,31.29,48721641,58387097.6,63.55926475201426,53.287355802215295,NaN,NaN,77.4237063863934,18.19109099527463,0.043298196674827955,0.29194654224471606,0.2486483455698881,1871867953,1775349778,58.6847140553975,56.158586115221006,NaN,NaN,12.364303801737636,14.821390399350175
2021-02-09T09:30:00-05:00,31.19,31.395,31.08,31.3,33571958,57236130.15,63.6384710773943,53.14735736823219,NaN,NaN,80.19262482678705,42.10039030765135,0.07713905710172525,0.3450721669470447,0.26793310984531943,1905439911,1821352255.8,63.47532459562281,54.25022901000029,NaN,NaN,14.595029934747284,14.78905319012119
2021-02-10T09:30:00-05:00,31.46,31.5,31.15,31.3,38899638,56153782.75,63.63847107739431,53.42564859161909,NaN,NaN,85.9907439328937,65.36540762883979,0.0918634009528349,0.3827623610363631,0.29089896008352817,1905439911,1858115703,66.78949800938548,52.69570633207194,NaN,NaN,16.382994334333205,15.016759067865765
2021-02-11T09:30:00-05:00,31.32,31.435,30.99,31.2,31909483,54979520.55,62.07370378120549,53.849198671039844,NaN,NaN,75.75944894833529,74.9652364507164,0.08724286647262108,0.3999525431743045,0.3127096767016834,1873530428,1875884903,68.28731321127685,51.83120226109763,NaN,NaN,17.442729266747246,15.363326239134548
2021-02-12T09:30:00-05:00,31.17,31.55,31.14,31.52,38271828,54401671.05,65.03636041226305,54.728648947491706,NaN,NaN,96.01605616626178,83.07651605213425,0.09734412774273804,0.434389836380106,0.33704570863736794,1911802256,1893616091.8,69.75325298988983,51.588155521625204,NaN,NaN,19.221026026070074,15.914426208696765
2021-02-16T09:30:00-05:00,31.84,32.21,31.701,32.06,71330493,54531562.15,69.38281030417721,56.170068142403714,NaN,NaN,140.10068809534926,95.61191239392542,0.12996121965532925,0.4994972332065295,0.36953601355120025,1983132749,1915869051,71.53184760972923,52.46225086882977,NaN,NaN,22.165818387887736,16.807482234295474
2021-02-17T09:30:00-05:00,31.96,32.26,31.85,32.22,60611463,52690060.85,70.55096411441635,58.428330302469746,NaN,NaN,136.6298793984025,106.89936330824851,0.15043403599649208,0.5575785585468154,0.4071445225503233,2043744212,1943529911.2,73.60921452340983,54.265892576733975,NaN,NaN,24.958575697051145,17.971924157546283
2021-02-18T09:30:00-05:00,31.99,32.198,31.77,32.03,45188234,52161187.45,67.26875392393839,59.92354247432255,NaN,NaN,114.84554531663623,112.670323584997,0.1395427848869747,0.5815730036590416,0.44203021877206694,1998555978,1962153124.6,74.93535377296685,56.54920282218692,NaN,NaN,26.371408745734083,19.171850527287397
2021-02-19T09:30:00-05:00,32.24,32.52,32.2,32.41,54330760,52691074.45,70.24979573613132,62.04474148067375,NaN,NaN,126.94178965492702,122.90679172631535,0.1456221034451411,0.6240578480784933,0.4784357446333522,2052886738,1998024386.6,77.30134759607054,59.39367891833284,NaN,NaN,28.504087751571856,20.50502727361375
2021-02-22T09:30:00-05:00,32.3,32.83,32.29,32.71,65930222,54091183.45,72.38789281589425,63.98037681731705,NaN,NaN,126.5200638425795,129.0075932615789,0.15658224303653245,0.6741635484290178,0.5175813053924854,2118816960,2039427327.4,79.684976157502,62.58263803620321,NaN,NaN,30.97827373610855,22.001205339684436
2021-02-23T09:30:00-05:00,32.94,32.95,32.57,32.91,94301211,55390170.1,73.74271028790102,65.47288198561535,NaN,NaN,126.43966328188715,126.2753882988865,0.16328838907920518,0.7216917917414918,0.5584034026622866,2213118171,2085424411.8,81.95244198541253,65.93840785443113,NaN,NaN,33.459965479095665,23.63817107388604
2021-02-24T09:30:00-05:00,32.96,33.64,32.94,33.55,66000610,55914970.95,77.5403883250556,67.12079414635409,NaN,NaN,147.50278016316247,128.4499684518385,0.19468427193336824,0.8017587425789969,0.6070744706456287,2279118781,2132499325.6,83.92940799540966,69.07217797778239,NaN,NaN,36.955116071383806,25.54059178781429
2021-02-25T09:30:00-05:00,33.82,33.84,32.85,32.94,92168956,56320457.5,67.51697242382221,67.63842286398854,NaN,NaN,126.13651106233601,130.70816160097846,0.15969357483443747,0.8066914391886755,0.646997864354238,2186949825,2170178095,85.31590752615244,71.97223399913582,NaN,NaN,36.71323368839986,27.136683487897944
2021-02-26T09:30:00-05:00,32.89,32.99,32.19,32.31,103105676,58326602.75,59.02994585173186,67.54403606309566,NaN,NaN,70.19782864722545,119.35936939943812,0.08328699846791121,0.751106612439127,0.6678196139712158,2083844149,2176369577.2,85.53672683291188,74.3419519186527,NaN,NaN,33.55660620182384,28.05381530417307
2021-03-01T09:30:00-05:00,32.86,33.52,32.86,33.32,67590104,57793074.35,66.33587478754193,67.74236535134764,NaN,NaN,109.90157294904414,116.03567122073105,0.08939825106861221,0.7795674278069811,0.6901691767383689,2151434253,2182893035.8,85.779374761354,76.27728482622102,NaN,NaN,33.43670887358303,28.822800099803064
2021-03-02T09:30:00-05:00,33.28,33.47,33.17,33.2,49987015,58195054.7,64.85607112615773,67.82933678340217,NaN,NaN,105.87966970724581,111.92367250580278,0.07459200145872558,0.7834091785617758,0.7088171771030503,2101447238,2160558849.2,80.78243783742883,77.51350720063571,NaN,NaN,32.830238860510946,29.395291351332762
2021-03-03T09:30:00-05:00,33.33,33.955,33.29,33.46,72541660,59108987.1,66.59485568371622,68.04050711242517,NaN,NaN,118.69016707320401,106.16114988781109,0.0715319367642906,0.7982320980584134,0.7267001612941228,2173988898,2139532872.6,76.27750628042405,78.19122207713848,NaN,NaN,32.92495904320279,29.89952959302848
2021-03-04T09:30:00-05:00,33.37,33.689,32.6,33.08,101311514,61864805.15,61.783546881468595,68.01978161958682,NaN,NaN,76.2280427145298,96.17945621824985,0.03498822626463549,0.7704354441249173,0.7354472178602818,2072677384,2116678384.4,71.60333624504639,78.42808086526487,NaN,NaN,31.41349636123398,30.11581055991498
2021-03-05T09:30:00-05:00,33.64,33.795,32.78,33.71,109299834,64176709.2,66.14994707958041,68.0993235243952,NaN,NaN,93.66114445223945,100.87211937925265,0.043749392161079315,0.7901339580616309,0.7463845659005516,2181977218,2136304998.2,73.12631485973131,78.66901385596783,NaN,NaN,31.585848913971226,30.325816039065874
2021-03-08T09:30:00-05:00,33.96,34.58,33.82,34.14,90538153,66780522.65,68.77249279368033,68.05572941650257,NaN,NaN,144.06665230194724,107.70513524983328,0.06758425561000414,0.8308648854130567,0.7632806298030526,2272515371,2160521221.8,74.91404840991262,78.9105996274095,NaN,NaN,32.60657236053087,30.65163837070373
2021-03-09T09:30:00-05:00,33.87,34.3291,33.5201,33.83,117224570,70205669.1,64.87047949756624,67.64998051529899,NaN,NaN,108.64942578711562,108.25908646580724,0.05223844831704394,0.8285786901993575,0.7763402418823135,2155290801,2171289934.4,75.68856065717478,79.05912435124985,NaN,NaN,32.1629477599436,30.86753971202371
2021-03-10T09:30:00-05:00,33.99,34.65,33.93,34.52,73262073,72190174.85,69.07618727193267,67.77908289729858,NaN,NaN,136.07905211764486,111.73686347469541,0.0768380100620355,0.872387754459858,0.7955497443978224,2228552874,2182202729.6,76.48101312335132,79.16952859056303,NaN,NaN,33.19470905636938,31.199992475501663
2021-03-11T09:30:00-05:00,34.34,34.69,34.14,34.42,50900116,72790198.75,67.80914606535958,67.60475077795773,NaN,NaN,128.6111798686221,122.21349090551386,0.07459392179047364,0.8887921466359145,0.8141982248454409,2177652758,2203197804.4,77.96888370616053,79.21720974128375,NaN,NaN,33.60265099036088,31.543229406195838
2021-03-12T09:30:00-05:00,34.82,34.9499,34.66,34.77,68125959,74601022.55,69.89082597340756,67.42638886063726,NaN,NaN,152.01118828865134,133.88349967279623,0.08419032663322823,0.9194361331369763,0.835245806503748,2245778717,2215958104.2,78.84485657822066,79.1572011999065,NaN,NaN,34.59556091386999,31.979276764435003
2021-03-15T09:30:00-04:00,34.9,34.91,34.25,34.57,57858586,75580360.45,67.21596907885609,66.9601930599912,NaN,NaN,122.84281165907828,129.63873154422245,0.06541346188833597,0.917012633864168,0.851599171975832,2187920131,2199039056.2,74.60896443225622,78.63266708896677,NaN,NaN,34.597278054476135,32.353276948726595
2021-03-16T09:30:00-04:00,34.39,34.43,33.94,34.21,67404134,75384042.5,62.57370902052821,65.89114453823925,NaN,NaN,77.60081331132939,123.42900904906521,0.019477179002458156,0.8759456457289048,0.8564684667264466,2120515997,2192084095.4,72.875727725397,77.84311849825157,NaN,NaN,33.18891967236973,32.472654480675615
2021-03-17T09:30:00-04:00,34.46,34.64,34.08,34.44,64051120,75556025.35,64.27149097523763,65.65932443476892,NaN,NaN,86.23729017234857,113.46065666000595,-0.00346601593219531,0.8521359468112024,0.8556019627433977,2184567117,2183286944,70.64034574700726,76.7948640854555,NaN,NaN,32.515709420130854,32.47880518631208
2021-03-18T09:30:00-04:00,34.79,35.29,34.5,34.62,96687416,78130984.45,65.5871843386531,66.12769861240615,NaN,NaN,114.07272726971533,110.55296614022461,-0.013977852038321581,0.8381296476954958,0.8521074997338174,2281254533,2204007299,72.75977688292524,75.8822248033136,NaN,NaN,32.333541310968755,32.458053204120176
2021-03-19T09:30:00-04:00,34.35,34.38,33.86,34.22,98506969,80339794.9,60.275269302545226,65.69479822062067,NaN,NaN,43.121850259108214,88.77509853431599,-0.05312929210951878,0.7856958845969189,0.8388251767064376,2182747564,2191401068.4,69.47381688945681,74.71754209817809,NaN,NaN,30.61002390986729,32.19404901922691
2021-03-22T09:30:00-04:00,33.82,33.89,33.512,33.63,68170640,80451815.8,53.40476179024964,64.87684755377009,NaN,NaN,-13.957127601184354,61.415110682263446,-0.1201833616431669,0.688595974652479,0.8087793362956459,2114576924,2176732427,65.75269578962991,73.64398909476388,NaN,NaN,26.943188406144948,31.443926074500915
2021-03-23T09:30:00-04:00,33.43,33.6617,33.04,33.16,70441893,79258849.9,48.64766299520213,63.594905218876235,NaN,NaN,-64.36345990342699,33.022256039312175,-0.19327913178365963,0.5671804215660714,0.760459553349731,2044135031,2161456233.8,62.0267089467966,72.62607499950477,NaN,NaN,22.284349192077013,30.1354150912975
2021-03-24T09:30:00-04:00,33.4,33.8,33.28,33.28,63357120,79126675.4,49.87533331882636,62.74431853583037,NaN,NaN,-45.152913905411395,6.744215223760182,-0.22823697787143093,0.4751633310104424,0.7034003088818733,2107492151,2146041240.6,58.42866396714994,71.68502697965502,NaN,NaN,18.872035254133156,28.52636082884545
2021-03-25T09:30:00-04:00,33.26,33.89,33,33.84,60532633,77544859.25,55.25170739759805,61.9658728442602,NaN,NaN,-33.54973200820472,-22.780276631823824,-0.2088581936403714,0.44232756683140906,0.6511857604717805,2168024784,2123395290.8,53.517177659937715,70.28437432252692,NaN,NaN,17.516250575766616,26.953487935548473
2021-03-26T09:30:00-04:00,34.19,34.43,33.945,34.37,53771233,75078137.1,59.66161063764962,61.31509554740085,NaN,NaN,43.953275680432554,-22.613991547558953,-0.1578766299357972,0.45383997305203394,0.6117166029878311,2221796017,2131204981.4,54.92438035768607,68.85654089022502,NaN,NaN,17.74443549266486,25.63790901513653
2021-03-29T09:30:00-04:00,33.89,34.29,33.72,34.07,71777771,75287520.45,56.280637884434675,60.701535432177174,NaN,NaN,8.234330417216782,-18.175699943878726,-0.14236842231111768,0.433756075098934,0.5761244974100517,2150018246,2138293245.8,56.2198643062942,67.46591972230497,NaN,NaN,16.88239059124039,24.387120668865652
2021-03-30T09:30:00-04:00,34.25,34.4683,34.21,34.31,55011351,75538737.25,58.31577242831302,59.93293437191862,NaN,NaN,48.637293520674525,4.424450740941576,-0.11512116801982497,0.43222303738527046,0.5473442054050954,2205029597,2170472159,61.61353685182357,66.40395713148156,NaN,NaN,16.789986285783773,23.301815756996813
2021-03-31T09:30:00-04:00,34.24,34.38,34.03,34.05,51138343,74468571.4,55.31187906441903,59.04027244328,NaN,NaN,16.83028784199102,16.82109109042206,-0.11359090027523211,0.4053555800610553,0.5189464803362874,2153891254,2179751979.6,63.02813072733207,65.33676049013667,NaN,NaN,15.815955365352796,22.232407129619098
2021-04-01T09:30:00-04:00,34,34.47,34,34.47,51690145,71987502.95,58.98706995975506,58.26143272801911,NaN,NaN,38.77044236027692,31.28512596411836,-0.08460485260628559,0.4131904145784304,0.497795267184716,2205581399,2187263302.6,64.17881239868133,64.28918590588385,NaN,NaN,16.09081422786538,21.355036715082854
2021-04-05T09:30:00-04:00,34.84,34.905,34.63,34.74,51789970,69112009.75,61.196392235640744,57.831462953503724,NaN,NaN,120.10149139383843,46.514769106799534,-0.04930936850334067,0.43615855655554014,0.4854679250588808,2257371369,2194378373,65.2811055802278,63.62291027359612,NaN,NaN,16.98629975058176,20.73093143443984
2021-04-06T09:30:00-04:00,34.66,34.83,34.545,34.67,41336786,66651941.4,60.28961677883064,57.66831350766819,NaN,NaN,92.87513174844514,63.4429293730452,-0.03349511915029374,0.44359902612101365,0.4770941452713074,2216034583,2207581640.4,67.29247447921549,63.224106470297436,NaN,NaN,17.45962842855265,20.263602433598813
2021-04-07T09:30:00-04:00,34.77,34.9181,34.6,34.84,38660831,62723754.45,61.77111499673912,57.489715223489725,NaN,NaN,103.09555467021453,74.3345816029532,-0.01532775793898955,0.4579344478475704,0.47326220578656,2254695414,2217514803.8,68.75884515421298,63.08971357081213,NaN,NaN,18.276342396458567,19.979708142578776
2021-04-08T09:30:00-04:00,34.71,34.89,34.47,34.85,39927402,61057020.9,61.86125119954105,57.223577142124576,NaN,NaN,85.9437861375407,88.15728126206314,-0.006813766047115588,0.46474499822766546,0.47155876427478105,2294622816,2245661116.2,72.51855439229446,63.07248339290993,NaN,NaN,18.97457576060963,19.83611780229747
2021-04-09T09:30:00-04:00,35.09,35.17,34.89,35.15,40133729,60518701.55,64.5608363425931,57.529689073556575,NaN,NaN,130.48766533452704,106.50072585691316,0.013726015906724676,0.4887162841581869,0.47499026825146223,2334756545,2271496145.4,75.44017960107459,63.49865215802549,NaN,NaN,20.333422619901047,19.90716134766941
2021-04-12T09:30:00-04:00,35.22,35.31,35.14,35.3,44435497,59334178.45,65.86197525335042,58.41949003520663,NaN,NaN,148.97559838796008,112.27554725573751,0.031122666843354574,0.5138936018056555,0.4827709349623009,2379192042,2295860280,77.83353943459693,64.36156956123742,NaN,NaN,21.849827789400848,20.184685125059612
2021-04-13T09:30:00-04:00,35.1,35.14,34.78,34.97,39950895,58438793.9,60.59139404566383,59.272613681668176,NaN,NaN,95.06610563351511,112.71374203275147,0.014933889476579698,0.5014382968080255,0.48650440733144584,2339241147,2320501592.8,79.96053449118159,65.64255710012206,NaN,NaN,21.75341879925132,20.40878993565843
2021-04-14T09:30:00-04:00,34.88,35.43,34.825,35.18,44065279,57271851.15,62.640278315842494,60.18439546716933,NaN,NaN,107.44970874067452,113.58457284684349,0.012970559873962728,0.5027176071738992,0.4897470472999365,2383306426,2346223795.2,81.91171120427492,67.31991761705955,NaN,NaN,22.235484781323738,20.669746342182044
2021-04-15T09:30:00-04:00,35.26,35.3,34.82,35.15,55483534,56843471.85,62.143220672057936,60.67664641534503,NaN,NaN,88.06854748350561,114.00952511603649,0.004680584473345073,0.49559777789161785,0.4909171934182728,2327822892,2352863810.4,82.3884213152374,69.38214930672382,NaN,NaN,22.50583449059688,20.93204464909845
2021-04-16T09:30:00-04:00,35.46,35.525,35.24,35.4,39115658,53964883.95,64.65988056706755,61.03366569601774,NaN,NaN,116.91804038045622,111.29560012522231,0.010718042133217587,0.5043147460847948,0.4935967039515772,2366938550,2359300211.4,82.85997065876006,71.37754861394339,NaN,NaN,23.425100103160624,21.28819542825019
2021-04-19T09:30:00-04:00,35.39,35.49,35.18,35.3,31172291,50598150.05,62.85977344190421,61.50360395012272,NaN,NaN,97.33665349591423,100.96781114681313,0.003058552837703843,0.497419894998707,0.49436134216100314,2335766259,2350615054.8,79.75673011456442,73.05875331453412,NaN,NaN,23.734744637212653,21.63770245810197
2021-04-20T09:30:00-04:00,35.09,35.11,34.52,34.64,50227704,49701003.25,52.47604807890506,61.086480782307866,NaN,NaN,24.582735328812024,86.87113708587252,-0.048529257168397066,0.4336997707005068,0.48222902786890387,2285538555,2339874536.4,75.96766792482134,74.08404839117681,NaN,NaN,20.95899493409188,21.540744240386243
2021-04-21T09:30:00-04:00,34.52,35.15,34.415,35.12,39680014,48162909.3,57.92026435570253,61.272794017399534,NaN,NaN,37.281731459966934,72.83754162973099,-0.05208342457188453,0.41712474715404824,0.46920817172593277,2325218569,2328256965,71.98406927068109,74.72375828713031,NaN,NaN,20.15372334102863,21.34259839762087
2021-04-22T09:30:00-04:00,35.08,35.13,34.675,34.73,43611151,47175610.85,52.64341242515086,60.819675622070655,NaN,NaN,23.160477716858786,59.855927676401635,-0.080747378891449,0.3682739481116215,0.4490213270030705,2281607418,2319013870.2,68.88891113111069,75.06019391087526,NaN,NaN,17.78965223231402,20.83503465971989
2021-04-23T09:30:00-04:00,34.73,35.53,34.675,35.38,50468640,46672411.2,59.29895367692076,60.684144296447805,NaN,NaN,83.08616927077925,53.08955345446624,-0.05709263936185244,0.37765552780075495,0.4347481671626074,2332076058,2312041371.8,66.56381789625057,75.1518162191626,NaN,NaN,17.897683181252567,20.415413019938846
2021-04-26T09:30:00-04:00,35.51,35.85,35.48,35.52,43749697,46171334.4,60.58387423181299,60.70516268594655,NaN,NaN,152.77967217341973,64.17815718996734,-0.03430245951612759,0.3918700927674479,0.4261725522835755,2375825755,2320053271,67.90432554202087,75.19551986650585,NaN,NaN,18.39604019526577,20.126931187842693
2021-04-27T09:30:00-04:00,35.57,35.85,35.49,35.8,50852378,45125064.75,63.09338788092273,60.79961074910251,NaN,NaN,156.4850809801735,90.55862632023964,-0.004236212639069203,0.420877286484739,0.4251134991238082,2426678133,2348281186.6,72.14202518563664,75.43717558303612,NaN,NaN,19.606987165200874,20.052653470322433
2021-04-28T09:30:00-04:00,35.94,36.04,35.83,35.94,35771677,44163081.05,64.31669468345231,60.97499956938189,NaN,NaN,176.59230520530295,118.42074106930686,0.01988959200000584,0.44997548912381546,0.4300858971238096,2462449810,2375727434.8,75.5256602002411,75.65196885503231,NaN,NaN,20.968732097497565,20.183521845633166
2021-04-29T09:30:00-04:00,36.22,36.61,36.19,36.58,48573019,44034814.85,69.32263716142111,61.31512819929817,NaN,NaN,235.8513542463309,160.95891637520126,0.0708908274900355,0.518699431486354,0.4478086039963185,2511022829,2421610517,79.91716423981728,75.97175347208534,NaN,NaN,23.841843035177003,20.70613915842514
2021-04-30T09:30:00-04:00,36.38,36.51,36.2025,36.26,43940862,43647350.7,64.45381309130269,61.21454518772334,NaN,NaN,177.85943787697082,179.91357009643957,0.07463696153334604,0.541104805913001,0.466467844379655,2467081967,2448611698.8,81.96770402744372,76.26705094300299,NaN,NaN,24.67225908203991,21.27272771894154
2021-05-03T09:30:00-04:00,36.57,36.64,36.3,36.44,33320594,42723881.9,65.90443460187842,61.594048084595805,NaN,NaN,164.34903100224747,182.22744186220513,0.08030685411254895,0.5668514120203412,0.4865445579077922,2500402561,2473527060,83.62879323143339,76.52906942444953,NaN,NaN,25.801272139264082,21.919662636130475
2021-05-04T09:30:00-04:00,36.28,36.73,36.04,36.73,66939714,44004028.3,68.15897639244378,61.98824080435304,NaN,NaN,142.1672977206839,179.36388521030722,0.09372220358961203,0.6036973123948073,0.5099751088051953,2567342275,2501659888.4,85.2778788655169,76.7695099716811,NaN,NaN,27.451201670608157,22.709882498198716
2021-05-05T09:30:00-04:00,36.84,37.17,36.84,37.03,25780978,43360035.65,70.34364751608524,62.57398557892642,NaN,NaN,171.46762492634448,178.33894915451552,0.11171356538655863,0.6496170655383935,0.5379035001518349,2593123253,2527794577,86.62567160739279,77.07217070683507,NaN,NaN,29.522998440518055,23.683184775672906
2021-05-06T09:30:00-04:00,37.18,37.59,36.96,37.58,43332915,43530311.3,73.88174161879994,63.23268993976445,NaN,NaN,176.65866274216324,166.50041085368198,0.14732974428037537,0.722065680502304,0.5747359362219286,2636456168,2552881244.8,87.7819561949091,77.42374110227429,NaN,NaN,32.50346007090471,24.943224103563164
2021-05-07T09:30:00-04:00,37.15,37.79,37.06,37.78,64616660,44754457.85,75.04752347022716,64.10324351321609,NaN,NaN,160.23224823910212,162.97497292610825,0.16945378150536372,0.7865531631036333,0.6170993815982696,2701072828,2599679417,89.59001820030615,78.1261188226844,NaN,NaN,35.30605822689652,26.423628978325073
2021-05-10T09:30:00-04:00,37.98,38.26,37.72,37.75,56341073,45349736.65,74.51028728522896,65.67711774223922,NaN,NaN,161.18735118821397,162.34263696330154,0.16689714500588715,0.8257208128556286,0.6588236678497414,2644731755,2628545255.8,90.52172823550818,79.16569455916203,NaN,NaN,37.39220723824908,27.990568729742787
2021-05-11T09:30:00-04:00,37.37,37.7099,36.935,37.08,82719020,47488142.9,63.56590279601908,66.08037763083325,NaN,NaN,94.51769248790991,152.81271591674673,0.10778146627336882,0.7935505006914525,0.6857690344180837,2562012735,2627479347.8,90.20068696073481,80.46688153702301,NaN,NaN,35.83024157099179,29.11052199277836
2021-05-12T09:30:00-04:00,37.37,37.51,36.55,36.7,97911948,50180476.35,58.332555192047515,66.48674497132588,NaN,NaN,62.35698374516605,130.99058768051103,0.03457608390664535,0.7289891393013903,0.694413055394745,2464100787,2601674854.6,82.56634852945572,81.44384135119051,NaN,NaN,32.82132835900029,29.640637187952922
2021-05-13T09:30:00-04:00,36.56,37.515,36.54,37.29,66882590,50750429.15,63.374438117294645,66.77785100278115,NaN,NaN,70.74911420244312,109.80867797256698,0.01820142338862829,0.7171648346305304,0.6989634112419021,2530983377,2580580296.4,76.84084755133433,82.17791489798222,NaN,NaN,31.846935965463707,29.95582272759732
2021-05-14T09:30:00-04:00,37.5,37.975,37.46,37.88,44850183,51037155.4,67.59691199769111,67.27878227177247,NaN,NaN,111.73456086759158,100.10914049826489,0.038264060367865005,0.7467934867017334,0.7085294263338684,2575833560,2555532442.8,70.582069270479,82.3691823071578,NaN,NaN,32.44830032869027,30.311890956324884
2021-05-17T09:30:00-04:00,37.76,37.99,37.61,37.95,40376669,51497374.3,68.0672923066375,67.63406115932352,NaN,NaN,107.81403853352035,89.43447796732616,0.046840776209438495,0.7670803965956665,0.720239620386228,2616210229,2549828137.6,69.19971722040698,82.15901745249855,NaN,NaN,33.06779040372628,30.705590877382225
2021-05-18T09:30:00-04:00,37.92,38.05,37.4,37.42,40299245,51000951.35,60.86318873698853,67.38738216314754,NaN,NaN,81.83893858249374,86.89872718624292,0.009371375689945394,0.7319538399986598,0.7225824643087144,2575910984,2552607787.4,69.51305316725345,81.72954552157084,NaN,NaN,31.235804406810413,30.78133566730054
2021-05-19T09:30:00-04:00,36.99,37.21,36.59,37.19,63573906,52195645.95,57.99461641931919,66.57823782442595,NaN,NaN,24.752443434377764,79.37781912408526,-0.0358706907282107,0.677744100898451,0.7136147916266617,2512337078,2562255045.6,70.62981534315941,81.06616345752386,NaN,NaN,28.83004821733783,30.502580317305867
2021-05-20T09:30:00-04:00,37.25,37.465,36.95,37.21,59216120,52975894.4,58.17919882100323,66.13005109083315,NaN,NaN,37.87573637205758,72.80314355800814,-0.0675766771549895,0.6291439451829248,0.6967206223379143,2571553198,2570369009.8,71.57298935005468,80.32368383771036,NaN,NaN,26.975196514381256,29.998668345459492
2021-05-21T09:30:00-04:00,37.36,37.78,37.34,37.58,44950309,52699977.85,61.54575622744989,65.81871692123111,NaN,NaN,70.91213030067222,64.63865744462427,-0.06664622742769721,0.6134128380532928,0.68005906548099,2616503507,2578502999.2,72.5255006403348,79.53059150977474,NaN,NaN,26.38291924309782,29.482132759407826
2021-05-24T09:30:00-04:00,37.74,37.85,37.55,37.76,29159629,51970474.45,63.10191177492116,65.4574980199795,NaN,NaN,83.66717400267835,59.809284538455884,-0.05728212339597616,0.6084564112360198,0.665738534631996,2645663136,2584393580.6,73.2251889183148,78.66968508497459,NaN,NaN,26.347951963895216,29.034392645763166
2021-05-25T09:30:00-04:00,37.81,38.1,37.33,37.38,38755863,51365648.7,57.785446535431646,64.56048366421852,NaN,NaN,63.472468541809995,56.135990530319134,-0.07873018423175415,0.5673258043423033,0.6460559885740574,2606907273,2590592838.4,73.97630992414702,77.76615925045704,NaN,NaN,24.723479418047738,28.418547898946677
2021-05-26T09:30:00-04:00,37.52,37.66,37.22,37.49,38601859,51507157.8,58.86582768135764,63.48791838297264,NaN,NaN,36.3633012943014,58.45816210230386,-0.08691627299939642,0.5374106473248119,0.6243269203242083,2645509132,2617227249.2,76.96608996782801,76.9935973770941,NaN,NaN,23.6966883215114,27.743996530741637
2021-05-27T09:30:00-04:00,37.83,38.02,37.609,37.92,39789527,51067983.2,62.86656781458322,62.61785012185521,NaN,NaN,92.49527853874517,69.38207053564138,-0.06574113411259108,0.5421505026834694,0.6078916367960605,2685298659,2639976341.4,79.16757550819229,76.24913718480025,NaN,NaN,23.97980039278528,27.2062542253193
2021-05-28T09:30:00-04:00,38.09,38.09,37.71,37.99,39268124,50834346.3,63.48911772540292,61.83062372472478,NaN,NaN,100.94635187096132,75.3889148496992,-0.050097503955833234,0.545269756851269,0.5953672608071022,2724566783,2661588996.6,81.02323811639404,75.57067360486352,NaN,NaN,24.390028220888404,26.803936224686314
2021-06-01T09:30:00-04:00,38.37,38.48,38.115,38.22,35710666,50953849.9,65.53376059672402,61.971184996203704,NaN,NaN,155.05090308319308,89.66566066580215,-0.02841597269460905,0.5598472949388409,0.5882632676334499,2760277449,2684511859.2,82.77569124794223,75.04031676823548,NaN,NaN,25.326542070208436,26.59287991690376
2021-06-02T09:30:00-04:00,38.34,38.38,38.07,38.28,37537542,49483741.3,66.06760869423468,62.5236888177885,NaN,NaN,143.43337687162744,105.65784233176564,-0.01487082078969515,0.569674741646331,0.5845455624360262,2797814991,2722693402.8,85.22344058763123,75.23010905810517,NaN,NaN,26.251104349804244,26.544054835889543
2021-06-03T09:30:00-04:00,38.16,38.6,38.04,38.37,54877518,50938568.3,66.8958970674862,62.77522159994504,NaN,NaN,145.96836000327139,127.57885407355961,-0.005187029559453382,0.5780617754867095,0.5832488050461628,2852692509,2764130078.2,87.32810480436507,75.97919886189308,NaN,NaN,27.255866684756924,26.645742242870597
2021-06-04T09:30:00-04:00,38.42,38.5,38.13,38.47,27250919,50134468.5,67.83537748343363,62.792254848926646,NaN,NaN,131.98847262248114,135.47749289030682,0.0022188941966743148,0.5860224227920057,0.5838035285953314,2879943428,2803059032,88.92419460364455,77.2893506714049,NaN,NaN,28.363076341273164,26.891075685499533
2021-06-07T09:30:00-04:00,38.53,38.53,38.15,38.22,37401849,48773727.95,63.02021980383107,62.43174967015477,NaN,NaN,105.71811719684408,136.43184595548337,-0.014532375656249541,0.5656380590250194,0.5801704346812689,2842541579,2826653991.2,89.76560720596346,78.75834281323037,NaN,NaN,28.06125738666846,27.058244499952238
2021-06-08T09:30:00-04:00,38.01,38.24,37.73,38.12,47747727,48344060.65,61.150406312645934,62.45226521127315,NaN,NaN,55.114007673124874,116.44446687346972,-0.03594100541849721,0.5352441779081474,0.5711851833266446,2794793852,2833557271.8,90.00485275755833,80.22204278396643,NaN,NaN,27.30912901569134,27.094085145057825
2021-06-09T09:30:00-04:00,37.97,38.02,37.66,37.76,40776244,46246921.85,54.8420105997429,62.227079081303415,NaN,NaN,12.223371804989547,90.20246586014214,-0.07565717816675899,0.4766137106181958,0.5522708887849548,2754017608,2824797795.2,87.21873861140922,81.4069658745557,NaN,NaN,24.860593762567454,26.7750149475592
2021-06-10T09:30:00-04:00,38.08,38.18,37.29,37.32,53775465,44040097.7,48.28552119770923,61.520387822496694,NaN,NaN,-39.121357264414556,53.184522406604955,-0.12969915187176873,0.3901469489452438,0.5198461008170125,2700242143,2794307722,78.15037286899448,81.8767789830514,NaN,NaN,20.665017164454483,25.90215812140138
2021-06-11T09:30:00-04:00,37.39,37.575,37.38,37.56,40416652,42716800.8,51.67894171267297,60.815615357155494,NaN,NaN,-66.62927440312188,13.460973001484353,-0.14619566851928295,0.33710151516790887,0.4832971836871918,2740658795,2766450795.4,70.89750759591561,81.76049376559287,NaN,NaN,18.063557901593345,24.782358090000233
2021-06-14T09:30:00-04:00,37.49,37.545,36.95,37.17,50613372,43004960.25,46.35580406784621,59.619464806650136,NaN,NaN,-113.52054349127634,-30.386759136139734,-0.17816656410190024,0.26058897855981655,0.4387555426617168,2690045423,2735951564.2,63.90469778205394,81.09474439871711,NaN,NaN,14.119990609382288,23.25916273562624
2021-06-15T09:30:00-04:00,37.18,37.43,37,37.24,51315057,43551879.65,47.40301236080886,58.87786236560566,NaN,NaN,-100.36087956147009,-61.481736583058726,-0.18839833044154936,0.2032576296097801,0.39165596005132947,2741360480,2725264889.8,61.61160493461063,80.21155118517879,NaN,NaN,11.21248420906205,21.538208660402784
2021-06-16T09:30:00-04:00,37.12,37.45,36.74,37.2,84961113,45784973.05,46.84031257231327,58.01889700067392,NaN,NaN,-106.71079075811382,-85.26856909567941,-0.19105861074572084,0.15283269661917842,0.34389130736489926,2656399367,2705741241.6,57.54878047442547,78.8246005070786,NaN,NaN,8.666071981526303,19.69933199199186
2021-06-17T09:30:00-04:00,37.39,37.41,35.99,36.1,97659932,47489274.35,34.65671422555252,56.003907458600295,NaN,NaN,-202.7517092020854,-117.99463948321359,-0.25604503642310894,0.02383501183601311,0.27988004825912205,2558739435,2677440700,52.17761853263008,76.89674643739559,NaN,NaN,1.7901326140660967,17.140874938002465
2021-06-18T09:30:00-04:00,35.62,35.7408,35.18,35.23,180959978,53576467.25,28.37115342210508,53.49548143693617,NaN,NaN,-305.74042993742734,-165.81687059007467,-0.34142794563469936,-0.14690488378425215,0.1945230618504472,2377779457,2604864832.4,41.48458273541887,74.07255676732595,NaN,NaN,-6.792637820475231,13.721801686791366
2021-06-21T09:30:00-04:00,35.44,35.93,35.38,35.91,89831353,55820519.45,37.85789272904382,51.51863373210186,NaN,NaN,-199.16424516674218,-182.94561092516784,-0.33542350012128885,-0.22475631330116386,0.110667186820125,2467610810,2560377909.8,36.54119851985777,70.7700930010342,NaN,NaN,-10.309559630958354,10.288750069969979
2021-06-22T09:30:00-04:00,35.99,36.11,35.63,35.97,42576449,56491360.45,38.63023620320977,49.55882141131436,NaN,NaN,-147.85177070002018,-192.44378915287786,-0.31125644765018734,-0.2784033727426092,0.03285307490757816,2510187259,2514143265.6,32.24119676054937,66.98564701338549,NaN,NaN,-12.657916098584701,7.010654903033596
2021-06-23T09:30:00-04:00,36,36.21,35.95,36.04,48094886,56958311.6,39.57382137668122,47.60724457625686,NaN,NaN,-112.3099866350668,-193.56362832826844,-0.27562470878779094,-0.3116778110771605,-0.036053102289369574,2558282145,2494519821.2,30.59555038227124,62.93332169752164,NaN,NaN,-14.162450562520624,3.985925550811565
2021-06-24T09:30:00-04:00,36.25,36.58,36.08,36.49,42942760,57175356.65,45.387098954211,46.003796109883815,NaN,NaN,-75.01136519117595,-168.01555952608655,-0.20979608451784998,-0.29829820793668205,-0.08850212341883207,2601224905,2503016915.2,32.209079337344335,58.88224203564306,NaN,NaN,-13.499735432761476,1.4879739817297022
2021-06-25T09:30:00-04:00,36.68,37.025,36.465,36.93,56845029,58028131.75,50.410632907118625,45.10311133154722,NaN,NaN,-35.83304576315376,-114.03408269123186,-0.12865149167039544,-0.24931648800682638,-0.12066499633643094,2658069934,2559075010.6,41.819065081406606,55.45748902674614,NaN,NaN,-11.247921195518776,-0.33143961502008024
2021-06-28T09:30:00-04:00,36.86,36.89,36.45,36.66,70250695,59577260.3,47.521923367379706,44.129648264028205,NaN,NaN,-42.36867273204688,-82.6749682042928,-0.08717819861782833,-0.22963774460871633,-0.142459545990888,2587819239,2583116696.4,45.39426808166135,52.2710186927535,NaN,NaN,-10.34072557888751,-1.7613376098582842
2021-06-29T09:30:00-04:00,36.85,37.045,36.43,36.53,61051191,60844286.55,46.15065068086474,43.508836841251195,NaN,NaN,-36.735030063418925,-60.45162007697256,-0.06361103658562164,-0.22197334172291505,-0.1583623051372934,2526768048,2586432854.2,45.88819983569126,49.31883735163079,NaN,NaN,-10.03378037519342,-2.9431151477633035
2021-06-30T09:30:00-04:00,36.42,36.77,36.41,36.69,42414087,61088113.8,48.134328489330926,43.49803736208132,NaN,NaN,-35.17303277542299,-45.02422930504381,-0.03385041522750651,-0.20067532417167655,-0.16682490894417004,2569182135,2588612852.2,46.2325133275575,47.03899024152815,NaN,NaN,-9.181476313525913,-3.834309600015105
2021-07-01T09:30:00-04:00,36.87,37,36.68,36.98,36615580,60175016.9,51.613513034226976,43.49336388504946,NaN,NaN,-5.366895195404728,-31.095335305889574,0.006605493739998469,-0.15856804176917194,-0.1651735355091704,2605797715,2589527414.2,46.38663965425503,45.28821395998096,NaN,NaN,-7.402084381656697,-4.343991711678189
2021-07-02T09:30:00-04:00,36.98,37.02,36.7901,36.94,27018418,60163391.85,51.10429759757376,43.83254199431571,NaN,NaN,5.435371153314969,-22.841651922595826,0.03056935186439902,-0.12696184567867164,-0.15753119754307066,2578779297,2573669286.8,44.02981441618238,43.86857943384727,NaN,NaN,-6.100512530897713,-4.594923257280978
2021-07-06T09:30:00-04:00,36.85,36.87,36.12,36.36,49225254,60754562.1,44.282171590661534,43.60962479644805,NaN,NaN,-40.42464083289851,-22.45284554276604,0.00840887478519664,-0.14702010406157484,-0.15542897884677148,2529554043,2562016247.6,42.32791709822078,42.49117315981943,NaN,NaN,-6.974140762371167,-4.9348114722938625
2021-07-07T09:30:00-04:00,36.14,36.495,36.06,36.41,43747099,60554530.7,44.964249370243905,43.475620282014525,NaN,NaN,-50.295250895900956,-25.164889709262447,-0.0013137905172583009,-0.15707121699334436,-0.15575742647608606,2573301142,2571322866.4,44.18352538493653,41.53651208199879,NaN,NaN,-7.482639597434574,-5.298786918742535
2021-07-08T09:30:00-04:00,35.83,36.04,35.51,35.68,75084217,62269929.35,37.706618916533564,43.6934706170846,NaN,NaN,-117.40675567475655,-41.61163428912916,-0.05250578156084759,-0.22138965342714556,-0.16888387186629797,2498216925,2557129824.4,41.96591324324712,40.80710456132858,NaN,NaN,-10.271137724158066,-6.009122748087611
2021-07-09T09:30:00-04:00,36.2,36.7599,36.09,36.71,70546482,63108480.2,49.97559869779831,45.23664527963412,NaN,NaN,-2.0141981931858273,-40.941094888685384,-0.01456761420727834,-0.1870933896253959,-0.17252577541811756,2568763407,2549722962.8,40.81462399003436,40.75925036522968,NaN,NaN,-8.505660976535749,-6.365771066437345
2021-07-12T09:30:00-04:00,36.49,37.14,36.33,37.07,62953355,64235315.35,53.428148934311224,46.348806437153215,NaN,NaN,57.63290515107916,-30.501588089132543,0.03452219605066065,-0.12937303035479175,-0.1638952264054524,2631716762,2560310455.8,43.21280404437254,41.235793616980736,NaN,NaN,-5.878585646795347,-6.296173149345631
2021-07-13T09:30:00-04:00,36.95,37.01,36.535,36.67,44476176,63928455.55,49.35239016664884,47.114674577398866,NaN,NaN,45.84857814136624,-13.246944294279592,0.03944816349770236,-0.11458502203332444,-0.1540331855310268,2587240586,2571847764.4,45.79054047489919,42.20360388229144,NaN,NaN,-5.125314417322002,-6.128907616199399
2021-07-14T09:30:00-04:00,36.69,36.93,36.1,36.5,69632708,64844338.1,47.687385446586205,47.694214868106364,NaN,NaN,13.133416135191911,-0.56121088806102,0.031023014847249675,-0.1152544169719647,-0.14627743181921438,2517607878,2560709111.6,43.726829313585,43.141552377385274,NaN,NaN,-5.070115182781565,-5.9776515542825654
2021-07-15T09:30:00-04:00,36.14,36.85,36.14,36.62,53977596,63295162.25,48.99546183328264,47.951955073754334,NaN,NaN,25.222247674995863,27.964589781889465,0.03310772027611489,-0.10489278147407077,-0.13800050175018566,2571585474,2575382821.4,47.108643862680395,44.205806986337855,NaN,NaN,-4.620043831655529,-5.783707593907274
2021-07-16T09:30:00-04:00,36.81,36.81,36.04,36.12,56160744,61220202.85,44.05266962587048,47.49781483937947,NaN,NaN,-15.613366618485777,25.244756096829477,0.002028104170330919,-0.135465371537272,-0.13749347570760292,2515424730,2564715086,44.99175373914486,44.43242760474773,NaN,NaN,-5.796159537193626,-5.785486442948182
2021-07-19T09:30:00-04:00,35.42,35.61,34.9,35.11,89972179,56670812.9,36.124777512211736,46.68373299258176,NaN,NaN,-228.8953207911148,-32.06088909160932,-0.08076065234745136,-0.23844429114191712,-0.15768363879446576,2425452551,2523462243.8,37.899317673743,43.89707400418214,NaN,NaN,-9.668717383286628,-6.340233720139389
2021-07-20T09:30:00-04:00,35.07,36.22,35,35.98,70635830,55711036.75,45.26277145705415,46.62031304802387,NaN,NaN,-127.05984388550799,-66.64257349698417,-0.07145849504424934,-0.24700675759977742,-0.17554826255552808,2496088381,2505231802.8,35.254447251986306,43.13752024820321,NaN,NaN,-9.672932963459102,-6.816333612042205
2021-07-21T09:30:00-04:00,36.27,36.78,36.24,36.6,59975036,56580966.1,50.67799380909574,46.80200342800707,NaN,NaN,24.1358008578977,-64.442096552443,-0.020714719102098267,-0.2014416614331509,-0.18072694233105263,2556063417,2512922910.6,37.244218532200065,42.495499191391964,NaN,NaN,-7.697752394077552,-6.942250580904397
2021-07-22T09:30:00-04:00,36.47,36.56,36.045,36.2,35292344,55940839,47.418611476097425,46.50236760242638,NaN,NaN,-36.18415083382415,-76.72337625420701,-0.011703016098644214,-0.1953557124543579,-0.18365269635571368,2520771073,2502760030.4,35.68367674420837,41.731001840674345,NaN,NaN,-7.274773397175377,-6.98975384037168
2021-07-23T09:30:00-04:00,36.55,36.65,36.155,36.26,36766925,55632047.25,47.95928498404578,46.277723844317244,NaN,NaN,-16.90161169583615,-76.98102526967708,0.0000622226059524833,-0.1835749180982731,-0.18363714070422557,2557537998,2511182684,38.002190612153,41.30045728324368,NaN,NaN,-6.7731302401737,-6.958807611771968
2021-07-26T09:30:00-04:00,36.19,36.54,36.17,36.47,25396047,54059598.15,49.900997141226746,46.67906852650047,NaN,NaN,-4.306292075660922,-32.0632195265863,0.02250907864388224,-0.15550079239937276,-0.178009871043255,2582934045,2542678982.8,45.861588295874306,41.55286236879035,NaN,NaN,-5.758482292349213,-6.7873325661401465
2021-07-27T09:30:00-04:00,36.19,36.62,36.02,36.46,38988356,52496481.2,49.80569865107242,47.02488633227393,NaN,NaN,-7.155114743601156,-8.082273698204931,0.036383075420624994,-0.13253102676747375,-0.16891410218809874,2543945689,2552250444.4,48.01817949274195,41.8267662336336,NaN,NaN,-4.979811106316152,-6.529115214736719
2021-07-28T09:30:00-04:00,36.59,36.64,36.1619,36.41,42908194,51589331.35,49.298746048938504,47.852895413160006,NaN,NaN,4.783185897816211,-11.95279669022123,0.04152084131847705,-0.11701305054000244,-0.1585338918584795,2501037495,2541245260,45.761022416935994,42.097845460325665,NaN,NaN,-4.484862743448749,-6.237079147409866
2021-07-29T09:30:00-04:00,36.65,36.9661,36.49,36.81,41434227,51540338.35,53.38641309170148,48.09652501272451,NaN,NaN,86.55223443571825,12.594480363687245,0.069536891094018,-0.071612777990957,-0.141149669084975,2542471722,2545585389.8,46.8226515988439,42.526990289526346,NaN,NaN,-2.8776549760068724,-5.75716140863801
2021-07-30T09:30:00-04:00,36.71,36.98,36.43,36.52,52385325,52328825.6,50.224875351180934,47.86771975678664,NaN,NaN,65.09923513932932,28.994649730720333,0.06623128167966041,-0.05836056698539949,-0.1245918486650599,2490086397,2532095069.6,43.943526825847634,42.57918477391742,NaN,NaN,-2.3966524292875135,-5.277088697302225
2021-08-02T09:30:00-04:00,36.77,37.19,36.48,36.53,47589850,53357397.2,50.3340979839399,47.937841743736,NaN,NaN,91.97699069112566,48.25130628407766,0.062461493251348976,-0.04651498210087368,-0.10897647535222266,2537676247,2523043510,42.07411365392647,42.31372571527651,NaN,NaN,-1.972833695740924,-4.805052268507754
2021-08-03T09:30:00-04:00,36.66,36.99,36.12,36.94,42169580,53004613.5,54.721071066896364,48.44024785947244,NaN,NaN,73.77826279435195,64.43798179166828,0.08398308809771678,-0.00399761523007669,-0.08798070332779347,2579845827,2530223537.6,44.105384085167806,42.34076534181814,NaN,NaN,-0.36036205910954894,-4.17009652430801
2021-08-04T09:30:00-04:00,36.59,37.0181,36.4326,36.63,52346378,53434577.45,51.04943125138182,48.58695996076524,NaN,NaN,69.76722099285453,77.43478881067594,0.07408850204600924,0.004629924229718085,-0.06945857781629115,2527499449,2535515928.4,45.619125596555016,42.23437117995204,NaN,NaN,0.005910054181341326,-3.5735241559523887
2021-08-05T09:30:00-04:00,36.86,37.11,36.85,37.11,37168237,51538778.45,55.97512942148483,49.438564231880555,NaN,NaN,140.29554641322713,88.18345120617771,0.09526864472404623,0.04962722808876663,-0.0456414166352796,2564667686,2539955121.2,46.91770415483968,42.371939066787384,NaN,NaN,1.7855034544949169,-2.807948783031345
2021-08-06T09:30:00-04:00,37.46,37.93,37.45,37.86,58081048,50915506.75,62.35010509316002,51.311801916234,NaN,NaN,257.3217978538732,126.62796374908649,0.15182915999321459,0.14414503335623863,-0.007684126636975951,2622748734,2566487588.6,53.9896071927681,43.52124546100345,NaN,NaN,5.457739753025299,-1.6271361350232534
2021-08-09T09:30:00-04:00,37.81,38.135,37.6,37.96,48015613,50168619.65,63.11699005134569,52.58710324439768,NaN,NaN,236.88658881883939,155.60988337462922,0.185772880849568,0.22453197442498407,0.038759093575416056,2670764347,2593105208.6,59.77879853047566,45.272984838038404,NaN,NaN,8.645012363053514,-0.1596863495837153
2021-08-10T09:30:00-04:00,37.93,38.47,37.885,38.36,40907442,49990182.95,66.09215667752386,53.68811487785684,NaN,NaN,232.27879128789087,187.30998907333702,0.22248333236331527,0.31686325902956014,0.09437992666624487,2711671789,2619470401,64.53836238440581,47.2225665417674,NaN,NaN,12.303889329390325,1.6208244616982903
2021-08-11T09:30:00-04:00,38.47,38.8099,38.29,38.8,48372124,48927153.75,69.04967547496675,55.233190877776075,NaN,NaN,217.48662093371613,216.85386906150933,0.26104911655763574,0.42069132236328954,0.1596422058056538,2760043913,2665979293.8,71.0470652899269,49.748522866461585,NaN,NaN,16.38459125733647,3.729934003932316
2021-08-12T09:30:00-04:00,38.84,38.92,38.6,38.87,44608141,48458681,69.50537718546117,56.77219746359147,NaN,NaN,180.59086852069024,224.91293348300195,0.2745485858439959,0.5028279381106486,0.22827935226665277,2804652054,2713976167.4,75.95240362117815,52.45925236710623,NaN,NaN,19.813298674767882,6.027557528337397
2021-08-13T09:30:00-04:00,38.9,38.95,38.49,38.58,43077193,47804503.45,65.22100140518154,57.86648348244538,NaN,NaN,138.8633837695679,201.2212506661409,0.24802919933748702,0.5383158514385116,0.29028665210102456,2761574861,2741741392.8,78.24825330690085,54.77258558217955,NaN,NaN,21.482020952826733,8.23533801755016
2021-08-16T09:30:00-04:00,38.33,38.52,37.995,38.48,48013659,45706577.45,63.76146765640124,58.86332412568316,NaN,NaN,95.27672883731127,172.89927866983527,0.20937700678488175,0.5520079105821267,0.342630903797245,2713561202,2750300763.8,78.91650447033743,56.979608794864944,NaN,NaN,22.446766329886835,10.265542062169684
2021-08-17T09:30:00-04:00,38.22,38.5,37.8337,38.21,52414806,44795526.25,59.86603566551367,59.6181305268671,NaN,NaN,72.86500652101626,141.01652171646035,0.15382020285734782,0.5349061573689298,0.38108595451158195,2661146396,2740195685.2,75.94992843717742,59.13595922488219,NaN,NaN,22.168761077526188,11.966001921506328
2021-08-18T09:30:00-04:00,38.06,38.33,37.7101,37.74,39550428,43774295.85,53.71419383695188,59.64154343724213,NaN,NaN,46.83084729104602,106.88536698792635,0.07746617536142353,0.4779186737133614,0.40045249835193786,2621595968,2712506096.2,68.36607726231703,60.674775343701704,NaN,NaN,20.08476552184998,13.125825292983992
2021-08-19T09:30:00-04:00,37.33,37.74,37.215,37.46,48961333,44457745.3,50.39195590365087,59.65347776241855,NaN,NaN,6.2440050483833645,72.01599429346496,0.004028250374296605,0.4054878113198086,0.401459560945512,2572634635,2666102612.4,57.926997575582426,61.67359468296848,NaN,NaN,17.314841067501433,13.724256117915054
2021-08-20T09:30:00-04:00,37.46,37.75,37.32,37.69,33898584,44314328.25,52.9653936810633,59.84142745507022,NaN,NaN,11.443576990545985,46.532032937660574,-0.03119435332678272,0.3624666192870336,0.39366097261381633,2606533219,2635094284,52.19194404032802,62.39629685342573,NaN,NaN,15.712123867700479,14.008237225027258
2021-08-23T09:30:00-04:00,37.88,38.16,37.88,38,28807400,44484895.9,56.25897975297071,59.95127807550409,NaN,NaN,44.52978996784715,36.38264516376775,-0.0354413955643626,0.34935922815836307,0.38480062372272567,2635340619,2619450167.4,49.527769930849104,62.783610128117246,NaN,NaN,15.28906234949442,14.191212242808282
2021-08-24T09:30:00-04:00,38.07,38.32,38.04,38.23,37677316,44419343.9,58.576629291608825,60.488935078377445,NaN,NaN,56.3215114567854,33.073946150921586,-0.02507555399682848,0.3534561812266901,0.3785317352235186,2673017935,2621824475.2,49.94538285642518,63.09262850382226,NaN,NaN,15.601755538932412,14.392718427968871
2021-08-25T09:30:00-04:00,38.33,38.92,38.25,38.68,47904760,44669172.2,62.736775986595255,60.97190983302819,NaN,NaN,91.8564385902277,42.07906441075792,0.008003003797142305,0.38853548996994647,0.38053248617280416,2720922695,2641689820.6,53.41819681787317,63.556949408324655,NaN,NaN,17.131705757303322,14.784002332159508
2021-08-26T09:30:00-04:00,38.85,38.9,38.45,38.49,38484292,44521675.45,59.9969791237178,60.803829406639466,NaN,NaN,85.07405419527745,57.845074240136725,0.012721874136326305,0.396434828843212,0.3837129547068857,2682438403,2663650574.2,56.97223405997694,63.76999418455385,NaN,NaN,17.601003747855557,15.186431105830373
2021-08-27T09:30:00-04:00,38.54,39.01,38.53,39,38511081,43827963.25,64.480913185647,60.90125248766099,NaN,NaN,104.63042278850159,76.48244339972786,0.044061439764386534,0.4387897544123689,0.39472831464798236,2720949484,2686533827.2,60.365617823423726,63.81190984833585,NaN,NaN,19.40102462958377,15.788515894938001
2021-08-30T09:30:00-04:00,39.02,39.04,38.43,38.45,30096481,42953294.8,57.053676548257876,60.25564676414199,NaN,NaN,75.09410356695967,82.59530611955036,0.022696321073893466,0.4230987159903492,0.40040239491645574,2690853003,2697636304,61.934195355282775,63.625897917684206,NaN,NaN,18.60287856151579,16.190567704449116
2021-08-31T09:30:00-04:00,38.42,38.69,38.26,38.4,49876212,43338626.4,56.41746485499332,59.35334600557246,NaN,NaN,45.82805250758561,80.49661432971041,0.0012740245399803785,0.40199492559143124,0.40072090105145086,2640976791,2691228075.2,60.44718899837053,62.86876389685876,NaN,NaN,17.774023290751163,16.416775645349407
2021-09-01T09:30:00-04:00,38.43,38.45,38.05,38.18,43976202,42920117.6,53.58602764612642,58.216249609905695,NaN,NaN,3.697323973090708,62.864791406283004,-0.029913024384121134,0.36332962057129947,0.3932426449554206,2597000589,2666443654,54.951900499475904,61.36872795959431,NaN,NaN,16.231709497448545,16.390337624220713
2021-09-02T09:30:00-04:00,38.27,38.445,38.16,38.31,29616978,42542554.65,55.02248962464218,57.487784482724315,NaN,NaN,7.342259787867553,47.318432524801025,-0.0431811941234167,0.33926615230114976,0.38244734642456646,2626617567,2655279486.8,52.63083762905593,59.53891255403396,NaN,NaN,15.364126947195869,16.24373609893145
2021-09-03T09:30:00-04:00,38.24,38.32,37.98,38.07,34850458,41381025.15,51.83311677462266,56.63575941974013,NaN,NaN,-36.43353133565507,19.105641699969688,-0.06803673509017194,0.2974014275618515,0.36543816265202345,2591767109,2629443011.8,47.61817427116066,57.303317539807054,NaN,NaN,13.698355973699556,15.880110366755465
2021-09-07T09:30:00-04:00,38.2,38.2,37.84,37.84,39221523,40941320.65,48.90734516069383,55.852995812253006,NaN,NaN,-73.90166479996076,-10.693511973414397,-0.09805880120844457,0.24286466114146776,0.34092346234991233,2552545586,2601781528.4,42.9064709004598,54.94307057289865,NaN,NaN,11.426570186006865,15.243890340934236
2021-09-08T09:30:00-04:00,37.75,37.93,37.55,37.75,32523852,40522141.15,47.771034449706534,55.42848442744976,NaN,NaN,-107.76092621278426,-41.41130771748838,-0.12058737010674969,0.19018924971647522,0.3107766198232249,2520021734,2577590517,39.24887549758768,52.863270446846556,NaN,NaN,9.21370895318395,14.38243585696991
2021-09-09T09:30:00-04:00,37.7,38.22,37.67,37.86,33421022,39774586.05,49.32087485859795,55.351978638517416,NaN,NaN,-65.59441152920775,-55.26965481794806,-0.12419979954007265,0.15552687039813406,0.2797266699382067,2553442756,2568878950.4,37.992841031190636,51.43940212224714,NaN,NaN,7.758099381035842,13.436102074693615
2021-09-10T09:30:00-04:00,38.07,38.11,37.57,37.58,39350451,39511701.55,45.61071623761749,54.82664453541414,NaN,NaN,-91.08131771212867,-74.95437031794731,-0.1403724021258202,0.10426116728093149,0.24463356940675168,2514092305,2546373898,34.886821434775044,50.20332193613621,NaN,NaN,5.433570948402796,12.292883342366355
2021-09-13T09:30:00-04:00,37.85,38.065,37.74,38.01,40357251,39375704.45,51.62862065221233,54.49590459964569,NaN,NaN,-45.46631257113061,-76.76092656504241,-0.11793920495160842,0.09720956321724117,0.2151487681688496,2554449556,2538910387.4,33.89710044649044,49.086845544396304,NaN,NaN,5.0747960805748376,11.261728019253281
2021-09-14T09:30:00-04:00,38.14,38.28,37.375,37.5,45670619,39258552.45,45.23569547816347,53.54298075582816,NaN,NaN,-84.92423587704381,-78.96544078045903,-0.13220442235531568,0.04989324022470498,0.18209766258002066,2508778937,2530157057.6,32.72452824656513,47.85678450083487,NaN,NaN,2.770692894592947,10.048723001444662
2021-09-15T09:30:00-04:00,37.48,37.95,37.44,37.86,36371319,38456378.1,49.94714915552656,52.62943598218039,NaN,NaN,-70.58239536920458,-71.5297346117431,-0.11290100063946001,0.04097141178069563,0.15387241242015565,2545150256,2535182762,34.133333810018414,46.479294285988104,NaN,NaN,2.2683495231128554,8.93724107596869
2021-09-16T09:30:00-04:00,38,38.19,37.58,37.75,42630193,38610366.35,48.57209731097097,51.81337299555561,NaN,NaN,-50.377058431229045,-68.48626399214736,-0.10330630129612861,0.024739535799994883,0.1280458370961235,2502520063,2524998223.4,32.64158846183926,44.74139102897827,NaN,NaN,1.4462141216190696,7.867094368204458
2021-09-17T09:30:00-04:00,37.7,37.935,37.48,37.58,82987178,40311658.6,46.44405893698995,50.52502626350868,NaN,NaN,-90.69984010682545,-68.40996847108671,-0.10389341491244242,-0.001820931544429527,0.10207248336801289,2419532885,2506086339.4,30.018110299440863,42.573711920122356,NaN,NaN,0.13198455624616007,6.762078680781844
2021-09-20T09:30:00-04:00,36.59,36.685,36.03,36.55,95008836,43367171.2,36.11883796372614,49.02968065032784,NaN,NaN,-292.13483146067136,-117.74367224899484,-0.16547791094656716,-0.10477490531519607,0.0607030056313711,2324524049,2460101238,24.798891799836966,39.92119023759051,NaN,NaN,-4.7310470177235375,5.120203580995361
2021-09-21T09:30:00-04:00,36.78,36.915,36.41,36.5,45837597,44218681.05,35.70388192606539,47.55013901254728,NaN,NaN,-209.7002444358665,-142.69887396075939,-0.1991475553457434,-0.18823143855080815,0.010916116794935246,2278686452,2414082741,20.88539647914196,37.09534791478846,NaN,NaN,-8.644143798743933,3.1538682410326047
2021-09-22T09:30:00-04:00,36.96,37.37,36.88,37.11,58350790,45252354.75,44.13613803162411,46.87514689722568,NaN,NaN,-115.01589719411139,-151.58557432574074,-0.1709821374631224,-0.20281155503396775,-0.031829417570845356,2337037242,2372460138.2,18.102746935447357,34.46326551735785,NaN,NaN,-9.259051580825371,1.3805939807671797
2021-09-23T09:30:00-04:00,37.47,38.2,37.41,38.02,71804987,46447366.1,53.858041427168835,46.79197202597758,NaN,NaN,0.1303356142086855,-141.48409551665318,-0.086001176210347,-0.13933088783377912,-0.05332971162343211,2408842229,2353724571.4,17.00449539065177,31.918526786043266,NaN,NaN,-6.2375801000726465,0.2922833977900616
2021-09-24T09:30:00-04:00,37.99,38.355,37.935,38.22,48066072,46926455.1,55.68344794058808,47.066995680689395,NaN,NaN,51.90472283753313,-112.96318292778146,-0.014978702720101308,-0.07205309002355875,-0.057074387303457444,2456908301,2361199654.6,19.11297820638562,29.882441352845046,NaN,NaN,-3.2544211615461545,-0.21438868211511208
2021-09-27T09:30:00-04:00,38.56,38.85,38.49,38.74,58794503,47940626.2,60.10284965257041,47.866674572966296,NaN,NaN,141.43437378290014,-26.249341879067174,0.06402753755703441,0.02296003464283558,-0.041067502914198833,2515702804,2399435405.6,29.042976277129313,28.89219173689287,NaN,NaN,0.7900183540837746,-0.07090196265812829
2021-09-28T09:30:00-04:00,38.73,38.92,38.0409,38.1,96152675,51243435.9,53.08604764870008,48.24631837289441,NaN,NaN,89.8339925211754,33.65750551234121,0.06972178877996076,0.046084733060752114,-0.023637055719208645,2419550129,2427608141,35.34151651558807,28.613094666750037,NaN,NaN,1.7298562745877297,0.18634921409128
2021-09-29T09:30:00-04:00,38.22,38.3,37.95,38.13,49882532,51243751.9,53.36091310392913,48.534892533275205,NaN,NaN,55.402723322022986,67.74122961556809,0.07176592819247597,0.06607035452138632,-0.0056955736710896515,2469432661,2454087224.8,40.67195770532312,28.804460143473786,NaN,NaN,2.537532086918972,0.5222324816380931
2021-09-30T09:30:00-04:00,38.35,38.36,37.52,37.53,73319263,52710904.95,47.38170703409037,48.661391875880405,NaN,NaN,1.6756244661717477,68.05028738596071,0.03104639379862927,0.033112418577196934,0.0020660247785676657,2396113398,2451541458.6,40.327733267599456,29.193096702961242,NaN,NaN,1.221202556719965,0.622085349506932
2021-10-01T09:30:00-04:00,37.63,38.41,37.49,38.15,70443993,54752255.7,53.21545665991443,48.774737305001985,NaN,NaN,45.620888078658986,66.79352043418587,0.043444791257795226,0.0563720138508117,0.012927222593016471,2466557391,2453471276.6,40.73719315165909,29.681674753330434,NaN,NaN,2.105576969577274,0.8340127238026951
2021-10-04T09:30:00-04:00,38.09,38.59,37.755,37.82,69772684,56498367,50.03567205388918,49.11759277469668,NaN,NaN,54.09387395157408,49.325420467920665,0.027760734760855776,0.04762814104408619,0.019867406283230415,2396784707,2429687657.2,37.336849793638244,30.01112629240708,NaN,NaN,1.7586907454290372,0.9661095840350297
2021-10-05T09:30:00-04:00,38.1,38.75,37.955,38.56,56058435,57340212.6,56.33628823040138,49.573959851473454,NaN,NaN,114.66316939407464,54.29125584250052,0.06351895228498443,0.09926609663946095,0.035747144354476526,2452843142,2436346259.8,38.87514382246,30.349827007581485,NaN,NaN,3.6432819181085567,1.3485627746169622
2021-10-06T09:30:00-04:00,38.21,38.63,37.93,38.6,63431067,58885573.35,56.65447360258656,50.15127244373171,NaN,NaN,96.9907722998893,62.60886563807378,0.08482854849959626,0.14178282997897185,0.05695428147937559,2516274209,2445714569.4,41.06717736179057,30.951654786149437,NaN,NaN,5.198735327592187,1.8985874250419943
2021-10-07T09:30:00-04:00,39,39.24,38.78,38.83,53295643,59879304.4,58.52596723214695,51.014265893385776,NaN,NaN,166.2234066731888,95.51842207947718,0.10789695925198717,0.19182548054435955,0.08392852129237238,2569569852,2480405860.2,48.44077794173203,32.26755961774166,NaN,NaN,7.051693512986663,2.6347454376055186
2021-10-08T09:30:00-04:00,38.87,39.1557,38.69,39.02,38607472,59842155.45,60.060095056892465,52.7243556857548,NaN,NaN,143.7001685510314,115.13427817395169,0.12805985112421947,0.24400333519764672,0.11594348407342725,2608177324,2508729846.8,53.550762199650784,34.32126464629979,NaN,NaN,9.035714671218672,3.549169613835969
2021-10-11T09:30:00-04:00,39.11,39.4,38.61,38.63,50748310,60361708.4,55.520333566191425,54.139816517192365,NaN,NaN,115.98366508068796,127.51223639977445,0.108038528623279,0.250991644852526,0.142953116229247,2557429014,2540858708.2,58.56707323290863,37.01281298585455,NaN,NaN,9.365481964023797,4.380071378148516
2021-10-12T09:30:00-04:00,38.58,38.765,38.41,38.51,58527656,61004560.25,54.16371795108131,54.85607222572503,NaN,NaN,67.89358387724965,118.15831929640945,0.08086459743009017,0.2440338630168597,0.16316926558676953,2498901358,2550070351.4,59.90407671824533,39.99862225605441,NaN,NaN,9.240522116489243,5.074421483625763
2021-10-13T09:30:00-04:00,38.5,38.54,37.74,38.29,72113636,62791676.1,51.6709748754822,54.69985318631883,NaN,NaN,17.723004387174164,102.30476571386642,0.04406597889706404,0.2182517392080996,0.17418576031103555,2426787722,2532173054,56.1152653950027,42.79224868493662,NaN,NaN,8.41901371886514,5.552220374374245
2021-10-14T09:30:00-04:00,38.72,38.94,38.35,38.93,51893515,63254842.2,57.76106827288534,54.84825463862579,NaN,NaN,81.5849657377747,85.3770775267836,0.0579465927945971,0.24661900130428194,0.18867240850968484,2478681237,2513995331,52.48437343503175,45.17591977269706,NaN,NaN,9.51989560175039,6.119031121142266
2021-10-15T09:30:00-04:00,39.31,39.71,39.18,39.51,58411071,62026036.85,62.38688026479504,55.011399682356114,NaN,NaN,154.4721643855301,87.53147669368335,0.09890319120714561,0.31230139751861685,0.21339820631147124,2537092308,2499778327.8,49.77187456219331,46.656555364487346,NaN,NaN,11.954024261818576,6.95260156981031
2021-10-18T09:30:00-04:00,39.43,39.7499,39.32,39.52,56312728,60091231.45,62.46320914345116,55.6811969319812,NaN,NaN,153.6323459723981,95.06121287202538,0.11808199084348095,0.3610006948658224,0.24291870402234148,2593405036,2506973532.2,51.147949560572094,47.785586296271916,NaN,NaN,13.908281347968835,7.946270109547242
2021-10-19T09:30:00-04:00,39.7,39.91,39.55,39.91,33082564,59453479.8,65.4112511599078,56.541935364551094,NaN,NaN,170.4764383124212,115.57778375905968,0.1465870832526056,0.4261525580880985,0.2795654748354929,2626487600,2532490780.6,55.7753292046206,48.86439854622173,NaN,NaN,16.48459201313111,9.166030381487793
2021-10-20T09:30:00-04:00,39.84,40.23,39.73,40.23,44670214,58769451,67.65586735655091,57.99008967329828,NaN,NaN,180.83385501974738,148.19995388557433,0.17464209316339108,0.49786809128973175,0.3232259981263407,2671157814,2581364799,63.00368739743821,50.484109555495934,NaN,NaN,19.352247975591126,10.621204323502555
2021-10-21T09:30:00-04:00,40.22,40.3099,39.855,40.06,35067638,56932583.55,65.23392191643214,58.848551477335256,NaN,NaN,155.85326794787986,163.05361432759537,0.169275610178095,0.5348205108489594,0.3655449006708644,2636090176,2612846586.8,66.77120797335292,52.343682042759774,NaN,NaN,21.033040984116834,12.108609560733166
2021-10-22T09:30:00-04:00,40.25,40.6879,40.21,40.62,41458194,56602189.65,69.15149254289041,60.21396722654963,NaN,NaN,171.9192376341369,166.54302897731674,0.18944358406359746,0.6023493807503613,0.4129057966867638,2677548370,2640937799.2,69.73304838599331,54.65769622792799,NaN,NaN,23.734142321803375,13.769399955171767
2021-10-25T09:30:00-04:00,40.72,40.77,40.465,40.57,33120959,55318512.45,68.41026919026886,61.07639443796874,NaN,NaN,150.38712321025045,165.89398442488718,0.1851982671366565,0.6444036306075844,0.45920536347092794,2644427411,2651142274.2,70.75289498370299,56.93467845373107,NaN,NaN,25.7059348568818,15.474619226844629
2021-10-26T09:30:00-04:00,40.67,40.86,40.54,40.6,41586934,52590225.4,68.62755523396152,61.93161455449551,NaN,NaN,131.697220628914,158.13814088818577,0.17055702781372084,0.672401648238079,0.5018446204243582,2686014345,2663047623.2,71.94078920343665,59.13993644242007,NaN,NaN,27.38318282511063,17.175842598025486
2021-10-27T09:30:00-04:00,40.5,40.68,39.92,39.93,62449508,53218574.2,58.88584802628129,61.95732032550511,NaN,NaN,80.5647038805815,138.0843106603526,0.10510624505538368,0.6332274267435878,0.5281211816882041,2623564837,2653529027.8,69.5099443317473,60.64487689884974,NaN,NaN,26.03301844770031,18.44115343369332
2021-10-28T09:30:00-04:00,40.09,40.44,40.0649,40.42,44566648,51780943.45,63.020196713008644,62.168756158084825,NaN,NaN,82.46304742533113,123.40626655584283,0.08502899463585611,0.6344074249830243,0.5493784303471682,2668131485,2659937289.6,70.2390343092421,61.83689633524911,NaN,NaN,26.10991123829665,19.536690262922367
2021-10-29T09:30:00-04:00,40.47,40.545,40.18,40.26,42091996,50363343.6,60.86784961132189,62.550721589879856,NaN,NaN,77.01413574537327,104.4252461780901,0.05276819813811384,0.6153386780198105,0.5625704798816966,2626039489,2649635513.4,67.44686822183738,62.47116740588688,NaN,NaN,25.52761917068426,20.392537249745494
2021-11-01T09:30:00-04:00,40.54,40.63,40.12,40.28,37503770,48749897.9,61.046938584894285,63.04238020658079,NaN,NaN,71.8466603958169,88.7171536152034,0.025929065343623492,0.594981811561226,0.5690527462176025,2663543259,2653458683,67.95597157914597,63.046302753094075,NaN,NaN,25.105768060966593,21.065855937062793
2021-11-02T09:30:00-04:00,40.27,40.5,40.16,40.38,31436827,47518817.5,61.98376457263552,63.779008042091746,NaN,NaN,65.76966381133528,75.53164225168766,0.008941393534483644,0.5802294881357071,0.5712880946012234,2694980086,2655251831.2,68.20711420943076,63.910006239838935,NaN,NaN,25.007494094492337,21.62894710240987
2021-11-03T09:30:00-04:00,40.25,40.68,40.17,40.53,42946753,46494601.8,63.40546946058672,64.18217955549899,NaN,NaN,70.9243808371874,73.60357764300883,0.002189452389847024,0.5740249100885322,0.5718354576986852,2737926839,2678124231.6,71.2972469051897,65.25378291627878,NaN,NaN,25.305928347391095,22.15423013740719
2021-11-04T09:30:00-04:00,40.38,40.48,39.69,40,48279711,46243805.2,55.506769865809225,63.69074309842857,NaN,NaN,26.895631197996178,62.49009439754186,-0.04119398476237479,0.5203429767457166,0.5615369615080914,2689647128,2682427360.2,71.85156455069784,66.83090362974339,NaN,NaN,23.28516554189811,22.315792338048748
2021-11-05T09:30:00-04:00,40.32,40.49,39.89,40.02,57866347,47206748.95,55.730883633732795,63.20986270487725,NaN,NaN,30.904651067271274,53.26819746192145,-0.07006949795521833,0.47395008906406844,0.5440195870192868,2747513475,2706722157.4,74.8094809851122,68.52101301721055,NaN,NaN,21.691273935975968,22.226575423466922
2021-11-08T09:30:00-05:00,40.27,40.535,40.141,40.24,32864577,46312562.3,58.22365480198137,62.69646296502537,NaN,NaN,46.75412505663747,48.249690394085576,-0.07541478803644408,0.4497511019737317,0.5251658900101758,2780378052,2730089116,77.28218324622898,70.05721687732543,NaN,NaN,20.991735264342147,22.0501696864491
2021-11-09T09:30:00-05:00,40.03,40.155,39.7643,40.02,48420388,45807198.9,54.89478122790604,61.7849568129793,NaN,NaN,-3.641011527425206,34.36755532633348,-0.09363946771174814,0.40811655537049063,0.5017560230822388,2731957664,2737484631.6,78.01764464972453,71.12964239534588,NaN,NaN,19.45726084784646,21.679754138077293
2021-11-10T09:30:00-05:00,39.98,40.2,39.85,39.95,60695081,45236271.15,53.83999871374577,60.971105155644565,NaN,NaN,-19.909787585688843,16.200721641758175,-0.10919525858506213,0.3652619498509111,0.4744572084359732,2671262583,2724151780.4,73.40391866624759,71.60340744483837,NaN,NaN,17.882740801302905,21.137323661395236
2021-11-11T09:30:00-05:00,40.01,40.19,39.84,40.06,31438902,44213540.5,55.29371538229009,59.98126392988739,NaN,NaN,-34.80427705521596,3.86073999111575,-0.11052672383053286,0.3362988036478072,0.44682552747834003,2702701485,2726762651.8,73.7315165557025,71.88901231410331,NaN,NaN,16.91625189700117,20.534313409338942
2021-11-12T09:30:00-05:00,40.12,40.16,39.79,40.15,39218825,43253928.2,56.50077841882722,59.13058601764156,NaN,NaN,-46.78056686788145,-11.676303595914792,-0.10389730025062349,0.3169539021650607,0.4208512024156842,2741920310,2725644018.8,73.31483704470274,72.07200817560329,NaN,NaN,16.40013449941989,19.94371642220765
2021-11-15T09:30:00-05:00,40.26,40.36,40.07,40.15,30081055,41942344.55,56.50077841882722,58.2643876737034,NaN,NaN,-9.378394369421285,-22.902807481126537,-0.09813245790172764,0.2981856300385246,0.39631808794025225,2741920310,2717952470.4,70.37009049161244,71.95981541047298,NaN,NaN,15.965001411860271,19.375328563586596
2021-11-16T09:30:00-05:00,40.2,40.35,40,40.11,32599496,41918191.15,55.72524554512815,58.03863035362103,NaN,NaN,-32.76321599034923,-28.727248373711348,-0.09554076371158604,0.27689213330076967,0.3724328970123557,2709320814,2713425100.4,68.6228931220345,71.89645460977921,NaN,NaN,15.400187252751572,18.807451233467308
2021-11-17T09:30:00-05:00,40.05,40.05,39.54,39.65,53557211,42362541,47.62874351998841,56.93924083983387,NaN,NaN,-169.87113655238406,-58.71951816705039,-0.12165946028228225,0.2203585716595029,0.34201803194178515,2655763603,2710325304.4,67.38917538675443,71.69289325817296,NaN,NaN,12.647905804222347,17.9275161721466
2021-11-18T09:30:00-05:00,39.69,39.765,39.265,39.45,42995332,42758925.7,44.59493726316754,55.77688995782285,NaN,NaN,-219.21035801453425,-95.60073435891404,-0.14753420922408617,0.15760027041167746,0.3051344796357636,2612768271,2692338661.6,60.58305490247478,71.20262087821848,NaN,NaN,9.38700552013853,16.707443221859734
2021-11-19T09:30:00-05:00,39.11,39.25,38.715,39.02,71858073,44278919.65,38.8632673489988,54.192342012401745,NaN,NaN,-287.18809346557,-143.68223967845174,-0.18624146179476697,0.07233265239230491,0.2585741141870719,2540910198,2652136639.2,48.73530992226865,69.82971647415582,NaN,NaN,4.651392761564748,14.98515029896045
2021-11-22T09:30:00-05:00,39.54,39.96,39.22,39.57,81965804,46721161.9,48.058973047128255,53.19771404629408,NaN,NaN,-120.14647826171073,-165.83585645690965,-0.1679969883871438,0.04857787870314212,0.21657486709028592,2622876002,2628327777.6,43.330796347441265,68.05283662687086,NaN,NaN,3.198015493379279,13.30127389816314
2021-11-23T09:30:00-05:00,39.83,40.22,39.66,40.19,61571249,47720377.65,56.078889347643695,52.67438689536958,NaN,NaN,-3.069824069120706,-159.89717807266393,-0.11016254633212738,0.07887168417512669,0.18903423050725407,2684447251,2623353065,42.275876297158284,65.97988158344005,NaN,NaN,4.659525683403204,12.06673843891172
2021-11-24T09:30:00-05:00,40.11,40.26,39.945,40.1,40410284,46618416.45,54.75718023948643,52.620844779203665,NaN,NaN,19.742623892531245,-121.97442598368086,-0.07560511451733337,0.09452783736058734,0.1701329518779207,2644036967,2621007737.8,41.75969728054924,63.83046249271514,NaN,NaN,5.380143880956883,11.111510644918171
2021-11-26T09:30:00-05:00,38.84,39.005,38.33,38.77,76492188,48214693.45,39.820927213429506,51.48441932061057,NaN,NaN,-257.5728433194982,-129.64692304467366,-0.13641040323424503,-0.00038005216488556925,0.13603035106935946,2567544779,2611963039.4,39.74431217104424,61.32580757742458,NaN,NaN,0.24672917239123893,9.559399005985753
2021-11-29T09:30:00-05:00,39.22,39.36,38.595,38.89,79316461,50075916.7,41.374743365662496,50.28092564658779,NaN,NaN,-162.83425780580455,-104.77615591272058,-0.16095316454943803,-0.06516110461743807,0.09579205993199995,2646861240,2633153247.8,46.284982326157134,59.11172179741944,NaN,NaN,-3.0163954551254806,7.76285694011272
2021-11-30T09:30:00-05:00,38.42,38.58,37.9,37.96,121263739,54263915.15,34.03937256948832,48.791253599557955,NaN,NaN,-226.33813785306745,-126.01448783099195,-0.2281224062970621,-0.18936094793932767,0.03876145835773442,2525597501,2613697547.6,41.79873083198924,56.52465652472406,NaN,NaN,-8.750515968902043,5.403803667396326
2021-12-01T09:30:00-05:00,38.63,38.88,37.54,37.54,102020897,57793118.65,31.337286535559258,47.18391701540178,NaN,NaN,-194.27589541902063,-164.25570210097192,-0.28542103186787343,-0.3180148314771074,-0.032593799609233955,2423576604,2561523418.2,32.6572565685498,53.6141806606028,NaN,NaN,-14.255695734836223,2.595303752791676
2021-12-02T09:30:00-05:00,37.89,38.8657,37.75,38.66,98076428,60549602.4,44.0842130833727,46.383238279764825,NaN,NaN,-121.80857725412002,-192.5659423303022,-0.2345995232651975,-0.32584320369073083,-0.09124368042553332,2521653032,2537046631.2,29.407875284627337,50.448206284097424,NaN,NaN,-13.88682500119211,0.2407139307939925
2021-12-03T09:30:00-05:00,38.71,38.805,37.725,38.03,97178184,62994526.05,39.62774232136143,45.178021415660126,NaN,NaN,-124.3417348459461,-165.91972063559177,-0.2298207685699551,-0.3785196411379772,-0.1486988725680221,2424474848,2508432645,26.134178394269398,47.078159237637905,NaN,NaN,-15.35320443640309,-1.986988693091305
2021-12-06T09:30:00-05:00,38.63,38.98,38.33,38.61,69716619,63587039.65,45.12739973183385,44.36563722373203,NaN,NaN,-70.4322282571796,-147.43931472586678,-0.17640804900625873,-0.3692089338258455,-0.1928008848195868,2494191467,2477898690.4,23.170085381336236,43.7067303011896,NaN,NaN,-14.371011303726277,-3.7561347803248726
2021-12-07T09:30:00-05:00,39.06,39.41,38.87,39.3,115475490,67717585.3,50.86221669497489,44.01827802014965,NaN,NaN,-13.349812136687177,-104.8416495825907,-0.08789047283204052,-0.30266397585963745,-0.21477350302759693,2609666957,2494712581.6,28.01195631473942,40.80594910066851,NaN,NaN,-11.379065342729538,-4.845124860668396
2021-12-08T09:30:00-05:00,39.32,39.48,38.995,39.09,53033223,67948227.05,49.17765574042222,44.128914607323495,NaN,NaN,-10.317213063399713,-68.04991311146654,-0.03924566750974107,-0.2638305874147733,-0.2245849199050322,2556633734,2521324007.6,34.994556584456774,38.492047757647256,NaN,NaN,-9.709045962534677,-5.539970732363579
2021-12-09T09:30:00-05:00,38.9,39.21,38.76,39.01,45521116,67189528.8,48.518400939662286,44.409162012787405,NaN,NaN,-26.265025797586922,-48.941202820159916,-0.009756638459079203,-0.23678071797888123,-0.22702407951980202,2511112618,2519215924.8,34.70735782245127,36.64378368050272,NaN,NaN,-8.645970546949306,-5.983684991590112
2021-12-10T09:30:00-05:00,39.28,39.29,38.8002,39.05,38900921,67562629.75,48.88735181833311,45.12516804631128,NaN,NaN,-16.296525794656127,-27.332161009901917,0.01386041451315917,-0.20969856137835308,-0.22355897589151225,2550013539,2544323663,40.925837922929375,36.08596425197848,NaN,NaN,-7.698598193053864,-6.228672591799219
2021-12-13T09:30:00-05:00,38.96,38.97,38.5,38.63,44343023,67818839.65,45.222588586155005,44.922569156241764,NaN,NaN,-50.50021637199113,-23.345758632864218,0.003171265651916194,-0.219594893826617,-0.2227661594785332,2505670516,2546619472.8,41.47471681094861,35.953387142229005,NaN,NaN,-8.020717290601445,-6.484678977342394
2021-12-14T09:30:00-05:00,38.57,39.15,38.54,38.86,51734388,68901506.3,47.5417267820339,44.31277183012678,NaN,NaN,-27.130312061725853,-26.101858617871954,0.01301425047488014,-0.20649834638493303,-0.21951259685981317,2557404904,2536167062.2,39.66762429542609,35.767083427819564,NaN,NaN,-7.588713356893689,-6.64239817442115
2021-12-15T09:30:00-05:00,38.96,39.085,38.48,38.97,70424908,70792776.9,48.66121680409293,43.87734587045581,NaN,NaN,-21.603089033556685,-28.359033811903352,0.027522611620939663,-0.18510933233363858,-0.21263194395457824,2627829812,2550406277.8,43.29248923194836,35.87656856720521,NaN,NaN,-6.911501505827341,-6.680841507479178
2021-12-16T09:30:00-05:00,39.42,39.74,39.215,39.46,71156600,71672746.35,53.42893406849202,44.849346360103134,NaN,NaN,76.31427343354066,-7.843173965677829,0.06838257064932357,-0.1271537306429238,-0.19553630129224736,2698986412,2587981036.6,51.56269300985661,36.72073862712038,NaN,NaN,-4.894683823897362,-6.425676124110347
2021-12-17T09:30:00-05:00,39.2,39.25,38.35,38.59,97801910,74413075.25,45.37214349606306,45.13487494084603,NaN,NaN,-33.2563984613022,-11.235148499007042,0.03666937364201073,-0.14969958423973395,-0.18636895788174468,2601184502,2598215229.2,53.549729935859254,37.23964917067053,NaN,NaN,-5.609002287354839,-6.309008433145275
2021-12-20T09:30:00-05:00,37.81,37.86,37.21,37.66,85242261,75082284.65,38.6608617091441,45.4649813079643,NaN,NaN,-181.17825226277185,-37.37075567716319,-0.042781450151161055,-0.239845770570696,-0.19706432041953495,2515942241,2600269574.2,53.95803454285207,38.10817086430359,NaN,NaN,-8.549637780776658,-6.629098339949758
2021-12-21T09:30:00-05:00,38.04,38.6084,38.04,38.44,57667861,73867387.5,45.89005162479279,46.504464528623835,NaN,NaN,-64.18067721365374,-44.780828707548764,-0.03876263740578495,-0.24551761717676612,-0.20675497977098117,2573610102,2603510613.8,54.63553174007853,39.678047662269925,NaN,NaN,-8.519424954265771,-6.89914499913776
2021-12-22T09:30:00-05:00,38.33,38.65,38.27,38.62,49702741,73273962.1,47.42981523885559,46.743436111158324,NaN,NaN,-35.60225510379881,-47.58066192159718,-0.02083959675759081,-0.2328044757179697,-0.21196487896037888,2623312843,2602607220,54.395265803746106,41.46286127077841,NaN,NaN,-7.985807249592105,-7.0543824634883805
2021-12-23T09:30:00-05:00,38.84,39.165,38.8,38.82,39057328,73206314.3,49.160894709083095,47.42437556742416,NaN,NaN,48.37937256425283,-53.16764209545475,0.006182640096016212,-0.20423657884035862,-0.21041921893637483,2662370171,2595283971.8,52.3841893209444,43.33786205125519,NaN,NaN,-7.010758751024467,-7.048150504564965
2021-12-27T09:30:00-05:00,38.94,39.22,38.74,39.22,36120273,71187718.55,52.527804633700384,47.95297591755748,NaN,NaN,67.10595218896947,-33.095171965400425,0.05024096781858853,-0.14761800916313916,-0.1978589769817277,2698490444,2614745160.2,56.94024787050977,45.750016514767594,NaN,NaN,-5.138480464499982,-6.775340498841396
2021-12-28T09:30:00-05:00,39.15,39.4899,39.14,39.24,34055239,68924657.45,52.696491643118485,48.0839955567106,NaN,NaN,101.71619815151924,23.483718117457798,0.07830235533268143,-0.09998103281587589,-0.17828338814855732,2732545683,2658065848.6,64.9743145605095,48.390184960894025,NaN,NaN,-3.597176671717206,-6.321317094966512
2021-12-29T09:30:00-05:00,39.32,39.43,39.14,39.19,27150504,64218995.7,52.19713175533827,48.299672414918895,NaN,NaN,87.6333454931522,53.846522658818984,0.09022044295961681,-0.0655078344490363,-0.1557282774086531,2705395179,2684422864,68.78977042810197,50.80412880686868,NaN,NaN,-2.4769597463087214,-5.7721231880153985
2021-12-30T09:30:00-05:00,39.31,39.53,38.9954,39.12,30089129,60622407.3,51.46188960040565,48.509921604971986,NaN,NaN,75.60807510613327,76.0885887008054,0.08991347320228218,-0.043336435905800386,-0.13324990910808257,2675306050,2694821505.4,70.17038512605033,53.33720218569719,NaN,NaN,-1.7416054042904656,-5.1963349331975515
2021-12-31T09:30:00-05:00,39.04,39.245,38.97,39.05,28497790,57143475.4,50.69290852265106,48.6388899409947,NaN,NaN,46.7290332242357,75.75852083280198,0.08175523518408048,-0.031055865127981974,-0.11281110031206246,2646808260,2691709123.2,69.18392008250333,55.355636625666754,NaN,NaN,-1.322035266722722,-4.642863552272576
2022-01-03T09:30:00-05:00,39.34,39.68,39.32,39.53,49884422,54778787.3,55.59305133740226,49.3796372803695,NaN,NaN,123.69393395518959,87.07611718604599,0.1040170210234159,0.01721017596720742,-0.08680684505620848,2696692682,2691349570.8,69.06313089632121,57.3262376317648,NaN,NaN,0.4052778010820048,-3.9217005017933504
2022-01-04T09:30:00-05:00,39.99,40.7,39.97,40.57,74210177,55003465.2,63.95208834386252,50.55180596335727,NaN,NaN,259.32350778014415,118.59757911177098,0.1796793047898058,0.13779228593104875,-0.04188701885875703,2770902859,2699021006,70.25633960671273,59.51114586828527,NaN,NaN,4.724005138096404,-2.686599696094814
2022-01-05T09:30:00-05:00,40.69,40.9,40.07,40.1,76288355,53044108.45,58.584975006285624,51.260645834942466,NaN,NaN,206.2563260587767,142.32217522489586,0.188071446330609,0.1932022890545042,0.005130842723895225,2694614504,2696864871,69.4456232283358,61.37922686802723,NaN,NaN,6.729452625099849,-1.3414493644955765
2022-01-06T09:30:00-05:00,40.52,40.72,40.15,40.69,57725155,53278705.05,62.80495123922757,51.93036134713786,NaN,NaN,186.7340407204153,164.54736834775227,0.22107810681430223,0.281478476241773,0.06040036942747078,2752339659,2712271592.8,71.93751158770608,62.83457105215933,NaN,NaN,9.829146733229337,0.25435007803655374
2022-01-07T09:30:00-05:00,40.78,41.27,40.635,41.17,62185450,54111921.75,65.85336490494285,53.39330573348642,NaN,NaN,200.66818845811514,195.33519939452816,0.26025858248057043,0.38572359752818386,0.1254650150476134,2814525109,2745814962.6,76.44225449657489,64.46975137792474,NaN,NaN,13.431406226466578,2.136786670669414
2022-01-10T09:30:00-05:00,41.43,41.46,40.6,41.03,73620239,55847887.65,64.20064357989676,55.21757586711161,NaN,NaN,161.98486486245218,202.99338557598068,0.2610946470981927,0.45183332392035425,0.19073867682216156,2740904870,2754657400.2,77.4690259723059,66.14910790860002,NaN,NaN,15.814425166080698,4.09073502715674
2022-01-11T09:30:00-05:00,41.18,41.41,40.795,41.39,60706271,56666050.05,66.52699595437733,56.691643319224795,NaN,NaN,147.8479196963873,180.69826795922933,0.2691670942304959,0.5271975446102815,0.25803045037978556,2801611141,2760799056.6,78.18037944952329,67.83088274498893,NaN,NaN,18.537679382535817,6.154584220782323
2022-01-12T09:30:00-05:00,41.5,41.655,41.22,41.42,51560590,56657360.15,66.72107249308038,58.069590265955135,NaN,NaN,138.84413866574621,167.21583048062323,0.25967867939873424,0.5826287996282034,0.3229501202294691,2853171731,2792510502,81.4389251672132,69.76257269952228,NaN,NaN,20.785383978108595,8.244698471828933
2022-01-13T09:30:00-05:00,41.48,41.6975,41.115,41.26,51659563,55719092.9,64.57077878652908,59.17029627148698,NaN,NaN,113.9550350440163,152.66002934534342,0.2269636385193639,0.606654668378674,0.3796910298593101,2801512168,2802345003.8,82.32070967141827,71.90089558169899,NaN,NaN,22.06253182722345,10.21867466545672
2022-01-14T09:30:00-05:00,40.6,40.865,40.335,40.83,81135462,56218036,59.061759389800166,59.63700732549411,NaN,NaN,59.882840428592786,124.50295973943896,0.16365750963683384,0.5842629169053524,0.4206054072685185,2720376706,2783515323.2,74.97627344209587,73.18918312252656,NaN,NaN,21.595048246137853,11.843870891268311
2022-01-18T09:30:00-05:00,40.56,40.6,39.67,39.92,82556556,55455768.3,49.447047739301745,59.4049041895072,NaN,NaN,15.20573420171912,95.14713360729232,0.053490604124771635,0.48746866242448306,0.4339780582997114,2637820150,2762898379.2,67.83955786932039,73.3938433588702,NaN,NaN,18.071264660769142,12.733498572625573
2022-01-19T09:30:00-05:00,40.22,40.245,39.215,39.25,85975120,55492411.25,43.794231271119266,58.80469701206299,NaN,NaN,-28.793156880218017,59.81891829197126,-0.06507827369605079,0.35263021617964796,0.41770848987569875,2551845030,2712945157,54.34252635362305,72.36189735355028,NaN,NaN,13.11229449226104,12.78761227543064
2022-01-20T09:30:00-05:00,39.36,39.87,38.92,39,80314021,56624719.25,41.870761916047904,58.11961646318029,NaN,NaN,-59.002649454033836,20.24956066801524,-0.1557460231324444,0.22302596096014327,0.37877198409258767,2471531009,2636617012.6,40.93948148487027,70.27397566489456,NaN,NaN,8.473458962818075,12.17130465934313
2022-01-21T09:30:00-05:00,38.84,38.95,38.04,38.2,117914259,60035295.15,36.36644011771073,57.09629729139884,NaN,NaN,-128.15864587416442,-28.17317551562088,-0.2589176709941742,0.05512489534986997,0.31404256634404415,2353616750,2547037929,31.210438683675477,67.56158413640686,NaN,NaN,2.4985732436321797,10.789485885670137
2022-01-24T09:30:00-05:00,37.54,38.39,36.82,38.31,169203858,66542621.65,37.581488966775666,55.80975712206837,NaN,NaN,-158.30736531380185,-71.81121666409982,-0.305853892064222,-0.06827479873623332,0.23757909332798866,2522820608,2507526709.4,28.044686800983982,64.6316952724542,NaN,NaN,-1.8375866827680665,8.985618375893251
2022-01-25T09:30:00-05:00,37.88,38.75,37.255,38.47,97364909,69604853.45,39.39422070777345,54.055623719490576,NaN,NaN,-124.37636203877005,-99.72763591219766,-0.31119437673681427,-0.15141387759302916,0.1597804991437851,2620185517,2503999782.8,27.773870947907753,61.5972332253967,NaN,NaN,-4.8149494634869265,7.014108684553226
2022-01-26T09:30:00-05:00,38.89,39.21,38.11,38.57,106681998,73236191.4,40.556181660004874,52.76785276618481,NaN,NaN,-84.94687113922822,-110.95837876399969,-0.29330328754385815,-0.20684861028603763,0.08645467725782054,2726867515,2539004279.8,34.531128150815135,59.10334071985951,NaN,NaN,-6.911914491613848,5.024676802243643
2022-01-27T09:30:00-05:00,38.94,39.34,37.97,38.22,91498935,76453612.95,37.82289613319433,50.983420258611,NaN,NaN,-87.32489723002915,-116.62282831919876,-0.2898384295779531,-0.2758433597146208,0.013995069863332266,2635368580,2571771794,40.17364651605694,56.83449321474172,NaN,NaN,-9.517717788683482,2.9471918606826257
2022-01-28T09:30:00-05:00,38.07,38.73,37.59,38.72,79753586,78936835.8,43.66406902443105,49.398470552860154,NaN,NaN,-91.3732889085145,-109.26575692606878,-0.24069167278829426,-0.28686952112203556,-0.046177848333741306,2715122166,2644072877.2,50.3432186465817,54.97027636831364,NaN,NaN,-10.068513771737518,1.0878053417654625
2022-01-31T09:30:00-05:00,38.45,39.09,38.22,39.06,58740942,80448993.4,47.2902863195589,48.19058789140745,NaN,NaN,-61.06296252325005,-89.81687636795841,-0.17515098222505104,-0.2651165761150551,-0.08996559389000408,2773863108,2694281377.2,55.94381372502693,53.43276120779371,NaN,NaN,-9.449984453770924,-0.41759320045402126
2022-02-01T09:30:00-05:00,39.11,39.695,38.91,39.6,64601491,81184846.85,52.517838280373226,47.18993377183573,NaN,NaN,-21.877501738913836,-69.31710430798717,-0.08960790559456418,-0.2019754758832093,-0.11236757028864512,2838464599,2737937193.6,60.15214664698787,52.14503029332689,NaN,NaN,-7.286407213678209,-1.3988523452003339
2022-02-02T09:30:00-05:00,39.58,39.935,39.33,39.87,46649415,79806808.75,54.92496241042235,46.3473544802173,NaN,NaN,-0.143851892263222,-52.35650045859417,-0.013038565006043584,-0.1286657765461996,-0.11562721154015601,2885114014,2769586493.4,62.917667330326005,50.82208330497781,NaN,NaN,-4.7473179211996195,-1.8772045703430889
2022-02-03T09:30:00-05:00,39.86,40,39.37,39.43,50676954,78526238.7,50.43755382195726,45.33783841131931,NaN,NaN,-5.105287819342395,-35.9125785764568,0.008611496539582236,-0.10486284086567821,-0.11347433740526044,2834437060,2809400189.4,66.1045525699311,49.6637863691573,NaN,NaN,-3.920275903811479,-2.1690719036957162
2022-02-04T09:30:00-05:00,39.5,40.44,39.48,40.1,77792442,79529603.05,56.29328132585646,45.14008997818048,NaN,NaN,24.620762233000146,-12.713768348153874,0.06552226543817256,-0.031571505607544736,-0.0970937710457173,2912229502,2848821656.6,68.94997232210365,49.233336289157855,NaN,NaN,-1.3061915558382964,-2.0458032825732277
2022-02-07T09:30:00-05:00,40.15,40.48,39.925,40.22,52710433,79055852.2,57.26710771799983,45.69866569094462,NaN,NaN,43.39875912948839,8.178575982393813,0.10630135244949497,0.035782919516151424,-0.07051843293334355,2964939935,2887037022,71.45188593484188,49.49135972240938,NaN,NaN,1.0948448277346248,-1.597139266814963
2022-02-08T09:30:00-05:00,40.5,40.88,40.4,40.78,56921248,78220902.65,61.57030930219969,46.96838555030752,NaN,NaN,80.905072162408,28.73509076265818,0.16266919644609412,0.1328180626242741,-0.029851133821820017,3021861183,2923716338.8,73.64677228577794,50.87023443184902,NaN,NaN,4.5520408942530235,-0.718684958090965
2022-02-09T09:30:00-05:00,41,41.31,40.9,41.04,67505320,78560855.1,63.41249013755047,48.50708042327199,NaN,NaN,111.36740609837356,51.037342360785544,0.2063368206423191,0.22806989198107885,0.021733071338759763,3089366503,2964566836.6,75.8717292296657,53.36539498504869,NaN,NaN,7.981073329319482,0.5241376543962416
2022-02-10T09:30:00-05:00,40.85,41.385,40.51,40.68,67260802,79345865.7,59.18219856784805,50.13677745542465,NaN,NaN,99.81817222304802,72.02203436926362,0.19971782917527198,0.27138035780784975,0.07166252863257777,3022105701,3002100564.8,77.73200743912494,56.68836418186652,NaN,NaN,9.603730387998127,1.821222330625082
2022-02-11T09:30:00-05:00,40.55,41.04,39.87,40.11,77962762,80661025.65,53.13776240853017,51.2479398441214,NaN,NaN,67.49388030724985,80.59665798411356,0.148070232961028,0.25675031983386276,0.10868008687283477,2944142939,3008483252.2,78.04204206713104,60.25960384373416,NaN,NaN,9.12706767633359,2.864914522869155
2022-02-14T09:30:00-05:00,40.09,40.23,39.33,39.66,71539805,80181242.8,48.89227742565986,51.92637246682757,NaN,NaN,23.89315340514742,76.69553683924536,0.07822766962310868,0.20646467390172063,0.12823700427861195,2872603134,2990015892,74.79715101123881,63.618409562543526,NaN,NaN,7.377729333260036,3.509602352924995
2022-02-15T09:30:00-05:00,40.14,40.41,40,40.2,55459558,78826392.9,53.67530160418739,52.863452462840606,NaN,NaN,62.36474870176347,72.98747214711646,0.0636433064632837,0.2077911373577166,0.1441478308944329,2928062692,2971256193.8,71.54295233333339,66.26211128986625,NaN,NaN,7.4006698627485035,4.065469140042639
2022-02-16T09:30:00-05:00,40,40.41,39.95,40.23,41168838,76586078.8,53.93323994068479,54.01419130623278,NaN,NaN,57.0988443226618,62.133759791974114,0.0517661845460507,0.20885556157699625,0.15708937703094555,2969231530,2947229199.2,67.49277024065273,68.21347727019453,NaN,NaN,7.496267675961753,4.555583216602512
2022-02-17T09:30:00-05:00,39.81,39.94,39.115,39.23,59108474,75525801.45,44.94890663939274,54.10596542158719,NaN,NaN,-6.493103662194221,40.87150461492566,-0.02364165198938753,0.12753731204421115,0.15117896403359868,2910123056,2924832670.2,63.86344426004926,69.17920767115649,NaN,NaN,4.612258786925746,4.563679726648688
2022-02-18T09:30:00-05:00,39.19,39.55,39.02,39.22,47824547,72021315.85,44.86841426308617,53.932974560410564,NaN,NaN,-25.216671428677415,22.329394267740216,-0.07168293496972719,0.06157529532143968,0.13325823029116687,2862298509,2908463784.2,61.27021325164401,69.55966478020058,NaN,NaN,2.332434511085518,4.244930410139664
2022-02-22T09:30:00-05:00,39.04,39.395,38.69,39.02,60719703,66597108.1,43.202106495325516,53.267565147192876,NaN,NaN,-55.26052304858092,6.4986589769945455,-0.11201496513827872,-0.006760476131681514,0.1052544890065972,2801578806,2894258918.6,59.03012434535958,69.47952033008427,NaN,NaN,-0.04785400059140544,3.6316754943209397
2022-02-23T09:30:00-05:00,39.31,39.43,38.235,38.34,64169775,64937351.4,38.03066078696692,52.060829316946055,NaN,NaN,-96.50326389755186,-25.27494354286852,-0.17577788719913184,-0.11446786999231762,0.061310017206814234,2737409031,2856128186.4,53.387535149509915,68.79879660288312,NaN,NaN,-3.8097741358538126,2.568611261438832
2022-02-24T09:30:00-05:00,37.07,38,36.8,37.88,143075729,66757037.95,34.980216212591145,50.9567337734199,NaN,NaN,-186.3367393566575,-73.96206027873238,-0.23644376122757635,-0.23424468432765622,0.0021990768999201396,2594333302,2781148540.8,44.39999956926962,67.24847138855016,NaN,NaN,-7.977993028810772,1.0619535056888887
2022-02-25T09:30:00-05:00,38.13,39.2,38.12,39.1,99127106,67138446.5,47.09947209975642,50.300033114412756,NaN,NaN,-74.49311914892037,-87.5620633760776,-0.18423568181376584,-0.22809552536728717,-0.04385984355352132,2693460408,2737816011.2,40.18919222298156,65.19412995289858,NaN,NaN,-7.652291243886077,-0.18293860139324902
2022-02-28T09:30:00-05:00,38.17,38.765,38.115,38.52,107370166,68519275.5,42.99634629767014,49.28069301296063,NaN,NaN,-108.08260990208962,-104.13525107076005,-0.17846911339272983,-0.2669462352944336,-0.08847712190170379,2586090242,2682574357.8,35.559280781651196,62.63037244195639,NaN,NaN,-8.806347783777303,-1.4148541988766854
2022-03-01T09:30:00-05:00,38.15,38.26,36.85,37.1,129873103,72075883.55,34.96516530840209,47.380325584832235,NaN,NaN,-182.82211660533568,-129.647569782111,-0.2553135477826403,-0.4076190566300042,-0.15230550884736388,2456217139,2613502024.4,30.783888753622946,59.56873790394532,NaN,NaN,-12.895939983378021,-3.0550093109483045
2022-03-02T09:30:00-05:00,37.41,38.285,37.39,38.06,88182450,73254931.5,42.750655336607416,45.90448024190773,NaN,NaN,-120.1246081732875,-134.37183863725812,-0.22744069495719726,-0.43660637754386045,-0.20916568258666318,2544399589,2574900136,28.48184640653558,56.18374627372174,NaN,NaN,-13.265558928857802,-4.513659256363947
2022-03-03T09:30:00-05:00,38.23,38.43,37.62,37.94,71952780,74520099.75,42.07264790474089,44.68236948025721,NaN,NaN,-99.24118166579666,-116.95272709908595,-0.2037989097917049,-0.4639143198262943,-0.2601154100345894,2472446809,2550522837.4,27.103444017911883,52.56742031506366,NaN,NaN,-13.779163775882319,-5.837302759152285
2022-03-04T09:30:00-05:00,37.27,37.28,36.8,37.23,105917530,77282128.55,38.211248770958385,43.616189934716374,NaN,NaN,-139.05996758509002,-129.8660967863199,-0.22123634002336762,-0.5366608350637989,-0.3154244950404313,2366529279,2485136611.6,23.77921613846526,48.69150417730181,NaN,NaN,-15.549598929425432,-7.224773640619878
2022-03-07T09:30:00-05:00,36.89,36.93,35.845,35.87,116046210,79194816.95,32.12849220113263,42.418776704393,NaN,NaN,-165.99781101787718,-141.4491370094774,-0.30448456683364544,-0.6960302035824881,-0.3915456367488427,2250483069,2418015177,20.939975972379244,44.84456310309756,NaN,NaN,-19.359174880121074,-8.958259531977191
2022-03-08T09:30:00-05:00,36.02,36.67,35.49,35.66,114914996,82305045.1,31.299943894035408,40.82053686795357,NaN,NaN,-156.432000717908,-136.17111383199187,-0.35053342105280344,-0.829712413064847,-0.47917899201204356,2135568073,2353885363.8,18.648891762022814,41.06641591943252,NaN,NaN,-22.547432979291138,-10.899570024450611
2022-03-09T09:30:00-05:00,36.848,37.285,36.7,36.97,88716382,83894801.8,41.44447649544557,39.928482336150765,NaN,NaN,-90.35441962690582,-130.21707612271553,-0.27305068659811815,-0.8204923502596912,-0.5474416636615731,2224284455,2289862337,16.68607412140949,37.43736619662944,NaN,NaN,-21.63370120088597,-12.433017335369948
2022-03-10T09:30:00-05:00,36.36,36.9,36.25,36.66,71547288,84096900.2,39.94142590991602,39.570805141188146,NaN,NaN,-100.09442870632783,-130.38772553082177,-0.22496479617888077,-0.8286476588851741,-0.6036828627062933,2152737167,2225920408.6,14.989235227819606,33.94635126575589,NaN,NaN,-21.438151522167075,-13.719465076340967
2022-03-11T09:30:00-05:00,36.98,37.21,36.375,36.4,76788207,84573270.45,38.67456562659812,39.128387381439,NaN,NaN,-87.77785569034494,-120.13130315187274,-0.19412139645641546,-0.8463346082768126,-0.6522132118203972,2075948960,2167804344.8,13.63232385652411,30.543644880390183,NaN,NaN,-21.693482713720204,-14.85861045310943
2022-03-14T09:30:00-04:00,36.95,37.46,36.6875,36.86,70969670,84223615.85,42.16944114989518,39.05462557105112,NaN,NaN,-62.514708292211914,-99.4346826067397,-0.12931095796192715,-0.813851909272806,-0.6845409513108789,2146918630,2147091457,13.17456430736351,27.26824773481903,NaN,NaN,-20.7900863587223,-15.705964153911268
2022-03-15T09:30:00-04:00,37.23,37.44,36.91,37.38,51828689,83238060.05,45.921308289932874,39.6182432498344,NaN,NaN,-43.26789562823027,-76.80186158880414,-0.04248432223691356,-0.7376463541070208,-0.6951620318701073,2198747319,2159727306.2,15.048636584520793,24.52975498017695,NaN,NaN,-18.85393668474001,-16.15567451545823
2022-03-16T09:30:00-04:00,37.86,38.485,37.735,38.43,87007585,84815461.4,52.60738524445357,40.87732675211028,NaN,NaN,26.378979835977383,-53.455181696227484,0.08751023585610018,-0.5857742370499821,-0.6732844729060823,2285754904,2172021396,16.92740720671685,22.567426954280318,NaN,NaN,-14.938426429252532,-15.98178193171456
2022-03-17T09:30:00-04:00,38.21,38.92,37.9594,38.91,58266358,85670337.4,55.32652513339426,41.46497339737014,NaN,NaN,63.459135986197104,-20.74446875772251,0.2011715599416044,-0.4218200229790767,-0.6229915829206811,2344021262,2210278215,22.659430314468494,21.315301103672237,NaN,NaN,-10.851520892035724,-15.248887497474726
2022-03-18T09:30:00-04:00,38.9,39.1,38.53,39,82342948,86832061.1,55.838152853014755,42.38224529418046,NaN,NaN,89.47371495213277,14.705845370773025,0.27328981538670816,-0.28137931368729596,-0.5546691290740041,2426364210,2280361265,31.926023708924646,21.055782741334628,NaN,NaN,-7.446983672976009,-14.134329808260624
2022-03-21T09:30:00-04:00,39.02,39.135,38.61,38.81,46828635,86782265.5,54.42115923315749,43.771959145948706,NaN,NaN,91.32568208553215,45.47392344632184,0.2970972934717314,-0.18329751223433988,-0.4803948057060713,2379535575,2326884654,37.296895860494885,21.520997534682618,NaN,NaN,-5.0625487357443,-12.838361083615435
2022-03-22T09:30:00-04:00,39.27,39.69,39.22,39.44,61053078,86798934.25,58.208196642592334,44.876069239233345,NaN,NaN,134.0851061896993,80.94452380990775,0.3410298244035929,-0.05410752520158013,-0.39513734960517305,2440588653,2375252920.8,42.386261118363386,22.51417001409889,NaN,NaN,-1.8560976033871597,-11.269466300725682
2022-03-23T09:30:00-04:00,39.19,39.28,38.685,38.71,42142591,85697575.05,52.74000780888661,45.638023518100894,NaN,NaN,88.58644028497508,93.3860158997073,0.3077040339612052,-0.010507307153666545,-0.31821134111487176,2398446062,2397791152.4,44.641052665891145,23.76685634609741,NaN,NaN,-0.6984713411262797,-9.759324163640054
2022-03-24T09:30:00-04:00,38.98,39.0599,38.7,39.02,30421479,80064862.55,54.68674848334781,46.81484492612872,NaN,NaN,81.90601090336648,97.07539088314118,0.29337026806193517,0.048501493962547215,-0.24486877409938795,2428867541,2414760408.2,46.343715197448304,25.378606278881907,NaN,NaN,0.8382040636733044,-8.245391559738145
2022-03-25T09:30:00-04:00,39.15,39.6,39.09,39.52,48621632,77539588.85,57.712410291821264,48.64226764689219,NaN,NaN,111.32793015535792,101.4462339237862,0.3031484408452346,0.1340667769571553,-0.1690816638880793,2477489173,2424985400.8,47.393653516483695,27.26815467488937,NaN,NaN,3.0496116732531173,-6.631819669310822
2022-03-28T09:30:00-04:00,39.4,39.44,38.96,39.41,44761020,74409131.55,56.81362690597946,50.46467357631676,NaN,NaN,95.31977847870124,102.24505320242001,0.2879072101478473,0.19080234879672986,-0.09710486135111746,2432728153,2435623916.4,48.522318069078956,29.401970839679098,NaN,NaN,4.607271807440408,-5.026235172632075
2022-03-29T09:30:00-04:00,39.89,40.005,39.27,39.5,67968613,71313907.05,57.398212558328325,51.604226152236954,NaN,NaN,104.72548174458954,96.37312831339807,0.26989060654721375,0.24025839683289973,-0.029632209714314017,2500696766,2447645539,49.8321599901605,31.76954840173274,NaN,NaN,6.058201915724572,-3.4427441600096964
2022-03-30T09:30:00-04:00,39.5,39.52,38.99,39.22,47405299,69275049.5,54.90799544141637,52.67326683305841,NaN,NaN,73.92767734805814,93.44137572601468,0.22685124221238712,0.2539318430511699,0.02708060083878277,2453291467,2458614620,51.05590804975584,34.345739317585334,NaN,NaN,6.634626779263994,-2.003119740113455
2022-03-31T09:30:00-04:00,39.17,39.33,38.31,38.32,66619563,69008388.65,47.73866960366837,53.320702831420576,NaN,NaN,34.56775974638801,83.97372549461899,0.13030029938317694,0.18995597506775397,0.05965567568457701,2386671904,2450175492.6,50.04448049358362,36.94660764880387,NaN,NaN,5.078917325626028,-0.9914001592935289
2022-04-01T09:30:00-04:00,38.58,38.66,37.9501,38.22,68422545,67133639.4,47.00428701206779,53.6660489644329,NaN,NaN,8.475115504820383,63.403162564511476,0.05602784612600896,0.12969048334208821,0.07366263721607925,2318249359,2418327529.8,46.31554911063941,39.31382084903786,NaN,NaN,3.5896078266747,-0.33697044701235346
2022-04-04T09:30:00-04:00,38.13,38.3564,37.78,38.05,134312434,68046950.6,45.71674627175923,53.65143739170621,NaN,NaN,-12.71598100327832,41.79601066811557,-0.0049823320061517795,0.06743472220838953,0.07241705421454131,2183936925,2368569284.2,41.155813140630976,41.178619174474306,NaN,NaN,1.9801287085641817,-0.005956281929991314
2022-04-05T09:30:00-04:00,37.9,38.31,37.72,37.81,56165655,65109483.55,43.88895841255725,53.02869261799933,NaN,NaN,-32.41587412332896,14.36773949453185,-0.058937599395467055,-0.001254945029792509,0.057682654365674546,2127771270,2293984185,34.88270820734806,42.46114067451939,NaN,NaN,0.10120696937300966,0.009352753970437395
2022-04-06T09:30:00-04:00,37.51,37.71,37.405,37.55,55835385,63465433.7,41.933027616958576,52.07201422396821,NaN,NaN,-69.98081319912832,-14.413958614905445,-0.106784583699576,-0.07579807525879545,0.030986508440780547,2071935885,2217713068.6,29.86894356981402,42.97610590704407,NaN,NaN,-2.0532946243574526,-0.28531115721926115
2022-04-07T09:30:00-04:00,37.52,37.69,36.9804,37.51,53346897,62555414.15,41.62567927762856,51.056837540012054,NaN,NaN,-92.52926587109059,-39.83336373840116,-0.13401152681593445,-0.1365279000791375,-0.002516373263203066,2018588988,2144096485.4,25.986526268541112,42.551856089873816,NaN,NaN,-3.9432583542891586,-0.8078750425149608
2022-04-08T09:30:00-04:00,37.66,38.06,37.56,37.89,44672328,60949620.2,45.697623112413716,50.43372781710179,NaN,NaN,-62.96403937992146,-54.121194715349546,-0.11977808806306768,-0.15223898334203767,-0.03246089527896999,2063261316,2093098876.8,23.68934993687482,41.579888523900955,NaN,NaN,-4.565220939849335,-1.344638742134157
2022-04-11T09:30:00-04:00,37.79,38.155,37.66,37.72,54435476,60122910.5,44.211796576180156,49.4339849552152,NaN,NaN,-71.32621781926387,-65.84324207854664,-0.1151309421631165,-0.17637457298286563,-0.061243630819749116,2008825840,2058076659.8,22.23565104310768,40.14055923281126,NaN,NaN,-5.489447325800179,-1.9367542540864457
2022-04-12T09:30:00-04:00,37.69,38.04,37.15,37.31,67215440,60892248.05,40.768906326707494,48.578906277916694,NaN,NaN,-112.47639623575687,-81.85534650103223,-0.13178974258358694,-0.2259808090492328,-0.09419106646564585,1941610400,2020844485.8,20.776019923527826,38.435914036928175,NaN,NaN,-7.249344692877485,-2.6956957453423085
2022-04-13T09:30:00-04:00,36.96,37.325,36.89,37.31,57446004,59414169,40.768906326707494,47.58477469529953,NaN,NaN,-130.24033492589194,-93.90725084638495,-0.13446379790061225,-0.26227081384141115,-0.1278070159407989,1941610400,1994779388.8,19.7962978844033,36.53966994313924,NaN,NaN,-8.718751066300719,-3.5561322197649385
2022-04-14T09:30:00-04:00,37.23,37.49,36.88,36.89,68544217,59928061.95,37.31650861698576,46.12792457566843,NaN,NaN,-120.16788281963437,-99.43497423609372,-0.1547292561267204,-0.3212185860991994,-0.166489329972479,1873066183,1965674827.8,18.733974271379864,34.492549997060394,NaN,NaN,-10.981519365073206,-4.616901811951834
2022-04-18T09:30:00-04:00,36.66,37.28,36.65,37.11,52748434,58448336.25,40.17434458380905,44.93940440979912,NaN,NaN,-112.83125438387896,-109.40841723688523,-0.1437623519703088,-0.346192269935365,-0.20242991796505622,1925814617,1938185488,17.76433594678784,32.295551274039596,NaN,NaN,-12.187209109869535,-5.698374283082934
2022-04-19T09:30:00-04:00,37.21,37.68,37.2,37.62,41519065,58182857.75,46.28783146831756,44.14580576051263,NaN,NaN,-63.89510794202968,-107.92219526143838,-0.09495972539437444,-0.3211295747080243,-0.22616984931364983,1967333682,1929887056.4,17.47036911871045,29.983994783221736,NaN,NaN,-11.57169265294242,-6.537419764491432
2022-04-20T09:30:00-04:00,37.91,38.15,37.79,37.88,54635831,57861995.4,49.14118517176595,43.73389074125188,NaN,NaN,-20.490291520578158,-89.52497431840263,-0.04073869886512921,-0.27709322289506133,-0.23635452402993212,2021969513,1945958879,20.223814157377134,27.78170236233754,NaN,NaN,-10.236692345491385,-7.0658872760628535
2022-04-21T09:30:00-04:00,38.14,38.315,37.21,37.28,55001040,58504917.85,43.41010660769513,43.42470767011094,NaN,NaN,-48.49173684407974,-73.17525470204019,-0.04075421917154548,-0.287297297994364,-0.2465430788228185,1966968473,1951030493.6,21.11816783116572,25.715537172164833,NaN,NaN,-10.708139159735392,-7.586208973730359
2022-04-22T09:30:00-04:00,37.22,37.23,36.13,36.17,73170903,60642389.05,35.22540054132989,42.58335863648681,NaN,NaN,-145.09604310092118,-78.16088675829755,-0.10721746413571431,-0.3805649089924614,-0.2733474448567471,1893797570,1955176771,21.889149738397094,23.97079435986181,NaN,NaN,-13.897592698981006,-8.487835220194738
2022-04-25T09:30:00-04:00,35.87,36.31,35.3299,36.23,91392751,62780945,35.928617419108335,41.884206575583164,NaN,NaN,-183.56679261836808,-92.30799440519537,-0.1369337055273882,-0.4445145767659824,-0.3075808712385942,1985190321,1967051911.8,24.17498433927439,22.757878016907767,NaN,NaN,-16.18439637200673,-9.58734395616788
2022-04-26T09:30:00-04:00,35.82,36.2,35.301,35.32,81457467,64615767.35,30.51727383665282,40.92908624873285,NaN,NaN,-195.02549227978741,-118.5340712727469,-0.2036508967994718,-0.562144492237934,-0.35849359543846215,1903732854,1954331746.2,23.38554350637267,21.936651966838095,NaN,NaN,-20.08878647311657,-11.087550030017692
2022-04-27T09:30:00-04:00,35.27,35.65,35.16,35.29,81602997,65297486.55,30.354958783817196,40.102081332079884,NaN,NaN,-190.7396950170195,-152.58395197203518,-0.23343843546997373,-0.6502916397759293,-0.41685320430595557,1822129857,1914363815,21.058596971948333,21.307341495561975,NaN,NaN,-23.185495519784713,-12.815827957127265
2022-04-28T09:30:00-04:00,35.65,35.865,35.12,35.74,62679984,66061220.8,35.865341833338434,39.69062865748774,NaN,NaN,-146.8121836078972,-172.24804132479866,-0.2073531392907194,-0.6760446284193549,-0.46869148912863545,1884809841,1897932088.6,20.170007416794462,20.891875863294356,NaN,NaN,-24.082508123357133,-14.425353695160103
2022-04-29T09:30:00-04:00,35.56,35.69,34.4301,34.51,74631676,66461826.45,29.09023559908242,38.50438669224979,NaN,NaN,-172.7792220498299,-177.78467711458043,-0.2543563424599615,-0.7866369172035874,-0.5322805747436259,1810178165,1881208207.6,19.27838500307807,20.576806939451735,NaN,NaN,-27.295016589708233,-16.263876965809835
2022-05-02T09:30:00-04:00,34.67,34.79,33.84,34.52,104408797,68261139.05,29.207322697587486,37.432638558064596,NaN,NaN,-170.70890805437668,-175.21310020178214,-0.26499238279269355,-0.8635210532344928,-0.5985286704417992,1914586962,1867087535.8,18.53342397433771,20.312362148825308,NaN,NaN,-29.71504049141474,-18.185471755181965
2022-05-03T09:30:00-04:00,34.76,35.32,34.64,34.97,73896338,65240334.25,34.45245703401331,36.981463608586445,NaN,NaN,-111.40998575156296,-158.48999889613725,-0.2235928878764658,-0.8780197802873815,-0.6544268924109157,1988483300,1884037625,22.409334084499093,20.429027446037537,NaN,NaN,-30.046443425882252,-19.87989627956772
2022-05-04T09:30:00-04:00,35.03,36.095,34.91,36.04,87794900,66821796.5,44.90529236013163,37.276919753831024,NaN,NaN,-58.06808292785565,-131.9556764783045,-0.11167219250833837,-0.7940171330463386,-0.6823449405380002,2076278200,1934867293.6,32.743150175807344,21.353802609709255,NaN,NaN,-26.692820167994043,-20.85317112077148
2022-05-05T09:30:00-04:00,35.62,35.685,34.56,34.99,101094042,69084729.35,38.42899318680117,37.35638293738926,NaN,NaN,-86.74563864949928,-119.9423674866249,-0.0964561664887823,-0.8029151486489781,-0.7064589821601958,1975184158,1952942157,36.006971259271545,22.587588108844376,NaN,NaN,-26.117245439731978,-21.60518173776584
2022-05-06T09:30:00-04:00,34.85,34.895,34.235,34.74,99281940,71381481.5,37.058573875401414,37.133827886788715,NaN,NaN,-102.56668037593943,-105.8998591518468,-0.09137642879474339,-0.820679518153625,-0.7293030893588817,1875902218,1966086967.6,38.35004822799157,24.057996128930352,NaN,NaN,-26.13943519899981,-22.252932232227835
2022-05-09T09:30:00-04:00,34.27,34.48,33.75,33.91,85922821,73444006.15,32.86785444564238,36.17525809945477,NaN,NaN,-124.16500629915326,-96.59107880080212,-0.1297221881438626,-0.8914558245387099,-0.7617336363948473,1789979397,1941165454.6,35.682490628980034,25.35886195109247,NaN,NaN,-27.620680370617485,-23.019753394854927
2022-05-10T09:30:00-04:00,34.22,34.44,33.19,33.61,107581186,76101291.65,31.48208428282942,34.91389375024503,NaN,NaN,-130.38439192382694,-100.38596003525493,-0.15915703474925935,-0.9606799298314215,-0.8015228950821621,1682398211,1879948436.8,30.137103736236156,26.066954063868117,NaN,NaN,-29.25446140861892,-23.910425968249783
2022-05-11T09:30:00-04:00,33.65,34.33,33.25,33.3,110212184,78251128.85,30.071186540879992,33.96111374547252,NaN,NaN,-126.38744140851205,-114.0498317313862,-0.18173909614395378,-1.0286967652621044,-0.8469576691181506,1572186027,1779130002.2,23.625239056381076,26.246030579954926,NaN,NaN,-31.025507468976638,-24.926866182639333
2022-05-12T09:30:00-04:00,33.02,33.36,32.41,33.05,114331847,81095421,28.944604861241316,33.512485482609044,NaN,NaN,-150.0625540771233,-126.71321481691102,-0.1945988955644824,-1.0902062885737536,-0.8956073930092712,1457854180,1675664006.6,19.07096722843869,26.04473182924361,NaN,NaN,-32.81221819580078,-26.053345041662396
2022-05-13T09:30:00-04:00,33.45,33.805,33.2347,33.53,64036196,80870019.95,34.0530938064973,33.37851951027969,NaN,NaN,-104.98131298961714,-127.19614133964656,-0.15366041276249143,-1.0876829089623854,-0.934022496199894,1521890376,1604861638.2,16.69871617722366,25.51071267481142,NaN,NaN,-32.741384611668764,-27.00877926594902
2022-05-16T09:30:00-04:00,33.4,33.545,32.985,33.25,55662163,81015706.4,32.58156484052698,33.52596886769927,NaN,NaN,-109.33385762109496,-124.2299116040349,-0.12929947316389434,-1.095646837654762,-0.9663473644908676,1466228213,1540111401.4,14.876249334716249,24.90290594826453,NaN,NaN,-33.123629052692266,-27.88232923548377
2022-05-17T09:30:00-04:00,33.9,34.235,33.71,34.14,62878389,82083672.6,41.26908222621522,34.305549113584846,NaN,NaN,-58.954958009043736,-109.94402482107826,-0.04164469087250855,-1.0184032280815032,-0.9767585372089946,1529106602,1509453079.6,14.092022701577818,24.405293500380917,NaN,NaN,-30.686772585230077,-28.28296399973324
2022-05-18T09:30:00-04:00,33.82,33.87,33.07,33.2,74279347,83065848.4,35.99357170309074,34.31470838999572,NaN,NaN,-92.13917736851272,-103.09437201307837,-0.0356049708291204,-1.0212647507453951,-0.9856597799162747,1454827255,1485981325.2,13.505039264535938,23.92922434664817,NaN,NaN,-30.284889586045473,-28.568953369206415
2022-05-19T09:30:00-04:00,32.75,33.22,32.7,32.98,71533232,83892458,34.87007431678353,34.72755401268866,NaN,NaN,-111.96913908784532,-95.4756890152228,-0.035006733881733254,-1.0294181972684413,-0.994411463386708,1383294023,1471069293.8,13.130824892291187,23.490112910163393,NaN,NaN,-30.320528244184896,-28.8191783513462
2022-05-20T09:30:00-04:00,33.21,33.38,32.225,32.92,77984603,84133143,34.55330004141585,35.10940953724783,NaN,NaN,-111.27188941821542,-96.73380430094244,-0.0275598600507152,-1.028861288450102,-1.0013014283993869,1305309420,1427753102.6,12.08342439225892,23.02939865430062,NaN,NaN,-30.44347692105515,-29.051221004161764
2022-05-23T09:30:00-04:00,33.55,34.24,33.38,33.99,78189319,83472971.4,44.27542137764794,35.81104984750745,NaN,NaN,-28.48666089492928,-80.5643649557093,0.055966003877017556,-0.9313439235531149,-0.9873099274301325,1383498739,1411207207.8,11.699528207520984,22.26441252023076,NaN,NaN,-27.405573634931134,-28.8161285228431
2022-05-24T09:30:00-04:00,33.79,34.025,33.22,33.92,77871468,83293671.45,43.816843271972914,35.73330348406754,NaN,NaN,-35.642812546962574,-75.90193586329306,0.109918446499637,-0.8499118693055863,-0.9598303158052233,1305627271,1366511341.6,10.709693679263495,20.690594199049055,NaN,NaN,-25.13574859515222,-28.290359961744404
2022-05-25T09:30:00-04:00,33.84,34.4,33.74,34.19,72192590,82823151.1,46.13430866996381,36.283683161436294,NaN,NaN,4.622882730488667,-56.549523843492786,0.16395404471035369,-0.7548877599172812,-0.9188418046276349,1377819861,1351109862.8,10.383687663532072,18.860359656496232,NaN,NaN,-22.56063608061983,-27.47182797872661
2022-05-26T09:30:00-04:00,34.56,35.105,34.53,34.98,50803236,82229313.7,52.330132702731845,37.3745087919599,NaN,NaN,87.916098096199,-16.572476406683915,0.2480206286376888,-0.6088160188305238,-0.8568366474682126,1428623097,1360175677.6,12.080228123153717,16.983943934722102,NaN,NaN,-18.326618365147436,-26.165369462501012
2022-05-27T09:30:00-04:00,35.13,35.64,35.065,35.57,43862515,80690855.65,56.36671959431814,39.05299915972245,NaN,NaN,136.12018078853347,32.90593763466586,0.3331743214268037,-0.4403687456847081,-0.7735430671115118,1472485612,1393610916,18.228609518703536,15.737238141130925,NaN,NaN,-13.424556238772706,-24.34525328768268
2022-05-31T09:30:00-04:00,35.28,35.745,35.09,35.47,64813362,78711083.9,55.50876442599678,40.76919059852012,NaN,NaN,120.55139187591881,62.713548188835475,0.369751935996914,-0.3113531471153692,-0.6811050831122832,1407672250,1398445618.2,19.109499673869095,14.949552136676136,NaN,NaN,-9.734740191812946,-22.25803713112986
2022-06-01T09:30:00-04:00,35.38,35.47,34.57,34.9,48642415,77448387.75,50.76557286655728,42.24736105035421,NaN,NaN,79.19071278193871,85.68025325461574,0.3431285053673985,-0.2521944514030352,-0.5953229567704337,1359029835,1409126131,21.130818256316843,14.771379222385836,NaN,NaN,-7.958630997067252,-20.215264826263773
2022-06-02T09:30:00-04:00,34.93,35.41,34.655,35.38,45334692,75325377.35,54.30648187345965,44.05892369408409,NaN,NaN,101.31158570005272,105.01799384852855,0.3445140159782587,-0.16468043679761024,-0.5091944527758689,1404364527,1414435064.2,22.171873231396958,14.992872508311427,NaN,NaN,-5.3679100820560475,-18.09421414851981
2022-06-03T09:30:00-04:00,35.05,35.2,34.83,34.87,36699409,72105645.7,50.177275613347604,45.21065096600197,NaN,NaN,85.41006505601678,104.5167872404921,0.29941765326963415,-0.13492238618882624,-0.4343400394584604,1367665118,1402243468.4,21.470973266543822,15.333748014691439,NaN,NaN,-4.410341217758979,-16.13937515841112
2022-06-06T09:30:00-04:00,35.16,35.52,34.96,34.97,32829609,68783029.15,50.9645740118126,46.52372304966523,NaN,NaN,96.09265313781376,96.51128171034816,0.26579772025028076,-0.10209288914560943,-0.3678906093958902,1400494727,1387845291.4,20.641088333829757,15.745522228913831,NaN,NaN,-3.4044582142363278,-14.320101309243293
2022-06-07T09:30:00-04:00,34.73,35.27,34.7,35.24,32031352,66088455.7,53.11864731279532,47.37012055584952,NaN,NaN,78.14855346061967,88.03071402728833,0.25137659954715796,-0.053669859961942734,-0.3050464595091007,1432526079,1392816057.2,21.76534583125209,16.29361673817628,NaN,NaN,-1.9407637251930805,-12.551624511521835
2022-06-08T09:30:00-04:00,34.97,35.07,34.49,34.62,38251766,62621984.7,47.913629670780196,48.22155326782734,NaN,NaN,43.96504033884833,80.98557953867025,0.19237424252172614,-0.06457865635694304,-0.2569528988786692,1394274313,1399864952.8,23.422092269703924,17.00197766711685,NaN,NaN,-2.185105109116021,-11.070693168321004
2022-06-09T09:30:00-04:00,34.58,34.6,33.73,33.75,49715109,59597130.95,41.73381399798728,48.71182038791331,NaN,NaN,-16.75635655609509,57.37199108744069,0.09212935553716464,-0.14179120445721338,-0.23392055999437802,1344559204,1387903888.2,22.549469291926897,17.674737981376545,NaN,NaN,-4.364769971907352,-10.112704140261911
2022-06-10T09:30:00-04:00,33.02,33.14,32.5,32.53,74190907,57590083.95,34.93015912575778,48.73873889393774,NaN,NaN,-126.00672513313688,15.088633049609962,-0.051256711375955416,-0.2979914492143223,-0.24673473783836689,1270368297,1368444524,21.16775200949965,18.32361852546517,NaN,NaN,-8.714433033517222,-9.91295112501267
2022-06-13T09:30:00-04:00,31.71,32.1,31.3725,31.56,104066783,59591613.3,30.65154469345657,47.76560484506693,NaN,NaN,-187.02670784158877,-41.53523914627054,-0.19809505915512166,-0.49435356178226897,-0.2962585026271473,1166301514,1321605881.4,18.26642454311441,18.79268254943613,NaN,NaN,-13.96669066040262,-10.49205677292552
2022-06-14T09:30:00-04:00,31.69,31.905,31.05,31.29,75592236,60588116.95,29.565941736276372,46.74768330680289,NaN,NaN,-181.03155727111238,-93.37126129261695,-0.29427585748718993,-0.6641033244861347,-0.3698274669989448,1090709278,1253242521.2,15.028655148788573,19.101179797259352,NaN,NaN,-18.456753237362065,-11.629870553559313
2022-06-15T09:30:00-04:00,31.62,32.09,31.1,31.64,87863646,61837379.8,32.88436164804605,45.80125851952305,NaN,NaN,-139.82157833766732,-130.12858502792008,-0.31342586307378356,-0.7616097958411743,-0.4481839327673907,1178572924,1210102243.4,13.41295404171126,19.317555967129294,NaN,NaN,-21.02164955655669,-12.971553268273222
2022-06-16T09:30:00-04:00,31,31.01,30.58,30.84,100884890,63167656.95,29.46699833364346,44.1681774931596,NaN,NaN,-158.85922059381286,-158.54915783546363,-0.3559665376140586,-0.8931421047849639,-0.5371755671709053,1077688034,1156728009.4,11.732370608852904,19.292709001822093,NaN,NaN,-24.358549365392555,-14.598266996433127
2022-06-17T09:30:00-04:00,30.91,31.275,30.63,30.93,116937652,65437877.95,30.343994128747596,42.309411388475986,NaN,NaN,-132.79929172630682,-159.9076711540976,-0.35332893730583803,-0.9788367388032029,-0.6255078014973648,1194625686,1141579487.2,11.299634310399782,18.797782201228966,NaN,NaN,-26.72014183496338,-16.329963401937448
2022-06-21T09:30:00-04:00,31.47,31.58,31.19,31.38,58065774,64441936.5,34.714923129987326,40.82413701018959,NaN,NaN,-100.96083241191674,-142.69449606816323,-0.29873306984422243,-0.9989241388026429,-0.7001910689584204,1252691460,1158857476.4,15.14402565690429,18.514534057160056,NaN,NaN,-27.366753977982945,-17.906647769943948
2022-06-22T09:30:00-04:00,31.02,31.6,30.98,31.31,48035818,62934261.45,34.35379599204097,39.65186723343843,NaN,NaN,-91.11176185545862,-124.71053698503246,-0.24693708480901733,-1.008862424969692,-0.7619253401606747,1204655642,1181646749.2,20.0651068634824,18.438411814814735,NaN,NaN,-27.99318748570272,-19.347582015052343
2022-06-23T09:30:00-04:00,31.33,31.39,30.675,31.19,69348921,62508134.1,33.70646702519531,38.18043760141955,NaN,NaN,-87.82127486469147,-114.31047629043731,-0.20223930658467404,-1.0147244733915173,-0.8124851668068432,1135306721,1172993508.6,19.600298652418346,18.254727916316263,NaN,NaN,-28.691434849255465,-20.682418134224218
2022-06-24T09:30:00-04:00,31.32,32.37,31.2702,32.34,65489323,62172970.75,44.49960358244759,37.77488959921241,NaN,NaN,-47.562987873346664,-92.05122974634406,-0.08282430093140747,-0.9160155429711025,-0.8331912420396951,1200796044,1197615110.6,24.929061245914085,18.501734200556996,NaN,NaN,-26.00887064272357,-21.443339921152695
2022-06-27T09:30:00-04:00,32.59,32.59,32.08,32.23,47244836,61995050.75,43.76561538742365,37.26067826889891,NaN,NaN,-31.78913272636498,-71.8491979463557,-0.0030593996340209095,-0.8370154915822212,-0.8339560919482003,1153551208,1189400215,24.34919612132211,18.766599042520735,NaN,NaN,-24.052800984064053,-21.816120072997176
2022-06-28T09:30:00-04:00,32.56,32.87,31.89,31.91,42465051,61925177.55,41.61517864053798,36.439001935166246,NaN,NaN,-30.364301532480592,-57.72989177046848,0.03427744006092259,-0.791109291872047,-0.8253867319329696,1111086157,1161079154.4,22.413558617531493,18.812899955826406,NaN,NaN,-23.019769016868434,-21.988069922121642
2022-06-29T09:30:00-04:00,31.94,32.06,31.6201,31.73,64507480,61909883.45,40.4123199074209,35.90319409492629,NaN,NaN,-43.685209042924875,-48.24458120796173,0.05192028159355311,-0.7604863799410282,-0.8124066615345813,1046578677,1129463761.4,20.458388393896442,18.601206821840158,NaN,NaN,-22.495445716760532,-22.060552178498625
2022-06-30T09:30:00-04:00,31.23,31.73,30.85,31.45,75294325,63242478.95,38.54589219388939,35.67548539463358,NaN,NaN,-60.33879172729522,-42.748084580482484,0.049794336501725156,-0.7501637409074249,-0.79995807740915,971284352,1096659287.6,18.641326400653483,18.32205375817777,NaN,NaN,-22.566836936553912,-22.132878572506524
2022-07-01T09:30:00-04:00,31.35,31.98,31.14,31.88,77308387,64841163.7,42.90679981126083,36.24524544359809,NaN,NaN,-40.6676638705249,-41.36901977991812,0.08058619443868809,-0.6992253343607899,-0.779811528799478,1048592739,1066218626.6,17.121654797996698,18.033046814498988,NaN,NaN,-21.393876008340897,-22.02730677762572
2022-07-05T09:30:00-04:00,31.38,31.79,31.02,31.77,51536755,65583031,42.084078580927375,37.061855006988864,NaN,NaN,-44.94116117615858,-43.99942546987684,0.09575092281651831,-0.6601228752788302,-0.7558737980953485,997055984,1034919581.8,15.704076583622921,17.850021960249595,NaN,NaN,-20.63907345926336,-21.828987732145386
2022-07-06T09:30:00-04:00,31.7,31.95,31.39,31.69,48001737,66341637.4,41.461416101322826,37.91153174734932,NaN,NaN,-29.838574843771895,-43.8942801321351,0.10202220320741251,-0.6283460440860829,-0.7303682472934954,949054247,1002513199.8,14.376838500850937,17.803463628254047,NaN,NaN,-20.169140889561714,-21.591866754633433
2022-07-07T09:30:00-04:00,31.96,32.24,31.93,32.15,33120102,66396074.9,46.37454742349938,38.875116445596,NaN,NaN,18.928718545609396,-31.371494614428247,0.13661950103738507,-0.559593870996764,-0.6962133720341491,982174349,989632334.2,13.874883304786536,17.836458575616568,NaN,NaN,-18.39995734189272,-21.135879695670475
2022-07-08T09:30:00-04:00,32.24,32.335,31.95,32.08,29062247,65936598.95,45.74534846924516,40.03785574099612,NaN,NaN,44.618265310968695,-10.380083206775456,0.15302260500893516,-0.5049351157729802,-0.6579577207819154,953112102,985997884.2,13.729228098158657,17.979091253424123,NaN,NaN,-17.080058129366247,-20.55647661476987
2022-07-11T09:30:00-04:00,31.9,32.055,31.73,31.82,30564301,64979058.55,43.39050006369014,40.969749022063446,NaN,NaN,34.06120966084662,4.565691499498847,0.14468793733964547,-0.4770977991073586,-0.6217857364470041,922547801,960788896.6,12.730934368721975,18.08132697187571,NaN,NaN,-16.54723936333599,-19.9837284359936
2022-07-12T09:30:00-04:00,31.58,32.2,31.555,31.62,38210988,63180062.6,41.615836730527235,41.46267142210201,NaN,NaN,32.45948671180344,20.04582107709125,0.12478431746026375,-0.46580533962167436,-0.5905896570819381,884336813,938245062.4,11.897762534751323,17.84945103457907,NaN,NaN,-16.55356078985088,-19.49370448654464
2022-07-13T09:30:00-04:00,31.28,31.55,30.9505,31.34,51459499,60549698.4,39.19867648075053,41.808734314152694,NaN,NaN,-64.59566937938256,13.094402169969115,0.093283061300519,-0.4739858304562894,-0.5672688917568084,832877314,915009675.8,11.092027854913368,17.208516819681282,NaN,NaN,-17.20518467443943,-19.166773084815325
2022-07-14T09:30:00-04:00,30.7,30.835,30.37,30.74,57782271,59659200.15,34.56560615641513,41.87010139495411,NaN,NaN,-160.39005930939365,-22.769353401031495,0.03552971591746623,-0.5228567468599756,-0.5583864627774419,775095043,873593814.6,9.815993156838886,16.509637855711322,NaN,NaN,-19.135787832877664,-19.1623466202528
2022-07-15T09:30:00-04:00,31.18,31.96,31.1,31.78,59650240,58248529.85,46.392926503718975,42.0053387464735,NaN,NaN,6.78134800219755,-30.33673686278572,0.06892958464605392,-0.47222448196987443,-0.5411540666159284,834745283,849920450.8,9.16683725126451,15.383764713236351,NaN,NaN,-17.220771043371393,-18.884978680698314
2022-07-18T09:30:00-04:00,32.23,32.45,31.52,31.66,38671385,55137854.6,45.37382312779611,42.12021072792867,NaN,NaN,47.110684203491765,-27.72684195425669,0.08352605124426937,-0.43674650256059167,-0.520272553804861,796073898,824625670.2,8.518593570860318,14.253007388203367,NaN,NaN,-15.989602439798064,-18.47135350342685
2022-07-19T09:30:00-04:00,32.08,32.71,31.9916,32.61,40568032,51319373.6,53.9905203944319,43.00416371034966,NaN,NaN,139.9719450580119,-6.224350285014998,0.15366626628953606,-0.32818972094294097,-0.481855987232477,836641930,815086693.6,8.280775244778553,13.243522861578155,NaN,NaN,-11.988040663693495,-17.545165954893513
2022-07-20T09:30:00-04:00,32.54,32.79,32.44,32.73,38508816,50341525.7,54.95703696508548,44.04307207161141,NaN,NaN,157.65633366573746,38.22605032400901,0.2016244633532825,-0.22982540804087392,-0.4314498713941564,875150746,823541380,10.661432144357676,12.543740272325385,NaN,NaN,-8.50442362889808,-16.253631336894166
2022-07-21T09:30:00-04:00,32.64,32.94,32.39,32.94,40573064,49968388,56.672374549908234,45.33782081132705,NaN,NaN,154.90349922523646,101.28476203093503,0.23844940015323945,-0.13338812120260712,-0.3718375213558466,915723810,851667133.4,18.262091990902675,12.516652100200329,NaN,NaN,-5.1202066590573745,-14.663142097203195
2022-07-22T09:30:00-04:00,32.99,33.16,32.5,32.75,25741223,47788003.1,54.64473854785011,46.176245006797714,NaN,NaN,143.77904411624104,128.68430125374374,0.2402952611262008,-0.07146844494809557,-0.3117637060742964,889982587,862714594.2,21.10147628519519,12.800925063571649,NaN,NaN,-2.914178190151182,-12.984718681910051
2022-07-25T09:30:00-04:00,32.95,33.11,32.72,32.96,24699278,45748500.85,56.49735135012142,47.20576449031158,NaN,NaN,139.23851147563119,147.1098667081716,0.2450995359659952,-0.005389286116802339,-0.25048882208279755,914681865,886436187.6,26.96798865603543,13.605490211601111,NaN,NaN,-0.5263635677725301,-11.204953665604691
2022-07-26T09:30:00-04:00,32.8,32.99,32.42,32.5,26357790,44704148.55,51.531924709529534,47.92508653375491,NaN,NaN,90.5351977518248,137.2225172469342,0.20818977309888592,0.00974839429080987,-0.19844137880807605,888324075,896772616.6,29.430287786235112,14.680736589128555,NaN,NaN,0.1029527310955302,-9.589538466076089
2022-07-27T09:30:00-04:00,32.63,33.16,32.5234,33,44819674,44821879.7,56.053121124890545,48.61641322671142,NaN,NaN,113.09998997784545,128.3112485093558,0.20785978095188873,0.06138334738178486,-0.14647643357010387,933143749,908371217.2,32.19291555242438,15.98916746395983,NaN,NaN,2.024421160429205,-7.9304013765753325
2022-07-28T09:30:00-04:00,33.03,33.25,32.5,33.24,40974555,43645233.45,58.07474001013797,49.49708405106092,NaN,NaN,110.4880612855677,119.42816092142202,0.21340823207886767,0.12028385652848073,-0.09312437555038694,974118304,920050116,34.95415805995577,17.50523388980248,NaN,NaN,4.230389138707329,-6.19314558867781
2022-07-29T09:30:00-04:00,33.32,33.82,33.29,33.71,38724004,41816717.4,61.78244715285635,50.81079455742992,NaN,NaN,157.85288992665053,122.24293008350392,0.236541980738251,0.2025531003724268,-0.03398888036582419,1012842308,944622060.2,40.44883368898362,19.485083841249743,NaN,NaN,7.280991221403453,-4.268268901523344
2022-08-01T09:30:00-04:00,33.39,33.615,33.2,33.43,35143634,39708479.75,58.4652424608236,52.014323538165385,NaN,NaN,119.70487372169781,118.33620253271722,0.2210827689908218,0.24236458087270307,0.021281811881881267,977698674,957225422,43.103673454287986,21.714077478359503,NaN,NaN,8.847960279517466,-2.394521875660371
2022-08-02T09:30:00-04:00,33.27,33.49,33.02,33.06,36807188,38972001.4,54.31516108438742,53.09407243842516,NaN,NaN,87.24048711673774,117.6772604056998,0.17599715266065602,0.2412782527077013,0.06528110004704528,940891486,967738904.2,45.29457713738298,24.15711671282162,NaN,NaN,8.934611540750018,-0.7760742447446012
2022-08-03T09:30:00-04:00,33.31,33.64,33.12,33.56,27314918,37937660.45,58.5926532641204,54.810290088975535,NaN,NaN,103.81437762360234,115.82013793485116,0.16982597681523523,0.2775635710660893,0.10773759425085408,968206404,974751435.2,46.76700112649932,26.796474424940218,NaN,NaN,10.320238919043796,0.8091133500823124
2022-08-04T09:30:00-04:00,33.53,33.62,33.39,33.45,24505822,37506946.45,57.32108725543737,55.59087299981257,NaN,NaN,98.27966632864546,113.37845894346671,0.14905327892066322,0.2940541929016831,0.14500091398101989,943700582,968667890.8,45.619844090792974,29.400260627763682,NaN,NaN,11.071393130928843,2.2751533187746737
2022-08-05T09:30:00-04:00,33.36,33.85,33.245,33.69,34366113,37772139.75,59.39176764498911,56.59215475104064,NaN,NaN,100.05387497083922,101.81865595230445,0.14221402879619688,0.32276844997626597,0.1805544211800691,978066695,961712768.2,44.28248472503075,31.954824281632998,NaN,NaN,12.30498418641492,3.7079862998661373
2022-08-08T09:30:00-04:00,33.94,34.05,33.635,33.67,24370078,37462428.6,59.134288217731246,56.959566738419156,NaN,NaN,110.46410773321934,99.97050275460876,0.1275497914599955,0.33999166050506346,0.21244186904506795,953696617,956912356.8,43.33815619826856,34.458922921167996,NaN,NaN,13.242300290548481,5.070031155677901
2022-08-09T09:30:00-04:00,33.73,33.9299,33.665,33.84,26425426,36873150.5,60.694118795179584,57.36935829771159,NaN,NaN,105.45936230551776,103.61427779236479,0.12058437163728192,0.36317233359167034,0.24258796195438842,980122043,964758468.2,45.38808705152333,36.93939827167983,NaN,NaN,14.465915203250296,6.4123003053311
2022-08-10T09:30:00-04:00,34.43,34.725,34.36,34.6,45365971,36568474.1,66.79593321478393,58.092469630917044,NaN,NaN,169.30037179754126,116.71147662715256,0.15618714577580878,0.4378218941741494,0.28163474839834063,1025488014,976214790.2,48.3276460490575,39.08693784726232,NaN,NaN,17.46005626365885,7.9905511565207785
2022-08-11T09:30:00-04:00,34.92,35.23,34.88,35.01,46985196,36028620.35,69.54285095438748,59.15662051709829,NaN,NaN,201.46018412662266,137.347580186748,0.1939123185203232,0.5240251465487447,0.33011282802842146,1072473210,1001969315.8,54.284916723238744,41.45718359283685,NaN,NaN,20.888274047041087,9.833082998023679
2022-08-12T09:30:00-04:00,35.18,35.57,35,35.56,36370283,34864622.5,72.7943056427414,60.320688680856854,NaN,NaN,207.2631314184849,158.78943147627712,0.2394826612363638,0.6294661545738762,0.3899834933375124,1108843493,1028124675.4,59.40370650667795,43.77402058216846,NaN,NaN,24.930220203204918,11.989816884478142
2022-08-15T09:30:00-04:00,35.2,35.65,35.13,35.55,25365997,34199353.1,72.64246046748588,61.82858409213946,NaN,NaN,184.24864528401622,173.54633898643652,0.25129761067254724,0.7041055066781965,0.45280789600564925,1083477496,1054080851.2,63.74251204259337,46.22489374333691,NaN,NaN,28.09870258067494,14.291086269649112
2022-08-16T09:30:00-04:00,35.39,35.97,35.39,35.81,41300751,34235989.05,74.15214475008067,63.121371493938746,NaN,NaN,172.52027166711522,186.958520858756,0.25799398552259367,0.7753003779088914,0.5173063923862977,1124778247,1083012092,67.8651156564386,48.772908036480786,NaN,NaN,31.229257386113513,16.710825000572598
2022-08-17T09:30:00-04:00,35.4,35.79,35.38,35.63,33158031,33968449.8,71.22188316762508,64.06045314804497,NaN,NaN,135.02976550821623,180.10439960089099,0.23246330939084991,0.8078855291248601,0.5754222197340102,1091620216,1096238532.4,69.56866781688419,51.245373019118524,NaN,NaN,33.01287697003185,19.039689567638206
2022-08-18T09:30:00-04:00,35.6,35.72,35.43,35.67,15966226,32738107.9,71.49148905877838,64.7539561413251,NaN,NaN,114.49567097911746,162.71149697138995,0.20158175741101303,0.8273994164977765,0.6258176590867635,1107586442,1103261178.8,70.4639773574495,53.38931185258038,NaN,NaN,34.55656598565214,21.256386198783055
2022-08-19T09:30:00-04:00,35.46,35.46,34.84,34.96,33587391,33130416.3,60.633218287263176,64.90881155749936,NaN,NaN,68.10309755357225,134.8794901984074,0.12064254863321933,0.7766208448782876,0.6559782962450683,1073999051,1096292290.4,68.3160365863897,55.190194933444786,NaN,NaN,32.71696602627156,22.89361188842427
2022-08-22T09:30:00-04:00,34.45,34.455,34.1,34.19,36810125,33735958.65,51.498092579312654,64.70759237856545,NaN,NaN,5.214418152778467,99.07264477215986,0.008467108821399671,0.666562182271818,0.6580950734504183,1037188926,1087034576.4,65.46130839922598,56.63067573786214,NaN,NaN,28.00105946174237,23.623247256041143
2022-08-23T09:30:00-04:00,34.15,34.395,34.05,34.05,23243967,33580267.5,50.02241804424742,64.0954327200031,NaN,NaN,-7.027069737157158,63.1631764913054,-0.07722034358873187,0.5615696439645035,0.6387899875532353,1013944959,1064867918.8,59.09385785705809,57.51116550433063,NaN,NaN,23.744495156634997,23.640568384697406
2022-08-24T09:30:00-04:00,33.99,34.34,33.925,34.23,20682181,32373392.85,51.92965997532927,63.71033077142395,NaN,NaN,-12.839281374879363,33.58936711468629,-0.12121610760117718,0.48726985305176385,0.608485960652941,1034627140,1053469303.6,56.073389627421854,58.25784732837555,NaN,NaN,20.810747969870704,23.23630832543645
2022-08-25T09:30:00-04:00,34.3,34.7873,34.21,34.76,26402559,31644793.05,57.118694847464305,63.5479684287436,NaN,NaN,16.915613316185006,14.073355582099794,-0.11416154001417944,0.46578403563521675,0.5799455756493962,1061029699,1044157955,53.660529964601224,58.927707702630585,NaN,NaN,19.829399036804094,22.74960699848897
2022-08-26T09:30:00-04:00,34.91,34.915,33.69,33.72,38230598,31620122.75,46.509285307679264,62.64618250659703,NaN,NaN,-28.900260118020945,-5.3273159522188465,-0.17541296063149558,0.36067937486002677,0.5360923354915224,1022799101,1033917965,51.05848494198439,59.47915975575314,NaN,NaN,15.186886920570982,21.669218415929258
2022-08-29T09:30:00-04:00,33.47,33.72,33.28,33.48,34872092,31606545.65,44.45709963748175,61.486395423904334,NaN,NaN,-86.40060004621576,-23.65031959201769,-0.22481241799264762,0.25507681300071283,0.47988923099336045,987927009,1024065581.6,48.61581989302421,59.70971210157463,NaN,NaN,10.807903099801237,20.117601942196682
2022-08-30T09:30:00-04:00,33.59,33.695,33.1,33.3,41870670,31859719.75,42.92722533525866,59.78148771822395,NaN,NaN,-100.20188050117429,-42.28528174482112,-0.2598522404073684,0.15507393048414997,0.41492617089151834,946056339,1010487857.6,45.39286695829439,59.50008502366298,NaN,NaN,6.810222286812174,18.216547705713182
2022-08-31T09:30:00-04:00,33.47,33.59,33,33.05,39768164,32482382.05,40.82585729062098,57.73027388509778,NaN,NaN,-111.74928519114425,-62.06728250807409,-0.28792985708712365,0.05501384953261379,0.34294370661973744,906288175,984820064.6,39.99493309743594,58.47937190753421,NaN,NaN,2.8607636813916844,16.022864273667253
2022-09-01T09:30:00-04:00,32.91,33.2,32.51,33.15,40604574,33287319.65,42.04789110971091,55.53410141845274,NaN,NaN,-129.01356008626328,-91.25311718856376,-0.2871793903074281,-0.016030531264547676,0.27114885904288044,946892749,961992674.6,35.90558258153567,56.80093448430977,NaN,NaN,0.019166192398983258,13.73662169062893
2022-09-02T09:30:00-04:00,33.53,33.81,32.73,32.89,43208800,33729454,39.74941485553066,53.18459816045594,NaN,NaN,-107.0887833481155,-106.89082183458268,-0.2907191990702464,-0.09225013979492758,0.19846905927531883,903683949,938169644.2,32.20478603261071,54.54823976931101,NaN,NaN,-3.066100197331758,11.336232849491688
2022-09-06T09:30:00-04:00,33.06,33.14,32.48,32.81,45877052,34804802.7,39.042231937094996,50.67674724524268,NaN,NaN,-124.713313804992,-114.55336458633792,-0.2846127194537421,-0.15729684004185884,0.12731587941188327,857806897,912145621.8,28.722120018260455,51.75231150944114,NaN,NaN,-5.808195295287036,8.887028828809013
2022-09-07T09:30:00-04:00,32.71,33.52,32.6607,33.46,35023002,35234681.5,47.25337717142625,48.964711102657056,NaN,NaN,-86.16790884743511,-111.74657025559009,-0.22554466036696263,-0.15461494604682002,0.07092971432014261,892829899,901500333.8,27.416057153644616,48.741410747781174,NaN,NaN,-5.853076701624278,6.781299467318544
2022-09-08T09:30:00-04:00,33.29,34.07,33.15,34.05,50760926,35504429.25,53.39059544827523,47.67179013047826,NaN,NaN,-39.431317380357264,-97.28297669343269,-0.13969275249225924,-0.10368622629518143,0.0360065261970778,943590825,908960863.8,29.824466268264743,45.838588527125125,NaN,NaN,-3.9343247967990735,5.250496001016027
2022-09-09T09:30:00-04:00,34.2,34.45,34.185,34.36,41327148,35221526.85,56.26967696963111,47.36010860779025,NaN,NaN,9.318279025150192,-69.61660887114998,-0.05910430379008772,-0.037873853540531854,0.021230450249555867,984917973,916565908.6,32.29081273980259,43.265358252368905,NaN,NaN,-1.4238056046130683,4.297024343069014
2022-09-12T09:30:00-04:00,34.5,34.82,34.425,34.64,41969764,35501500.9,58.74826122817803,47.87797779699492,NaN,NaN,39.0672132020526,-40.38540956111632,0.012180711775202784,0.03645633996855935,0.024275628193356564,1026887737,941206666.2,39.687126784115705,41.42434527986102,NaN,NaN,1.4422057134196153,3.8891931102619566
2022-09-13T09:30:00-04:00,33.96,34.08,33.235,33.35,60771555,37271778.8,45.853579943662375,47.58020364695313,NaN,NaN,-48.741577215091894,-25.1910622431363,-0.026323857120864838,-0.008629193207724484,0.017694663913140354,966116182,962868523.2,45.33993436281697,40.44192217312951,NaN,NaN,-0.32062605941278793,3.287790371736993
2022-09-14T09:30:00-04:00,33.42,33.575,32.95,33.25,39233194,37168400.95,45.02849623588675,47.08726337985009,NaN,NaN,-68.39647773397195,-21.636776020443666,-0.055620920114120245,-0.05183148622950995,0.003789433884610293,926882988,969679141,47.021183012399405,39.795335986342195,NaN,NaN,-1.9538698050904426,2.5389817750473593
2022-09-15T09:30:00-04:00,33.29,33.79,33.2,33.36,47653027,37893150.75,46.17580335492175,46.30562827323991,NaN,NaN,-43.65361421277275,-22.481235386926766,-0.06408261560371571,-0.07631383562003435,-0.012231220016318638,974536015,975868179,48.569306167511435,39.43167714369292,NaN,NaN,-2.8891151382327926,1.7635393588644805
2022-09-16T09:30:00-04:00,33.03,33.12,32.705,33.06,53893313,39789505.1,43.508748690806655,46.09130422917758,NaN,NaN,-91.58054358568292,-42.66099990909338,-0.08506071525200071,-0.11855711408131953,-0.03349639882931882,920642702,963013124.8,45.58940010462573,39.04102822673873,NaN,NaN,-4.491997905654486,0.8698911782189138
2022-09-19T09:30:00-04:00,32.5,33.275,32.5,33.26,36491408,39934705.95,45.75804273702133,46.18422873628755,NaN,NaN,-80.8725106917756,-66.64894468785903,-0.08068144541078551,-0.1343482055928007,-0.053666760182015195,957134110,949062399.4,42.53913955979839,38.60697963150832,NaN,NaN,-5.140609707595732,0.01124819453110737
2022-09-20T09:30:00-04:00,32.995,33.06,32.465,32.77,42193565,40203877.95,41.40794074112146,46.0757084081349,NaN,NaN,-105.87990961278489,-78.07661116739762,-0.10448853488882409,-0.18427742879304532,-0.07978889390422123,914940545,938827272,40.403288707585695,38.25058118502913,NaN,NaN,-7.043873838330904,-0.9966263815920369
2022-09-21T09:30:00-04:00,32.98,33.1,32.07,32.09,49644639,41523911.55,36.25663828313503,45.7493356218859,NaN,NaN,-140.04171971447522,-92.40565956349828,-0.15660148697634874,-0.27554075262465716,-0.11893926564830842,865295906,926509855.6,37.934800379127125,38.10342884800707,NaN,NaN,-10.405185544229122,-2.340706261968763
2022-09-22T09:30:00-04:00,32.16,32.21,31.49,31.55,52299458,43104775.4,32.770199581186645,45.08664336984845,NaN,NaN,-202.68185669619163,-124.21130806018205,-0.2144327589102939,-0.3869802142861758,-0.1725474553758819,812996448,894201942.2,32.35159034227888,37.84957225948873,NaN,NaN,-14.421178225507845,-4.066487971045775
2022-09-23T09:30:00-04:00,31.24,31.31,30.6,31.05,56800974,44624696.15,29.90292611511866,44.383322745533306,NaN,NaN,-257.33336926997316,-157.3618731970401,-0.26977510991974524,-0.5097663427755634,-0.2399912328558182,756195474,861312496.6,27.856797538307944,37.53900165275281,NaN,NaN,-18.75240959753923,-6.164476774830554
2022-09-26T09:30:00-04:00,30.82,31.11,30.34,30.56,49969720,45211652.25,27.375050410041894,43.549952636458094,NaN,NaN,-234.80410737052767,-188.14819253279052,-0.31940326733973434,-0.6392453170304861,-0.3198420496907518,706225754,811130825.4,22.679328747741067,37.10737370485857,NaN,NaN,-23.221830278227195,-8.601241561030074
2022-09-27T09:30:00-04:00,30.8,30.9586,30.12,30.43,60650379,46500566.6,26.729449696792344,42.08395781684139,NaN,NaN,-195.5961324926486,-206.09143710876324,-0.3391459452723187,-0.7437744812811502,-0.4046285360088315,645575375,757257791.4,18.667948029907265,36.482508767448756,NaN,NaN,-26.98255537202957,-11.227143534030002
2022-09-28T09:30:00-04:00,30.52,31.21,30.44,31.03,46088696,46711467.9,34.41707864629899,40.72870661670023,NaN,NaN,-133.95825920969938,-204.8747450078081,-0.29176216304134733,-0.7693312398105157,-0.4775690767691683,691664071,722531424.4,16.626505049244813,35.53979725180447,NaN,NaN,-27.780990331506178,-13.591978790812313
2022-09-29T09:30:00-04:00,30.7,30.82,30.26,30.64,41860011,46816060.25,32.06227179074972,38.999606246780125,NaN,NaN,-130.29785838512421,-190.3979453455946,-0.2673032543905318,-0.811698144757333,-0.5443948903668012,649804060,689892946.8,14.969570901329377,34.30256569191353,NaN,NaN,-29.189737675574623,-15.820230060064072
2022-09-30T09:30:00-04:00,30.66,31.04,30.28,30.36,37984314,46685047.25,30.451379980717434,36.97840044339009,NaN,NaN,-111.81711046941969,-161.2946935854839,-0.2508662075724729,-0.8579776498323923,-0.6071114422599194,611819746,661017801.2,13.671497256163605,32.44430643991695,NaN,NaN,-30.84711507028751,-17.96692791866742
2022-10-03T09:30:00-04:00,30.66,31.34,30.3,31.18,47086078,46878911.15,39.964457317381694,36.557748827227186,NaN,NaN,-78.83967220145169,-130.10180655166872,-0.1695475604655241,-0.8190458928418245,-0.6494983323763004,658905824,651553815.2,13.265477235160034,30.153273787941455,NaN,NaN,-29.18798379023107,-19.56993590031937
2022-10-04T09:30:00-04:00,31.66,32.37,31.62,32.34,53441833,47257150.2,50.31743622297794,36.935530254876554,NaN,NaN,-11.62458334896084,-93.30749672293116,-0.029740802232768537,-0.6866743351672611,-0.6569335329344925,712347657,664908271.6,17.01080417692644,28.009675299693384,NaN,NaN,-23.9374717851889,-20.193869598157875
2022-10-05T09:30:00-04:00,31.84,32.265,31.725,32.09,41766843,47594342.25,48.38102043307791,37.093045760459134,NaN,NaN,-13.312500120118974,-69.17834490501507,0.049481148985692114,-0.5950820967023773,-0.6445632456880694,670580814,660691620.2,16.764643749280552,25.73791369839118,NaN,NaN,-20.485291746594825,-20.235501333648866
2022-10-06T09:30:00-04:00,31.91,32.13,31.5709,31.64,34717920,46792191.95,45.022363906457166,37.201161133005606,NaN,NaN,-23.03429529781078,-47.72563228755239,0.07370046098832916,-0.552437669452658,-0.6261381304409872,635862894,657903387,16.59364954705144,23.666788658564446,NaN,NaN,-18.769983464161324,-20.02614163800779
2022-10-07T09:30:00-04:00,31.36,31.46,30.72,30.89,36380688,46544868.95,40.03405251276077,36.79230468841557,NaN,NaN,-63.06786626680143,-37.97578344702873,0.04286229054903168,-0.5725602672546977,-0.6154225578037293,599482206,655435879,16.43389919145838,21.802128632254444,NaN,NaN,-18.996825053296316,-19.879096411620438
2022-10-10T09:30:00-04:00,31.06,31.185,30.57,30.75,31011716,45996966.55,39.161805630850075,36.63186646625333,NaN,NaN,-69.2486805016299,-36.057585107064384,0.017962827706367257,-0.5929690231707703,-0.6109318508771375,568470490,637348812.2,15.27318873996623,20.007121491710198,NaN,NaN,-19.45440084930344,-19.818425617003722
2022-10-11T09:30:00-04:00,30.55,30.865,30.225,30.36,50431913,45479984.45,36.759123735259145,36.6677582842622,NaN,NaN,-86.1106857106673,-50.95480557940567,-0.017904454152257943,-0.6333124185674599,-0.615407964415202,518038577,598486996.2,13.12776236624785,18.235190205075963,NaN,NaN,-20.591647804161013,-19.928885929454765
2022-10-12T09:30:00-04:00,30.37,30.685,30.18,30.29,48265691,45931609.3,36.328302805555744,36.92190851457428,NaN,NaN,-85.75793929603142,-65.44389341458816,-0.038303470010853324,-0.6632873019287686,-0.6249838319179153,469772886,558325410.6,11.352905404043838,16.73528413805918,NaN,NaN,-21.629559761841126,-20.171839334081387
2022-10-13T09:30:00-04:00,29.68,31.62,29.59,31.54,83086056,47703260.75,48.03950720934114,38.21737859273303,NaN,NaN,-39.64326837056756,-68.76568802913951,0.03638869130380651,-0.5794979677881571,-0.6158866590919636,552858942,541724620.2,10.708437410893552,15.510401271815292,NaN,NaN,-18.707365969483316,-19.96262885342452
2022-10-14T09:30:00-04:00,31.82,32.19,30.94,31.01,60886878,48052939,44.317470603658435,39.42755146370563,NaN,NaN,7.7349529533503505,-54.60512418510916,0.053088294945772496,-0.549526290409748,-0.6026145853555205,491972064,520222591.8,9.922729987804018,14.5992156461055,NaN,NaN,-17.508407976607288,-19.61202587102206
2022-10-17T09:30:00-04:00,31.67,32,31.5825,31.79,47222232,48589480.2,50.40727677024038,41.11882482609478,NaN,NaN,60.18437641029768,-28.718512802723644,0.11604400676163706,-0.45755957690347415,-0.5736035836651112,539194296,514367353,9.713718511884906,13.959627823389619,NaN,NaN,-14.415197683879494,-18.86962184428741
2022-10-18T09:30:00-04:00,32.62,32.66,31.93,32.3,48150747,48887339.3,53.953312936720394,42.51427013255345,NaN,NaN,123.66139043716827,13.23590242684347,0.18719665161292764,-0.33960776914895163,-0.5268044207618793,587345043,528228646.2,14.315088264740282,13.79452662449644,NaN,NaN,-10.68924345991727,-17.70099636080596
2022-10-19T09:30:00-04:00,32.02,32.29,31.5925,31.77,35205662,48165390.45,49.95570095697238,43.79237221585505,NaN,NaN,84.16161420383165,47.219813126816085,0.19296000666718555,-0.28560441242789736,-0.4785644190950829,552139381,544701945.2,19.561822921243973,14.12254462591891,NaN,NaN,-8.918895934390342,-16.44641058560373
2022-10-20T09:30:00-04:00,31.73,32.05,31.17,31.26,43124407,47706637.9,46.393498230812156,44.931094948004684,NaN,NaN,39.47611659116528,63.04369011916265,0.15827305547164222,-0.2807230997555301,-0.43899615522717234,509014974,535933151.6,18.898454215053874,14.49589869441107,NaN,NaN,-8.611447276222368,-15.327130112834963
2022-10-21T09:30:00-04:00,31.35,32.22,31.12,32.19,54487276,47590953,52.978122469427355,45.86064245886509,NaN,NaN,73.87279387279425,76.27125830305144,0.19158768285919014,-0.19951155165318468,-0.3910992345123748,563502250,550239188.8,23.45887269485982,15.223998370103914,NaN,NaN,-6.118567589197066,-14.011621180886692
2022-10-24T09:30:00-04:00,32.38,32.77,32.28,32.62,40117237,47098328.85,55.68832582331672,46.244277430317865,NaN,NaN,137.54000990392146,91.74238500177619,0.23343247548338325,-0.09930864015814578,-0.33274111564152903,603619487,563124227,27.417620283407402,15.967342377709697,NaN,NaN,-3.2036761591638845,-12.467629034926292
2022-10-25T09:30:00-04:00,32.45,33.07,32.39,33.01,33950312,45763325.5,58.04997287693147,46.934916890593115,NaN,NaN,147.2886979390986,96.46784650216225,0.27534549086367144,0.01144074793806027,-0.26390474292561117,637569799,573169178.2,30.4381351525454,16.944020335085757,NaN,NaN,-0.06695731664754404,-10.696104503743614
2022-10-26T09:30:00-04:00,33.11,33.46,33.015,33.09,38012085,45359494.95,58.538125725652726,47.900328449107086,NaN,NaN,159.86213122818458,111.60794990703285,0.2946930735677542,0.10446159903408159,-0.19023147453367262,675581884,597857678.8,37.34007561097894,18.42590791108058,NaN,NaN,2.576921308260293,-8.799957959171628
2022-10-27T09:30:00-04:00,33.4,33.73,33.3,33.36,41232173,45328103.05,60.220569665384076,49.342222531437315,NaN,NaN,164.6439004262514,136.64150667405005,0.31033653898017305,0.1976891991915437,-0.11264733978862934,716814057,639417495.4,46.892608722547365,20.601530020444077,NaN,NaN,5.270901618789119,-6.789835162320093
2022-10-28T09:30:00-04:00,33.45,34.23,33.385,34.19,36421273,45249951,64.93151139322671,51.18291580017851,NaN,NaN,183.07400416298688,158.4817487320886,0.35786885111926325,0.3346887241104497,-0.023180127008813528,753235330,677364111.4,53.81579851993992,23.354573576156486,NaN,NaN,9.148482662513318,-4.51293261591532
2022-10-31T09:30:00-04:00,33.97,34.205,33.93,33.98,40083802,44899837.2,62.901782603522946,53.050248576483064,NaN,NaN,162.2299698262573,163.41974071655574,0.35571072637976,0.42145828096588644,0.06574755458612648,713151528,699270519.6,57.278245678520605,26.50817952703311,NaN,NaN,11.719477625940787,-2.1940168670787332
2022-11-01T09:30:00-04:00,34.26,34.345,33.92,34.07,38946147,44175052.9,63.429404044413076,54.986041522115734,NaN,NaN,140.10842406834104,161.98368594240424,0.34085529338046133,0.49181667131170315,0.1509613779312418,752097675,722176094.8,60.60404512006088,30.02611807817718,NaN,NaN,13.969708614050841,0.1150867730826346
2022-11-02T09:30:00-04:00,34,34.6,33.61,33.64,58039881,44988704.8,59.104276409535835,55.7763821792725,NaN,NaN,110.72383315402189,152.1560263275717,0.28485811655018317,0.5070340236189708,0.2221759070687876,694057794,725871276.8,61.12975193264634,33.627640544016664,NaN,NaN,14.681472790163507,2.195999061237045
2022-11-03T09:30:00-04:00,33.22,33.56,33.08,33.3,40828076,45294212.6,55.86080106280107,56.60090578349697,NaN,NaN,63.31921447824488,131.89108913797043,0.21110389675017172,0.48605577800650224,0.2749518812563305,653229718,713154409,58.24897729712227,37.079515351825115,NaN,NaN,14.36110322199346,3.933871084202247
2022-11-04T09:30:00-04:00,33.78,34.085,33.43,33.91,41825626,45566459.5,60.09220979768344,57.29268671402862,NaN,NaN,84.30834856794675,112.1379580189624,0.19023185664696401,0.5127417020650356,0.32250984541807154,695055344,701518411.8,55.664099741418354,40.36168543964892,NaN,NaN,15.313737465224847,5.55956628149119
2022-11-07T09:30:00-05:00,34.16,34.27,33.935,34.25,30060292,45518888.3,62.26367985053151,57.88628435072942,NaN,NaN,95.67882316886399,98.82772868748373,0.18593514299924735,0.5549287741671307,0.36899363116788336,725115636,703911233.4,56.095570536058865,43.34600560188597,NaN,NaN,16.75315654243574,7.1586506044832685
2022-11-08T09:30:00-05:00,34.26,34.62,34.09,34.45,34839570,44739271.15,63.52108109231679,58.85524007468259,NaN,NaN,101.39075818752897,91.08419551132131,0.18289450694962184,0.5976117648549106,0.4147172579052888,759955206,705482739.6,56.39570481907998,45.976997166017114,NaN,NaN,18.312393634397438,8.752042465899578
2022-11-09T09:30:00-05:00,34.22,34.35,33.795,33.87,42126188,44432296,57.53391950034726,59.65098445107795,NaN,NaN,71.23049566316239,83.18552801314941,0.130605919815462,0.5779746576746163,0.4473687378591543,717829018,710236984.4,57.34569745278117,48.723228825854775,NaN,NaN,17.9328773360931,10.063590304498652
2022-11-10T09:30:00-05:00,34.9,35.63,34.81,35.58,67677668,43661876.6,67.31530431140192,60.675068868361855,NaN,NaN,152.04719680644394,100.9311244787892,0.19603549800558245,0.6924131103661324,0.49637761236054995,785506686,736692378,62.27150880143735,51.4955599763246,NaN,NaN,20.91363192809609,11.613596250726857
2022-11-11T09:30:00-05:00,35.76,36.03,35.6294,35.87,46076139,42921339.65,68.63475574994598,61.599813863121085,NaN,NaN,170.4782209997029,118.16509896514044,0.24075072786019736,0.7973160221857967,0.5565652943255993,831582825,763997874.2,66.56347764171161,54.291692644774905,NaN,NaN,23.714075111488608,13.342236087978536
2022-11-14T09:30:00-05:00,35.77,35.8,35.33,35.36,38002710,42460363.55,63.75998670637836,62.00767199379586,NaN,NaN,133.2710070734812,125.68353574606388,0.2185357085825459,0.8297349300537817,0.6111992214712358,793580115,777690770,68.49876146146677,57.010308809697854,NaN,NaN,24.43802806805537,14.927349227989513
2022-11-15T09:30:00-05:00,35.74,35.875,35.0782,35.44,57802083,42942930.35,64.18964487617164,62.41135193311864,NaN,NaN,120.31335881435216,129.4680558714285,0.19268898838964454,0.8520604569582915,0.6593714685686469,851382198,795976168.4,70.91935261611604,59.40882859577908,NaN,NaN,25.141833020940492,16.38656119841108
2022-11-16T09:30:00-05:00,35.42,35.51,35.1537,35.27,32852429,42825268.7,62.49406931483529,62.573744765222294,NaN,NaN,103.52179417994829,135.9263155747857,0.1495273230670564,0.8462806224024675,0.6967532993354111,818529769,816116318.6,73.34852340258806,61.29853678721056,NaN,NaN,25.21501953800587,17.647769532638907
2022-11-17T09:30:00-05:00,34.86,35.1,34.755,35.08,35706943,42454395.5,60.568374518154634,62.262092131288576,NaN,NaN,71.54964462346747,119.8268051381904,0.09615843510900512,0.8169513432216675,0.7207929081126624,782822826,815579546.6,73.17308801764158,62.681200322760674,NaN,NaN,24.721857008544603,18.658353457768293
2022-11-18T09:30:00-05:00,35.55,35.6,35.075,35.37,39455364,41702799.9,62.4692971034925,62.23120030985783,NaN,NaN,89.79948747958485,103.69105843416678,0.06960285715249015,0.807796479553275,0.7381936224007849,822278190,813718619.6,72.52543805253576,63.77028549233319,NaN,NaN,24.835106355462568,19.540746728867475
2022-11-21T09:30:00-05:00,35.32,35.545,35.28,35.48,24630914,40928483.75,63.19409450504689,62.21439248561739,NaN,NaN,86.12056089747787,94.26096919896614,0.04959961124444667,0.8001931364563433,0.7505935252118966,846909104,824384417.4,73.94864474372568,64.72347117973781,NaN,NaN,25.12641306883525,20.338699063148585
2022-11-22T09:30:00-05:00,35.67,35.879,35.67,35.84,29582250,40710080.65,65.53964190893294,62.674061449860005,NaN,NaN,103.64660730576321,90.92761889724834,0.0505932117363449,0.8138350398823277,0.7632418281459828,876491354,829406248.6,74.61539180842801,65.68673117086509,NaN,NaN,26.025375888433523,21.15108146676072
2022-11-23T09:30:00-05:00,35.78,36.08,35.78,35.99,27916869,40205319.85,66.49766339058753,63.43383733041618,NaN,NaN,104.94968737891378,91.21319753704144,0.05117812103036656,0.8272144794339411,0.7760363584035745,904408223,846581939.4,76.80221695649767,67.01196257510618,NaN,NaN,27.043821337898873,21.992901448351883
2022-11-25T09:30:00-05:00,36.03,36.16,35.96,36.11,11266482,38707035.3,67.28132018511138,63.94734521523247,NaN,NaN,105.50700412306082,98.0046694369601,0.049445033482884204,0.8378426502571799,0.7883976167742957,915674705,873152315.2,79.7137019971014,68.72979130765496,NaN,NaN,28.11446733578377,22.867410860842153
2022-11-28T09:30:00-05:00,35.91,36.055,35.43,35.49,34206518,38596297.55,59.53306090846883,63.75230100508514,NaN,NaN,64.31545494417426,92.907862929878,-0.0009878447228389708,0.7871628108707469,0.7881506555935859,881468187,884990314.6,80.86593578896981,70.49910311143432,NaN,NaN,26.925117912278907,23.44708329676169
2022-11-29T09:30:00-05:00,35.451,35.78,35.41,35.7,31489580,38166586.45,61.164427775746745,63.58396862533014,NaN,NaN,57.14924796548094,87.11360034347861,-0.026330120962890224,0.7552380043899731,0.7815681253528634,912957767,898200047.2,82.08849600022657,72.33430248151622,NaN,NaN,26.358837427375796,23.863048172563705
2022-11-30T09:30:00-05:00,35.65,36.32,35.14,36.31,58607003,39149629.25,65.51349116145352,64.15393802969486,NaN,NaN,78.37496556320312,82.05927199496658,-0.009030532781185596,0.7702799593763814,0.779310492157567,971564770,917214730.4,83.70270007568159,74.21694552600911,NaN,NaN,27.103945709865872,24.326033535035442
2022-12-01T09:30:00-05:00,36.49,36.49,35.815,36.1,58157583,39155514.35,62.90190724306982,63.83869538195686,NaN,NaN,94.58143286102393,79.98562109138861,-0.018220625008413593,0.7565347108970499,0.7747553359054635,913407187,919014523.2,83.8510504891822,75.75834136084802,NaN,NaN,26.98101118733316,24.70531605679226
2022-12-02T09:30:00-05:00,35.72,35.96,35.61,35.93,40483338,39138277.45,60.78931913143071,63.27830705206291,NaN,NaN,63.129069113728384,71.51003408952212,-0.04093794086235447,0.7235829098275204,0.7645208506898749,872923849,910464352,80.1198366281009,76.7266527170187,NaN,NaN,26.28355288794692,24.930778461242927
2022-12-05T09:30:00-05:00,35.66,35.72,34.855,35.04,53401994,39717095.85,51.11116439722458,62.3748197442662,NaN,NaN,-28.904669608613805,52.8660091789645,-0.1167983912845939,0.6185228615841325,0.7353212528687264,819521855,898075085.6,74.91770246334768,77.18514850286734,NaN,NaN,22.61321505679764,24.5996979748936
2022-12-06T09:30:00-05:00,35,35.1963,34.45,34.73,45102232,40469192.85,48.23080823510064,61.234902841332556,NaN,NaN,-104.38428951114906,20.559301683638502,-0.18471074656219222,0.5044328196659862,0.6891435662281784,774419623,870367456.8,64.78642999456183,76.74708260132773,NaN,NaN,18.64881338429909,23.749571604808672
2022-12-07T09:30:00-05:00,34.59,34.975,34.51,34.59,37775859,40616007.3,46.94415081153185,60.124194376810884,NaN,NaN,-128.74247748224332,-20.864186925450788,-0.23281131589625637,0.3981294213578579,0.6309407372541143,736643764,823383255.6,51.955734356233975,75.21902624087387,NaN,NaN,15.011677211290825,22.501300977163265
2022-12-08T09:30:00-05:00,34.69,34.86,34.502,34.62,46600862,40839741,47.268777434021665,59.17422315651568,NaN,NaN,-153.2325910381192,-70.42699170527942,-0.25459310336125873,0.3126993580525408,0.5672924614137995,783244626,797350743.4,46.46488038635773,73.3112971243536,NaN,NaN,12.129421899535158,21.019603966073536
2022-12-09T09:30:00-05:00,34.49,34.7799,34.48,34.53,40885648,39500140,46.35249384925368,58.02302292407005,NaN,NaN,-142.45989665575186,-111.54478485917545,-0.265814801415331,0.23502395964463574,0.5008387610599667,742358978,771237769.2,41.70378559983618,71.10975052058934,NaN,NaN,9.461868175679381,19.368498853160084
2022-12-12T09:30:00-05:00,34.55,35.03,34.39,34.99,72570892,40824877.65,51.52470237972147,57.18949491511823,NaN,NaN,-94.89869992740451,-124.74359092293359,-0.23412381925363646,0.20818398699292118,0.44230780624655763,814929870,770319372.2,41.542559978268855,68.79503018019957,NaN,NaN,8.500791472042872,17.815969227286196
2022-12-13T09:30:00-05:00,35.9,35.9,34.845,35.08,55659034,41707693.85,52.48982496650587,56.2573651335163,NaN,NaN,-16.70448983224162,-107.2076309871521,-0.20027621421132596,0.1919625384824002,0.39223875269372616,870588904,789553228.4,46.23082888852497,66.7675614002065,NaN,NaN,7.960590971442301,16.408058047879926
2022-12-14T09:30:00-05:00,34.99,35.33,34.49,34.64,54685076,41551843.5,47.509711487625346,54.90108285473328,NaN,NaN,-81.05913218348515,-97.67096192740048,-0.20021811893446773,0.14196610402564147,0.3421842229601092,815903828,805405241.2,49.803928959183835,64.83911225754122,NaN,NaN,6.060837202996599,14.929883641468022
2022-12-15T09:30:00-05:00,34.1,34.24,33.735,33.96,70334043,43425924.2,41.03063287141949,53.02603376089815,NaN,NaN,-173.7275140929837,-101.76994653837338,-0.2362015809406519,0.04693224678429431,0.2831338277249462,745569785,797870273,48.16549274581881,62.585668739592464,NaN,NaN,2.3167644962039984,13.128009477858877
2022-12-16T09:30:00-05:00,33.6,33.8001,33.3943,33.7,59619437,44621548.9,38.84910391901234,51.54860826165127,NaN,NaN,-183.92377547837987,-110.06272230289896,-0.2655471102875769,-0.04880006013452487,0.216747050153052,685950348,786588547,45.73925249394438,60.07661993280493,NaN,NaN,-1.4854765433195094,11.040368617690536
2022-12-19T09:30:00-05:00,33.4,33.74,33.19,33.4,37456785,44521619.95,36.441517893706575,49.782686127219826,NaN,NaN,-168.1821326270137,-124.7194088428208,-0.2911412418759588,-0.14717950219189646,0.1439617396840623,648493563,753301285.6,39.42832330811966,57.02946474051158,NaN,NaN,-5.440414728459301,8.685970996811989
2022-12-20T09:30:00-05:00,33.53,33.77,33.4113,33.54,45446449,45562396.7,38.36127343553957,47.843242003940254,NaN,NaN,-133.40494520618233,-148.05949991760895,-0.284299041493952,-0.2114120621833777,0.07288697931057429,693940012,717971507.2,34.057247094895146,53.48336095616969,NaN,NaN,-8.157740008064392,6.279726567543934
2022-12-21T09:30:00-05:00,33.86,34.16,33.84,34.06,31318106,45649189.5,45.00559867518515,46.564934249091344,NaN,NaN,-83.86735964998408,-148.62114541090872,-0.23258636880524353,-0.21784598169598013,0.014740387109263405,725258118,699842365.2,31.6729389103469,49.75635298625288,NaN,NaN,-8.56856506359183,4.158542048810253
2022-12-22T09:30:00-05:00,33.84,33.87,33.21,33.76,25608721,45533782.1,42.180634601622586,45.23574249696219,NaN,NaN,-111.64099626027368,-136.20384184436674,-0.20726099006226936,-0.2443358504685733,-0.03707486040630394,699649397,690658287.6,30.50772502859033,46.21263072914498,NaN,NaN,-9.763012657227879,2.1697485193762347
2022-12-23T09:30:00-05:00,33.74,34,33.57,33.95,17116166,45826266.3,44.55436178020209,44.76739945288915,NaN,NaN,-82.34395707725422,-115.8878781641416,-0.1680592091679693,-0.24714887186626555,-0.07908966269829626,716765563,696821330.6,32.307435287355375,43.1690402165741,NaN,NaN,-10.055373733362186,0.42330248327074615
2022-12-27T09:30:00-05:00,34.02,34.105,33.795,33.94,25601078,45395994.3,44.45092633692491,44.49740788873375,NaN,NaN,-64.72221068532863,-95.19589377580458,-0.13459548219910694,-0.24733401544717992,-0.112738533248073,691164485,705355515,34.82454219388288,41.02890537366846,NaN,NaN,-10.32191888420304,-1.1117291406540804
2022-12-28T09:30:00-05:00,34,34.09,33.78,33.82,24395063,45041268.45,43.15617019584118,44.22683784475584,NaN,NaN,-61.91490131664374,-80.89788499789685,-0.11319565282017019,-0.25423309927328575,-0.14103744645311556,666769422,699921397,33.95865192380958,39.74339948563814,NaN,NaN,-10.89766508099224,-2.509719989273817
2022-12-29T09:30:00-05:00,34,34.35,33.92,34.29,26624198,43442128.2,49.37582673509319,44.37734136626096,NaN,NaN,-27.384891692401755,-69.60139140638039,-0.06256863770932145,-0.21924824358976736,-0.1566796058804459,693393620,693548497.4,32.924719343729066,38.77624512545038,NaN,NaN,-9.620325567021386,-3.5255207860948983
2022-12-30T09:30:00-05:00,34.04,34.265,33.92,34.2,24735712,41771034.65,48.286303817453316,44.515470649703786,NaN,NaN,-26.213823362996145,-52.51595682692488,-0.031871825751900146,-0.1965193880703211,-0.16464756231842095,668657908,687350199.6,31.907182188770292,38.07648773894567,NaN,NaN,-8.856147380646041,-4.287038871030775
2023-01-03T09:30:00-05:00,34.45,34.69,34.07,34.32,37396480,41616691.75,49.874499926891346,44.3975990459302,NaN,NaN,12.199814185246632,-33.60720257442472,-0.0018017048861229956,-0.1668996934260747,-0.1650979885399517,706054388,685207964.6,31.5443307346451,37.36232850725827,NaN,NaN,-7.771134993050373,-4.784766888462147
2023-01-04T09:30:00-05:00,34.67,35.12,34.57,34.87,44669324,41180058.25,56.47271218294656,44.68209098996168,NaN,NaN,87.5341544183006,-3.1559295536988685,0.05374499461160853,-0.09791674527544103,-0.15166173988704956,750723712,697119810,35.908837638209846,36.625043417950046,NaN,NaN,-4.798216001697022,-4.7866881903528435
2023-01-05T09:30:00-05:00,34.75,34.75,34.37,34.61,45585748,41204234.05,52.92595383751591,45.0689654435253,NaN,NaN,49.89646040938639,19.206342791507165,0.07053326685173955,-0.06349515632237512,-0.13402842317411467,705137964,704793518.4,38.62363761372385,35.82645117898862,NaN,NaN,-3.282682661152426,-4.571830257609927
2023-01-06T09:30:00-05:00,34.84,35.49,34.6,35.38,41229683,41376925.25,60.78164479014546,46.47975200914858,NaN,NaN,126.31704138364002,49.94672940671552,0.12771987293980908,0.025621418000646656,-0.1020984549391624,746367647,715388323.8,42.260170829592404,35.40464247068673,NaN,NaN,0.7174143631020505,-3.8162238832225013
2023-01-09T09:30:00-05:00,35.5,35.7,35.16,35.25,48726649,41483214.6,58.99173421115174,47.918511315729965,NaN,NaN,139.95812371679082,83.18111882267291,0.1495025587890686,0.08477974354717333,-0.06472281524189526,697640998,721184941.8,44.207886711216986,35.29525920049191,NaN,NaN,3.390399774332078,-2.7867062178575615
2023-01-10T09:30:00-05:00,35.19,35.48,35.0742,35.45,34663664,41172115.4,60.89944751087481,49.66550628838484,NaN,NaN,120.83104088114224,104.90736416185204,0.16867195142123864,0.14611712403465305,-0.02255482738658559,732304662,726434996.6,45.98509197410502,35.76359981949087,NaN,NaN,6.193043202805858,-1.5038848720485016
2023-01-11T09:30:00-05:00,35.54,35.78,35.47,35.78,32014710,39144306.3,63.88483008711399,51.488617477783016,NaN,NaN,143.85039652244168,116.17061258268025,0.19311035005532073,0.21883311018256535,0.0257227601272446,764319372,729154128.6,46.928025680553745,36.682941147037916,NaN,NaN,9.517692300458728,0.0706261525953884
2023-01-12T09:30:00-05:00,35.9,36.06,35.62,35.85,56642385,39193473.85,64.50393758353853,52.88135597123682,NaN,NaN,150.65988425964736,136.32329735273245,0.20253742819228374,0.2788945453675993,0.07635711717531554,820961757,752318887.2,54.254544174744616,38.29591295163776,NaN,NaN,12.406678960646063,1.832919410888342
2023-01-13T09:30:00-05:00,35.39,36.17,35.26,36.12,65920861,39755263.1,66.86351000401083,54.64441849997885,NaN,NaN,132.96102372829978,137.6520938216644,0.21436342744138195,0.344311401477043,0.12994797403566102,886882618,780421881.4,61.244511149756,40.49139767457816,NaN,NaN,15.591034334226919,3.79836439993671
2023-01-17T09:30:00-05:00,36.03,36.05,35.77,35.88,65345169,39505819.4,62.86330279911182,55.95220000132955,NaN,NaN,118.77658277411382,133.41578563312902,0.19403749938715403,0.37249484826960355,0.17845734888244952,821537449,805201171.6,66.15517680136813,42.909093497007646,NaN,NaN,17.14878388183687,5.705567183065304
2023-01-18T09:30:00-05:00,35.68,35.9,35.18,35.21,53693044,39209499.75,53.28017642760913,56.58286072209271,NaN,NaN,68.73997760785866,122.99757297847228,0.12674103876869683,0.33688364734332055,0.21014260857462372,767844405,812309120.2,67.43004250595271,45.23805780501264,NaN,NaN,15.542262181221222,7.110809325659006
2023-01-19T09:30:00-05:00,34.78,34.98,34.56,34.8,61169520,40395136.5,48.416169503342175,56.95857495834277,NaN,NaN,5.992550229808656,95.42600371994567,0.04983587410532461,0.2724374512062795,0.22260157710095488,706674885,800780222.8,63.26729891411969,47.33153259003478,NaN,NaN,12.585855904523877,7.892958836925416
2023-01-20T09:30:00-05:00,34.9,35.37,34.745,35.35,42330132,40239320.65,54.42657429011663,57.319342640844454,NaN,NaN,36.21368051458511,72.53676297093322,0.03209102693665339,0.2627153607717716,0.2306243338351182,749005017,786388874.8,58.41910985743635,49.15256048387102,NaN,NaN,12.00278583943722,8.480076980141389
2023-01-23T09:30:00-05:00,35.38,35.91,35.265,35.76,44997272,40923278.95,58.324854953019376,58.0363820076706,NaN,NaN,77.67953490881513,61.480465207036296,0.04334931998219971,0.28481098381286785,0.24146166383066814,794002289,767812809,52.795278514305515,50.644567364266386,NaN,NaN,12.813184061153551,9.099092277428841
2023-01-24T09:30:00-05:00,35.7,35.935,35.3,35.78,34333543,41359520.05,58.511287703257764,58.6532954202682,NaN,NaN,73.74321293846144,52.473791239905815,0.0472083503471209,0.3004721017645693,0.2532637514174484,828335832,769172485.6,53.150783950942426,52.18788545114477,NaN,NaN,13.504255950256733,9.728401373547111
2023-01-25T09:30:00-05:00,35.47,36.07,35.455,36.06,38458654,42426644.45,61.13273870900655,58.98615445784392,NaN,NaN,87.8823841147087,56.302272541275826,0.0627123646757819,0.33165420726217576,0.26894184258639386,866794486,788962501.8,58.09728575708824,53.77277460249322,NaN,NaN,14.892894240419633,10.466186068814615
2023-01-26T09:30:00-05:00,36.15,36.305,35.905,36.25,29944164,42643798.75,62.84816594381755,59.69488389400832,NaN,NaN,113.89445755531376,77.88265400637684,0.07881595939372199,0.3674617918285463,0.28864583243482433,896738650,826975254.8,65.60856628944707,55.70026950790202,NaN,NaN,16.561382118207774,11.336928361585066
2023-01-27T09:30:00-05:00,36.2,36.46,36.15,36.25,30787365,42963413.85,62.848165943817556,59.842492547842035,NaN,NaN,122.93053658634773,95.22602522072937,0.08214618879916291,0.39132856843377795,0.30918237963461503,896738650,856521981.4,70.09571069274614,57.68852235527015,NaN,NaN,17.90655394872274,12.275446302604733
2023-01-30T09:30:00-05:00,36.06,36.3299,36.01,36.07,31595005,43211954.2,59.94144180756275,59.910328804728536,NaN,NaN,97.83721461700735,99.25756116236781,0.06562133689164262,0.39120905074916834,0.3255877138575257,865143645,870750252.6,71.99087451991728,59.67302148446303,NaN,NaN,18.239170184454515,13.127406857154702
2023-01-31T09:30:00-05:00,36.14,36.57,35.97,36.56,30282099,43489273.55,64.72437373041146,60.18353782040973,NaN,NaN,120.88079650640795,108.6850778759571,0.08012623517425144,0.42574550782534004,0.3456192726510886,895425744,884168235,73.6845999792356,61.65155777054378,NaN,NaN,19.96160476310274,14.103720843718706
2023-02-01T09:30:00-05:00,36.18,36.88,36.095,36.56,51418673,44190383.2,64.72437373041146,60.2435052235024,NaN,NaN,134.8881073550654,118.08622252402844,0.08186632982520614,0.44795218493259625,0.3660858551073901,895425744,889894486.6,74.39616784886684,63.61356792542329,NaN,NaN,21.35542127986384,15.139678048882297
2023-02-02T09:30:00-05:00,36.76,36.805,36.365,36.66,42107281,44062281.05,65.69386513464656,60.328500048581546,NaN,NaN,136.6691248864794,122.64115599026158,0.0817096506744428,0.4682229184504436,0.3865132677760008,937533025,898053361.6,75.4161685264446,65.12511252197329,NaN,NaN,22.795169699631288,16.23331971327501
2023-02-03T09:30:00-05:00,36.37,36.9,36.36,36.59,43155021,43940744.7,64.3604330190976,60.14970883537346,NaN,NaN,128.61939878469664,123.77892842993137,0.06933708816030909,0.47318462797638716,0.40384753981607807,894378004,897581232.4,75.22940229088702,66.12403331776837,NaN,NaN,23.65559216837077,17.293644349717262
2023-02-06T09:30:00-05:00,36.38,36.59,36.3,36.58,32273606,43492940.85,64.16007919736205,60.24233572096277,NaN,NaN,98.18786659915254,123.84905882636039,0.053627463366375694,0.4708818690240477,0.417254405657672,862104398,896973383,74.97197613384789,66.75380469865976,NaN,NaN,24.32640666742948,18.298324680819007
2023-02-07T09:30:00-05:00,36.35,37.1052,36.35,37,33000523,42706634.55,68.58360884991859,61.335438036842014,NaN,NaN,131.18881896256377,125.91066331759157,0.06396912468058574,0.4972158115084042,0.4332466868278185,895104921,896909218.4,74.94282339950618,67.29043190534216,NaN,NaN,26.174252578501832,19.42345723763084
2023-02-08T09:30:00-05:00,36.73,37.095,36.68,36.78,34555520,42701227.35,64.1193527080325,62.45709398003419,NaN,NaN,120.93955717349985,123.12095328127846,0.04910799703715418,0.4946316831242612,0.445523686087107,860549401,889933949.8,71.67974925370874,67.89132121531281,NaN,NaN,26.545229634507816,20.44085329432755
2023-02-09T09:30:00-05:00,36.93,37.04,36.29,36.37,44329561,43316969.9,56.710693947294146,62.62024538411829,NaN,NaN,71.57390118819151,110.10190854162087,0.0069920112180169025,0.45426370010962813,0.44727168889161123,816219840,865671312.8,61.62809815768989,68.12053466533092,NaN,NaN,24.685836883880185,21.047279521406498
2023-02-10T09:30:00-05:00,36.19,36.52,36.07,36.49,28108890,41890295.15,58.231863535413225,62.61360314000357,NaN,NaN,37.79818214452713,91.93766521358697,-0.016191576505843963,0.42703221825930626,0.4432237947651502,844328730,855661458,58.01362196130316,68.4932734829736,NaN,NaN,23.5647562106501,21.4069190484413
2023-02-13T09:30:00-05:00,36.47,36.91,36.44,36.91,32209034,40204703.8,63.11699281370983,62.942582076464426,NaN,NaN,87.5778746874257,89.8156668312416,-0.007111178884165459,0.4343348211599434,0.44144600004410883,876537764,858548131.2,58.764708873295525,68.89426812028455,NaN,NaN,24.021888887148517,21.780486168256616
2023-02-14T09:30:00-05:00,36.84,37.075,36.48,36.71,33525330,38613711.85,59.545534784482555,62.82921036756985,NaN,NaN,80.08985047483569,79.59587313369597,-0.01783509350497009,0.41915213316289623,0.4369872266678663,843012434,848129633.8,54.94440911842245,68.66906264609413,NaN,NaN,23.331620110930555,22.002076731495748
2023-02-15T09:30:00-05:00,36.42,36.765,36.37,36.75,28514721,37354795.7,60.03263624759139,62.6281011035537,NaN,NaN,57.79981216573104,66.96792413214222,-0.025052912939224348,0.4056710854938359,0.43072399843306025,871527155,850325184.6,55.59948549796181,67.95412830384518,NaN,NaN,22.907390147634178,22.131407219515523
2023-02-16T09:30:00-05:00,36.4,36.66,36.31,36.38,34379073,36015273.35,53.603236902060104,61.96774902914246,NaN,NaN,22.458555918316602,57.14485507816725,-0.05580295132224439,0.36097030928025475,0.41677326060249914,837148082,854510833,56.88643389886168,67.01060853285344,NaN,NaN,20.59319650898013,21.91166283229618
2023-02-17T09:30:00-05:00,36.2,36.435,36.09,36.39,35884876,35693010.55,53.747415881622,61.52531860586098,NaN,NaN,-21.14313873707815,45.35659090184619,-0.07531266235889295,0.322632432653883,0.3979450950127759,873032958,860251678.6,58.656455806763596,66.05815005334246,NaN,NaN,18.758144680024976,21.46116023911458
2023-02-21T09:30:00-05:00,36.08,36.13,35.475,35.64,36425232,35264408.55,42.963830010074034,59.9709940544083,NaN,NaN,-161.15261185587886,-4.389506406814737,-0.13508419439507657,0.22908985201893017,0.36417404641400675,836607726,852265671,55.25787639938415,64.7419555119245,NaN,NaN,13.414740597193187,20.311671718840095
2023-02-22T09:30:00-05:00,35.64,35.78,35.41,35.6,31065167,35100989.75,42.47437138738088,58.381708172763254,NaN,NaN,-194.9001108441154,-59.387498670604955,-0.1713393078412705,0.14999991161241866,0.32133921945368915,805542559,844771696,52.201334102383115,63.15661024431853,NaN,NaN,9.023758072388674,18.699112626489892
2023-02-23T09:30:00-05:00,35.75,35.92,35.3001,35.63,42357613,35295937.7,42.99886768140263,56.760636926102976,NaN,NaN,-178.1924172877372,-106.58594456129859,-0.18609647934023182,0.08871862027839938,0.2748150996186312,847900172,840046299.4,50.311539794840186,61.36342247777536,NaN,NaN,5.626471781257666,16.83159250574243
2023-02-24T09:30:00-05:00,35.32,35.77,35.26,35.66,48732617,36235360.35,43.55311767164521,55.274400115570664,NaN,NaN,-163.8214947301662,-143.84195469099515,-0.18618141047610615,0.042088336523498526,0.22826974699960467,896632789,851943240.8,54.752801548117624,59.90080813900611,NaN,NaN,2.985395524587627,14.85356436557746
2023-02-27T09:30:00-05:00,35.99,36.05,35.5817,35.65,31664597,36279221.95,43.40162499811254,53.79165338705285,NaN,NaN,-106.05758264811475,-160.82484347320246,-0.1791939748280443,0.004277278464549283,0.1834712532925936,864968192,850330287.6,54.047463557924324,58.406200097868705,NaN,NaN,0.7537566628782825,12.83930612233472
2023-02-28T09:30:00-05:00,35.7,35.8999,35.61,35.72,32531448,36326044.1,44.847790575570734,52.09623779602799,NaN,NaN,-98.51163454788251,-148.2966480116032,-0.1626261771959254,-0.019811468202313165,0.14281470899361223,897499640,862508670.4,58.40448751265584,57.224890391665106,NaN,NaN,-0.7807600731364205,10.893582380124558
2023-03-01T09:30:00-05:00,35.56,35.76,35.46,35.6,32790337,36451456,42.82754072291436,50.57539408280528,NaN,NaN,-103.97815711185063,-130.11225726515028,-0.15267680377514842,-0.048031295725323275,0.10464550804982513,864709303,874342019.2,62.15893896583903,56.544832513960124,NaN,NaN,-2.648707133766187,8.95896959242588
2023-03-02T09:30:00-05:00,35.39,35.47,35.01,35.43,38409461,35800995.4,40.073480374435185,49.38702168474392,NaN,NaN,-127.70008038960337,-120.0137898855235,-0.15024019489687615,-0.08315473557127007,0.06708545932560608,826299842,870021953.2,60.028709347910976,56.43059045611877,NaN,NaN,-5.04033087836293,6.959069525170336
2023-03-03T09:30:00-05:00,35.57,36,35.5,35.99,33091585,35350210.6,51.20489504038441,48.88509536367044,NaN,NaN,-47.51760170279347,-96.75301128004894,-0.10571084996958187,-0.06505310313637125,0.04065774683321062,859391427,862573680.8,56.437502147181306,56.318010469395794,NaN,NaN,-4.027669293961086,5.389535408151562
2023-03-06T09:30:00-05:00,36.01,36.245,35.91,36.02,30111132,34698016.15,51.72225898275539,48.07118580431655,NaN,NaN,-11.939946940585905,-77.92948413854317,-0.07071532081408721,-0.047736404184398396,0.022978916629688817,889502559,867480554.2,58.21118316261267,56.27847291863272,NaN,NaN,-3.054000955001139,4.183315927701176
2023-03-07T09:30:00-05:00,35.89,35.92,35,35.09,53804397,35774555.7,38.20045091083253,46.54653695619869,NaN,NaN,-104.80780567811729,-79.18871836459013,-0.10463370889393606,-0.10781321948773126,-0.0031795105937952005,835698162,855120258.6,52.4211869307965,56.09824276237373,NaN,NaN,-6.7738692099636175,2.618003765177634
2023-03-08T09:30:00-05:00,35.05,35.235,34.78,34.96,50860314,36667545.25,36.75398948430155,44.88377647310657,NaN,NaN,-138.6377319024538,-86.12063332271077,-0.12867533481991192,-0.1640236791186851,-0.03534834429877318,784837848,839145967.6,46.04666714044846,55.415898593979925,NaN,NaN,-10.189457460803467,0.788366447180334
2023-03-09T09:30:00-05:00,34.76,34.815,33.37,33.54,107108500,40295194.25,25.427926179021867,42.871254278603836,NaN,NaN,-251.86884839211464,-110.95438692321302,-0.22729760502296747,-0.3194703505774825,-0.09217274555451505,677729348,809431868.8,37.02709529481399,53.99737440797652,NaN,NaN,-18.499556197568022,-1.9670510734980025
2023-03-10T09:30:00-05:00,33.145,33.72,32.525,32.93,166575162,46407474.3,22.25520267661355,40.62181047824608,NaN,NaN,-288.28381603598854,-159.10762978985204,-0.3152852709103617,-0.48627933419246716,-0.17099406328210548,511154186,739784420.6,24.776541262384583,51.57738051194945,NaN,NaN,-26.366552308010778,-5.452694106999827
2023-03-13T09:30:00-04:00,31.76,32.3199,31.365,31.63,165965875,53300323.55,17.30084994223489,38.78874047340043,NaN,NaN,-295.8125177104232,-215.88214394381947,-0.43531050312680836,-0.715132192190616,-0.2798216890638076,345188311,630921571,15.913785793401274,48.76708832580782,NaN,NaN,-35.411802720672306,-9.732566766095895
2023-03-14T09:30:00-04:00,32.84,32.845,31.87,32.27,128115514,58095647.55,26.031084755504622,37.61421999969498,NaN,NaN,-192.03491108858987,-233.327565025914,-0.4443259117452735,-0.8352290787453995,-0.390903167000126,473303825,558442703.6,12.665425132657617,45.943094827970285,NaN,NaN,-38.322143383933145,-13.816791997215502
2023-03-15T09:30:00-04:00,31.355,31.535,30.96,31.41,132235003,63031131.2,22.581403488757275,36.155829700220316,NaN,NaN,-196.55531730298108,-244.91108210601948,-0.4780036980288851,-0.9884077895362324,-0.5104040915073473,341068822,469688898.4,9.979178946307243,43.062211910217925,NaN,NaN,-42.056373450281946,-17.851017919082135
2023-03-16T09:30:00-04:00,31.2,32.34,30.9,32.01,134093142,68310052.25,29.591871136488265,35.15859780485196,NaN,NaN,-139.64362080804847,-222.46603658920623,-0.4311106833446725,-1.049292445688188,-0.6181817623435155,475161964,429175421.6,9.03697221314215,39.79679552914825,NaN,NaN,-41.957792683648535,-21.294842885448762
2023-03-17T09:30:00-04:00,31.71,31.71,30.895,30.98,136760563,73429126.75,25.34838616952395,33.86908074566706,NaN,NaN,-137.23337478082854,-192.25594833817425,-0.43921586441712945,-1.1672015928649273,-0.7279857284477979,338401401,394624864.6,8.315866214837754,36.53025286178492,NaN,NaN,-43.6296949249542,-24.48553603394954
2023-03-20T09:30:00-04:00,31.07,31.44,31.02,31.17,75384575,75404111.7,27.416105404056296,32.62396037627317,NaN,NaN,-116.98135670802304,-156.4897161376942,-0.4025093504559668,-1.2311224165177563,-0.8286130660617895,413785976,408344397.6,11.341157370253839,33.16858642304192,NaN,NaN,-44.04997947977422,-27.28045652621021
2023-03-21T09:30:00-04:00,31.88,32.04,31.81,31.96,115899169,79377808.55,35.42503900529536,32.0952102535861,NaN,NaN,-78.4386412467744,-133.7704621693311,-0.30043195179145676,-1.2041530058011105,-0.9037210540096537,529685145,419620661.6,13.857113146778303,29.71845600739473,NaN,NaN,-41.33213029000741,-29.287838492466953
2023-03-22T09:30:00-04:00,31.96,32.05,31.2,31.22,67874143,81218257.35,31.87690594060004,31.509740651169302,NaN,NaN,-84.87347855221373,-111.43409441917761,-0.25968869540403494,-1.2283319232646974,-0.9686432278606625,461811002,443769097.6,19.14859114060536,26.798447564015756,NaN,NaN,-40.468361119262646,-30.885056010580623
2023-03-23T09:30:00-04:00,31.28,31.6,30.79,31.01,82366321,83218692.75,30.930137716137338,30.061543699437372,NaN,NaN,-87.75907934252653,-101.05718612607322,-0.22510907509114686,-1.2500295717245962,-1.0249204966334493,379444681,424625641,18.194450177279023,24.06680099473702,NaN,NaN,-40.14072227542019,-32.207294048414845
2023-03-24T09:30:00-04:00,30.63,31.02,30.39,30.99,76647535,84614438.65,30.836203503349395,28.569682593765517,NaN,NaN,-90.48940615944676,-91.70839240179687,-0.18356699805485688,-1.2543792442020205,-1.0708122461471636,302797146,417504790,17.838386632031828,21.183029813981243,NaN,NaN,-39.92048522079502,-33.30917850161201
2023-03-27T09:30:00-04:00,31.52,31.59,31.235,31.42,61393348,86100876.2,35.38012875040529,28.368231010877857,NaN,NaN,-63.030687422634266,-80.91825854471912,-0.11070235731450251,-1.2091901927902917,-1.0984878354757892,364190494,407585693.6,17.329638332432367,18.676490628383807,NaN,NaN,-38.288378712155286,-34.020492817403905
2023-03-28T09:30:00-04:00,31.38,31.52,31.22,31.41,42980099,86623308.75,35.32201030425749,28.265946783731856,NaN,NaN,-59.20567599894536,-77.07166549515333,-0.04985248434872824,-1.1608034409116996,-1.1109509565629714,321210395,365890743.6,15.348117902046823,16.48373711135512,NaN,NaN,-37.01662353138044,-34.44851149082913
2023-03-29T09:30:00-04:00,31.75,31.88,31.61,31.87,52147171,87591150.45,40.18918382202141,29.320322329660392,NaN,NaN,-39.02945230635348,-67.90286024598127,0.0303848399404143,-1.0729699066374536,-1.103354746577868,373357566,348200056.4,14.586051645742685,14.880805422135742,NaN,NaN,-34.45998995098341,-34.450151270851165
2023-03-30T09:30:00-04:00,32.1,32.12,31.62,31.8,45061690,87923761.9,39.6995952329199,30.56635036939656,NaN,NaN,-32.32185756020791,-56.81541588951755,0.08467505497675942,-0.9975109278569185,-1.082185982833678,328295876,337970295.4,14.148574120641626,14.121664912011244,NaN,NaN,-32.51962447278907,-34.17436172827087
2023-03-31T09:30:00-04:00,31.98,32.16,31.86,32.15,49034438,88720904.55,43.41156533146244,32.4314014686271,NaN,NaN,-16.075340686118878,-41.932602794851974,0.14646656905507838,-0.8991027715148299,-1.0455693405699082,377330314,352876929,18.007707609880143,14.27123075604545,NaN,NaN,-29.784648526482542,-33.54725984230111
2023-04-03T09:30:00-04:00,32.115,32.3399,32.0201,32.21,51213486,89776022.25,44.047440823087484,33.71828404488302,NaN,NaN,3.390708730282134,-28.6483235642687,0.1908795893298414,-0.8069698539076064,-0.9978494432374478,428543800,365747590.2,21.2972694409943,14.887791063783782,NaN,NaN,-27.353434180618365,-32.66242760491786
2023-04-04T09:30:00-04:00,32.29,32.34,31.7,31.91,45939269,89382765.85,41.53435912679474,35.072066590457126,NaN,NaN,0.6489811403676268,-16.677392136406095,0.19866249028464922,-0.7495213303816364,-0.9481838206662856,382604531,378026417.4,24.412951442145186,15.918774813486493,NaN,NaN,-25.92283754383506,-31.699629024763173
2023-04-05T09:30:00-04:00,31.67,31.96,31.66,31.87,57965324,89738016.35,41.19685937691124,35.90099432191591,NaN,NaN,1.5726924128360016,-8.556963192568208,0.19921815015630828,-0.6991611329709002,-0.8983792831272085,324639207,368282745.6,23.614065940404117,16.959995794005206,NaN,NaN,-24.81904263240871,-30.716688111569677
2023-04-06T09:30:00-04:00,31.81,32.046,31.775,31.99,36762286,86220705.65,42.701102873554746,37.14047408648953,NaN,NaN,37.709634855039916,5.4493352904813595,0.20497155447225124,-0.6421648400368944,-0.8471363945091457,361401493,374903869,25.400527707239007,18.18032875774815,NaN,NaN,-23.48600905951986,-29.683733961276847
2023-04-10T09:30:00-04:00,31.87,32.07,31.8,32.06,27900715,79286983.3,43.60733964696639,38.29699081812597,NaN,NaN,60.88763328288136,20.841930084281408,0.2100231465225303,-0.5846074613559828,-0.7946306078785131,389302208,377298247.8,26.073851978708916,19.232664086923513,NaN,NaN,-22.11982052220762,-28.60317489855267
2023-04-11T09:30:00-04:00,32.14,32.48,32.12,32.34,53912616,73684320.35,47.20432321885958,39.13836826195199,NaN,NaN,114.29861584680249,43.023511507585475,0.22729306760588464,-0.5105142733711574,-0.737807340977042,443214824,380232452.6,26.94406636320447,20.167446459525383,NaN,NaN,-19.970353890951362,-27.369914754609624
2023-04-12T09:30:00-04:00,32.5,32.67,32.19,32.27,63645798,70460834.55,46.407379577899675,40.17625923604482,NaN,NaN,124.85868455949253,67.86545219141047,0.22846165360451187,-0.45223027397140214,-0.680691927575914,379569026,379625351.6,26.873579383137482,20.71923133399196,NaN,NaN,-18.328807811837663,-26.078328048499344
2023-04-13T09:30:00-04:00,32.29,32.575,32.07,32.56,58550281,66776598.45,50.16139741785461,41.54992064331034,NaN,NaN,119.6329915597864,91.47751202080053,0.2419306241504271,-0.3782786473878801,-0.6202092715383072,438119307,402321371.6,33.841524109934994,21.836879472038817,NaN,NaN,-15.878349611777335,-24.62118827182477
2023-04-14T09:30:00-04:00,32.9,33.15,32.72,32.88,65054415,63324662.1,53.9911391235561,43.203844616182245,NaN,NaN,181.97748280544886,120.33108161088232,0.26376629282465824,-0.2905014055074844,-0.5542676983321426,503173722,430675817.4,41.35924312028972,23.516940649771524,NaN,NaN,-12.648396417360235,-22.910789435472694
2023-04-17T09:30:00-04:00,32.86,33.27,32.72,33.26,69670589,59970163.4,58.10788635626582,44.82725587374371,NaN,NaN,185.74443775440142,145.30244250518632,0.2929292670554922,-0.18810611451277737,-0.4810353815682696,572844311,467384238,49.3789893853259,25.80618001069249,NaN,NaN,-8.586231344615154,-20.864423993921616
2023-04-18T09:30:00-04:00,33.33,33.4299,33.08,33.36,49507548,58676312.05,59.14391219372099,46.52882029441968,NaN,NaN,187.12690532081774,159.86810039998937,0.30661949223492174,-0.09776101627461742,-0.40438050850953916,622351859,503211645,55.74103368706256,28.691388281050756,NaN,NaN,-4.872317416366728,-18.579837339985204
2023-04-19T09:30:00-04:00,33.31,33.53,33.25,33.44,39478861,54855296.65,59.99625372005769,47.94361100142227,NaN,NaN,165.78386541073758,168.0531365702384,0.30791883271806386,-0.019481967611959305,-0.32740080033002317,661830720,559663983.8,63.520739119166706,32.18672310058104,NaN,NaN,-1.4948821644261008,-16.139129457762476
2023-04-20T09:30:00-04:00,33.22,33.4308,33.21,33.34,39291820,53426180.5,58.35737317078848,49.27630942555574,NaN,NaN,133.8019685732695,170.886931972935,0.28919470435719574,0.03409258011647154,-0.2551021242407242,622538900,596547902.4,67.53591729263798,36.00010475572367,NaN,NaN,0.9874288189870998,-13.69247827536968
2023-04-21T09:30:00-04:00,33.24,33.26,33.03,33.22,41545017,51385115.3,56.3675333057367,50.20173570943247,NaN,NaN,102.67148261413621,155.02573193467248,0.2569663168871236,0.06610577186818034,-0.19086054501894328,580993883,612111934.6,69.082363532751,39.64829446450016,NaN,NaN,2.6347005372697567,-11.360024159278332